"DATE","TOTAL_CASES","NEW_CASES","TOTAL_CONFIRMED","NEW_CONFIRMED","TOTAL_PROBABLE","NEW_PROBABLE","POS_TESTS","NEW_POS_TESTS","NEG_TESTS","NEW_NEG_TESTS","TOTAL_TESTS","NEW_TESTS","NEW_DEATHS","TOTAL_DEATHS","NEW_HOSPITALIZED","TOTAL_HOSPITALIZED","TOTAL_DEATHS_BY_DOD","NEW_DEATHS_BY_DOD","Region","Population","New_cases_per_100k_per_week","PositivityRate_per_week","Tests_per_100k","New_cases_per_100k","PositivityPercentage_per_week"
2022-12-10,152812,23,114101,11,38711,12,123156,11,560392,73,683548,84,0,1551,0,2813,1552,0,"Knox County",470313,NA,NA,17.8604461284294,4.8903602494509,NA
2022-12-09,152789,79,114090,43,38699,36,123145,44,560319,243,683464,287,0,1551,0,2813,1552,0,"Knox County",470313,NA,NA,61.0231909388003,16.7973243350705,NA
2022-12-08,152710,97,114047,56,38663,41,123101,57,560076,288,683177,345,0,1551,0,2813,1552,0,"Knox County",470313,NA,NA,73.3554037417635,20.6245627911625,NA
2022-12-07,152613,105,113991,58,38622,47,123044,59,559788,307,682832,366,1,1551,0,2813,1552,0,"Knox County",470313,NA,NA,77.8205152738708,22.3255576605367,NA
2022-12-06,152508,79,113933,55,38575,24,122985,57,559481,265,682466,322,1,1550,0,2813,1552,0,"Knox County",470313,NA,NA,68.4650434923126,16.7973243350705,NA
2022-12-05,152429,110,113878,51,38551,59,122928,50,559216,271,682144,321,0,1549,0,2813,1552,0,"Knox County",470313,NA,NA,68.2524191336408,23.3886794538956,NA
2022-12-04,152319,18,113827,9,38492,9,122878,10,558945,62,681823,72,0,1549,0,2813,1552,0,"Knox County",470313,108.651047281279,0.160267111853088,15.308953824368,3.82723845609201,16.0267111853088
2022-12-03,152301,31,113818,16,38483,15,122868,16,558883,116,681751,132,0,1549,0,2813,1552,0,"Knox County",470313,110.352042150653,0.158807588075881,28.0664153446747,6.59135511882512,15.8807588075881
2022-12-02,152270,91,113802,56,38468,35,122852,57,558767,403,681619,460,0,1549,0,2813,1552,0,"Knox County",470313,112.903534454714,0.151635282457879,97.807204989018,19.3488166391318,15.1635282457879
2022-12-01,152179,91,113746,46,38433,45,122795,50,558364,292,681159,342,6,1549,0,2813,1552,0,"Knox County",470313,111.627788302684,0.148387096774194,72.7175306657481,19.3488166391318,14.8387096774194
2022-11-30,152088,80,113700,47,38388,33,122745,47,558072,407,680817,454,1,1543,0,2813,1552,0,"Knox County",470313,106.312179335889,0.136471707085116,96.5314588369873,17.0099486937423,13.6471707085117
2022-11-29,152008,89,113653,58,38355,31,122698,57,557665,334,680363,391,0,1542,0,2813,1552,0,"Knox County",470313,108.438422922607,0.132136279926335,83.1361242406653,18.9235679217883,13.2136279926335
2022-11-28,151919,76,113595,31,38324,45,122641,31,557331,260,679972,291,0,1542,0,2813,1552,2,"Knox County",470313,101.209194727766,0.125116713352007,61.8736883734874,16.1594512590551,12.5116713352007
2022-11-27,151843,42,113564,4,38279,38,122610,5,557071,111,679681,116,0,1542,0,2813,1550,0,"Knox County",470313,106.312179335889,0.120311070448307,24.6644256059263,8.93022306421468,12.0311070448307
2022-11-26,151801,27,113560,7,38241,20,122605,7,556960,48,679565,55,0,1542,0,2813,1550,0,"Knox County",470313,105.461681901202,0.120436225699384,11.6943397269478,5.74085768413801,12.0436225699384
2022-11-25,151774,36,113553,15,38221,21,122598,15,556912,91,679510,106,0,1542,0,2813,1550,0,"Knox County",470313,93.7673421742542,0.120797720797721,22.5381820192085,7.65447691218401,12.0797720797721
2022-11-24,151738,14,113538,6,38200,8,122583,7,556821,93,679404,100,0,1542,0,2813,1550,0,"Knox County",470313,77.3952665565272,0.111698612029081,21.2624358671778,2.97674102140489,11.1698612029081
2022-11-23,151724,63,113532,31,38192,32,122576,31,556728,241,679304,272,0,1542,0,2813,1550,0,"Knox County",470313,73.780652459107,0.114951164537941,57.8338255587237,13.395334596322,11.4951164537941
2022-11-22,151661,63,113501,32,38160,31,122545,32,556487,210,679032,242,1,1542,0,2813,1550,0,"Knox County",470313,68.2524191336408,0.1082910321489,51.4550947985703,13.395334596322,10.82910321489
2022-11-21,151598,69,113469,14,38129,55,122513,18,556277,122,678790,140,0,1541,0,2813,1550,1,"Knox County",470313,66.7640486229383,0.111542192046557,29.7674102140489,14.6710807483527,11.1542192046557
2022-11-20,151529,20,113455,15,38074,5,122495,16,556155,80,678650,96,0,1541,0,2813,1549,0,"Knox County",470313,62.0863127321592,0.124629080118694,20.4119384324907,4.25248717343556,12.4629080118694
2022-11-19,151509,18,113440,11,38069,7,122479,11,556075,63,678554,74,0,1541,0,2813,1549,2,"Knox County",470313,60.1726935041132,0.12621359223301,15.7342025417116,3.82723845609201,12.621359223301
2022-11-18,151491,45,113429,26,38062,19,122468,29,556012,189,678480,218,0,1541,0,2813,1547,1,"Knox County",470313,62.0863127321592,0.126094570928196,46.3521101904476,9.56809614023002,12.6094570928196
2022-11-17,151446,51,113403,24,38043,27,122439,23,555823,193,678262,216,1,1541,0,2813,1546,0,"Knox County",470313,69.953414003015,0.127186009538951,45.9268614731041,10.8438422922607,12.7186009538951
2022-11-16,151395,64,113379,36,38016,28,122416,35,555630,184,678046,219,1,1540,0,2813,1546,0,"Knox County",470313,70.1660383616868,0.136099585062241,46.5647345491194,13.6079589549938,13.6099585062241
2022-11-15,151331,63,113343,36,37988,27,122381,36,555446,216,677827,252,0,1539,0,2813,1546,0,"Knox County",470313,70.1660383616868,0.138271604938272,53.5813383852881,13.395334596322,13.8271604938272
2022-11-14,151268,62,113307,22,37961,40,122345,23,555230,135,677575,158,0,1539,0,2813,1546,0,"Knox County",470313,68.6776678509843,0.140308191403082,33.594648670141,13.1827102376502,14.0308191403082
2022-11-13,151206,13,113285,6,37921,7,122322,6,555095,81,677417,87,0,1539,0,2813,1546,1,"Knox County",470313,67.1892973402819,0.133169934640523,18.4983192044447,2.76411666273312,13.3169934640523
2022-11-12,151193,24,113279,9,37914,15,122316,12,555014,86,677330,98,0,1539,0,2813,1545,0,"Knox County",470313,68.4650434923126,0.131410256410256,20.8371871498343,5.10298460812268,13.1410256410256
2022-11-11,151169,31,113270,17,37899,14,122304,17,554928,140,677232,157,0,1539,0,2813,1545,0,"Knox County",470313,65.4883024709077,0.128053917438922,33.3820243114692,6.59135511882512,12.8053917438922
2022-11-10,151138,57,113253,24,37885,33,122287,25,554788,133,677075,158,0,1539,0,2813,1545,0,"Knox County",470313,66.7640486229383,0.136403897254207,33.594648670141,12.1195884442914,13.6403897254207
2022-11-09,151081,89,113229,51,37852,38,122262,52,554655,494,676917,546,0,1539,0,2813,1545,1,"Knox County",470313,72.0796575897328,0.117445054945055,116.092899834791,18.9235679217883,11.7445054945055
2022-11-08,150992,68,113178,41,37814,27,122210,44,554161,237,676371,281,1,1539,0,2813,1544,0,"Knox County",470313,73.1427793830917,0.120538720538721,59.7474447867697,14.4584563896809,12.0538720538721
2022-11-07,150924,86,113137,33,37787,53,122166,33,553924,142,676090,175,0,1538,0,2813,1544,1,"Knox County",470313,78.2457639912144,0.125832223701731,37.2092627675612,18.2856948457729,12.5832223701731
2022-11-06,150838,27,113104,12,37734,15,122133,11,553782,70,675915,81,0,1538,0,2813,1543,0,"Knox County",470313,81.2225050126193,0.129679144385027,17.222573052414,5.74085768413801,12.9679144385027
2022-11-05,150811,20,113092,13,37719,7,122122,13,553712,85,675834,98,0,1538,0,2813,1543,1,"Knox County",470313,80.3720075779321,0.130347593582888,20.8371871498343,4.25248717343556,13.0347593582888
2022-11-04,150791,80,113079,58,37712,22,122109,58,553627,300,675736,358,2,1538,0,2813,1542,1,"Knox County",470313,90.7906011528493,0.139068945197407,76.1195204044966,17.0099486937423,13.9068945197407
2022-11-03,150711,90,113021,57,37690,33,122051,59,553327,394,675378,453,2,1536,0,2813,1541,0,"Knox County",470313,97.807204989018,0.135542168674699,96.3188344783155,19.13619228046,13.5542168674699
2022-11-02,150621,86,112964,42,37657,44,121992,43,552933,314,674925,357,0,1534,0,2813,1541,1,"Knox County",470313,97.1693319130026,0.144758735440932,75.9068960458248,18.2856948457729,14.4758735440932
2022-11-01,150535,80,112922,44,37613,36,121949,41,552619,249,674568,290,4,1534,0,2813,1540,0,"Knox County",470313,99.720824217064,0.142384105960265,61.6610640148157,17.0099486937423,14.2384105960265
2022-10-31,150455,129,112878,73,37577,56,121908,77,552370,399,674278,476,0,1530,0,2813,1540,0,"Knox County",470313,108.86367163995,0.142924751538097,101.209194727766,27.4285422686594,14.2924751538098
2022-10-30,150326,5,112805,5,37521,0,121831,5,551971,27,673802,32,0,1530,0,2813,1540,0,"Knox County",470313,104.185935749171,0.143410852713178,6.8039794774969,1.06312179335889,14.3410852713178
2022-10-29,150321,16,112800,8,37521,8,121826,9,551944,79,673770,88,0,1530,0,2813,1540,0,"Knox County",470313,103.335438314484,0.142161635832522,18.7109435631165,3.40198973874845,14.2161635832522
2022-10-28,150305,66,112792,30,37513,36,121817,33,551865,153,673682,186,0,1530,0,2813,1540,0,"Knox County",470313,100.358697293079,0.141870350690755,39.5481307129507,14.0332076723374,14.1870350690755
2022-10-27,150239,81,112762,59,37477,22,121784,61,551712,254,673496,315,-1,1530,0,2813,1540,0,"Knox County",470313,98.4450780650333,0.154243119266055,66.9766729816101,17.222573052414,15.4243119266055
2022-10-26,150158,72,112703,35,37455,37,121723,37,551458,233,673181,270,4,1531,0,2813,1540,0,"Knox County",470313,95.4683370436284,0.15872057936029,57.4085768413801,15.308953824368,15.872057936029
2022-10-25,150086,62,112668,28,37418,34,121686,32,551225,179,672911,211,0,1527,1,2813,1540,1,"Knox County",470313,91.6410985875364,0.160963244613435,44.8637396797452,13.1827102376502,16.0963244613435
2022-10-24,150024,91,112640,40,37384,51,121654,43,551046,127,672700,170,0,1527,0,2812,1539,0,"Knox County",470313,83.5613729580088,0.172955974842767,36.1461409742023,19.3488166391318,17.2955974842767
2022-10-23,149933,25,112600,15,37333,10,121611,15,550919,59,672530,74,0,1527,0,2812,1539,0,"Knox County",470313,87.8138601314444,0.17503805175038,15.7342025417116,5.31560896679445,17.503805175038
2022-10-22,149908,16,112585,9,37323,7,121596,9,550860,86,672456,95,0,1527,0,2812,1539,1,"Knox County",470313,87.8138601314444,0.174110522331567,20.1993140738189,3.40198973874845,17.4110522331567
2022-10-21,149892,62,112576,41,37316,21,121587,42,550774,228,672361,270,0,1527,0,2812,1538,0,"Knox County",470313,86.9633626967573,0.170106761565836,57.4085768413801,13.1827102376502,17.0106761565836
2022-10-20,149830,63,112535,36,37295,27,121545,37,550546,250,672091,287,2,1527,0,2812,1538,0,"Knox County",470313,83.1361242406653,0.156136528685548,61.0231909388003,13.395334596322,15.6136528685548
2022-10-19,149767,58,112499,39,37268,19,121508,41,550296,125,671804,166,0,1525,0,2812,1538,2,"Knox County",470313,80.1593832192604,0.172034564021995,35.2956435395152,12.3322128029631,17.2034564021995
2022-10-18,149709,55,112460,35,37249,20,121467,37,550171,184,671638,221,4,1525,2,2812,1536,1,"Knox County",470313,78.6710127085579,0.174590802805924,46.989983266463,11.6943397269478,17.4590802805924
2022-10-17,149654,78,112425,42,37229,36,121430,44,549987,122,671417,166,2,1521,0,2810,1535,1,"Knox County",470313,75.9068960458248,0.175918686473808,35.2956435395152,16.5846999763987,17.5918686473808
2022-10-16,149576,12,112383,6,37193,6,121386,7,549865,55,671251,62,0,1519,0,2810,1534,3,"Knox County",470313,73.1427793830917,0.171270718232044,13.1827102376502,2.55149230406134,17.1270718232044
2022-10-15,149564,15,112377,8,37187,7,121379,8,549810,127,671189,135,0,1519,0,2810,1531,0,"Knox County",470313,72.9301550244199,0.165263963274675,28.70428842069,3.18936538007667,16.5263963274675
2022-10-14,149549,43,112369,24,37180,19,121371,26,549683,114,671054,140,0,1519,1,2810,1531,1,"Knox County",470313,68.8902922096561,0.169923534409516,29.7674102140489,9.14284742288646,16.9923534409516
2022-10-13,149506,54,112345,29,37161,25,121345,34,549569,155,670914,189,1,1519,0,2809,1530,0,"Knox County",470313,66.9766729816101,0.182576459684893,40.1860037889661,11.481715368276,18.2576459684893
2022-10-12,149452,63,112316,42,37136,21,121311,46,549414,221,670725,267,0,1518,0,2809,1530,2,"Knox County",470313,68.039794774969,0.171186440677966,56.7707037653648,13.395334596322,17.1186440677966
2022-10-11,149389,73,112274,29,37115,44,121265,28,549193,183,670458,211,1,1518,0,2809,1528,0,"Knox County",470313,71.867033231061,0.164957264957265,44.8637396797452,15.5215781830398,16.4957264957265
2022-10-10,149316,68,112245,37,37071,31,121237,41,549010,139,670247,180,2,1517,1,2809,1528,0,"Knox County",470313,69.7407896443432,0.160472972972973,38.2723845609201,14.4584563896809,16.0472972972973
2022-10-09,149248,36,112208,24,37040,12,121196,27,548871,139,670067,166,0,1515,0,2808,1528,0,"Knox County",470313,74.8437742524659,0.16304347826087,35.2956435395152,7.65447691218401,16.304347826087
2022-10-08,149212,31,112184,18,37028,13,121169,17,548732,125,669901,142,0,1515,0,2808,1528,2,"Knox County",470313,78.2457639912144,0.169111969111969,30.1926589313925,6.59135511882512,16.9111969111969
2022-10-07,149181,55,112166,30,37015,25,121152,32,548607,257,669759,289,0,1515,1,2808,1526,2,"Knox County",470313,80.7972562952757,0.155817174515235,61.4484396561439,11.6943397269478,15.5817174515235
2022-10-06,149126,98,112136,64,36990,34,121120,70,548350,275,669470,345,6,1515,0,2807,1524,0,"Knox County",470313,90.1527280768339,0.163125,73.3554037417635,20.8371871498343,16.3125
2022-10-05,149028,80,112072,40,36956,40,121050,41,548075,182,669125,223,0,1509,0,2807,1524,1,"Knox County",470313,93.7673421742542,0.16452442159383,47.4152319838065,17.0099486937423,16.452442159383
2022-10-04,148948,47,112032,31,36916,16,121009,32,547893,327,668902,359,0,1509,0,2807,1523,0,"Knox County",470313,88.2391088487879,0.152582159624413,76.3321447631684,9.99334485757357,15.2582159624413
2022-10-03,148901,110,112001,35,36900,75,120977,36,547566,111,668543,147,1,1509,1,2807,1523,1,"Knox County",470313,97.1693319130026,0.152603231597846,31.2557807247514,23.3886794538956,15.2603231597846
2022-10-02,148791,19,111966,10,36825,9,120941,12,547455,92,668396,104,0,1508,0,2806,1522,1,"Knox County",470313,93.5547178155824,0.149160969546302,22.1129333018649,4.03986281476378,14.9160969546302
2022-10-01,148772,29,111956,20,36816,9,120929,22,547363,81,668292,103,0,1508,0,2806,1521,0,"Knox County",470313,93.1294690982388,0.156050955414013,21.9003089431931,6.16610640148157,15.6050955414013
2022-09-30,148743,76,111936,46,36807,30,120907,50,547282,166,668189,216,1,1508,0,2806,1521,1,"Knox County",470313,97.5945806303462,0.175684702738811,45.9268614731041,16.1594512590551,17.5684702738811
2022-09-29,148667,64,111890,38,36777,26,120857,42,547116,226,667973,268,2,1507,0,2806,1520,0,"Knox County",470313,90.3653524355057,0.165492957746479,56.9833281240365,13.6079589549938,16.5492957746479
2022-09-28,148603,76,111852,45,36751,31,120815,48,546890,241,667705,289,4,1505,2,2806,1520,0,"Knox County",470313,89.5148550008186,0.162853297442799,61.4484396561439,16.1594512590551,16.28532974428
2022-09-27,148527,92,111807,54,36720,38,120767,56,546649,171,667416,227,1,1501,0,2804,1520,0,"Knox County",470313,99.0829511410486,0.196454948301329,48.2657294184936,19.5614409978036,19.6454948301329
2022-09-26,148435,69,111753,29,36682,40,120711,33,546478,92,667189,125,0,1500,0,2804,1520,0,"Knox County",470313,90.3653524355057,0.197447447447447,26.5780448339723,14.6710807483527,19.7447447447447
2022-09-25,148366,28,111724,17,36642,11,120678,16,546386,89,667064,105,0,1500,0,2804,1520,1,"Knox County",470313,92.2789716635517,0.200300075018755,22.3255576605367,5.95348204280979,20.0300075018755
2022-09-24,148338,14,111707,10,36631,4,120662,10,546297,65,666959,75,0,1500,0,2804,1519,1,"Knox County",470313,89.089606283475,0.195402298850575,15.9468269003834,2.97674102140489,19.5402298850575
2022-09-23,148324,75,111697,46,36627,29,120652,50,546232,192,666884,242,5,1500,0,2804,1518,3,"Knox County",470313,88.8769819248033,0.191585274229902,51.4550947985703,15.9468269003834,19.1585274229902
2022-09-22,148249,97,111651,66,36598,31,120602,73,546040,233,666642,306,4,1495,1,2804,1515,0,"Knox County",470313,95.893585760972,0.20891161431702,65.0630537535641,20.6245627911625,20.891161431702
2022-09-21,148152,89,111585,54,36567,35,120529,59,545807,226,666336,285,3,1491,1,2803,1515,0,"Knox County",470313,98.6577024237051,0.217582417582418,60.5979422214568,18.9235679217883,21.7582417582418
2022-09-20,148063,84,111531,35,36532,49,120470,38,545581,168,666051,206,1,1488,0,2802,1515,3,"Knox County",470313,96.9567075543308,0.207589285714286,43.8006178863863,17.8604461284294,20.7589285714286
2022-09-19,147979,113,111496,46,36483,67,120432,51,545413,152,665845,203,0,1487,0,2802,1512,0,"Knox County",470313,106.312179335889,0.208860759493671,43.162744810371,24.0265525299109,20.8860759493671
2022-09-18,147866,49,111450,37,36416,12,120381,40,545261,95,665642,135,0,1487,1,2802,1512,1,"Knox County",470313,110.777290867996,0.221074380165289,28.70428842069,10.4185935749171,22.1074380165289
2022-09-17,147817,41,111413,16,36404,25,120341,18,545166,117,665507,135,0,1487,0,2801,1511,0,"Knox County",470313,116.518148552134,0.217592592592593,28.70428842069,8.7175987055429,21.7592592592593
2022-09-16,147776,91,111397,33,36379,58,120323,39,545049,295,665372,334,0,1487,0,2801,1511,0,"Knox County",470313,119.920138290883,0.198254364089776,71.0165357963739,19.3488166391318,19.8254364089776
2022-09-15,147685,146,111364,82,36321,64,120284,87,544754,288,665038,375,2,1487,0,2801,1511,1,"Knox County",470313,130.3387318658,0.198445905558876,79.7341345019168,31.0431563660796,19.8445905558876
2022-09-14,147539,126,111282,67,36257,59,120197,74,544466,220,664663,294,4,1485,0,2801,1510,1,"Knox County",470313,138.205833136656,0.206302021403092,62.5115614495028,26.790669192644,20.6302021403092
2022-09-13,147413,106,111215,62,36198,44,120123,65,544246,213,664369,278,0,1481,0,2801,1509,1,"Knox County",470313,142.883569027435,0.213226909920182,59.1095717107543,22.5381820192085,21.3226909920182
2022-09-12,147307,116,111153,49,36154,67,120058,57,544033,137,664091,194,0,1481,0,2801,1508,1,"Knox County",470313,143.52144210345,0.217765042979943,41.249125582325,24.6644256059263,21.7765042979943
2022-09-11,147191,48,111104,26,36087,22,120001,27,543896,77,663897,104,0,1481,0,2801,1507,1,"Knox County",470313,143.308817744778,0.214119019836639,22.1129333018649,10.2059692162454,21.4119019836639
2022-09-10,147143,72,111078,50,36065,22,119974,54,543819,139,663793,193,0,1481,0,2801,1506,0,"Knox County",470313,149.900172863604,0.227426636568849,41.0365012236532,15.308953824368,22.7426636568849
2022-09-09,147071,154,111028,103,36043,51,119920,112,543680,259,663600,371,0,1481,0,2801,1506,4,"Knox County",470313,163.295507459926,0.263128800442233,78.8836370672297,32.7441512354538,26.3128800442233
2022-09-08,146917,178,110925,115,35992,63,119808,122,543421,336,663229,458,0,1481,0,2801,1502,1,"Knox County",470313,170.099486937423,0.270084566596195,97.3819562716744,37.8471358435765,27.0084566596195
2022-09-07,146739,181,110810,97,35929,84,119686,105,543085,263,662771,368,0,1481,0,2801,1501,2,"Knox County",470313,181.79382666437,0.275686673448627,78.2457639912144,38.4850089195918,27.5686673448627
2022-09-06,146558,167,110713,97,35845,70,119581,98,542822,162,662403,260,-1,1481,0,2801,1499,0,"Knox County",470313,194.763912543349,0.29517453798768,55.2823332546623,35.508267898187,29.517453798768
2022-09-05,146391,45,110616,14,35775,31,119483,16,542660,56,662143,72,0,1482,1,2801,1499,2,"Knox County",470313,179.667583077653,0.292442497261774,15.308953824368,9.56809614023002,29.2442497261774
2022-09-04,146346,87,110602,56,35744,31,119467,58,542604,130,662071,188,0,1482,0,2800,1497,2,"Knox County",470313,187.959933065852,0.295811518324607,39.9733794302943,18.4983192044447,29.5811518324607
2022-09-03,146259,90,110546,58,35713,32,119409,68,542474,155,661883,223,0,1482,0,2800,1495,0,"Knox County",470313,191.787171521944,0.298453608247423,47.4152319838065,19.13619228046,29.8453608247423
2022-09-02,146169,227,110488,167,35681,60,119341,177,542319,396,661660,573,1,1482,1,2800,1495,1,"Knox County",470313,207.308749704984,0.300653594771242,121.833757518929,48.2657294184936,30.0653594771242
2022-09-01,145942,168,110321,88,35621,80,119164,95,541923,227,661087,322,3,1481,1,2799,1494,0,"Knox County",470313,205.182506118266,0.307577268195414,68.4650434923126,35.7208922568587,30.7577268195414
2022-08-31,145774,277,110233,168,35541,109,119069,182,541696,301,660765,483,1,1478,0,2798,1494,2,"Knox County",470313,225.594444550757,0.327204148986327,102.697565238469,58.8969473520825,32.7204148986327
2022-08-30,145497,249,110065,148,35432,101,118887,158,541395,216,660282,374,-1,1477,0,2798,1492,0,"Knox County",470313,243.029641961842,0.337360178970917,79.521510143245,52.9434653092728,33.7360178970917
2022-08-29,145248,240,109917,111,35331,129,118729,118,541179,123,659908,241,0,1478,0,2798,1492,2,"Knox County",470313,284.491391902839,0.356073211314476,51.2424704398985,51.0298460812268,35.6073211314476
2022-08-28,145008,105,109806,76,35202,29,118611,81,541056,137,659667,218,1,1478,0,2798,1490,1,"Knox County",470313,288.318630358931,0.36113393590797,46.3521101904476,22.3255576605367,36.113393590797
2022-08-27,144903,135,109730,73,35173,62,118530,77,540919,211,659449,288,0,1477,0,2798,1489,0,"Knox County",470313,297.886726499161,0.355342136854742,61.2358152974721,28.70428842069,35.5342136854742
2022-08-26,144768,230,109657,154,35111,76,118453,167,540708,352,659161,519,0,1477,0,2798,1489,0,"Knox County",470313,298.524599575177,0.359100204498978,110.352042150653,48.903602494509,35.9100204498978
2022-08-25,144538,254,109503,144,35035,110,118286,155,540356,326,658642,481,3,1477,0,2798,1489,1,"Knox County",470313,316.810294420949,0.360215053763441,102.272316521125,54.0065871026317,36.0215053763441
2022-08-24,144284,281,109359,162,34925,119,118131,169,540030,272,658161,441,2,1474,1,2798,1488,0,"Knox County",470313,317.660791855637,0.361046057767369,93.7673421742542,59.7474447867697,36.1046057767369
2022-08-23,144003,286,109197,174,34806,112,117962,188,539758,292,657720,480,4,1472,0,2797,1488,0,"Knox County",470313,325.527893126492,0.357946026986507,102.059692162454,60.8105665801286,35.7946026986507
2022-08-22,143717,281,109023,151,34694,130,117774,155,539466,276,657240,431,0,1468,1,2797,1488,0,"Knox County",470313,334.245491832035,0.347095871238628,91.6410985875364,59.7474447867697,34.7095871238628
2022-08-21,143436,129,108872,90,34564,39,117619,104,539190,196,656809,300,0,1468,0,2796,1488,0,"Knox County",470313,339.348476440158,0.345238095238095,63.7873076015334,27.4285422686594,34.5238095238095
2022-08-20,143307,75,108782,52,34525,23,117515,61,538994,123,656509,184,0,1468,0,2796,1488,2,"Knox County",470313,326.591014919851,0.352256699576869,39.1228819956072,15.9468269003834,35.2256699576869
2022-08-19,143232,211,108730,146,34502,65,117454,149,538871,248,656325,397,0,1468,0,2796,1486,0,"Knox County",470313,322.551152105087,0.361459100957996,84.4118703926959,44.8637396797452,36.1459100957996
2022-08-18,143021,616,108584,212,34437,404,117305,222,538623,286,655928,508,0,1468,2,2796,1486,3,"Knox County",470313,399.521169944271,0.382342210871945,108.013174205263,130.976604941815,38.2342210871945
2022-08-17,142405,199,108372,135,34033,64,117083,149,538337,266,655420,415,3,1468,0,2794,1483,1,"Knox County",470313,382.085972533185,0.378637200736648,88.2391088487879,42.3122473756839,37.8637200736648
2022-08-16,142206,260,108237,175,33969,85,116934,191,538071,191,655005,382,4,1465,0,2794,1482,1,"Knox County",470313,376.557739207719,0.393962552541078,81.2225050126193,55.2823332546623,39.3962552541078
2022-08-15,141946,236,108062,145,33884,91,116743,147,537880,154,654623,301,1,1461,0,2794,1481,0,"Knox County",470313,366.989643067489,0.411338962605549,63.9999319602052,50.1793486465396,41.1338962605549
2022-08-14,141710,90,107917,69,33793,21,116596,79,537726,122,654322,201,1,1460,0,2794,1481,1,"Knox County",470313,358.69729307929,0.417922948073702,42.7374960930274,19.13619228046,41.7922948073702
2022-08-13,141620,98,107848,67,33772,31,116517,79,537604,154,654121,233,0,1459,0,2794,1480,0,"Knox County",470313,363.587653328741,0.416906032006565,49.5414755705243,20.8371871498343,41.6906032006565
2022-08-12,141522,211,107781,145,33741,66,116438,150,537450,338,653888,488,1,1459,1,2794,1480,1,"Knox County",470313,363.587653328741,0.402294303797468,103.760687031828,44.8637396797452,40.2294303797468
2022-08-11,141311,178,107636,128,33675,50,116288,133,537112,188,653400,321,0,1458,0,2793,1479,2,"Knox County",470313,270.458184230502,0.396411789833405,68.2524191336408,37.8471358435765,39.6411789833405
2022-08-10,141133,222,107508,158,33625,64,116155,168,536924,255,653079,423,1,1458,0,2793,1477,1,"Knox County",470313,275.348544479953,0.403150276713495,89.9401037181622,47.2026076251348,40.3150276713495
2022-08-09,140911,272,107350,192,33561,80,115987,199,536669,349,652656,548,5,1457,0,2793,1476,3,"Knox County",470313,277.900036784014,0.379721669980119,116.518148552134,57.8338255587237,37.9721669980119
2022-08-08,140639,237,107158,150,33481,87,115788,156,536320,327,652108,483,2,1452,0,2793,1473,0,"Knox County",470313,278.112661142686,0.35743418613274,102.697565238469,50.3919730052114,35.743418613274
2022-08-07,140402,84,107008,58,33394,26,115632,61,535993,115,651625,176,1,1450,0,2793,1473,1,"Knox County",470313,276.836914990655,0.354041916167665,37.421887126233,17.8604461284294,35.4041916167665
2022-08-06,140318,96,106950,69,33368,27,115571,74,535878,102,651449,176,0,1449,1,2793,1472,1,"Knox County",470313,276.411666273312,0.359847036328872,37.421887126233,20.4119384324907,35.9847036328872
2022-08-05,140222,205,106881,121,33341,84,115497,120,535776,281,651273,401,2,1449,1,2792,1471,2,"Knox County",470313,275.135920121281,0.360363924050633,85.262367827383,43.5879935277145,36.0363924050633
2022-08-04,140017,191,106760,128,33257,63,115377,136,535495,239,650872,375,5,1447,0,2791,1469,3,"Knox County",470313,277.900036784014,0.353989155693261,79.7341345019168,40.6112525063096,35.3989155693261
2022-08-03,139826,205,106632,121,33194,84,115241,126,535256,289,650497,415,-2,1442,0,2791,1466,1,"Knox County",470313,274.285422686594,0.338772338772339,88.2391088487879,43.5879935277145,33.8772338772339
2022-08-02,139621,283,106511,173,33110,110,115115,181,534967,308,650082,489,0,1444,0,2791,1465,1,"Knox County",470313,276.624290631983,0.339562624254473,103.9733113905,60.1726935041132,33.9562624254473
2022-08-01,139338,175,106338,99,33000,76,114934,110,534659,133,649593,243,4,1444,1,2791,1464,1,"Knox County",470313,263.441580394333,0.355164835164835,51.6677191572421,37.2092627675612,35.5164835164835
2022-07-31,139163,99,106239,64,32924,35,114824,73,534526,153,649350,226,0,1440,0,2790,1463,1,"Knox County",470313,266.63094577441,0.352688172043011,48.0531050598219,21.049811508506,35.2688172043011
2022-07-30,139064,116,106175,85,32889,31,114751,95,534373,203,649124,298,0,1440,0,2790,1462,1,"Knox County",470313,270.883432947845,0.343686146301594,63.3620588841899,24.6644256059263,34.3686146301594
2022-07-29,138948,218,106090,151,32858,67,114656,154,534170,298,648826,452,0,1440,0,2790,1461,1,"Knox County",470313,273.647549610578,0.350280224179343,96.1062101196437,46.3521101904476,35.0280224179343
2022-07-28,138730,282,105939,187,32791,95,114502,203,533872,319,648374,522,1,1440,0,2790,1460,1,"Knox County",470313,292.99636624971,0.356143667296786,110.989915226668,59.9600691454414,35.6143667296786
2022-07-27,138448,198,105752,129,32696,69,114299,134,533553,248,647852,382,4,1439,0,2790,1459,0,"Knox County",470313,291.507995739008,0.363705972434916,81.2225050126193,42.0996230170121,36.3705972434916
2022-07-26,138250,300,105623,229,32627,71,114165,237,533305,239,647470,476,1,1435,1,2790,1459,1,"Knox County",470313,295.122609836428,0.387071950750289,101.209194727766,63.7873076015334,38.7071950750289
2022-07-25,137950,289,105394,172,32556,117,113928,181,533066,249,646994,430,1,1434,0,2789,1458,2,"Knox County",470313,319.361786725011,0.386575735821967,91.4284742288646,61.4484396561439,38.6575735821967
2022-07-24,137661,112,105222,68,32439,44,113747,73,532817,178,646564,251,0,1433,0,2789,1456,1,"Knox County",470313,322.125903387744,0.383137673425827,53.3687140266163,23.8139281712392,38.3137673425827
2022-07-23,137549,110,105154,53,32395,57,113674,59,532639,143,646313,202,0,1433,0,2789,1455,0,"Knox County",470313,320.850157235713,0.383425414364641,42.9501204516992,23.3886794538956,38.3425414364641
2022-07-22,137439,262,105101,183,32338,79,113615,190,532496,309,646111,499,0,1433,0,2789,1455,1,"Knox County",470313,330.205629017271,0.389934829833454,106.099554977217,55.7075819720059,38.9934829833454
2022-07-21,137177,286,104918,175,32259,111,113425,179,532187,354,645612,533,0,1433,2,2789,1454,2,"Knox County",470313,331.056126451959,0.379733141002524,113.328783172058,60.8105665801286,37.9733141002524
2022-07-20,136891,223,104743,142,32148,81,113246,153,531833,318,645079,471,5,1433,0,2787,1452,0,"Knox County",470313,336.371735418753,0.374563242487771,100.146072934408,47.4152319838065,37.4563242487771
2022-07-19,136668,226,104601,144,32067,82,113093,148,531515,234,644608,382,1,1428,1,2787,1452,2,"Knox County",470313,320.637532877041,0.355130057803468,81.2225050126193,48.0531050598219,35.5130057803468
2022-07-18,136442,347,104457,205,31985,142,112945,231,531281,382,644226,613,1,1427,0,2786,1450,1,"Knox County",470313,332.969745680005,0.350050830227042,130.3387318658,73.780652459107,35.0050830227042
2022-07-17,136095,76,104252,62,31843,14,112714,69,530899,87,643613,156,0,1426,0,2786,1449,1,"Knox County",470313,325.315268767821,0.360294117647059,33.1693999527974,16.1594512590551,36.0294117647059
2022-07-16,136019,102,104190,65,31829,37,112645,67,530812,123,643457,190,1,1426,0,2786,1448,2,"Knox County",470313,323.614273898446,0.364627285513361,40.3986281476379,21.6876845845214,36.4627285513361
2022-07-15,135917,191,104125,119,31792,72,112578,129,530689,326,643267,455,0,1425,2,2786,1446,2,"Knox County",470313,308.51794443275,0.348571428571429,96.7440831956591,40.6112525063096,34.8571428571429
2022-07-14,135726,205,104006,143,31720,62,112449,145,530363,239,642812,384,1,1425,0,2784,1444,5,"Knox County",470313,291.295371380336,0.355337608449642,81.6477537299628,43.5879935277145,35.5337608449642
2022-07-13,135521,267,103863,171,31658,96,112304,179,530124,320,642428,499,0,1424,0,2784,1439,1,"Knox County",470313,300.650843161894,0.361328854050019,106.099554977217,56.7707037653648,36.1328854050019
2022-07-12,135254,236,103692,162,31562,74,112125,171,529804,293,641929,464,4,1424,0,2784,1438,1,"Knox County",470313,302.777086748612,0.358927924664976,98.6577024237051,50.1793486465396,35.8927924664976
2022-07-11,135018,200,103530,136,31488,64,111954,143,529511,253,641465,396,0,1420,1,2784,1437,0,"Knox County",470313,271.521306023861,0.354952830188679,84.1992460340241,42.5248717343556,35.4952830188679
2022-07-10,134818,83,103394,43,31424,40,111811,42,529258,87,641069,129,0,1420,1,2783,1437,1,"Knox County",470313,273.009676534563,0.34803337306317,27.4285422686594,17.6478217697576,34.803337306317
2022-07-09,134735,118,103351,78,31384,40,111769,78,529171,105,640940,183,0,1420,0,2782,1436,2,"Knox County",470313,276.411666273312,0.353386454183267,38.9102576369354,25.0896743232698,35.3386454183267
2022-07-08,134617,193,103273,125,31344,68,111691,132,529066,304,640757,436,1,1420,0,2782,1434,0,"Knox County",470313,276.836914990655,0.357286230429546,92.7042203808953,41.0365012236532,35.7286230429546
2022-07-07,134424,181,103148,105,31276,76,111559,109,528762,205,640321,314,0,1419,0,2782,1434,4,"Knox County",470313,271.733930382532,0.352746798843453,66.7640486229383,38.4850089195918,35.2746798843453
2022-07-06,134243,227,103043,156,31200,71,111450,157,528557,228,640007,385,3,1419,1,2782,1430,0,"Knox County",470313,263.228956035661,0.360641525791071,81.8603780886346,48.2657294184936,36.0641525791071
2022-07-05,134016,164,102887,118,31129,46,111293,122,528329,118,639622,240,0,1416,1,2781,1430,1,"Knox County",470313,247.920002211293,0.375900144023044,51.0298460812268,34.8703948221716,37.5900144023044
2022-07-04,133852,79,102769,44,31083,35,111171,47,528211,123,639382,170,1,1416,1,2780,1429,0,"Knox County",470313,222.192454812008,0.369951534733441,36.1461409742023,16.7973243350705,36.9951534733441
2022-07-03,133773,105,102725,65,31048,40,111124,69,528088,159,639212,228,0,1415,0,2779,1429,0,"Knox County",470313,226.870190702787,0.365030674846626,48.4783537771654,22.3255576605367,36.5030674846626
2022-07-02,133668,108,102660,75,31008,33,111055,79,527929,200,638984,279,0,1415,0,2779,1429,3,"Knox County",470313,224.74394711607,0.348440545808967,59.3221960694261,22.963430736552,34.8440545808967
2022-07-01,133560,184,102585,124,30975,60,110976,130,527729,318,638705,448,0,1415,1,2779,1426,1,"Knox County",470313,222.830327888024,0.345445736434109,95.2557126849566,39.1228819956072,34.5445736434108
2022-06-30,133376,195,102461,118,30915,77,110846,124,527411,308,638257,432,1,1415,2,2778,1425,1,"Knox County",470313,225.807068909428,0.333638863428048,91.8537229462082,41.4617499409967,33.3638863428048
2022-06-29,133181,184,102343,120,30838,64,110722,131,527103,244,637825,375,2,1414,0,2776,1424,1,"Knox County",470313,216.664221486542,0.323204419889503,79.7341345019168,39.1228819956072,32.3204419889503
2022-06-28,132997,183,102223,116,30774,67,110591,122,526859,265,637450,387,1,1412,0,2776,1423,0,"Knox County",470313,220.704084301306,0.302716688227684,82.2856268059781,38.9102576369354,30.2716688227684
2022-06-27,132814,142,102107,100,30707,42,110469,102,526594,167,637063,269,0,1411,0,2776,1423,0,"Knox County",470313,234.099418897628,0.313068651778329,57.1959524827083,30.1926589313925,31.3068651778329
2022-06-26,132672,89,102007,57,30665,32,110367,62,526427,168,636794,230,0,1411,0,2776,1423,0,"Knox County",470313,230.697429158879,0.309917355371901,48.903602494509,18.9235679217883,30.9917355371901
2022-06-25,132583,104,101950,60,30633,44,110305,71,526259,203,636564,274,0,1411,0,2776,1423,0,"Knox County",470313,229.846931724192,0.307246376811594,58.2590742760672,22.1129333018649,30.7246376811594
2022-06-24,132479,145,101890,119,30589,26,110234,128,526056,386,636290,514,0,1411,1,2776,1423,2,"Knox County",470313,221.554581735993,0.298266827891979,109.288920357294,30.8305320074078,29.8266827891979
2022-06-23,132334,185,101771,128,30563,57,110106,136,525670,304,635776,440,1,1411,1,2775,1421,0,"Knox County",470313,219.428338149275,0.302129369224588,93.5547178155824,39.335506354279,30.2129369224588
2022-06-22,132149,182,101643,127,30506,55,109970,131,525366,331,635336,462,0,1410,0,2774,1421,0,"Knox County",470313,219.003089431931,0.291925465838509,98.2324537063615,38.6976332782636,29.1925465838509
2022-06-21,131967,177,101516,88,30451,89,109839,95,525035,175,634874,270,1,1410,1,2774,1421,0,"Knox County",470313,217.727343279901,0.294835298901993,57.4085768413801,37.6345114849047,29.4835298901993
2022-06-20,131790,120,101428,84,30362,36,109744,91,524860,157,634604,248,0,1409,0,2773,1421,1,"Knox County",470313,213.049607389122,0.292863002461034,52.730840950601,25.5149230406134,29.2863002461034
2022-06-19,131670,89,101344,59,30326,30,109653,65,524703,198,634356,263,0,1409,0,2773,1420,0,"Knox County",470313,213.049607389122,0.290165924726831,55.9202063306777,18.9235679217883,29.0165924726831
2022-06-18,131581,99,101285,81,30296,18,109588,87,524505,194,634093,281,-1,1409,0,2773,1420,0,"Knox County",470313,211.986485595763,0.295803066989508,59.7474447867697,21.049811508506,29.5803066989508
2022-06-17,131482,133,101204,85,30278,48,109501,89,524311,254,633812,343,3,1410,2,2773,1420,1,"Knox County",470313,209.434993291701,0.300823580407456,72.9301550244199,28.2790397033465,30.0823580407456
2022-06-16,131349,138,101119,104,30230,34,109412,108,524057,301,633469,409,1,1407,0,2771,1419,0,"Knox County",470313,199.441648434128,0.292618629173989,86.9633626967573,29.3421614967054,29.2618629173989
2022-06-15,131211,113,101015,81,30196,32,109304,85,523756,264,633060,349,0,1406,0,2771,1419,1,"Knox County",470313,184.770567685775,0.286638927415626,74.2059011764506,24.0265525299109,28.6638927415626
2022-06-14,131098,170,100934,106,30164,64,109219,114,523492,244,632711,358,2,1406,0,2771,1418,0,"Knox County",470313,183.282197175073,0.283873833851622,76.1195204044966,36.1461409742023,28.3873833851622
2022-06-13,130928,117,100828,71,30100,46,109105,71,523248,150,632353,221,1,1404,0,2771,1418,2,"Knox County",470313,182.644324099057,0.278327338129496,46.989983266463,24.877049964598,27.8327338129496
2022-06-12,130811,79,100757,44,30054,35,109034,48,523098,129,632132,177,1,1403,1,2771,1416,1,"Knox County",470313,180.51808051234,0.281571562207671,37.6345114849047,16.7973243350705,28.1571562207671
2022-06-11,130732,102,100713,82,30019,20,108986,93,522969,227,631955,320,0,1402,0,2770,1415,0,"Knox County",470313,181.155953588355,0.279283417547083,68.039794774969,21.6876845845214,27.9283417547083
2022-06-10,130630,122,100631,77,29999,45,108893,88,522742,368,631635,456,0,1402,1,2770,1415,0,"Knox County",470313,178.817085642965,0.265065502183406,96.9567075543308,25.9401717579569,26.5065502183406
2022-06-09,130508,161,100554,107,29954,54,108805,114,522374,330,631179,444,1,1402,0,2769,1415,0,"Knox County",470313,183.707445892416,0.263655913978495,94.4052152502695,34.2325217461563,26.3655913978495
2022-06-08,130347,150,100447,100,29900,50,108691,116,522044,324,630735,440,0,1401,0,2769,1415,0,"Knox County",470313,191.574547163272,0.266556291390728,93.5547178155824,31.8936538007667,26.6556291390728
2022-06-07,130197,121,100347,70,29850,51,108575,71,521720,169,630295,240,0,1401,0,2769,1415,0,"Knox County",470313,181.155953588355,0.261531766753699,51.0298460812268,25.7275473992852,26.1531766753699
2022-06-06,130076,116,100277,79,29799,37,108504,81,521551,280,630055,361,0,1401,1,2769,1415,0,"Knox County",470313,180.943329229683,0.250615258408532,76.7573934805119,24.6644256059263,25.0615258408532
2022-06-05,129960,75,100198,54,29762,21,108423,57,521271,233,629694,290,3,1401,1,2768,1415,0,"Knox County",470313,180.092831794996,0.243041944335555,61.6610640148157,15.9468269003834,24.3041944335555
2022-06-04,129885,86,100144,72,29741,14,108366,76,521038,300,629404,376,0,1398,0,2767,1415,1,"Knox County",470313,176.690842056248,0.231300345224396,79.9467588605886,18.2856948457729,23.1300345224396
2022-06-03,129799,132,100072,90,29727,42,108290,96,520738,346,629028,442,0,1398,1,2767,1414,3,"Knox County",470313,178.817085642965,0.235634400308523,93.9799665329259,28.0664153446747,23.5634400308523
2022-06-02,129667,114,99982,88,29685,26,108194,96,520392,284,628586,380,0,1398,0,2766,1411,0,"Knox County",470313,168.823740785392,0.234480031633057,80.7972562952757,24.2391768885827,23.4480031633057
2022-06-01,129553,169,99894,90,29659,79,108098,105,520108,303,628206,408,1,1398,1,2766,1411,0,"Knox County",470313,172.863603600156,0.233079695634762,86.7507383380855,35.9335166155305,23.3079695634762
2022-05-31,129384,129,99804,94,29580,35,107993,96,519805,214,627798,310,0,1397,2,2765,1411,0,"Knox County",470313,174.56459846953,0.236462797039346,65.9135511882512,27.4285422686594,23.6462797039346
2022-05-30,129255,57,99710,32,29545,25,107897,36,519591,118,627488,154,0,1397,3,2763,1411,0,"Knox County",470313,162.019761307895,0.238135593220339,32.7441512354538,12.1195884442914,23.8135593220339
2022-05-29,129198,56,99678,43,29520,13,107861,46,519473,200,627334,246,0,1397,0,2760,1411,1,"Knox County",470313,157.979898493131,0.237910189982729,52.3055922332574,11.9069640856196,23.7910189982729
2022-05-28,129142,69,99635,56,29507,13,107815,58,519273,229,627088,287,0,1397,0,2760,1410,0,"Knox County",470313,154.365284395711,0.23933542882802,61.0231909388003,14.6710807483527,23.933542882802
2022-05-27,129073,98,99579,66,29494,32,107757,67,519044,417,626801,484,2,1397,2,2760,1410,0,"Knox County",470313,147.13605620087,0.222124283825474,102.910189597141,20.8371871498343,22.2124283825474
2022-05-26,128975,102,99513,78,29462,24,107690,82,518627,367,626317,449,1,1395,3,2758,1410,1,"Knox County",470313,144.584563896809,0.209580838323353,95.4683370436284,21.6876845845214,20.9580838323353
2022-05-25,128873,108,99435,79,29438,29,107608,86,518260,264,625868,350,2,1394,0,2755,1409,1,"Knox County",470313,131.614478017831,0.206578947368421,74.4185255351224,22.963430736552,20.6578947368421
2022-05-24,128765,106,99356,68,29409,38,107522,73,517996,281,625518,354,0,1392,1,2755,1408,0,"Knox County",470313,126.72411776838,0.192771084337349,75.2690229698095,22.5381820192085,19.2771084337349
2022-05-23,128659,107,99288,71,29371,36,107449,70,517715,337,625164,407,1,1392,2,2754,1408,0,"Knox County",470313,137.355335701969,0.187039192859915,86.5381139794137,22.7508063778803,18.7039192859915
2022-05-22,128552,47,99217,38,29335,9,107379,40,517378,180,624757,220,1,1391,2,2752,1408,0,"Knox County",470313,135.441716473923,0.186593492747942,46.7773589077912,9.99334485757357,18.6593492747942
2022-05-21,128505,55,99179,45,29326,10,107339,49,517198,208,624537,257,0,1390,3,2750,1408,0,"Knox County",470313,132.464975452518,0.185243950813169,54.644460178647,11.6943397269478,18.5243950813169
2022-05-20,128450,87,99134,59,29316,28,107290,63,516990,225,624280,288,0,1390,1,2747,1408,0,"Knox County",470313,130.126107507128,0.199139784946237,61.2358152974721,18.4983192044447,19.9139784946237
2022-05-19,128363,95,99075,67,29288,28,107227,69,516765,254,623992,323,6,1390,1,2746,1408,0,"Knox County",470313,128.637736996426,0.204638472032742,68.6776678509843,20.1993140738189,20.4638472032742
2022-05-18,128268,82,99008,54,29260,28,107158,56,516511,239,623669,295,1,1384,1,2745,1408,0,"Knox County",470313,123.10950367096,0.19589552238806,62.7241858081746,17.4351974110858,19.589552238806
2022-05-17,128186,80,98954,51,29232,29,107102,54,516272,315,623374,369,2,1383,0,2744,1408,0,"Knox County",470313,117.581270345493,0.185734136174155,78.4583883498861,17.0099486937423,18.5734136174155
2022-05-16,128106,64,98903,40,29203,24,107048,39,515957,254,623005,293,0,1381,1,2744,1408,1,"Knox County",470313,108.438422922607,0.180929095354523,62.298937090831,13.6079589549938,18.0929095354523
2022-05-15,128042,39,98863,25,29179,14,107009,27,515703,174,622712,201,0,1381,1,2743,1407,0,"Knox County",470313,106.737428053233,0.176209279368213,42.7374960930274,8.29234998819935,17.6209279368213
2022-05-14,128003,29,98838,21,29165,8,106982,22,515529,145,622511,167,0,1381,1,2742,1407,0,"Knox County",470313,101.209194727766,0.170454545454545,35.508267898187,6.16610640148157,17.0454545454545
2022-05-13,127974,77,98817,55,29157,22,106960,58,515384,251,622344,309,-3,1381,0,2741,1407,1,"Knox County",470313,99.0829511410486,0.166070516096065,65.7009268295794,16.3720756177269,16.6070516096065
2022-05-12,127897,72,98762,45,29135,27,106902,49,515133,301,622035,350,1,1384,0,2741,1406,1,"Knox County",470313,94.1925908915977,0.153729838709677,74.4185255351224,15.308953824368,15.3729838709677
2022-05-11,127825,47,98717,33,29108,14,106853,35,514832,177,621685,212,0,1383,0,2741,1405,0,"Knox County",470313,86.7507383380855,0.149395055234087,45.076364038417,9.99334485757357,14.9395055234087
2022-05-10,127778,78,98684,40,29094,38,106818,43,514655,322,621473,365,1,1383,3,2741,1405,1,"Knox County",470313,86.3254896207419,0.143911439114391,77.607890915199,16.5846999763987,14.3911439114391
2022-05-09,127700,54,98644,31,29056,23,106775,32,514333,181,621108,213,0,1382,1,2738,1404,0,"Knox County",470313,84.1992460340242,0.146395156851954,45.2889883970888,11.481715368276,14.6395156851954
2022-05-08,127646,31,98613,23,29033,8,106743,24,514152,133,620895,157,0,1382,0,2737,1404,0,"Knox County",470313,82.4982511646499,0.148336153412296,33.3820243114692,6.59135511882512,14.8336153412296
2022-05-07,127615,17,98590,10,29025,7,106719,13,514019,174,620738,187,0,1382,0,2737,1404,0,"Knox County",470313,79.9467588605886,0.141662018962632,39.7607550716225,3.61461409742023,14.1662018962632
2022-05-06,127598,51,98580,30,29018,21,106706,34,513845,209,620551,243,0,1382,1,2737,1404,1,"Knox County",470313,74.4185255351224,0.13317892298784,51.6677191572421,10.8438422922607,13.317892298784
2022-05-05,127547,48,98550,31,28997,17,106672,34,513636,185,620308,219,1,1382,0,2736,1403,0,"Knox County",470313,69.3155409269997,0.134711779448622,46.5647345491194,10.2059692162454,13.4711779448622
2022-05-04,127499,54,98519,35,28980,19,106638,38,513451,249,620089,287,1,1381,0,2736,1403,0,"Knox County",470313,70.8039114377021,0.130460801915021,61.0231909388003,11.481715368276,13.0460801915021
2022-05-03,127445,34,98484,21,28961,13,106600,24,513202,145,619802,169,0,1380,0,2736,1403,1,"Knox County",470313,61.4484396561439,0.134915254237288,35.9335166155305,7.22922819484046,13.4915254237288
2022-05-02,127411,37,98463,28,28948,9,106576,32,513057,190,619633,222,3,1380,2,2736,1402,0,"Knox County",470313,57.8338255587237,0.134097035040431,47.2026076251348,7.86710127085579,13.4097035040431
2022-05-01,127374,14,98435,9,28939,5,106544,9,512867,82,619411,91,0,1377,0,2734,1402,0,"Knox County",470313,54.2192114613034,0.129760225669958,19.3488166391318,2.97674102140489,12.9760225669958
2022-04-30,127360,19,98426,14,28934,5,106535,15,512785,141,619320,156,0,1377,0,2734,1402,0,"Knox County",470313,54.644460178647,0.134102379235761,33.1693999527974,4.03986281476378,13.4102379235761
2022-04-29,127341,24,98412,14,28929,10,106520,13,512644,200,619164,213,0,1377,0,2734,1402,1,"Knox County",470313,48.903602494509,0.121591746499632,45.2889883970888,5.10298460812268,12.1591746499632
2022-04-28,127317,32,98398,25,28919,7,106507,26,512444,226,618951,252,1,1377,0,2734,1401,0,"Knox County",470313,45.5016127557605,0.11294964028777,53.5813383852881,6.8039794774969,11.294964028777
2022-04-27,127285,35,98373,25,28912,10,106481,27,512218,181,618699,208,0,1376,0,2734,1401,0,"Knox County",470313,41.4617499409967,0.111365369946606,44.2258666037299,7.44185255351224,11.1365369946606
2022-04-26,127250,39,98348,21,28902,18,106454,21,512037,240,618491,261,0,1376,0,2734,1401,0,"Knox County",470313,42.5248717343556,0.101924447612259,55.4949576133341,8.29234998819935,10.1924447612259
2022-04-25,127211,60,98327,16,28884,44,106433,17,511797,101,618230,118,0,1376,2,2734,1401,1,"Knox County",470313,47.4152319838065,0.0985373364126251,25.0896743232698,12.7574615203067,9.85373364126251
2022-04-24,127151,15,98311,11,28840,4,106416,12,511696,148,618112,160,1,1376,0,2732,1400,1,"Knox County",470313,47.6278563424783,0.0957602339181287,34.0198973874845,3.18936538007667,9.57602339181287
2022-04-23,127136,12,98300,5,28836,7,106404,7,511548,197,617952,204,0,1375,0,2732,1399,0,"Knox County",470313,46.1394858317759,0.086864406779661,43.3753691690427,2.55149230406134,8.6864406779661
2022-04-22,127124,26,98295,19,28829,7,106397,21,511351,210,617748,231,0,1375,0,2732,1399,0,"Knox County",470313,46.5647345491194,0.0913528591352859,49.1162268531808,5.52823332546623,9.13528591352859
2022-04-21,127098,32,98276,23,28822,9,106376,23,511141,231,617517,254,0,1375,0,2732,1399,0,"Knox County",470313,46.5647345491194,0.0891364902506964,54.0065871026317,6.8039794774969,8.91364902506964
2022-04-20,127066,55,98253,32,28813,23,106353,34,510910,247,617263,281,1,1375,0,2732,1399,1,"Knox County",470313,50.817221722555,0.0894632206759443,59.7474447867697,11.6943397269478,8.94632206759443
2022-04-19,127011,29,98221,16,28790,13,106319,17,510663,151,616982,168,0,1374,0,2732,1398,0,"Knox County",470313,48.6909781358372,0.0925141242937853,35.7208922568587,6.16610640148157,9.25141242937853
2022-04-18,126982,38,98205,21,28777,17,106302,21,510512,117,616814,138,0,1374,1,2732,1398,0,"Knox County",470313,44.0132422450581,0.0940111420612813,29.3421614967054,8.07972562952757,9.40111420612813
2022-04-17,126944,16,98184,10,28760,6,106281,9,510395,101,616676,110,0,1374,0,2731,1398,1,"Knox County",470313,44.2258666037299,0.0952380952380952,23.3886794538956,3.40198973874845,9.52380952380952
2022-04-16,126928,10,98174,10,28754,0,106272,12,510294,126,616566,138,0,1374,0,2731,1397,0,"Knox County",470313,43.8006178863863,0.103787878787879,29.3421614967054,2.12624358671778,10.3787878787879
2022-04-15,126918,18,98164,13,28754,5,106260,13,510168,198,616428,211,0,1374,0,2731,1397,0,"Knox County",470313,42.0996230170121,0.0992307692307692,44.8637396797452,3.82723845609201,9.92307692307692
2022-04-14,126900,17,98151,5,28749,12,106247,6,509970,158,616217,164,1,1374,0,2731,1397,1,"Knox County",470313,38.9102576369354,0.0925619834710744,34.8703948221716,3.61461409742023,9.25619834710744
2022-04-13,126883,39,98146,26,28737,13,106241,28,509812,209,616053,237,-1,1373,0,2731,1396,1,"Knox County",470313,35.508267898187,0.0909090909090909,50.3919730052114,8.29234998819935,9.09090909090909
2022-04-12,126844,23,98120,6,28724,17,106213,8,509603,192,615816,200,5,1374,0,2731,1395,0,"Knox County",470313,34.2325217461563,0.0809682804674457,42.5248717343556,4.8903602494509,8.09682804674457
2022-04-11,126821,22,98114,13,28707,9,106205,13,509411,173,615616,186,1,1369,2,2731,1395,1,"Knox County",470313,30.8305320074078,0.0714285714285714,39.5481307129507,4.67773589077912,7.14285714285714
2022-04-10,126799,9,98101,7,28698,2,106192,7,509238,110,615430,117,0,1368,1,2729,1394,0,"Knox County",470313,29.3421614967054,0.0694333599361532,24.877049964598,1.913619228046,6.94333599361532
2022-04-09,126790,7,98094,5,28696,2,106185,5,509128,148,615313,153,0,1368,0,2728,1394,0,"Knox County",470313,28.70428842069,0.0630914826498423,32.5315268767821,1.48837051070245,6.30914826498423
2022-04-08,126783,18,98089,15,28694,3,106180,16,508980,176,615160,192,1,1368,0,2728,1394,0,"Knox County",470313,28.70428842069,0.066453162530024,40.8238768649814,3.82723845609201,6.6453162530024
2022-04-07,126765,16,98074,7,28691,9,106164,10,508804,181,614968,191,5,1367,0,2728,1394,0,"Knox County",470313,28.4916640620183,0.0681818181818182,40.6112525063096,3.40198973874845,6.81818181818182
2022-04-06,126749,21,98067,14,28682,7,106154,16,508623,204,614777,220,-1,1362,0,2728,1394,2,"Knox County",470313,24.6644256059263,0.0595710881652105,46.7773589077912,4.46511153210734,5.95710881652105
2022-04-05,126728,15,98053,12,28675,3,106138,13,508419,198,614557,211,4,1363,0,2728,1392,2,"Knox County",470313,22.963430736552,0.062992125984252,44.8637396797452,3.18936538007667,6.2992125984252
2022-04-04,126713,16,98041,5,28672,11,106125,7,508221,158,614346,165,8,1359,2,2728,1390,0,"Knox County",470313,21.6876845845214,0.0592473979183347,35.0830191808434,3.40198973874845,5.92473979183347
2022-04-03,126697,5,98036,4,28661,1,106118,3,508063,75,614181,78,1,1351,0,2726,1390,1,"Knox County",470313,20.8371871498343,0.0578512396694215,16.5846999763987,1.06312179335889,5.78512396694215
2022-04-02,126692,2,98032,2,28660,0,106115,3,507988,116,614103,119,0,1350,0,2726,1389,1,"Knox County",470313,19.7740653564754,0.0578231292517007,25.3022986819416,0.425248717343556,5.78231292517007
2022-04-01,126690,19,98030,8,28660,11,106112,8,507872,231,613984,239,4,1350,0,2726,1388,0,"Knox County",470313,19.9866897151471,0.0490596892886345,50.817221722555,4.03986281476378,4.90596892886345
2022-03-31,126671,17,98022,7,28649,10,106104,8,507641,238,613745,246,3,1346,0,2726,1388,0,"Knox County",470313,20.1993140738189,0.0453834115805947,52.3055922332574,3.61461409742023,4.53834115805947
2022-03-30,126654,22,98015,10,28639,12,106096,9,507403,256,613499,265,0,1343,1,2726,1388,0,"Knox County",470313,20.4119384324907,0.0385487528344671,56.3454550480212,4.67773589077912,3.85487528344671
2022-03-29,126632,20,98005,8,28627,12,106087,9,507147,192,613234,201,2,1343,0,2725,1388,3,"Knox County",470313,21.4750602258496,0.0357958872810358,42.7374960930274,4.25248717343556,3.57958872810358
2022-03-28,126612,19,97997,12,28615,7,106078,16,506955,332,613033,348,3,1341,0,2725,1385,0,"Knox County",470313,22.1129333018649,0.0374331550802139,73.9932768177788,4.03986281476378,3.74331550802139
2022-03-27,126593,4,97985,3,28608,1,106062,3,506623,73,612685,76,0,1338,0,2725,1385,1,"Knox County",470313,21.9003089431931,0.037483266398929,16.1594512590551,0.850497434687113,3.7483266398929
2022-03-26,126589,8,97982,5,28607,3,106059,5,506550,166,612609,171,0,1338,1,2725,1384,1,"Knox County",470313,23.1760550952238,0.03751617076326,36.3587653328741,1.70099486937423,3.751617076326
2022-03-25,126581,14,97977,7,28604,7,106054,8,506384,244,612438,252,0,1338,1,2724,1383,1,"Knox County",470313,22.1129333018649,0.0372033354714561,53.5813383852881,2.97674102140489,3.72033354714561
2022-03-24,126567,56,97970,9,28597,47,106046,10,506140,187,612186,197,1,1338,0,2723,1382,2,"Knox County",470313,30.4052832900643,0.0397350993377483,41.8869986583403,11.9069640856196,3.97350993377483
2022-03-23,126511,11,97961,6,28550,5,106036,6,505953,201,611989,207,0,1337,0,2723,1380,1,"Knox County",470313,28.0664153446747,0.0392561983471074,44.0132422450581,2.33886794538956,3.92561983471074
2022-03-22,126500,16,97955,11,28545,5,106030,11,505752,151,611782,162,0,1337,1,2723,1379,4,"Knox County",470313,27.2159179099876,0.0417551309271054,34.4451461048281,3.40198973874845,4.17551309271054
2022-03-21,126484,12,97944,6,28540,6,106019,6,505601,124,611620,130,7,1337,1,2722,1375,0,"Knox County",470313,25.7275473992852,0.0410041841004184,27.6411666273312,2.55149230406134,4.10041841004184
2022-03-20,126472,11,97938,8,28534,3,106013,10,505477,98,611490,108,1,1330,0,2721,1375,0,"Knox County",470313,27.2159179099876,0.045639771801141,22.963430736552,2.33886794538956,4.5639771801141
2022-03-19,126461,11,97930,10,28531,1,106003,11,505379,175,611382,186,0,1329,0,2721,1375,0,"Knox County",470313,27.8537909860029,0.0499194847020934,39.5481307129507,2.33886794538956,4.99194847020934
2022-03-18,126450,24,97920,15,28530,9,105992,14,505204,219,611196,233,0,1329,1,2721,1375,2,"Knox County",470313,29.9800345727207,0.0556009811937858,49.5414755705243,5.10298460812268,5.56009811937858
2022-03-17,126426,35,97905,25,28521,10,105978,31,504985,209,610963,240,1,1329,0,2720,1373,2,"Knox County",470313,25.5149230406134,0.0703001579778831,51.0298460812268,7.44185255351224,7.03001579778831
2022-03-16,126391,21,97880,8,28511,13,105947,12,504776,236,610723,248,3,1328,2,2720,1371,2,"Knox County",470313,27.6411666273312,0.0726855394032135,52.730840950601,4.46511153210734,7.26855394032135
2022-03-15,126370,55,97872,18,28498,37,105935,19,504540,257,610475,276,1,1325,1,2718,1369,2,"Knox County",470313,35.9335166155305,0.0724841660802252,58.6843229934108,11.6943397269478,7.24841660802252
2022-03-14,126315,21,97854,16,28461,5,105916,22,504283,228,610199,250,10,1324,0,2717,1367,3,"Knox County",470313,37.8471358435765,0.0772225827384815,53.1560896679445,4.46511153210734,7.72225827384815
2022-03-13,126294,5,97838,5,28456,0,105894,10,504055,484,609949,494,2,1314,0,2717,1364,1,"Knox County",470313,36.5713896915458,0.0617540217955371,105.036433183858,1.06312179335889,6.17540217955371
2022-03-12,126289,9,97833,8,28456,1,105884,9,503571,293,609455,302,0,1312,3,2717,1363,2,"Knox County",470313,36.1461409742023,0.0572687224669604,64.212556318877,1.913619228046,5.72687224669604
2022-03-11,126280,20,97825,13,28455,7,105875,15,503278,467,609153,482,9,1312,0,2714,1361,4,"Knox County",470313,35.2956435395152,0.0514834205933682,102.484940879797,4.25248717343556,5.14834205933682
2022-03-10,126260,28,97812,20,28448,8,105860,23,502811,459,608671,482,4,1303,1,2714,1357,2,"Knox County",470313,33.8072730288127,0.0434096290449882,102.484940879797,5.95348204280979,4.34096290449882
2022-03-09,126232,64,97792,20,28440,44,105837,23,502352,419,608189,442,1,1299,2,2713,1355,2,"Knox County",470313,42.9501204516992,0.0443548387096774,93.9799665329259,13.6079589549938,4.43548387096774
2022-03-08,126168,35,97772,18,28396,17,105814,19,501933,311,607747,330,1,1298,1,2711,1353,3,"Knox County",470313,38.6976332782636,0.0434938892882818,70.1660383616868,7.44185255351224,4.34938892882818
2022-03-07,126133,27,97754,22,28379,5,105795,26,501622,268,607417,294,4,1297,2,2710,1350,0,"Knox County",470313,39.9733794302943,0.0442321302193914,62.5115614495028,5.74085768413801,4.42321302193914
2022-03-06,126106,14,97732,11,28374,3,105769,13,501354,212,607123,225,2,1293,2,2708,1350,0,"Knox County",470313,41.8869986583403,0.0500586624951115,47.8404807011501,2.97674102140489,5.00586624951115
2022-03-05,126092,19,97721,10,28371,9,105756,11,501142,266,606898,277,0,1291,1,2706,1350,2,"Knox County",470313,44.0132422450581,0.0513428120063191,58.8969473520825,4.03986281476378,5.13428120063191
2022-03-04,126073,53,97711,29,28362,24,105745,30,500876,380,606621,410,1,1291,1,2705,1348,2,"Knox County",470313,51.0298460812268,0.0589430894308943,87.175987055429,11.2690910096042,5.89430894308943
2022-03-03,126020,45,97682,29,28338,16,105715,34,500496,326,606211,360,8,1290,4,2704,1346,2,"Knox County",470313,54.644460178647,0.0667236954662104,76.5447691218401,9.56809614023002,6.67236954662104
2022-03-02,125975,37,97653,29,28322,8,105681,36,500170,338,605851,374,-2,1282,1,2700,1344,7,"Knox County",470313,48.903602494509,0.0744493392070485,79.521510143245,7.86710127085579,7.44493392070485
2022-03-01,125938,91,97624,48,28314,43,105645,60,499832,391,605477,451,3,1284,3,2699,1337,2,"Knox County",470313,60.8105665801286,0.0878293601003764,95.893585760972,19.3488166391318,8.78293601003764
2022-02-28,125847,132,97576,88,28271,44,105585,96,499441,549,605026,645,10,1281,4,2696,1335,5,"Knox County",470313,83.1361242406653,0.102115244347192,137.142711343297,28.0664153446747,10.2115244347192
2022-02-27,125715,3,97488,3,28227,0,105489,5,498892,75,604381,80,1,1271,1,2692,1330,5,"Knox County",470313,80.7972562952757,0.104736234116288,17.0099486937423,0.637873076015334,10.4736234116288
2022-02-26,125712,46,97485,32,28227,14,105484,35,498817,275,604301,310,0,1270,2,2691,1325,0,"Knox County",470313,86.5381139794137,0.11254752851711,65.9135511882512,9.7807204989018,11.254752851711
2022-02-25,125666,105,97453,66,28213,39,105449,74,498542,406,603991,480,2,1270,5,2689,1325,6,"Knox County",470313,97.5945806303462,0.125925925925926,102.059692162454,22.3255576605367,12.5925925925926
2022-02-24,125561,141,97387,84,28174,57,105375,94,498136,463,603511,557,1,1268,4,2684,1319,3,"Knox County",470313,118.006519062837,0.138073869520193,118.43176778018,29.9800345727207,13.8073869520193
2022-02-23,125420,139,97303,95,28117,44,105281,114,497673,413,602954,527,6,1267,1,2680,1316,4,"Knox County",470313,139.694203647358,0.15672131147541,112.053037020027,29.5547858553772,15.672131147541
2022-02-22,125281,141,97208,86,28073,55,105167,99,497260,356,602427,455,11,1261,7,2679,1312,3,"Knox County",470313,150.325421580947,0.16928618205632,96.7440831956591,29.9800345727207,16.928618205632
2022-02-21,125140,72,97122,47,28018,25,105068,50,496904,290,601972,340,0,1250,1,2672,1309,5,"Knox County",470313,137.56796006064,0.171335030920335,72.2922819484046,15.308953824368,17.1335030920335
2022-02-20,125068,72,97075,48,27993,24,105018,57,496614,289,601632,346,0,1250,1,2671,1304,2,"Knox County",470313,152.239040808993,0.17346600331675,73.5680281004352,15.308953824368,17.346600331675
2022-02-19,124996,89,97027,54,27969,35,104961,68,496325,322,601286,390,0,1250,1,2670,1302,4,"Knox County",470313,161.38188823188,0.179644588045234,82.9234998819935,18.9235679217883,17.9644588045234
2022-02-18,124907,139,96973,91,27934,48,104893,112,496003,498,600896,610,0,1250,3,2669,1298,4,"Knox County",470313,168.61111642672,0.184186046511628,129.700858789785,29.5547858553772,18.4186046511628
2022-02-17,124768,270,96882,208,27886,62,104781,252,495505,1208,600286,1460,1,1250,2,2666,1294,2,"Knox County",470313,196.039658695379,0.182170542635659,310.431563660796,57.4085768413801,18.2170542635659
2022-02-16,124498,224,96674,145,27824,79,104529,160,494297,546,598826,706,3,1249,3,2664,1292,3,"Knox County",470313,214.112729182481,0.185279777107035,150.112797222275,47.6278563424783,18.5279777107035
2022-02-15,124274,269,96529,212,27745,57,104369,241,493751,592,598120,833,5,1246,6,2661,1289,4,"Knox County",470313,241.328647092468,0.200640341515475,177.116090773591,57.1959524827083,20.0640341515475
2022-02-14,124005,341,96317,205,27688,136,104128,246,493159,602,597287,848,19,1241,8,2655,1285,1,"Knox County",470313,298.524599575177,0.218756017716156,180.305456153668,72.5049063070764,21.8756017716156
2022-02-13,123664,119,96112,100,27552,19,103882,116,492557,283,596439,399,1,1222,1,2647,1284,3,"Knox County",470313,308.51794443275,0.227792603888677,84.8371191100395,25.3022986819416,22.7792603888677
2022-02-12,123545,153,96012,109,27533,44,103766,127,492274,414,596040,541,0,1221,3,2646,1281,6,"Knox County",470313,322.125903387744,0.232351306281267,115.029778041432,32.5315268767821,23.2351306281267
2022-02-11,123392,339,95903,249,27489,90,103639,278,491860,630,595499,908,3,1221,10,2643,1275,5,"Knox County",470313,364.6507751221,0.249341527655838,193.062917673975,72.0796575897328,24.9341527655838
2022-02-10,123053,420,95654,272,27399,148,103361,302,491230,555,594591,857,7,1218,12,2633,1270,3,"Knox County",470313,396.544428922866,0.288688138256088,182.219075381714,89.3022306421468,28.8688138256088
2022-02-09,122633,435,95382,305,27251,130,103059,369,490675,606,593734,975,8,1211,4,2621,1267,6,"Knox County",470313,441.408168602611,0.313187838089909,207.308749704984,92.4915960222235,31.3187838089909
2022-02-08,122198,451,95077,331,27121,120,102690,389,490069,462,592759,851,6,1203,8,2617,1261,12,"Knox County",470313,480.105801880875,0.339654210819855,180.943329229683,95.893585760972,33.9654210819855
2022-02-07,121747,588,94746,408,27001,180,102301,440,489607,624,591908,1064,10,1197,11,2609,1249,5,"Knox County",470313,532.624018472804,0.361215370866845,226.232317626772,125.023122899006,36.1215370866845
2022-02-06,121159,250,94338,184,26821,66,101861,214,488983,435,590844,649,0,1187,13,2598,1244,5,"Knox County",470313,560.477809458807,0.362532078699743,137.993208777984,53.1560896679445,36.2532078699743
2022-02-05,120909,269,94154,192,26755,77,101647,220,488548,496,590195,716,0,1187,7,2585,1239,11,"Knox County",470313,585.142235064734,0.367441860465116,152.239040808993,57.1959524827083,36.7441860465116
2022-02-04,120640,649,93962,510,26678,139,101427,581,488052,963,589479,1544,3,1187,3,2578,1228,0,"Knox County",470313,651.055786252985,0.377854567307692,328.292009789225,137.993208777984,37.7854567307692
2022-02-03,119991,1638,93452,502,26539,1136,100846,505,487089,741,587935,1246,1,1184,13,2575,1228,2,"Knox County",470313,910.03225511521,0.385805535841022,264.929950905036,348.278699504373,38.5805535841022
2022-02-02,118353,715,92950,536,25403,179,100341,602,486348,904,586689,1506,7,1183,6,2562,1226,9,"Knox County",470313,969.567075543308,0.389519535374868,320.212284159698,152.026416450321,38.9519535374868
2022-02-01,117638,931,92414,733,25224,198,99739,829,485444,1139,585183,1968,5,1176,12,2556,1217,7,"Knox County",470313,1071.62676770576,0.390083975612562,418.444737866059,197.953277923425,39.0083975612562
2022-01-31,116707,711,91681,516,25026,195,98910,521,484305,605,583215,1126,11,1171,13,2544,1210,2,"Knox County",470313,1097.77956382239,0.396573386636208,239.415027864422,151.175919015634,39.6573386636208
2022-01-30,115996,386,91165,318,24831,68,98389,335,483700,569,582089,904,1,1160,7,2531,1208,6,"Knox County",470313,1126.69647660175,0.398779134295228,192.212420239287,82.0730024473064,39.8779134295228
2022-01-29,115610,677,90847,588,24763,89,98054,644,483131,912,581185,1556,0,1159,5,2524,1202,3,"Knox County",470313,1213.44721493984,0.407817258883249,330.843502093287,143.946690820794,40.7817258883249
2022-01-28,114933,932,90259,770,24674,162,97410,832,482219,1040,579629,1872,3,1159,15,2519,1199,6,"Knox County",470313,1273.61990844395,0.419335822361957,398.032799433569,198.165902282097,41.9335822361957
2022-01-27,114001,1428,89489,1198,24512,230,96578,1272,481179,1472,577757,2744,7,1156,13,2504,1193,8,"Knox County",470313,1228.96879312288,0.431226447413498,583.441240195359,303.627584183299,43.1226447413498
2022-01-26,112573,990,88291,800,24282,190,95306,850,479707,965,575013,1815,4,1149,4,2491,1185,8,"Knox County",470313,1287.44049175762,0.440801001251564,385.913210989277,210.49811508506,44.0801001251564
2022-01-25,111583,1018,87491,766,24092,252,94456,804,478742,930,573198,1734,7,1145,11,2487,1177,6,"Knox County",470313,1305.93881096206,0.447451280742065,368.690637936863,216.45159712787,44.7451280742065
2022-01-24,110565,1316,86725,1082,23840,234,93652,1161,477812,1550,571464,2711,13,1138,15,2476,1171,5,"Knox County",470313,1434.57654795849,0.442261547690462,576.424636359191,279.81365601206,44.2261547690462
2022-01-23,109249,768,85643,679,23606,89,92491,709,476262,818,568753,1527,0,1125,7,2461,1166,10,"Knox County",470313,1515.79905297111,0.449315853571173,324.677395691805,163.295507459926,44.9315853571173
2022-01-22,108481,899,84964,737,23517,162,91782,770,475444,1056,567226,1826,0,1125,14,2454,1156,3,"Knox County",470313,1563.00166059624,0.449645091011315,388.252078934667,191.149298445929,44.9645091011315
2022-01-21,107582,1514,84227,1230,23355,284,91012,1290,474388,1348,565400,2638,1,1125,6,2440,1153,6,"Knox County",470313,1686.74903734322,0.457219073024341,560.903058176151,321.913279029072,45.7219073024341
2022-01-20,106068,1406,82997,1164,23071,242,89722,1214,473040,1152,562762,2366,11,1124,11,2434,1147,2,"Knox County",470313,1682.07130145244,0.465074912772799,503.069232617427,298.94984829252,46.5074912772799
2022-01-19,104662,1662,81833,1302,22829,360,88508,1339,471888,1331,560396,2670,4,1113,7,2423,1145,2,"Knox County",470313,1824.95487047987,0.470979834539814,567.707037653648,353.381684112495,47.0979834539814
2022-01-18,103000,1042,80531,663,22469,379,87169,691,470557,686,557726,1377,6,1109,7,2416,1143,4,"Knox County",470313,1830.05785508799,0.474627853126034,292.783741891039,221.554581735993,47.4627853126034
2022-01-17,101958,1091,79868,859,22090,232,86478,903,469871,1279,556349,2182,7,1103,13,2409,1139,3,"Knox County",470313,1782.21737438684,0.47415329768271,463.94635062182,231.97317531091,47.415329768271
2022-01-16,100867,769,79009,689,21858,80,85575,716,468592,1073,554167,1789,0,1096,7,2396,1136,4,"Knox County",470313,1782.42999874552,0.466258081896552,380.384977663811,163.508131818597,46.6258081896552
2022-01-15,100098,751,78320,597,21778,154,84859,626,467519,816,552378,1442,1,1096,12,2389,1132,2,"Knox County",470313,1750.96159366209,0.468680862831858,306.604325204704,159.680893362505,46.8680862831858
2022-01-14,99347,1300,77723,1048,21624,252,84233,1093,466703,1188,550936,2281,6,1095,10,2377,1130,6,"Knox County",470313,1705.45998090633,0.466576876727866,484.996162130326,276.411666273312,46.6576876727866
2022-01-13,98047,1398,76675,1053,21372,345,83140,1104,465515,1401,548655,2505,6,1089,11,2367,1124,6,"Knox County",470313,1703.75898603696,0.454302962235013,532.624018472804,297.248853423146,45.4302962235013
2022-01-12,96649,1162,75622,886,21027,276,82036,935,464114,1058,546150,1993,1,1083,4,2356,1118,0,"Knox County",470313,1597.44680670107,0.447195813987766,423.760346832854,247.069504776606,44.7195813987766
2022-01-11,95487,1362,74736,1058,20751,304,81101,1093,463056,1283,544157,2376,2,1082,10,2352,1118,3,"Knox County",470313,1665.48660147604,0.444124107633169,505.195476204145,289.594376510962,44.4124107633169
2022-01-10,94125,1000,73678,685,20447,315,80008,714,461773,812,541781,1526,3,1080,5,2342,1115,1,"Knox County",470313,1646.13778483691,0.451480736055204,324.464771333133,212.624358671778,45.1480736055204
2022-01-09,93125,739,72993,626,20132,113,79294,664,460961,1205,540255,1869,5,1077,2,2337,1114,2,"Knox County",470313,1639.75905407675,0.445182961692396,397.394926357553,157.129401058444,44.5182961692396
2022-01-08,92386,621,72367,476,20019,145,78630,510,459756,912,538386,1422,0,1072,10,2335,1112,4,"Knox County",470313,1612.11788744942,0.437517892928715,302.351838031269,132.039726735174,43.7517892928715
2022-01-07,91765,964,71891,747,19874,217,78120,769,458844,1091,536964,1860,0,1072,7,2325,1108,0,"Knox County",470313,1540.6761029357,0.427200944579736,395.481307129507,204.969881759594,42.7200944579736
2022-01-06,90801,1157,71144,739,19657,418,77351,778,457753,1010,535104,1788,2,1072,7,2318,1108,4,"Knox County",470313,1489.43363249581,0.425666199158485,380.172353305139,246.006382983247,42.5666199158485
2022-01-05,89644,1210,70405,898,19239,312,76573,940,456743,1255,533316,2195,1,1070,8,2311,1104,1,"Knox County",470313,1499.63960171205,0.419453820190242,466.710467284553,257.275473992852,41.9453820190242
2022-01-04,88434,922,69507,576,18927,346,75633,566,455488,1040,531121,1606,0,1069,6,2303,1103,5,"Knox County",470313,1406.08488389647,0.402820805478559,341.474720026876,196.039658695379,40.2820805478559
2022-01-03,87512,714,68931,537,18581,177,75067,504,454448,820,529515,1324,6,1069,7,2297,1098,2,"Knox County",470313,1345.27431731634,0.39215848806366,281.514650881434,151.81379209165,39.215848806366
2022-01-02,86798,288,68394,206,18404,82,74563,265,453628,651,528191,916,3,1063,9,2290,1096,4,"Knox County",470313,1249.38073155537,0.389883898838988,194.763912543349,61.2358152974721,38.9883898838988
2022-01-01,86510,265,68188,217,18322,48,74298,237,452977,767,527275,1004,0,1060,15,2281,1092,0,"Knox County",470313,1173.68645986822,0.379594126998971,213.474856106465,56.3454550480212,37.9594126998971
2021-12-31,86245,591,67971,429,18274,162,74061,470,452210,1004,526271,1474,0,1060,5,2266,1092,3,"Knox County",470313,1094.37757408364,0.364800620937227,313.408304682201,125.660995975021,36.4800620937227
2021-12-30,85654,577,67542,401,18112,176,73591,403,451206,918,524797,1321,2,1060,6,2261,1089,2,"Knox County",470313,971.055446054011,0.34400406504065,280.876777805419,122.684254953616,34.400406504065
2021-12-29,85077,631,67141,476,17936,155,73188,504,450288,1195,523476,1699,1,1058,5,2255,1087,2,"Knox County",470313,847.945942383051,0.315603595890411,361.248785383351,134.165970321892,31.5603595890411
2021-12-28,84446,427,66665,261,17781,166,72684,281,449093,976,521777,1257,1,1057,5,2250,1085,0,"Knox County",470313,742.696884840521,0.296164535853252,267.268818850425,90.7906011528493,29.6164535853252
2021-12-27,84019,314,66404,234,17615,80,72403,255,448117,893,520520,1148,2,1056,1,2245,1085,1,"Knox County",470313,657.64714137181,0.273840571493367,244.092763755201,66.7640486229383,27.3840571493367
2021-12-26,83705,61,66170,49,17535,12,72148,60,447224,426,519372,486,7,1054,1,2244,1084,0,"Knox County",470313,609.381411953316,0.263440219334843,103.335438314484,12.9700858789785,26.3440219334843
2021-12-25,83644,85,66121,63,17523,22,72088,74,446798,489,518886,563,1,1047,1,2243,1084,0,"Knox County",470313,571.109027392396,0.257549068948163,119.707513932211,18.0730704871011,25.7549068948163
2021-12-24,83559,175,66058,124,17501,51,72014,138,446309,848,518323,986,0,1046,2,2242,1084,0,"Knox County",470313,482.657294184936,0.229892761394102,209.647617650373,37.2092627675612,22.9892761394102
2021-12-23,83384,218,65934,159,17450,59,71876,166,445461,959,517337,1125,4,1046,5,2240,1084,1,"Knox County",470313,406.325149421768,0.203469162995595,239.20240350575,46.3521101904476,20.3469162995595
2021-12-22,83166,175,65775,102,17391,73,71710,101,444502,812,516212,913,46,1042,10,2235,1083,2,"Knox County",470313,309.368441867437,0.165946279715962,194.126039467333,37.2092627675612,16.5946279715962
2021-12-21,82991,176,65673,123,17318,53,71609,120,443690,912,515299,1032,3,996,6,2225,1081,2,"Knox County",470313,255.999727840821,0.146169838477531,219.428338149275,37.421887126233,14.6169838477531
2021-12-20,82815,112,65550,78,17265,34,71489,84,442778,607,514267,691,1,993,3,2219,1079,1,"Knox County",470313,213.049607389122,0.128191856452726,146.923431842199,23.8139281712392,12.8191856452726
2021-12-19,82703,69,65472,49,17231,20,71405,58,442171,556,513576,614,3,992,6,2216,1078,1,"Knox County",470313,214.750602258496,0.12508440243079,130.551356224472,14.6710807483527,12.508440243079
2021-12-18,82634,88,65423,57,17211,31,71347,65,441615,660,512962,725,0,989,3,2210,1077,2,"Knox County",470313,215.388475334511,0.120276043378245,154.152660037039,18.7109435631165,12.0276043378245
2021-12-17,82546,118,65366,76,17180,42,71282,83,440955,1006,512237,1089,2,989,6,2207,1075,2,"Knox County",470313,203.26888689022,0.109387623202456,231.547926593566,25.0896743232698,10.9387623202456
2021-12-16,82428,138,65290,108,17138,30,71199,108,439949,661,511148,769,2,987,3,2201,1073,2,"Knox County",470313,186.258938196478,0.106120349734271,163.508131818597,29.3421614967054,10.6120349734271
2021-12-15,82290,156,65182,113,17108,43,71091,125,439288,841,510379,966,0,985,5,2198,1071,3,"Knox County",470313,182.219075381714,0.109242269792729,205.395130476938,33.1693999527974,10.9242269792729
2021-12-14,82134,101,65069,62,17065,39,70966,66,438447,806,509413,872,3,985,5,2193,1068,3,"Knox County",470313,166.27224848133,0.1028641285365,185.408440761791,21.4750602258496,10.28641285365
2021-12-13,82033,109,65007,73,17026,36,70900,78,437641,622,508541,700,4,982,3,2188,1065,0,"Knox County",470313,165.634375405315,0.101656495204882,148.837051070245,23.1760550952238,10.1656495204882
2021-12-12,81924,54,64934,29,16990,25,70822,41,437019,493,507841,534,6,978,5,2185,1065,1,"Knox County",470313,162.445010025239,0.100088417329797,113.54140753073,11.481715368276,10.0088417329797
2021-12-11,81870,65,64905,45,16965,20,70781,51,436526,540,507307,591,0,972,1,2180,1064,3,"Knox County",470313,157.554649775788,0.0999818873392501,125.660995975021,13.8205833136656,9.99818873392501
2021-12-10,81805,85,64860,48,16945,37,70730,57,435986,848,506716,905,0,972,3,2179,1061,2,"Knox County",470313,150.538045939619,0.0985572418961964,192.425044597959,18.0730704871011,9.85572418961964
2021-12-09,81720,164,64812,96,16908,68,70673,107,435138,982,505811,1089,3,972,2,2176,1059,1,"Knox County",470313,156.066279265085,0.0928053738730776,231.547926593566,34.8703948221716,9.28053738730776
2021-12-08,81556,130,64716,67,16840,63,70566,65,434156,746,504722,811,0,969,7,2174,1058,1,"Knox County",470313,150.538045939619,0.0845147219193021,172.438354882812,27.6411666273312,8.45147219193021
2021-12-07,81426,126,64649,69,16777,57,70501,75,433410,630,503911,705,2,969,2,2167,1057,0,"Knox County",470313,155.853654906413,0.0888472352389878,149.900172863604,26.790669192644,8.88472352389878
2021-12-06,81300,148,64580,107,16720,41,70426,115,432780,759,503206,874,8,967,4,2165,1057,3,"Knox County",470313,164.146004894613,0.0927573062261754,185.833689479134,31.4684050834232,9.27573062261754
2021-12-05,81152,43,64473,28,16679,15,70311,33,432021,342,502332,375,2,959,1,2161,1054,0,"Knox County",470313,161.807136949223,0.094018691588785,79.7341345019168,9.14284742288646,9.4018691588785
2021-12-04,81109,69,64445,50,16664,19,70278,55,431679,499,501957,554,0,957,3,2160,1054,2,"Knox County",470313,162.65763438391,0.0954263128176172,117.793894704165,14.6710807483527,9.54263128176172
2021-12-03,81040,147,64395,103,16645,44,70223,108,431180,1009,501403,1117,3,957,2,2157,1052,2,"Knox County",470313,175.840344621561,0.100995475113122,237.501408636376,31.2557807247514,10.0995475113122
2021-12-02,80893,133,64292,86,16601,47,70115,85,430171,794,500286,879,0,954,4,2155,1050,2,"Knox County",470313,169.248989502735,0.100846660395108,186.896811272493,28.2790397033465,10.0846660395108
2021-12-01,80760,184,64206,141,16554,43,70030,146,429377,1007,499407,1153,4,954,7,2151,1048,1,"Knox County",470313,180.730704871011,0.109068410818455,245.15588554856,39.1228819956072,10.9068410818455
2021-11-30,80576,116,64065,67,16511,49,69884,68,428370,693,498254,761,3,950,6,2144,1047,3,"Knox County",470313,178.604461284294,0.106774024155435,161.807136949223,24.6644256059263,10.6774024155435
2021-11-29,80460,165,63998,128,16462,37,69816,139,427677,967,497493,1106,2,947,5,2138,1044,1,"Knox County",470313,182.219075381714,0.106644238856182,235.162540690987,35.0830191808434,10.6644238856182
2021-11-28,80295,34,63870,22,16425,12,69677,22,426710,270,496387,292,3,945,5,2133,1043,2,"Knox County",470313,180.305456153668,0.106277720914364,62.0863127321592,7.22922819484046,10.6277720914364
2021-11-27,80261,59,63848,31,16413,28,69655,32,426440,266,496095,298,0,942,1,2128,1041,2,"Knox County",470313,178.17921256695,0.107028184088477,63.3620588841899,12.5448371616349,10.7028184088477
2021-11-26,80202,20,63817,18,16385,2,69623,20,426174,298,495797,318,0,942,4,2127,1039,1,"Knox County",470313,151.175919015634,0.106511337632619,67.6145460576254,4.25248717343556,10.6511337632619
2021-11-25,80182,52,63799,26,16383,26,69603,30,425876,331,495479,361,0,942,4,2123,1038,5,"Knox County",470313,133.95334596322,0.106551643739799,76.7573934805119,11.0564666509325,10.6551643739799
2021-11-24,80130,105,63773,66,16357,39,69573,73,425545,742,495118,815,0,942,3,2119,1033,4,"Knox County",470313,117.15602162815,0.0971905846621109,173.288852317499,22.3255576605367,9.71905846621109
2021-11-23,80025,98,63707,64,16318,34,69500,64,424803,673,494303,737,0,942,2,2116,1029,0,"Knox County",470313,113.328783172058,0.0967659791189203,156.7041523411,20.8371871498343,9.67659791189203
2021-11-22,79927,107,63643,84,16284,23,69436,82,424130,738,493566,820,0,942,3,2114,1029,0,"Knox County",470313,100.996570369095,0.08871189233727,174.351974110858,22.7508063778803,8.871189233727
2021-11-21,79820,44,63559,32,16261,12,69354,37,423392,284,492746,321,0,942,2,2111,1029,2,"Knox County",470313,103.122813955812,0.0920980926430518,68.2524191336408,9.35547178155824,9.20980926430518
2021-11-20,79776,54,63527,37,16249,17,69317,44,423108,533,492425,577,0,942,1,2109,1027,1,"Knox County",470313,102.059692162454,0.0886300329197265,122.684254953616,11.481715368276,8.86300329197265
2021-11-19,79722,112,63490,83,16232,29,69273,81,422575,825,491848,906,0,942,0,2108,1026,0,"Knox County",470313,121.621133160257,0.0905884945999559,192.637668956631,23.8139281712392,9.05884945999559
2021-11-18,79610,81,63407,45,16203,36,69192,50,421750,919,490942,969,3,942,2,2108,1026,0,"Knox County",470313,127.787239561739,0.0837706511175899,206.033003552953,17.222573052414,8.37706511175899
2021-11-17,79529,105,63362,65,16167,40,69142,66,420831,813,489973,879,0,939,1,2106,1026,1,"Knox County",470313,127.787239561739,0.081397581109618,186.896811272493,22.3255576605367,8.1397581109618
2021-11-16,79424,73,63297,50,16127,23,69076,67,420018,764,489094,831,0,939,2,2105,1025,3,"Knox County",470313,122.471630594944,0.080520460116915,176.690842056248,15.5215781830398,8.0520460116915
2021-11-15,79351,84,63247,45,16104,39,69009,34,419254,446,488263,480,3,939,0,2103,1022,0,"Knox County",470313,117.581270345493,0.076365101752972,102.059692162454,17.8604461284294,7.6365101752972
2021-11-14,79267,72,63202,62,16065,10,68975,68,418808,624,487783,692,0,936,2,2103,1022,2,"Knox County",470313,123.534752388303,0.0768653918260217,147.13605620087,15.308953824368,7.68653918260217
2021-11-13,79195,29,63140,13,16055,16,68907,12,418184,317,487091,329,0,936,2,2101,1020,0,"Knox County",470313,118.219143421509,0.0743216673220606,69.953414003015,6.16610640148157,7.43216673220606
2021-11-12,79166,65,63127,48,16039,17,68895,50,417867,676,486762,726,0,936,4,2099,1020,2,"Knox County",470313,108.225798563935,0.0707297187117815,154.365284395711,13.8205833136656,7.07297187117815
2021-11-11,79101,66,63079,47,16022,19,68845,54,417191,962,486036,1016,0,936,0,2095,1018,0,"Knox County",470313,105.036433183858,0.0708661417322835,216.026348410527,14.0332076723374,7.08661417322835
2021-11-10,79035,72,63032,49,16003,23,68791,67,416229,844,485020,911,1,936,2,2095,1018,0,"Knox County",470313,98.0198293476897,0.0706118355065196,193.70079074999,15.308953824368,7.06118355065196
2021-11-09,78963,103,62983,73,15980,30,68724,130,415385,1170,484109,1300,1,935,1,2093,1018,1,"Knox County",470313,104.398560107843,0.0760909424275761,276.411666273312,21.9003089431931,7.60909424275761
2021-11-08,78860,78,62910,58,15950,20,68594,70,414215,669,482809,739,6,934,1,2092,1017,3,"Knox County",470313,103.122813955812,0.0789427621214773,157.129401058444,16.5846999763987,7.89427621214773
2021-11-07,78782,30,62852,19,15930,11,68524,21,413546,390,482070,411,0,928,1,2091,1014,3,"Knox County",470313,94.1925908915977,0.0743740795287187,87.3886114141008,6.37873076015334,7.43740795287187
2021-11-06,78752,41,62833,27,15919,14,68503,30,413156,450,481659,480,0,928,2,2090,1011,1,"Knox County",470313,96.7440831956591,0.0755866021852051,102.059692162454,8.7175987055429,7.55866021852051
2021-11-05,78711,52,62806,32,15905,20,68473,36,412706,601,481179,637,0,928,2,2088,1010,0,"Knox County",470313,93.9799665329259,0.0742628321805606,135.441716473923,11.0564666509325,7.42628321805606
2021-11-04,78659,67,62774,45,15885,22,68437,49,412105,664,480542,713,0,928,1,2086,1010,1,"Knox County",470313,94.1925908915977,0.0776343671739549,151.601167732978,14.2458320310091,7.76343671739549
2021-11-03,78592,80,62729,60,15863,20,68388,66,411441,968,479829,1034,0,928,2,2085,1009,2,"Knox County",470313,95.893585760972,0.0756492284531426,219.853586866619,17.0099486937423,7.56492284531426
2021-11-02,78512,41,62669,19,15843,22,68322,22,410473,301,478795,323,4,928,1,2083,1007,3,"Knox County",470313,82.7108755233217,0.0677887940973023,68.6776678509843,8.7175987055429,6.77887940973023
2021-11-01,78471,94,62650,70,15821,24,68300,83,410172,650,478472,733,1,924,3,2082,1004,1,"Knox County",470313,86.1128652620702,0.0708843223274071,155.853654906413,19.9866897151471,7.08843223274071
2021-10-31,78377,26,62580,20,15797,6,68217,19,409522,278,477739,297,0,923,1,2079,1003,1,"Knox County",470313,85.262367827383,0.0723262983163386,63.1494345255181,5.52823332546623,7.23262983163386
2021-10-30,78351,56,62560,41,15791,15,68198,43,409244,523,477442,566,0,923,4,2078,1002,0,"Knox County",470313,88.4517332074597,0.0739019288868231,120.345387008226,11.9069640856196,7.39019288868232
2021-10-29,78295,73,62519,59,15776,14,68155,66,408721,836,476876,902,1,923,1,2074,1002,1,"Knox County",470313,92.916844739567,0.0761821366024518,191.787171521944,15.5215781830398,7.61821366024518
2021-10-28,78222,55,62460,32,15762,23,68089,39,407885,557,475974,596,4,922,3,2073,1001,2,"Knox County",470313,90.3653524355057,0.0759379914625927,126.72411776838,11.6943397269478,7.59379914625927
2021-10-27,78167,87,62428,57,15739,30,68050,65,407328,759,475378,824,1,918,3,2070,999,3,"Knox County",470313,91.8537229462082,0.0794623909455317,175.202471545545,18.4983192044447,7.94623909455317
2021-10-26,78080,95,62371,57,15709,38,67985,55,406569,555,474554,610,0,917,5,2067,996,2,"Knox County",470313,103.335438314484,0.0817137809187279,129.700858789785,20.1993140738189,8.17137809187279
2021-10-25,77985,70,62314,46,15671,24,67930,53,406014,491,473944,544,6,917,3,2062,994,1,"Knox County",470313,98.2324537063615,0.0783590689098871,115.667651117447,14.8837051070245,7.83590689098871
2021-10-24,77915,38,62268,20,15647,18,67877,23,405523,336,473400,359,1,911,5,2059,993,3,"Knox County",470313,100.783946010423,0.0781640536241763,76.3321447631684,8.07972562952757,7.81640536241763
2021-10-23,77877,59,62248,40,15629,19,67854,42,405187,471,473041,513,0,910,1,2054,990,2,"Knox County",470313,101.421819086438,0.078886844526219,109.076295998622,12.5448371616349,7.8886844526219
2021-10-22,77818,89,62208,55,15610,34,67812,54,404716,551,472528,605,0,910,2,2053,988,2,"Knox County",470313,104.823808825187,0.081708220192545,128.637736996426,18.9235679217883,8.1708220192545
2021-10-21,77729,125,62153,71,15576,54,67758,78,404165,712,471923,790,3,910,2,2051,986,2,"Knox County",470313,119.707513932211,0.0871613663133098,167.973243350705,26.5780448339723,8.71613663133098
2021-10-20,77604,147,62082,82,15522,65,67680,89,403453,959,471133,1048,3,907,3,2049,984,2,"Knox County",470313,132.464975452518,0.0881628999776236,222.830327888024,31.2557807247514,8.81628999776236
2021-10-19,77457,130,62000,85,15457,45,67591,92,402494,724,470085,816,4,904,3,2046,982,2,"Knox County",470313,139.90682800603,0.092192513368984,173.501476676171,27.6411666273312,9.2192513368984
2021-10-18,77327,119,61915,88,15412,31,67499,105,401770,604,469269,709,9,900,8,2043,980,3,"Knox County",470313,150.325421580947,0.0997933884297521,150.750670298291,25.3022986819416,9.97933884297521
2021-10-17,77208,63,61827,56,15381,7,67394,61,401166,303,468560,364,1,891,4,2035,977,2,"Knox County",470313,155.641030547742,0.107533539731682,77.3952665565272,13.395334596322,10.7533539731682
2021-10-16,77145,54,61771,39,15374,15,67333,42,400863,372,468196,414,0,890,1,2031,975,4,"Knox County",470313,154.577908754383,0.109776654024442,88.0264844901162,11.481715368276,10.9776654024442
2021-10-15,77091,125,61732,90,15359,35,67291,99,400491,794,467782,893,9,890,5,2030,971,2,"Knox County",470313,162.232385666567,0.1124354390147,189.873552293898,26.5780448339723,11.24354390147
2021-10-14,76966,191,61642,135,15324,56,67192,143,399697,699,466889,842,0,881,7,2025,969,5,"Knox County",470313,176.265593338904,0.124066063704286,179.029710001637,40.6112525063096,12.4066063704286
2021-10-13,76775,119,61507,88,15268,31,67049,99,398998,764,466047,863,7,881,5,2018,964,1,"Knox County",470313,170.312111296094,0.130789634768415,183.494821533745,25.3022986819416,13.0789634768415
2021-10-12,76656,135,61419,103,15237,32,66950,108,398234,821,465184,929,4,874,3,2013,963,9,"Knox County",470313,171.375233089453,0.131033107299561,197.528029206082,28.70428842069,13.1033107299561
2021-10-11,76521,191,61316,136,15205,55,66842,148,397413,581,464255,729,3,870,12,2010,954,1,"Knox County",470313,186.684186913821,0.139054429876837,155.003157471726,40.6112525063096,13.9054429876838
2021-10-10,76330,53,61180,40,15150,13,66694,52,396832,489,463526,541,0,867,4,1998,953,3,"Knox County",470313,184.557943327103,0.132604106697371,115.029778041432,11.2690910096042,13.2604106697371
2021-10-09,76277,64,61140,34,15137,30,66642,46,396343,483,462985,529,0,867,7,1994,950,4,"Knox County",470313,186.684186913821,0.130491926398798,112.478285737371,13.6079589549938,13.0491926398798
2021-10-08,76213,281,61106,115,15107,166,66596,123,395860,936,462456,1059,-1,867,5,1987,946,4,"Knox County",470313,219.853586866619,0.130917698470503,225.169195833413,59.7474447867697,13.0917698470503
2021-10-07,75932,256,60991,169,14941,87,66473,175,394924,1107,461397,1282,6,868,9,1982,942,1,"Knox County",470313,233.674170180284,0.126601483479434,272.58442781722,54.4318358199752,12.6601483479434
2021-10-06,75676,137,60822,101,14854,36,66298,112,393817,835,460115,947,1,862,4,1973,941,5,"Knox County",470313,237.501408636376,0.126994680851064,201.355267662174,29.1295371380336,12.6994680851064
2021-10-05,75539,208,60721,118,14818,90,66186,138,392982,915,459168,1053,3,861,4,1969,936,4,"Knox County",470313,253.022986819416,0.129315960912052,223.893449681382,44.2258666037299,12.9315960912052
2021-10-04,75331,307,60603,219,14728,88,66048,245,392067,829,458115,1074,3,858,4,1965,932,2,"Knox County",470313,277.687412425342,0.13739398612182,228.35856121349,65.2756781122359,13.739398612182
2021-10-03,75024,100,60384,91,14640,9,65803,105,391238,677,457041,782,1,855,6,1961,930,1,"Knox County",470313,287.680757282916,0.140350877192982,166.27224848133,21.2624358671778,14.0350877192982
2021-10-02,74924,67,60293,43,14631,24,65698,50,390561,471,456259,521,5,854,2,1955,929,4,"Knox County",470313,288.318630358931,0.141113426615064,110.777290867996,14.2458320310091,14.1113426615064
2021-10-01,74857,218,60250,147,14607,71,65648,164,390090,965,455738,1129,0,849,8,1953,925,3,"Knox County",470313,274.923295762609,0.145698291101945,240.052900940438,46.3521101904476,14.5698291101945
2021-09-30,74639,239,60103,165,14536,74,65484,185,389125,1103,454609,1288,1,849,8,1945,922,2,"Knox County",470313,271.308681665189,0.147041507212246,273.86017396925,50.817221722555,14.7041507212246
2021-09-29,74400,352,59938,164,14462,188,65299,186,388022,1105,453321,1291,6,848,8,1937,920,3,"Knox County",470313,317.022918779621,0.150322219108994,274.498047045266,74.8437742524659,15.0322219108994
2021-09-28,74048,337,59774,239,14274,98,65113,259,386917,766,452030,1025,2,842,1,1929,917,3,"Knox County",470313,344.451461048281,0.167932489451477,217.939967638573,71.6544088723892,16.7932489451477
2021-09-27,73711,237,59535,160,14176,77,64854,185,386151,756,451005,941,7,840,12,1928,914,6,"Knox County",470313,329.567755941256,0.162534040418518,200.079521510143,50.3919730052114,16.2534040418518
2021-09-26,73474,123,59375,99,14099,24,64669,117,385395,703,450064,820,2,833,1,1916,908,5,"Knox County",470313,334.458116190707,0.163364219529579,174.351974110858,26.1527961166287,16.336421952958
2021-09-25,73351,110,59276,90,14075,20,64552,102,384692,699,449244,801,0,831,3,1915,903,7,"Knox County",470313,343.600963613593,0.164222069910898,170.312111296094,23.3886794538956,16.4222069910898
2021-09-24,73241,245,59186,166,14055,79,64450,183,383993,937,448443,1120,13,831,5,1912,896,3,"Knox County",470313,349.341821297731,0.167032665385671,238.139281712392,52.0929678745856,16.7032665385671
2021-09-23,72996,350,59020,243,13976,107,64267,268,383056,1370,447323,1638,14,818,9,1907,893,3,"Knox County",470313,372.943125110299,0.170246202200105,348.278699504373,74.4185255351224,17.0246202200105
2021-09-22,72646,250,58777,186,13869,64,63999,201,381686,1260,445685,1461,3,804,4,1898,890,9,"Knox County",470313,351.255440525777,0.168460158852165,310.644188019468,53.1560896679445,16.8460158852165
2021-09-21,72396,392,58591,213,13805,179,63798,226,380426,996,444224,1222,10,801,7,1894,881,4,"Knox County",470313,362.949780252725,0.160189928776709,259.826966296913,83.348748599337,16.0189928776709
2021-09-20,72004,426,58378,304,13626,122,63572,339,379430,1295,443002,1634,5,791,9,1887,877,7,"Knox County",470313,403.135784041691,0.165133394664213,347.428202069686,90.5779767941775,16.5133394664213
2021-09-19,71578,119,58074,87,13504,32,63233,96,378135,432,441368,528,1,786,8,1878,870,8,"Knox County",470313,402.285286607004,0.168372203712518,112.265661378699,25.3022986819416,16.8372203712518
2021-09-18,71459,221,57987,178,13472,43,63137,193,377703,1075,440840,1268,0,785,7,1870,862,13,"Knox County",470313,425.886590419572,0.16976665539398,269.607686795815,46.989983266463,16.976665539398
2021-09-17,71238,541,57809,417,13429,124,62944,443,376628,1310,439572,1753,5,785,11,1863,849,5,"Knox County",470313,488.823400586418,0.185816498316498,372.730500751627,115.029778041432,18.5816498316498
2021-09-16,70697,577,57392,452,13305,125,62501,483,375318,1518,437819,2001,7,780,16,1852,844,3,"Knox County",470313,537.089130004912,0.200770244248505,425.461341702228,122.684254953616,20.0770244248505
2021-09-15,70120,337,56940,248,13180,89,62018,266,373800,807,435818,1073,6,773,5,1836,841,4,"Knox County",470313,555.587449209356,0.21584555332841,228.145936854818,71.6544088723892,21.584555332841
2021-09-14,69783,550,56692,439,13091,111,61752,474,372993,1406,434745,1880,12,767,8,1831,837,3,"Knox County",470313,589.182097879497,0.226299694189602,399.733794302943,116.943397269478,22.6299694189602
2021-09-13,69233,393,56253,292,12980,101,61278,327,371587,1134,432865,1461,20,755,15,1823,834,9,"Knox County",470313,582.165494043329,0.229024488157367,310.644188019468,83.5613729580088,22.9024488157367
2021-09-12,68840,383,55961,355,12879,28,60951,373,370453,1460,431404,1833,0,735,5,1808,825,8,"Knox County",470313,638.298324732678,0.227083148460378,389.740449445369,81.435129371291,22.7083148460378
2021-09-11,68457,851,55606,693,12851,158,60578,754,368993,2620,429571,3374,4,735,25,1803,817,10,"Knox County",470313,772.251670695898,0.233271028037383,717.39458615858,180.943329229683,23.3271028037383
2021-09-10,67606,1018,54913,744,12693,274,59824,802,366373,2512,426197,3314,1,731,24,1778,807,7,"Knox County",470313,873.673489782336,0.232927155865024,704.637124638273,216.45159712787,23.2927155865024
2021-09-09,66588,309,54169,167,12419,142,59022,172,363861,685,422883,857,1,730,18,1754,800,5,"Knox County",470313,816.6901616583,0.22969837587007,182.219075381714,65.7009268295794,22.969837587007
2021-09-08,66279,291,54002,225,12277,66,58850,247,363176,837,422026,1084,5,729,11,1736,795,6,"Knox County",470313,806.909441159398,0.228138810403535,230.484804800208,61.8736883734874,22.8138810403535
2021-09-07,65988,404,53777,296,12211,108,58603,308,362339,979,420942,1287,3,724,12,1725,789,1,"Knox County",470313,775.866284793319,0.225813777441332,273.647549610578,85.9002409033984,22.5813777441332
2021-09-06,65584,978,53481,782,12103,196,58295,838,361360,3219,419655,4057,1,721,19,1713,788,3,"Knox County",470313,900.251534616309,0.221055295457421,862.617023131404,207.946622780999,22.1055295457421
2021-09-05,64606,966,52699,801,11907,165,57457,833,358141,2905,415598,3738,2,720,15,1694,785,6,"Knox County",470313,1024.21153572196,0.22325108689515,794.789852715107,205.395130476938,22.325108689515
2021-09-04,63640,535,51898,382,11742,153,56624,403,355236,1185,411860,1588,2,718,10,1679,779,4,"Knox County",470313,957.022238381673,0.226248037676609,337.647481570784,113.754031889401,22.6248037676609
2021-09-03,63105,331,51516,237,11589,94,56221,249,354051,724,410272,973,5,716,8,1669,775,5,"Knox County",470313,810.949303974162,0.224528857479388,206.88350098764,70.3786627203586,22.4528857479388
2021-09-02,62774,316,51279,178,11495,138,55972,197,353327,541,409299,738,3,711,5,1661,770,3,"Knox County",470313,812.437674484864,0.228369847753435,156.916776699772,67.1892973402819,22.8369847753435
2021-09-01,62458,270,51101,208,11357,62,55775,220,352786,539,408561,759,2,708,2,1656,767,3,"Knox County",470313,807.972562952757,0.231963470319635,161.38188823188,57.4085768413801,23.1963470319635
2021-08-31,62188,592,50893,431,11295,161,55555,477,352247,1485,407802,1962,2,706,9,1654,764,4,"Knox County",470313,847.945942383051,0.232862830256967,417.168991714029,125.873620333693,23.2862830256967
2021-08-30,61596,509,50462,404,11134,105,55078,429,350762,1328,405840,1757,9,704,13,1645,760,6,"Knox County",470313,748.225118165987,0.243855840208424,373.580998186314,108.225798563935,24.3855840208424
2021-08-29,61087,481,50058,407,11029,74,54649,441,349434,1188,404083,1629,1,695,5,1632,754,7,"Knox County",470313,645.102304210175,0.256857325111631,346.365080276327,102.272316521125,25.6857325111631
2021-08-28,60606,394,49651,301,10955,93,54208,319,348246,845,402454,1164,0,694,4,1627,747,3,"Knox County",470313,615.122269637454,0.259630371854821,247.49475349395,83.7739973166806,25.9630371854821
2021-08-27,60212,466,49350,370,10862,96,53889,386,347401,925,401290,1311,5,694,5,1623,744,1,"Knox County",470313,643.826558058144,0.264914163090129,278.750534218701,99.0829511410486,26.4914163090129
2021-08-26,59746,447,48980,345,10766,102,53503,366,346476,1122,399979,1488,5,689,0,1618,743,5,"Knox County",470313,671.680349044147,0.261966236345581,316.385045703606,95.0430883262848,26.1966236345581
2021-08-25,59299,346,48635,224,10664,122,53137,235,345354,504,398491,739,2,684,4,1618,738,10,"Knox County",470313,687.839800303202,0.263980099502488,157.129401058444,73.5680281004352,26.3980099502488
2021-08-24,58953,333,48411,221,10542,112,52902,233,344850,553,397752,786,4,682,5,1614,728,0,"Knox County",470313,632.770091407212,0.271467207572684,167.122745916018,70.8039114377021,27.1467207572684
2021-08-23,58620,284,48190,206,10430,78,52669,226,344297,653,396966,879,1,678,1,1609,728,4,"Knox County",470313,584.929610706062,0.275887943971986,186.896811272493,60.385317862785,27.5887943971986
2021-08-22,58336,239,47984,218,10352,21,52443,234,343644,675,396087,909,2,677,0,1608,724,2,"Knox County",470313,533.474515907491,0.274738867509621,193.275542032646,50.817221722555,27.4738867509621
2021-08-21,58097,497,47766,375,10331,122,52209,408,342969,1499,395178,1907,0,675,8,1608,722,3,"Knox County",470313,555.374824850684,0.260381593714927,405.474651987081,105.674306259874,26.0381593714927
2021-08-20,57600,424,47391,330,10209,94,51801,356,341470,898,393271,1254,0,675,6,1600,719,3,"Knox County",470313,546.44460178647,0.258477769404672,266.63094577441,90.1527280768339,25.8477769404672
2021-08-19,57176,367,47061,253,10115,114,51445,262,340572,761,392017,1023,1,675,6,1594,716,0,"Knox County",470313,529.434653092728,0.260637588368681,217.514718921229,78.0331396325426,26.0637588368681
2021-08-18,56809,262,46808,192,10001,70,51183,198,339811,692,390994,890,2,674,5,1588,716,0,"Knox County",470313,511.574206964298,0.250653765690377,189.235679217883,55.7075819720059,25.0653765690377
2021-08-17,56547,260,46616,179,9931,81,50985,197,339119,829,390104,1026,0,672,5,1583,716,3,"Knox County",470313,496.052628781258,0.238463488843813,218.152591997244,55.2823332546623,23.8463488843813
2021-08-16,56287,179,46437,126,9850,53,50788,131,338290,333,389078,464,2,672,4,1578,713,0,"Knox County",470313,473.727071120722,0.238993710691824,98.6577024237051,38.0597602022483,23.8993710691824
2021-08-15,56108,203,46311,180,9797,23,50657,198,337957,679,388614,877,3,670,6,1574,713,1,"Knox County",470313,466.072594208538,0.235183443085607,186.471562555149,43.162744810371,23.5183443085607
2021-08-14,55905,220,46131,148,9774,72,50459,155,337278,618,387737,773,0,667,4,1568,712,2,"Knox County",470313,407.175646856455,0.237355319486285,164.358629253285,46.7773589077912,23.7355319486285
2021-08-13,55685,264,45983,205,9702,59,50304,219,336660,1163,386964,1382,1,667,5,1564,710,3,"Knox County",470313,373.155749468971,0.211344211344211,293.846863684397,56.1328306893494,21.1344211344211
2021-08-12,55421,220,45778,144,9643,76,50085,149,335497,493,385582,642,2,666,8,1559,707,2,"Knox County",470313,341.899968744219,0.205979517674265,136.504838267282,46.7773589077912,20.5979517674265
2021-08-11,55201,315,45634,236,9567,79,49936,247,335004,757,384940,1004,1,664,10,1551,705,3,"Knox County",470313,353.169059753823,0.21011673151751,213.474856106465,66.9766729816101,21.011673151751
2021-08-10,54886,172,45398,108,9488,64,49689,120,334247,489,383936,609,1,663,2,1541,702,4,"Knox County",470313,334.458116190707,0.211963136845766,129.488234431113,36.5713896915458,21.1963136845766
2021-08-09,54714,199,45290,162,9424,37,49569,170,333758,541,383327,711,1,662,5,1539,698,1,"Knox County",470313,338.710603364143,0.20973657885962,151.175919015634,42.3122473756839,20.973657885962
2021-08-08,54515,89,45128,67,9387,22,49399,75,333217,298,382616,373,1,661,5,1534,697,0,"Knox County",470313,314.47142647556,0.206589006188569,79.3088857845732,18.9235679217883,20.6589006188569
2021-08-07,54426,103,45061,74,9365,29,49324,78,332919,469,382243,547,0,660,2,1529,697,0,"Knox County",470313,289.594376510962,0.20083523158694,116.305524193463,21.9003089431931,20.083523158694
2021-08-06,54323,202,44987,147,9336,55,49246,163,332450,640,381696,803,0,660,10,1527,697,1,"Knox County",470313,276.411666273312,0.213691618682022,170.737360013438,42.9501204516992,21.3691618682022
2021-08-05,54121,173,44840,130,9281,43,49083,146,331810,641,380893,787,2,660,4,1517,696,2,"Knox County",470313,266.418321415738,0.206661150186181,167.335370274689,36.7840140502176,20.6661150186181
2021-08-04,53948,144,44710,101,9238,43,48937,104,331169,520,380106,624,1,658,4,1513,694,1,"Knox County",470313,230.059556082864,0.192186798383476,132.67759981119,30.6179076487361,19.2186798383476
2021-08-03,53804,237,44609,176,9195,61,48833,182,330649,614,379482,796,0,657,6,1509,693,3,"Knox County",470313,243.88013939653,0.197802197802198,169.248989502735,50.3919730052114,19.7802197802198
2021-08-02,53567,97,44433,75,9134,22,48651,82,330035,424,378686,506,2,657,3,1503,690,0,"Knox County",470313,222.192454812008,0.187105500450857,107.58792548792,20.6245627911625,18.7105500450857
2021-08-01,53470,105,44358,89,9112,16,48569,99,329611,410,378180,509,0,655,2,1500,690,2,"Knox County",470313,225.594444550757,0.18678915135608,108.225798563935,22.3255576605367,18.678915135608
2021-07-31,53365,103,44269,63,9096,40,48470,68,329201,306,377671,374,1,655,6,1498,688,0,"Knox County",470313,225.594444550757,0.19186178676972,79.521510143245,21.9003089431931,19.186178676972
2021-07-30,53262,118,44206,83,9056,35,48402,91,328895,171,377297,262,1,654,0,1492,688,1,"Knox County",470313,207.733998422327,0.200103680663556,55.7075819720059,25.0896743232698,20.0103680663556
2021-07-29,53144,118,44123,67,9021,51,48311,69,328724,358,377035,427,0,653,2,1492,687,1,"Knox County",470313,196.039658695379,0.198684962835906,90.7906011528493,25.0896743232698,19.8684962835906
2021-07-28,53026,130,44056,89,8970,41,48242,94,328366,395,376608,489,0,653,4,1490,686,0,"Knox County",470313,193.062917673975,0.20368718406185,103.9733113905,27.6411666273312,20.368718406185
2021-07-27,52896,117,43967,78,8929,39,48148,84,327971,367,376119,451,0,653,4,1486,686,0,"Knox County",470313,167.547994633361,0.194499668654738,95.893585760972,24.877049964598,19.4499668654738
2021-07-26,52779,97,43889,73,8890,24,48064,78,327604,273,375668,351,1,653,4,1482,686,0,"Knox County",470313,167.547994633361,0.203632553265805,74.6311498937941,20.6245627911625,20.3632553265805
2021-07-25,52682,51,43816,43,8866,8,47986,44,327331,238,375317,282,3,652,5,1478,686,1,"Knox County",470313,156.066279265085,0.200303490136571,59.9600691454414,10.8438422922607,20.0303490136571
2021-07-24,52631,65,43773,44,8858,21,47942,45,327093,263,375035,308,0,649,1,1473,685,2,"Knox County",470313,147.986553635558,0.196498054474708,65.4883024709077,13.8205833136656,19.6498054474708
2021-07-23,52566,55,43729,30,8837,25,47897,32,326830,233,374727,265,1,649,3,1472,683,1,"Knox County",470313,134.591219039236,0.17333851535173,56.3454550480212,11.6943397269478,17.333851535173
2021-07-22,52511,95,43699,70,8812,25,47865,79,326597,355,374462,434,0,648,3,1469,682,0,"Knox County",470313,129.700858789785,0.176744186046512,92.2789716635517,20.1993140738189,17.6744186046512
2021-07-21,52416,61,43629,47,8787,14,47786,46,326242,312,374028,358,1,648,1,1466,682,0,"Knox County",470313,115.029778041432,0.166598611678236,76.1195204044966,12.9700858789785,16.6598611678236
2021-07-20,52355,77,43582,42,8773,35,47740,44,325930,211,373670,255,0,647,3,1465,682,0,"Knox County",470313,106.524803694561,0.163337771859743,54.2192114613034,16.3720756177269,16.3337771859743
2021-07-19,52278,48,43540,36,8738,12,47696,41,325719,254,373415,295,0,647,0,1462,682,0,"Knox County",470313,96.1062101196437,0.150659990896677,62.7241858081746,10.2059692162454,15.0659990896677
2021-07-18,52230,36,43504,30,8726,6,47655,31,325465,203,373120,234,0,647,1,1462,682,1,"Knox County",470313,92.916844739567,0.14797580269893,49.7540999291961,7.65447691218401,14.797580269893
2021-07-17,52194,29,43474,22,8720,7,47624,23,325262,162,372886,185,0,647,1,1461,681,0,"Knox County",470313,85.262367827383,0.146100691016782,39.335506354279,6.16610640148157,14.6100691016782
2021-07-16,52165,37,43452,21,8713,16,47601,22,325100,220,372701,242,0,647,1,1460,681,0,"Knox County",470313,81.435129371291,0.142785821268098,51.4550947985703,7.86710127085579,14.2785821268098
2021-07-15,52128,55,43431,42,8697,13,47579,44,324880,286,372459,330,-1,647,1,1459,681,0,"Knox County",470313,72.9301550244199,0.132174828857293,70.1660383616868,11.6943397269478,13.2174828857293
2021-07-14,52073,21,43389,17,8684,4,47535,16,324594,199,372129,215,0,648,2,1458,681,0,"Knox County",470313,64.4251806775488,0.125854214123007,45.7142371144323,4.46511153210734,12.5854214123007
2021-07-13,52052,42,43372,26,8680,16,47519,29,324395,265,371914,294,3,648,3,1456,681,0,"Knox County",470313,56.9833281240365,0.114763231197772,62.5115614495028,8.93022306421468,11.4763231197772
2021-07-12,52010,28,43346,22,8664,6,47490,24,324130,186,371620,210,0,645,1,1453,681,1,"Knox County",470313,52.730840950601,0.110526315789474,44.6511153210734,5.95348204280979,11.0526315789474
2021-07-11,51982,8,43324,3,8658,5,47466,4,323944,107,371410,111,0,645,0,1452,680,0,"Knox County",470313,46.7773589077912,0.102079395085066,23.6013038125674,1.70099486937423,10.2079395085066
2021-07-10,51974,20,43321,16,8653,4,47462,16,323837,153,371299,169,0,645,2,1452,680,0,"Knox County",470313,44.8637396797452,0.0986632718014004,35.9335166155305,4.25248717343556,9.86632718014004
2021-07-09,51954,26,43305,20,8649,6,47446,20,323684,242,371130,262,0,645,0,1450,680,1,"Knox County",470313,42.5248717343556,0.0961659333752357,55.7075819720059,5.52823332546623,9.61659333752357
2021-07-08,51928,19,43285,14,8643,5,47426,16,323442,240,370868,256,0,645,0,1450,679,2,"Knox County",470313,34.8703948221716,0.0823994726433751,54.4318358199752,4.03986281476378,8.23994726433751
2021-07-07,51909,18,43271,5,8638,13,47410,5,323202,228,370612,233,1,645,1,1450,677,0,"Knox County",470313,34.2325217461563,0.0742671009771987,49.5414755705243,3.82723845609201,7.42671009771987
2021-07-06,51891,24,43266,9,8625,15,47405,13,322974,216,370379,229,0,644,2,1449,677,0,"Knox County",470313,30.4052832900643,0.0666666666666667,48.6909781358372,5.10298460812268,6.66666666666667
2021-07-05,51867,10,43257,7,8610,3,47392,6,322758,77,370150,83,0,644,1,1447,677,0,"Knox County",470313,26.5780448339723,0.0595681310498883,17.6478217697576,2.12624358671778,5.95681310498883
2021-07-04,51857,8,43250,7,8607,1,47386,7,322681,103,370067,110,0,644,1,1446,677,0,"Knox County",470313,26.5780448339723,0.0618479880774963,23.3886794538956,1.70099486937423,6.18479880774963
2021-07-03,51849,9,43243,7,8606,2,47379,7,322578,116,369957,123,0,644,1,1445,677,0,"Knox County",470313,24.2391768885827,0.0570987654320988,26.1527961166287,1.913619228046,5.70987654320988
2021-07-02,51840,17,43236,13,8604,4,47372,17,322462,262,369834,279,-1,644,0,1444,677,0,"Knox County",470313,22.3255576605367,0.0540746382330541,59.3221960694261,3.61461409742023,5.40746382330541
2021-07-01,51823,18,43223,15,8600,3,47355,17,322200,168,369555,185,-1,645,1,1444,677,0,"Knox County",470313,22.1129333018649,0.0579710144927536,39.335506354279,3.82723845609201,5.79710144927536
2021-06-30,51805,18,43208,12,8597,6,47338,11,322032,219,369370,230,0,646,0,1443,677,0,"Knox County",470313,22.1129333018649,0.062953995157385,48.903602494509,3.82723845609201,6.2953995157385
2021-06-29,51787,21,43196,16,8591,5,47327,19,321813,306,369140,325,0,646,1,1443,677,0,"Knox County",470313,21.4750602258496,0.0629213483146067,69.1029165683279,4.46511153210734,6.29213483146067
2021-06-28,51766,9,43180,2,8586,7,47308,2,321507,91,368815,93,0,646,0,1442,677,0,"Knox County",470313,21.2624358671778,0.0594795539033457,19.7740653564754,1.913619228046,5.94795539033457
2021-06-27,51757,5,43178,3,8579,2,47306,3,321416,101,368722,104,0,646,0,1442,677,0,"Knox County",470313,20.6245627911625,0.0567587752053772,22.1129333018649,1.06312179335889,5.67587752053771
2021-06-26,51752,3,43175,2,8577,1,47303,2,321315,116,368618,118,0,646,0,1442,677,0,"Knox County",470313,19.3488166391318,0.0532233883058471,25.0896743232698,0.637873076015334,5.32233883058471
2021-06-25,51749,13,43173,9,8576,4,47301,11,321199,214,368500,225,0,646,0,1442,677,0,"Knox County",470313,18.4983192044447,0.05078125,47.8404807011501,2.76411666273312,5.078125
2021-06-24,51736,14,43164,9,8572,5,47290,10,320985,277,368275,287,1,646,1,1442,677,1,"Knox County",470313,17.6478217697576,0.0419681620839363,61.0231909388003,2.97674102140489,4.19681620839363
2021-06-23,51722,13,43155,6,8567,7,47280,8,320708,203,367988,211,0,645,0,1441,676,1,"Knox County",470313,16.5846999763987,0.0403521643433602,44.8637396797452,2.76411666273312,4.03521643433602
2021-06-22,51709,14,43149,5,8560,9,47272,5,320505,189,367777,194,2,645,1,1441,675,1,"Knox County",470313,15.0963294656962,0.0332792207792208,41.249125582325,2.97674102140489,3.32792207792208
2021-06-21,51695,9,43144,8,8551,1,47267,9,320316,225,367583,234,0,643,1,1440,674,0,"Knox County",470313,15.0963294656962,0.0349599417334304,49.7540999291961,1.913619228046,3.49599417334304
2021-06-20,51686,3,43136,2,8550,1,47258,3,320091,124,367349,127,1,643,0,1439,674,0,"Knox County",470313,14.6710807483527,0.0343839541547278,27.0032935513158,0.637873076015334,3.43839541547278
2021-06-19,51683,3,43134,1,8549,2,47255,1,319967,126,367222,127,0,642,0,1439,674,0,"Knox County",470313,14.6710807483527,0.0334519572953737,27.0032935513158,0.637873076015334,3.34519572953737
2021-06-18,51680,5,43133,3,8547,2,47254,3,319841,201,367095,204,1,642,0,1439,674,0,"Knox County",470313,12.9700858789785,0.0281791907514451,43.3753691690427,1.06312179335889,2.81791907514451
2021-06-17,51675,12,43130,8,8545,4,47251,9,319640,413,366891,422,0,641,0,1439,674,1,"Knox County",470313,12.5448371616349,0.0250164581961817,89.7274793594904,2.55149230406134,2.50164581961817
2021-06-16,51663,7,43122,4,8541,3,47242,4,319227,245,366469,249,1,641,0,1439,673,0,"Knox County",470313,11.2690910096042,0.0218368657675016,52.9434653092728,1.48837051070245,2.18368657675016
2021-06-15,51656,13,43118,9,8538,4,47238,14,318982,338,366220,352,0,640,0,1439,673,0,"Knox County",470313,11.0564666509325,0.0250728862973761,74.8437742524659,2.76411666273312,2.50728862973761
2021-06-14,51643,7,43109,2,8534,5,47224,3,318644,175,365868,178,1,640,0,1439,673,0,"Knox County",470313,10.6312179335889,0.0223025919228451,37.8471358435765,1.48837051070245,2.23025919228451
2021-06-13,51636,3,43107,3,8529,0,47221,4,318469,104,365690,108,0,639,1,1439,673,0,"Knox County",470313,10.6312179335889,0.0231707317073171,22.963430736552,0.637873076015334,2.31707317073171
2021-06-12,51633,2,43104,1,8529,1,47217,1,318365,141,365582,142,0,639,0,1438,673,1,"Knox County",470313,10.4185935749171,0.0229607250755287,30.1926589313925,0.425248717343556,2.29607250755287
2021-06-11,51631,7,43103,3,8528,4,47216,2,318224,237,365440,239,0,639,0,1438,672,1,"Knox County",470313,10.8438422922607,0.0218934911242604,50.817221722555,1.48837051070245,2.18934911242604
2021-06-10,51624,7,43100,4,8524,3,47214,5,317987,253,365201,258,0,639,0,1438,671,0,"Knox County",470313,9.7807204989018,0.0216251638269987,54.8570845373188,1.48837051070245,2.16251638269987
2021-06-09,51617,2,43096,1,8521,1,47209,1,317734,232,364943,233,1,639,0,1438,671,1,"Knox County",470313,8.7175987055429,0.0198675496688742,49.5414755705243,0.425248717343556,1.98675496688742
2021-06-08,51615,5,43095,3,8520,2,47208,4,317502,207,364710,211,1,638,0,1438,670,1,"Knox County",470313,7.01660383616868,0.014609203798393,44.8637396797452,1.06312179335889,1.4609203798393
2021-06-07,51610,16,43092,10,8518,6,47204,10,317295,230,364499,240,0,637,2,1438,669,0,"Knox County",470313,8.93022306421468,0.0188679245283019,51.0298460812268,3.40198973874845,1.88679245283019
2021-06-06,51594,4,43082,2,8512,2,47194,2,317065,135,364259,137,0,637,0,1436,669,1,"Knox County",470313,9.14284742288646,0.0171232876712329,29.1295371380336,0.850497434687113,1.71232876712329
2021-06-05,51590,5,43080,2,8510,3,47192,3,316930,188,364122,191,0,637,0,1436,668,0,"Knox County",470313,9.7807204989018,0.0178926441351889,40.6112525063096,1.06312179335889,1.78926441351889
2021-06-04,51585,7,43078,2,8507,5,47189,3,316742,245,363931,248,1,637,0,1436,668,0,"Knox County",470313,9.7807204989018,0.0184453227931489,52.730840950601,1.48837051070245,1.84453227931489
2021-06-03,51578,7,43076,4,8502,3,47186,6,316497,297,363683,303,0,636,0,1436,668,0,"Knox County",470313,9.7807204989018,0.018554062699936,64.4251806775488,1.48837051070245,1.8554062699936
2021-06-02,51571,20,43072,7,8499,13,47180,6,316200,218,363380,224,0,636,1,1436,668,0,"Knox County",470313,13.6079589549938,0.0218790218790219,47.6278563424783,4.25248717343556,2.18790218790219
2021-06-01,51551,12,43065,9,8486,3,47174,10,315982,201,363156,211,0,636,1,1435,668,0,"Knox County",470313,15.0963294656962,0.0257400257400257,44.8637396797452,2.55149230406134,2.57400257400257
2021-05-31,51539,17,43056,14,8483,3,47164,12,315781,265,362945,277,0,636,0,1434,668,0,"Knox County",470313,15.308953824368,0.0263984915147706,58.8969473520825,3.61461409742023,2.63984915147706
2021-05-30,51522,3,43042,1,8480,2,47152,1,315516,153,362668,154,0,636,0,1434,668,1,"Knox County",470313,15.0963294656962,0.0254975124378109,32.7441512354538,0.637873076015334,2.54975124378109
2021-05-29,51519,14,43041,8,8478,6,47151,6,315363,137,362514,143,0,636,1,1434,667,2,"Knox County",470313,17.0099486937423,0.0282051282051282,30.4052832900643,2.97674102140489,2.82051282051282
2021-05-28,51505,10,43033,6,8472,4,47145,10,315226,262,362371,272,0,636,1,1433,665,0,"Knox County",470313,17.6478217697576,0.0321969696969697,57.8338255587237,2.12624358671778,3.21969696969697
2021-05-27,51495,23,43027,8,8468,15,47135,9,314964,254,362099,263,0,636,1,1432,665,0,"Knox County",470313,21.049811508506,0.0349740932642487,55.9202063306777,4.8903602494509,3.49740932642487
2021-05-26,51472,16,43019,8,8453,8,47126,11,314710,423,361836,434,0,636,0,1431,665,0,"Knox County",470313,20.1993140738189,0.0336374002280502,92.2789716635517,3.40198973874845,3.36374002280502
2021-05-25,51456,18,43011,8,8445,10,47115,7,314287,230,361402,237,0,636,1,1431,665,0,"Knox County",470313,21.4750602258496,0.0314606741573034,50.3919730052114,3.82723845609201,3.14606741573034
2021-05-24,51438,25,43003,21,8435,4,47108,24,314057,336,361165,360,0,636,1,1430,665,1,"Knox County",470313,23.1760550952238,0.0365002683843264,76.5447691218401,5.31560896679445,3.65002683843264
2021-05-23,51413,16,42982,8,8431,8,47084,8,313721,161,360805,169,1,636,1,1429,664,1,"Knox County",470313,25.9401717579569,0.0399361022364217,35.9335166155305,3.40198973874845,3.99361022364217
2021-05-22,51397,8,42974,4,8423,4,47076,4,313560,210,360636,214,0,635,0,1428,663,0,"Knox County",470313,24.6644256059263,0.0374551051821447,45.5016127557605,1.70099486937423,3.74551051821447
2021-05-21,51389,15,42970,11,8419,4,47072,13,313350,276,360422,289,0,635,1,1428,663,1,"Knox County",470313,25.7275473992852,0.0386571719226857,61.4484396561439,3.18936538007667,3.86571719226857
2021-05-20,51374,34,42959,26,8415,8,47059,27,313074,427,360133,454,0,635,1,1427,662,1,"Knox County",470313,28.0664153446747,0.0435790449698656,96.5314588369873,7.22922819484046,4.35790449698656
2021-05-19,51340,14,42933,6,8407,8,47032,6,312647,389,359679,395,0,635,1,1426,661,0,"Knox County",470313,27.6411666273312,0.0420207743153919,83.9866216753524,2.97674102140489,4.20207743153919
2021-05-18,51326,24,42927,14,8399,10,47026,14,312258,337,359284,351,1,635,0,1425,661,1,"Knox County",470313,28.9169127793618,0.043010752688172,74.6311498937941,5.10298460812268,4.3010752688172
2021-05-17,51302,15,42913,8,8389,7,47012,8,311921,290,358933,298,0,634,0,1425,660,0,"Knox County",470313,26.790669192644,0.0368663594470046,63.3620588841899,3.18936538007667,3.68663594470046
2021-05-16,51287,22,42905,13,8382,9,47004,12,311631,174,358635,186,1,634,1,1425,660,1,"Knox County",470313,28.0664153446747,0.0384087791495199,39.5481307129507,4.67773589077912,3.84087791495199
2021-05-15,51265,23,42892,13,8373,10,46992,17,311457,246,358449,263,0,633,2,1424,659,1,"Knox County",470313,31.2557807247514,0.0433810375670841,55.9202063306777,4.8903602494509,4.33810375670841
2021-05-14,51242,36,42879,25,8363,11,46975,26,311211,391,358186,417,0,633,4,1422,658,0,"Knox County",470313,35.7208922568587,0.0465313028764805,88.6643575661315,7.65447691218401,4.65313028764805
2021-05-13,51206,31,42854,17,8352,14,46949,17,310820,254,357769,271,0,633,0,1418,658,0,"Knox County",470313,35.0830191808434,0.0458505272810637,57.6212012000519,6.59135511882512,4.58505272810637
2021-05-12,51175,34,42837,28,8338,6,46932,26,310566,382,357498,408,0,633,0,1418,658,0,"Knox County",470313,39.335506354279,0.0546946216955333,86.7507383380855,7.22922819484046,5.46946216955333
2021-05-11,51141,36,42809,30,8332,6,46906,31,310184,418,357090,449,0,633,4,1418,658,0,"Knox County",470313,41.8869986583403,0.0597731239092496,95.4683370436284,7.65447691218401,5.97731239092496
2021-05-10,51105,21,42779,14,8326,7,46875,13,309766,220,356641,233,1,633,1,1414,658,1,"Knox County",470313,43.162744810371,0.0637629097440503,49.5414755705243,4.46511153210734,6.37629097440503
2021-05-09,51084,17,42765,14,8319,3,46862,17,309546,286,356408,303,0,632,1,1413,657,0,"Knox County",470313,42.0996230170121,0.0627133105802048,64.4251806775488,3.61461409742023,6.27133105802048
2021-05-08,51067,20,42751,11,8316,9,46845,14,309260,206,356105,220,0,632,1,1412,657,0,"Knox County",470313,41.4617499409967,0.0625814863102999,46.7773589077912,4.25248717343556,6.25814863102999
2021-05-07,51047,43,42740,31,8307,12,46831,33,309054,368,355885,401,0,632,0,1411,657,0,"Knox County",470313,42.9501204516992,0.0660831509846827,85.262367827383,9.14284742288646,6.60831509846827
2021-05-06,51004,40,42709,26,8295,14,46798,28,308686,240,355484,268,1,632,0,1411,657,1,"Knox County",470313,44.8637396797452,0.0709903593339176,56.9833281240365,8.50497434687113,7.09903593339176
2021-05-05,50964,51,42683,32,8281,19,46770,38,308446,422,355216,460,0,631,4,1411,656,0,"Knox County",470313,48.4783537771654,0.0745501285347044,97.807204989018,10.8438422922607,7.45501285347044
2021-05-04,50913,50,42651,32,8262,18,46732,34,308024,383,354756,417,0,631,0,1407,656,0,"Knox County",470313,51.4550947985703,0.076889661164205,88.6643575661315,10.6312179335889,7.6889661164205
2021-05-03,50863,24,42619,9,8244,15,46698,7,307641,204,354339,211,1,631,1,1407,656,1,"Knox County",470313,52.0929678745856,0.075,44.8637396797452,5.10298460812268,7.5
2021-05-02,50839,25,42610,18,8229,7,46691,20,307437,195,354128,215,0,630,2,1406,655,0,"Knox County",470313,53.7939627439599,0.0793795620437956,45.7142371144323,5.31560896679445,7.93795620437956
2021-05-01,50814,45,42592,35,8222,10,46671,37,307242,351,353913,388,0,630,2,1404,655,0,"Knox County",470313,59.1095717107543,0.0834745762711864,82.4982511646499,9.56809614023002,8.34745762711864
2021-04-30,50769,57,42557,30,8212,27,46634,29,306891,370,353525,399,0,630,3,1402,655,1,"Knox County",470313,62.0863127321592,0.0818490245971162,84.8371191100395,12.1195884442914,8.18490245971162
2021-04-29,50712,54,42527,34,8185,20,46605,35,306521,413,353126,448,0,630,2,1399,654,0,"Knox County",470313,65.0630537535641,0.0788022064617809,95.2557126849566,11.481715368276,7.88022064617809
2021-04-28,50658,47,42493,28,8165,19,46570,34,306108,394,352678,428,4,630,1,1397,654,2,"Knox County",470313,64.212556318877,0.0782122905027933,91.003225511521,9.99334485757357,7.82122905027933
2021-04-27,50611,39,42465,17,8146,22,46536,20,305714,261,352250,281,1,626,2,1396,652,1,"Knox County",470313,61.8736883734874,0.0767932489451477,59.7474447867697,8.29234998819935,7.67932489451477
2021-04-26,50572,69,42448,36,8124,33,46516,40,305453,341,351969,381,1,625,0,1394,651,2,"Knox County",470313,71.4417845137175,0.0846456692913386,81.0098806539475,14.6710807483527,8.46456692913386
2021-04-25,50503,37,42412,24,8091,13,46476,25,305112,259,351588,284,0,624,3,1394,649,0,"Knox County",470313,73.9932768177788,0.0843234955921809,60.385317862785,7.86710127085579,8.43234955921809
2021-04-24,50466,35,42388,22,8078,13,46451,28,304853,394,351304,422,0,624,3,1391,649,1,"Knox County",470313,71.867033231061,0.0798335225122966,89.7274793594904,7.44185255351224,7.98335225122966
2021-04-23,50431,42,42366,31,8065,11,46423,36,304459,346,350882,382,0,624,2,1388,648,1,"Knox County",470313,68.6776678509843,0.083015993907083,81.2225050126193,8.93022306421468,8.3015993907083
2021-04-22,50389,78,42335,61,8054,17,46387,64,304113,520,350500,584,1,624,1,1386,647,1,"Knox County",470313,73.780652459107,0.0894279507603186,124.172625464318,16.5846999763987,8.94279507603186
2021-04-21,50311,62,42274,34,8037,28,46323,34,303593,358,349916,392,1,623,1,1385,646,1,"Knox County",470313,76.9700178391837,0.0906089508437271,83.348748599337,13.1827102376502,9.06089508437271
2021-04-20,50249,38,42240,34,8009,4,46289,38,303235,345,349524,383,1,622,1,1384,645,1,"Knox County",470313,76.7573934805119,0.0937057991513437,81.435129371291,8.07972562952757,9.37057991513437
2021-04-19,50211,64,42206,40,8005,24,46251,39,302890,247,349141,286,0,621,0,1383,644,0,"Knox County",470313,75.694271687153,0.0965971459934138,60.8105665801286,13.6079589549938,9.65971459934138
2021-04-18,50147,38,42166,27,7981,11,46212,32,302643,284,348855,316,0,621,1,1383,644,1,"Knox County",470313,75.9068960458248,0.0980108499095841,67.1892973402819,8.07972562952757,9.80108499095841
2021-04-17,50109,37,42139,18,7970,19,46180,23,302359,235,348539,258,0,621,1,1382,643,0,"Knox County",470313,76.3321447631684,0.102268358323722,54.8570845373188,7.86710127085579,10.2268358323722
2021-04-16,50072,345,42121,329,7951,16,46157,369,302124,1647,348281,2016,1,621,4,1381,643,1,"Knox County",470313,140.757325440717,0.141440377804014,428.650707082305,73.3554037417635,14.1440377804014
2021-04-15,49727,86,41792,54,7935,32,45788,55,300477,420,346265,475,1,620,0,1377,642,1,"Knox County",470313,142.458320310091,0.142995637421231,100.996570369095,18.2856948457729,14.2995637421231
2021-04-14,49641,84,41738,59,7903,25,45733,61,300057,499,345790,560,0,619,3,1377,641,0,"Knox County",470313,147.13605620087,0.14368886818817,119.069640856196,17.8604461284294,14.368886818817
2021-04-13,49557,68,41679,38,7878,30,45672,43,299558,253,345230,296,-5,619,1,1374,641,0,"Knox County",470313,153.514786961024,0.147848823389589,62.9368101668463,14.4584563896809,14.7848823389589
2021-04-12,49489,63,41641,43,7848,20,45629,50,299305,270,344934,320,1,624,0,1373,641,1,"Knox County",470313,153.302162602352,0.149257250648432,68.039794774969,13.395334596322,14.9257250648432
2021-04-11,49426,26,41598,15,7828,11,45579,14,299035,211,344614,225,2,623,0,1373,640,0,"Knox County",470313,150.750670298291,0.148192771084337,47.8404807011501,5.52823332546623,14.8192771084337
2021-04-10,49400,50,41583,33,7817,17,45565,41,298824,423,344389,464,0,621,1,1373,640,1,"Knox County",470313,153.514786961024,0.145316804407713,98.6577024237051,10.6312179335889,14.5316804407713
2021-04-09,49350,82,41550,62,7800,20,45524,71,298401,441,343925,512,5,621,2,1372,639,0,"Knox County",470313,97.5945806303462,0.117461430575035,108.86367163995,17.4351974110858,11.7461430575035
2021-04-08,49268,49,41488,26,7780,23,45453,25,297960,331,343413,356,-6,616,0,1370,639,1,"Knox County",470313,89.7274793594904,0.111598975484815,75.694271687153,10.4185935749171,11.1598975484815
2021-04-07,49219,76,41462,53,7757,23,45428,57,297629,565,343057,622,2,622,1,1370,638,0,"Knox County",470313,88.0264844901162,0.107692307692308,132.252351093846,16.1594512590551,10.7692307692308
2021-04-06,49143,73,41409,40,7734,33,45371,44,297064,302,342435,346,2,620,0,1369,638,0,"Knox County",470313,89.089606283475,0.106151142355009,73.5680281004352,15.5215781830398,10.6151142355009
2021-04-05,49070,44,41369,32,7701,12,45327,35,296762,191,342089,226,0,618,3,1369,638,2,"Knox County",470313,85.0497434687113,0.104325699745547,48.0531050598219,9.35547178155824,10.4325699745547
2021-04-04,49026,49,41337,31,7689,18,45292,40,296571,244,341863,284,3,618,0,1366,636,1,"Knox County",470313,89.9401037181622,0.111387900355872,60.385317862785,10.4185935749171,11.1387900355872
2021-04-03,48977,80,41306,63,7671,17,45252,70,296327,444,341579,514,0,615,0,1366,635,3,"Knox County",470313,96.3188344783155,0.11958041958042,109.288920357294,17.0099486937423,11.958041958042
2021-04-02,48897,73,41243,43,7654,30,45182,44,295883,348,341065,392,0,615,2,1366,632,2,"Knox County",470313,94.4052152502695,0.114963503649635,83.348748599337,15.5215781830398,11.4963503649635
2021-04-01,48824,76,41200,64,7624,12,45138,67,295535,410,340673,477,1,615,1,1364,630,0,"Knox County",470313,100.146072934408,0.124781544914366,101.421819086438,16.1594512590551,12.4781544914366
2021-03-31,48748,86,41136,65,7612,21,45071,71,295125,574,340196,645,3,614,2,1363,630,2,"Knox County",470313,102.272316521125,0.128640776699029,137.142711343297,18.2856948457729,12.8640776699029
2021-03-30,48662,56,41071,32,7591,24,45000,38,294551,320,339551,358,1,611,2,1361,628,2,"Knox County",470313,98.6577024237051,0.12603591160221,76.1195204044966,11.9069640856196,12.603591160221
2021-03-29,48606,42,41039,21,7567,21,44962,22,294231,279,339193,301,5,610,0,1359,626,1,"Knox County",470313,98.2324537063615,0.118478626725008,63.9999319602052,8.93022306421468,11.8478626725008
2021-03-28,48564,80,41018,46,7546,34,44940,49,293952,357,338892,406,2,605,5,1359,625,2,"Knox County",470313,104.823808825187,0.116715163271904,86.3254896207419,17.0099486937423,11.6715163271904
2021-03-27,48484,43,40972,40,7512,3,44891,42,293595,314,338486,356,0,603,2,1354,623,2,"Knox County",470313,96.9567075543308,0.113458262350937,75.694271687153,9.14284742288646,11.3458262350937
2021-03-26,48441,79,40932,54,7509,25,44849,60,293281,333,338130,393,0,603,2,1352,621,2,"Knox County",470313,98.2324537063615,0.118869209809264,83.5613729580088,16.7973243350705,11.8869209809264
2021-03-25,48362,87,40878,63,7484,24,44789,67,292948,419,337737,486,0,603,4,1350,619,1,"Knox County",470313,100.571321651751,0.118505942275042,103.335438314484,18.4983192044447,11.8505942275042
2021-03-24,48275,123,40815,93,7460,30,44722,95,292529,535,337251,630,1,603,3,1346,618,1,"Knox County",470313,108.438422922607,0.127303754266212,133.95334596322,26.1527961166287,12.7303754266212
2021-03-23,48152,88,40722,58,7430,30,44627,63,291994,375,336621,438,1,602,3,1343,617,1,"Knox County",470313,115.242402400104,0.132225913621262,93.1294690982388,18.7109435631165,13.2225913621262
2021-03-22,48064,111,40664,77,7400,34,44564,79,291619,368,336183,447,2,601,1,1340,616,0,"Knox County",470313,129.913483148456,0.144169835234474,95.0430883262848,23.6013038125674,14.4169835234474
2021-03-21,47953,50,40587,33,7366,17,44485,34,291251,221,335736,255,-3,599,1,1339,616,1,"Knox County",470313,123.534752388303,0.146422628951747,54.2192114613034,10.6312179335889,14.6422628951747
2021-03-20,47903,59,40554,29,7349,30,44451,33,291030,220,335481,253,0,602,4,1338,615,0,"Knox County",470313,126.936742127052,0.148518263266713,53.7939627439599,12.5448371616349,14.8518263266713
2021-03-19,47844,146,40525,102,7319,44,44418,116,290810,655,335228,771,3,602,3,1334,615,1,"Knox County",470313,141.182574158061,0.148475609756098,163.933380535941,31.0431563660796,14.8475609756098
2021-03-18,47698,68,40423,50,7275,18,44302,66,290155,435,334457,501,2,599,1,1331,614,0,"Knox County",470313,137.142711343297,0.147496206373293,106.524803694561,14.4584563896809,14.7496206373293
2021-03-17,47630,46,40373,36,7257,10,44236,41,289720,358,333956,399,1,597,3,1330,614,2,"Knox County",470313,120.77063572557,0.140992167101828,84.8371191100395,9.7807204989018,14.0992167101828
2021-03-16,47584,128,40337,84,7247,44,44195,100,289362,533,333557,633,0,596,3,1327,612,1,"Knox County",470313,129.275610072441,0.143909174593434,134.591219039236,27.2159179099876,14.3909174593434
2021-03-15,47456,43,40253,28,7203,15,44095,39,288829,208,332924,247,1,596,1,1324,611,1,"Knox County",470313,114.81715368276,0.140241909120628,52.5182165919292,9.14284742288646,14.0241909120628
2021-03-14,47413,59,40225,37,7188,22,44056,46,288621,289,332677,335,0,595,0,1323,610,0,"Knox County",470313,116.730772910806,0.14049060210258,71.2291601550457,12.5448371616349,14.049060210258
2021-03-13,47354,70,40188,33,7166,37,44010,40,288332,468,332342,508,1,595,1,1323,610,2,"Knox County",470313,119.069640856196,0.131997642899234,108.013174205263,14.8837051070245,13.1997642899234
2021-03-12,47284,63,40155,60,7129,3,43970,67,287864,502,331834,569,0,594,1,1322,608,2,"Knox County",470313,101.421819086438,0.125,120.983260084242,13.395334596322,12.5
2021-03-11,47221,80,40095,53,7126,27,43903,64,287362,446,331265,510,2,594,0,1321,606,1,"Knox County",470313,103.9733113905,0.124023742580444,108.438422922607,17.0099486937423,12.4023742580444
2021-03-10,47141,94,40042,71,7099,23,43839,81,286916,705,330755,786,2,592,0,1321,605,0,"Knox County",470313,114.179280606745,0.121794871794872,167.122745916018,19.9866897151471,12.1794871794872
2021-03-09,47047,80,39971,50,7076,30,43758,55,286211,417,329969,472,0,590,2,1321,605,5,"Knox County",470313,103.9733113905,0.114385760140064,100.358697293079,17.0099486937423,11.4385760140064
2021-03-08,46967,84,39921,57,7046,27,43703,62,285794,290,329497,352,1,590,0,1319,600,2,"Knox County",470313,112.690910096042,0.117497168742922,74.8437742524659,17.8604461284294,11.7497168742922
2021-03-07,46883,62,39864,39,7019,23,43641,41,285504,204,329145,245,0,589,0,1319,598,0,"Knox County",470313,113.328783172058,0.119116792562464,52.0929678745856,13.1827102376502,11.9116792562464
2021-03-06,46821,122,39825,85,6996,37,43600,94,285300,639,328900,733,0,589,1,1319,598,0,"Knox County",470313,124.38524982299,0.126533951458958,155.853654906413,25.9401717579569,12.6533951458958
2021-03-05,46699,69,39740,43,6959,26,43506,48,284661,347,328167,395,2,589,2,1318,598,2,"Knox County",470313,125.660995975021,0.127397652447753,83.9866216753524,14.6710807483527,12.7397652447753
2021-03-04,46630,112,39697,85,6933,27,43458,99,284314,774,327772,873,5,587,2,1316,596,2,"Knox County",470313,132.464975452518,0.12448132780083,185.621065120462,23.8139281712392,12.448132780083
2021-03-03,46518,70,39612,29,6906,41,43359,36,283540,351,326899,387,1,582,4,1314,594,1,"Knox County",470313,127.361990844395,0.125831645935782,82.2856268059781,14.8837051070245,12.5831645935782
2021-03-02,46448,133,39583,91,6865,42,43323,99,283189,622,326512,721,-1,581,2,1310,593,5,"Knox County",470313,138.631081853999,0.129249865083648,153.302162602352,28.2790397033465,12.9249865083648
2021-03-01,46315,56,39492,30,6823,26,43224,33,282567,101,325791,134,1,582,1,1308,588,0,"Knox County",470313,132.67759981119,0.12901376146789,28.4916640620183,11.9069640856196,12.901376146789
2021-02-28,46259,77,39462,53,6797,24,43191,63,282466,424,325657,487,2,581,2,1307,588,1,"Knox County",470313,135.866965191266,0.126541554959786,103.548062673156,16.3720756177269,12.6541554959786
2021-02-27,46182,82,39409,47,6773,35,43128,59,282042,476,325170,535,1,579,3,1305,587,1,"Knox County",470313,127.361990844395,0.123725934314836,113.754031889401,17.4351974110858,12.3725934314836
2021-02-26,46100,105,39362,69,6738,36,43069,80,281566,360,324635,440,5,578,1,1302,586,0,"Knox County",470313,135.016467756579,0.131115459882583,93.5547178155824,22.3255576605367,13.1115459882583
2021-02-25,45995,131,39293,92,6702,39,42989,98,281206,738,324195,836,2,573,5,1301,586,1,"Knox County",470313,139.056330571343,0.132203389830508,177.753963849607,27.8537909860029,13.2203389830508
2021-02-24,45864,100,39201,70,6663,30,42891,78,280468,691,323359,769,2,571,2,1296,585,1,"Knox County",470313,145.435061331496,0.130035696073432,163.508131818597,21.2624358671778,13.0035696073432
2021-02-23,45764,115,39131,61,6633,54,42813,68,279777,538,322590,606,5,569,6,1294,584,2,"Knox County",470313,141.607822875404,0.12582085631731,128.850361355098,24.4518012472545,12.582085631731
2021-02-22,45649,60,39070,31,6579,29,42745,37,279239,222,321984,259,3,564,3,1288,582,2,"Knox County",470313,142.458320310091,0.122838250254324,55.0697088959905,12.7574615203067,12.2838250254323
2021-02-21,45589,82,39039,41,6550,41,42708,45,279017,367,321725,412,2,561,3,1285,580,3,"Knox County",470313,143.52144210345,0.120560020741509,87.6012357727726,17.4351974110858,12.0560020741509
2021-02-20,45507,137,38998,98,6509,39,42663,115,278650,751,321313,866,1,559,2,1282,577,1,"Knox County",470313,155.215781830398,0.12440305635148,184.13269460976,29.1295371380336,12.440305635148
2021-02-19,45370,93,38900,41,6470,52,42548,46,277899,179,320447,225,1,558,2,1280,576,2,"Knox County",470313,152.664289526337,0.122577397432671,47.8404807011501,19.7740653564754,12.2577397432671
2021-02-18,45277,147,38859,104,6418,43,42502,113,277720,686,320222,799,4,557,5,1278,574,6,"Knox County",470313,156.066279265085,0.127540650406504,169.886862578751,31.2557807247514,12.7540650406504
2021-02-17,45130,113,38755,68,6375,45,42389,76,277034,629,319423,705,1,553,4,1273,568,3,"Knox County",470313,158.830395927818,0.129132231404959,149.900172863604,24.0265525299109,12.9132231404959
2021-02-16,45017,145,38687,90,6330,55,42313,102,276405,538,318718,640,2,552,4,1269,565,0,"Knox County",470313,165.209126687972,0.136712749615975,136.079589549938,30.8305320074078,13.6712749615975
2021-02-15,44872,73,38597,34,6275,39,42211,43,275867,223,318078,266,2,550,1,1265,565,1,"Knox County",470313,167.973243350705,0.138001533350371,56.558079406693,15.5215781830398,13.8001533350371
2021-02-14,44799,162,38563,132,6236,30,42168,134,275644,540,317812,674,2,548,5,1264,564,1,"Knox County",470313,184.983192044447,0.150658682634731,143.308817744778,34.4451461048281,15.0658682634731
2021-02-13,44637,133,38431,89,6206,44,42034,105,275104,629,317138,734,4,546,7,1259,563,4,"Knox County",470313,184.13269460976,0.153104130596092,156.066279265085,28.2790397033465,15.3104130596092
2021-02-12,44504,174,38342,109,6162,65,41929,119,274475,702,316404,821,3,542,3,1252,559,1,"Knox County",470313,201.355267662174,0.149170079758569,174.56459846953,36.9966384088894,14.9170079758569
2021-02-11,44330,162,38233,112,6097,50,41810,117,273773,870,315583,987,5,539,5,1249,558,2,"Knox County",470313,204.544633042251,0.144188937228092,209.860242009045,34.4451461048281,14.4188937228092
2021-02-10,44168,147,38121,105,6047,42,41693,111,272903,640,314596,751,7,534,6,1244,556,2,"Knox County",470313,211.773861237091,0.150010260619741,159.680893362505,31.2557807247514,15.0010260619741
2021-02-09,44021,204,38016,149,6005,55,41582,160,272263,755,313845,915,0,527,6,1238,554,5,"Knox County",470313,224.318698398726,0.153263403263403,194.551288184677,43.3753691690427,15.3263403263403
2021-02-08,43817,103,37867,68,5950,35,41422,71,271508,282,312930,353,4,527,2,1232,549,3,"Knox County",470313,230.697429158879,0.156064947468959,75.0563986111377,21.9003089431931,15.6064947468959
2021-02-07,43714,109,37799,76,5915,33,41351,83,271226,523,312577,606,1,523,2,1230,546,1,"Knox County",470313,219.428338149275,0.148248500096768,128.850361355098,23.1760550952238,14.8248500096768
2021-02-06,43605,299,37723,173,5882,126,41268,194,270703,1028,311971,1222,2,522,6,1228,545,4,"Knox County",470313,254.72398168879,0.151193633952255,259.826966296913,63.5746832428617,15.1193633952255
2021-02-05,43306,173,37550,128,5756,45,41074,142,269675,489,310749,631,8,520,4,1222,541,3,"Knox County",470313,254.511357330118,0.160658737419945,134.165970321892,36.7840140502176,16.0658737419945
2021-02-04,43133,198,37422,148,5711,50,40932,158,269186,1156,310118,1314,2,512,7,1218,538,8,"Knox County",470313,262.165834242302,0.158667127071823,279.388407294717,42.0996230170121,15.8667127071823
2021-02-03,42935,228,37274,164,5661,64,40774,170,268030,1139,308804,1309,5,510,7,1211,530,0,"Knox County",470313,279.388407294717,0.154015748031496,278.325285501358,48.4783537771654,15.4015748031496
2021-02-02,42707,89,37110,68,5597,21,40604,76,266891,217,307495,293,7,505,1,1204,530,2,"Knox County",470313,254.936606047462,0.156075418994413,62.298937090831,18.9235679217883,15.6075418994413
2021-02-01,42618,152,37042,83,5576,69,40528,97,266674,311,307202,408,4,498,2,1203,528,3,"Knox County",470313,265.355199622379,0.159086979076604,86.7507383380855,32.3189025181103,15.9086979076604
2021-01-31,42466,173,36959,119,5507,54,40431,127,266363,675,306794,802,7,494,4,1201,525,2,"Knox County",470313,278.963158577373,0.161230975079445,170.524735654766,36.7840140502176,16.1230975079445
2021-01-30,42293,275,36840,233,5453,42,40304,251,265688,1033,305992,1284,7,487,9,1197,523,6,"Knox County",470313,273.86017396925,0.169011753021023,273.009676534563,58.471698634739,16.9011753021023
2021-01-29,42018,101,36607,52,5411,49,40053,62,264655,254,304708,316,4,480,1,1188,517,5,"Knox County",470313,258.551220144882,0.164338106880894,67.1892973402819,21.4750602258496,16.4338106880894
2021-01-28,41917,156,36555,116,5362,40,39991,126,264401,485,304392,611,9,476,6,1187,512,4,"Knox County",470313,249.620997080668,0.180967549273343,129.913483148456,33.1693999527974,18.0967549273343
2021-01-27,41761,169,36439,124,5322,45,39865,125,263916,587,303781,712,12,467,3,1181,508,4,"Knox County",470313,237.076159919033,0.195210122006326,151.388543374306,35.9335166155305,19.5210122006326
2021-01-26,41592,230,36315,169,5277,61,39740,191,263329,717,303069,908,3,455,8,1178,504,7,"Knox County",470313,267.056194491753,0.1942074985122,193.062917673975,48.903602494509,19.42074985122
2021-01-25,41362,157,36146,106,5216,51,39549,115,262612,299,302161,414,9,452,1,1170,497,4,"Knox County",470313,268.119316285112,0.197543094907866,88.0264844901162,33.3820243114692,19.7543094907866
2021-01-24,41205,152,36040,101,5165,51,39434,109,262313,574,301747,683,4,443,2,1169,493,5,"Knox County",470313,263.654204753005,0.198660714285714,145.222436972824,32.3189025181103,19.8660714285714
2021-01-23,41053,307,35939,220,5114,87,39325,231,261739,1068,301064,1299,7,439,7,1167,488,4,"Knox County",470313,270.458184230502,0.19401173376492,276.19904191464,65.2756781122359,19.401173376492
2021-01-22,40746,178,35719,142,5027,36,39094,175,260671,776,299765,951,3,432,8,1160,484,8,"Knox County",470313,286.830259848229,0.192183578343492,202.205765096861,37.8471358435765,19.2183578343492
2021-01-21,40568,257,35577,187,4991,70,38919,199,259895,805,298814,1004,11,429,5,1152,476,6,"Knox County",470313,308.305320074078,0.19176017417518,213.474856106465,54.644460178647,19.176017417518
2021-01-20,40311,193,35390,132,4921,61,38720,131,259090,513,297810,644,10,418,8,1147,470,10,"Knox County",470313,313.408304682201,0.194985600542097,136.930086984625,41.0365012236532,19.4985600542097
2021-01-19,40118,310,35258,195,4860,115,38589,218,258577,712,297166,930,8,408,14,1139,460,4,"Knox County",470313,330.418253375943,0.198818565400844,197.740653564754,65.9135511882512,19.8818565400844
2021-01-18,39808,128,35063,79,4745,49,38371,85,257865,321,296236,406,7,400,4,1125,456,9,"Knox County",470313,324.252146974462,0.194017238465439,86.3254896207419,27.2159179099876,19.4017238465439
2021-01-17,39680,180,34984,137,4696,43,38286,150,257544,505,295830,655,3,393,8,1121,447,6,"Knox County",470313,330.205629017271,0.201901850908473,139.268954930015,38.2723845609201,20.1901850908473
2021-01-16,39500,418,34847,338,4653,80,38136,386,257039,1252,295175,1638,1,390,7,1113,441,8,"Knox County",470313,353.806932829839,0.215799614643545,348.278699504373,88.8769819248033,21.5799614643545
2021-01-15,39082,187,34509,149,4573,38,37750,153,255787,532,293537,685,0,389,4,1106,433,10,"Knox County",470313,355.720552057885,0.221737671922174,145.647685690168,39.7607550716225,22.1737671922174
2021-01-14,38895,334,34360,264,4535,70,37597,288,255255,1079,292852,1367,6,389,8,1102,423,7,"Knox County",470313,372.092627675612,0.223083003952569,290.657498304321,71.0165357963739,22.3083003952569
2021-01-13,38561,243,34096,195,4465,48,37309,201,254176,644,291485,845,12,383,6,1094,416,2,"Knox County",470313,382.723845609201,0.226938400245173,179.667583077653,51.6677191572421,22.6938400245173
2021-01-12,38318,330,33901,259,4417,71,37108,281,253532,834,290640,1115,10,371,6,1088,414,5,"Knox County",470313,386.976332782636,0.230070034272091,237.076159919033,70.1660383616868,23.0070034272091
2021-01-11,37988,243,33642,196,4346,47,36827,228,252698,516,289525,744,4,361,5,1082,409,6,"Knox County",470313,411.428134029891,0.239324726911619,158.192522851803,51.6677191572421,23.9324726911619
2021-01-10,37745,324,33446,203,4299,121,36599,220,252182,739,288781,959,5,357,17,1077,403,6,"Knox County",470313,442.046041678627,0.238950088399293,203.906759966235,68.8902922096561,23.8950088399293
2021-01-09,37421,467,33243,386,4178,81,36379,421,251443,977,287822,1398,5,352,11,1060,397,2,"Knox County",470313,452.464635253544,0.251933080275552,297.248853423146,99.2955754997204,25.1933080275552
2021-01-08,36954,453,32857,365,4097,88,35958,387,250466,1043,286424,1430,7,347,6,1049,395,8,"Knox County",470313,509.022714660237,0.257826418936116,304.052832900643,96.3188344783155,25.7826418936116
2021-01-07,36501,379,32492,337,4009,42,35571,348,249423,868,284994,1216,10,340,10,1043,387,3,"Knox County",470313,518.590810800467,0.270663033605813,258.551220144882,80.5846319366039,27.0663033605813
2021-01-06,36122,487,32155,357,3967,130,35223,374,248555,805,283778,1179,9,330,15,1033,384,9,"Knox County",470313,570.471154316381,0.280935207063798,250.684118874026,103.548062673156,28.0935207063798
2021-01-05,35635,513,31798,322,3837,191,34849,341,247750,850,282599,1191,14,321,14,1018,375,6,"Knox County",470313,609.381411953316,0.285696685967722,253.235611178088,109.076295998622,28.5696685967722
2021-01-04,35122,321,31476,228,3646,93,34508,249,246900,465,281408,714,6,307,6,1004,369,8,"Knox County",470313,625.966111929715,0.289353283046865,151.81379209165,68.2524191336408,28.9353283046865
2021-01-03,34801,283,31248,182,3553,101,34259,195,246435,459,280694,654,2,301,9,998,361,9,"Knox County",470313,617.248513224172,0.297481367257774,139.056330571343,60.1726935041132,29.7481367257774
2021-01-02,34518,420,31066,318,3452,102,34064,342,245976,759,280040,1101,0,299,23,989,352,4,"Knox County",470313,607.255168366598,0.29873079492318,234.099418897628,89.3022306421468,29.873079492318
2021-01-01,34098,416,30748,346,3350,70,33722,373,245217,986,278939,1359,2,299,9,966,348,6,"Knox County",470313,599.388067095743,0.299703264094956,288.956503434947,88.4517332074597,29.9703264094956
2020-12-31,33682,449,30402,312,3280,137,33349,322,244231,929,277580,1251,12,297,8,957,342,3,"Knox County",470313,614.271772202767,0.294804671768023,265.993072698394,95.4683370436284,29.4804671768023
2020-12-30,33233,363,30090,248,3143,115,33027,271,243302,931,276329,1202,6,285,9,949,339,4,"Knox County",470313,587.906351727467,0.280112419700214,255.574479123477,77.1826421978555,28.0112419700214
2020-12-29,32870,590,29842,398,3028,192,32756,420,242371,1081,275127,1501,7,279,14,940,335,8,"Knox County",470313,604.278427345194,0.279105628373169,319.149162366339,125.448371616349,27.9105628373169
2020-12-28,32280,252,29444,174,2836,78,32336,185,241290,565,273626,750,4,272,4,926,327,5,"Knox County",470313,589.607346596841,0.269634177539013,159.468269003834,53.5813383852881,26.9634177539013
2020-12-27,32028,230,29270,156,2758,74,32151,172,240725,489,272876,661,3,268,8,922,322,7,"Knox County",470313,578.338255587237,0.266453674121406,140.544701082045,48.903602494509,26.6453674121406
2020-12-26,31798,359,29114,289,2684,70,31979,329,240236,1063,272215,1392,0,265,10,914,315,6,"Knox County",470313,565.368169708258,0.255298176441597,295.973107271115,76.3321447631684,25.5298176441597
2020-12-25,31439,353,28825,287,2614,66,31650,308,239173,1070,270823,1378,1,265,5,904,309,7,"Knox County",470313,551.972835111936,0.246711739397664,292.99636624971,75.0563986111377,24.6711739397664
2020-12-24,31086,351,28538,277,2548,74,31342,311,238103,1273,269445,1584,5,264,8,899,302,7,"Knox County",470313,531.135647962102,0.235710911667454,336.796984136097,74.6311498937941,23.5710911667454
2020-12-23,30735,472,28261,351,2474,121,31031,371,236830,1411,267861,1782,6,259,9,891,295,6,"Knox County",470313,554.311703057326,0.231653404067197,378.896607153109,100.358697293079,23.1653404067197
2020-12-22,30263,530,27910,392,2353,138,30660,432,235419,1470,266079,1902,7,253,15,882,289,6,"Knox County",470313,541.554241537019,0.223092390729178,404.411530193722,112.690910096042,22.3092390729178
2020-12-21,29733,442,27518,361,2215,81,30228,391,233949,1422,264177,1813,2,246,5,867,283,3,"Knox County",470313,581.952869684657,0.220129375951294,385.487962271934,93.9799665329259,22.0129375951294
2020-12-20,29291,514,27157,431,2134,83,29837,478,232527,2245,262364,2723,2,244,7,862,280,6,"Knox County",470313,642.338187547442,0.208366470494672,578.976128663252,109.288920357294,20.8366470494672
2020-12-19,28777,525,26726,441,2051,84,29359,489,230282,1445,259641,1934,6,242,14,855,274,7,"Knox County",470313,677.633831086957,0.211954864287893,411.215509671219,111.627788302684,21.1954864287893
2020-12-18,28252,480,26285,420,1967,60,28870,430,228837,1358,257707,1788,4,236,11,841,267,6,"Knox County",470313,704.637124638273,0.214549756025432,380.172353305139,102.059692162454,21.4549756025433
2020-12-17,27772,733,25865,635,1907,98,28440,663,227479,1898,255919,2561,11,232,11,830,261,4,"Knox County",470313,785.859629650892,0.224367372267807,544.530982558424,155.853654906413,22.4367372267807
2020-12-16,27039,564,25230,453,1809,111,27777,472,225581,1729,253358,2201,8,221,11,819,257,4,"Knox County",470313,805.421070648696,0.224835812893714,467.986213436584,119.920138290883,22.4835812893714
2020-12-15,26475,765,24777,675,1698,90,27305,716,223852,2415,251157,3131,2,213,15,808,253,8,"Knox County",470313,855.387794936564,0.225311126246053,665.726867001337,162.65763438391,22.5311126246053
2020-12-14,25710,472,24102,411,1608,61,26589,461,221437,1624,248026,2085,6,211,7,793,245,8,"Knox County",470313,861.766525696717,0.225841807221579,443.321787830657,100.358697293079,22.584180722158
2020-12-13,25238,628,23691,572,1547,56,26128,754,219813,2935,245941,3689,2,205,10,786,237,6,"Knox County",470313,886.0057025853,0.229167864742078,784.37125914019,133.528097245877,22.9167864742078
2020-12-12,24610,464,23119,392,1491,72,25374,454,216878,2171,242252,2625,3,203,19,776,231,4,"Knox County",470313,873.035616706321,0.218473451327434,558.138941513418,98.6577024237051,21.8473451327434
2020-12-11,24146,557,22727,523,1419,34,24920,429,214707,1406,239627,1835,6,200,10,757,227,2,"Knox County",470313,889.407692324048,0.21785182324709,390.165698162713,118.43176778018,21.785182324709
2020-12-10,23589,473,22204,415,1385,58,24491,538,213301,1910,237792,2448,8,194,9,747,225,10,"Knox County",470313,834.125359069386,0.212279338292439,520.504430028513,100.571321651751,21.2279338292439
2020-12-09,23116,407,21789,337,1327,70,23953,359,211391,924,235344,1283,2,186,13,738,215,3,"Knox County",470313,800.743334757917,0.217068320074871,272.797052175891,86.5381139794137,21.7068320074871
2020-12-08,22709,491,21452,446,1257,45,23594,538,210467,2077,234061,2615,9,184,10,725,212,2,"Knox County",470313,742.484260481849,0.213088057901086,556.0126979267,104.398560107843,21.3088057901086
2020-12-07,22218,323,21006,271,1212,52,23056,317,208390,1135,231446,1452,3,175,6,715,210,3,"Knox County",470313,710.803231039754,0.212516460776322,308.730568791422,68.6776678509843,21.2516460776322
2020-12-06,21895,332,20735,291,1160,41,22739,187,207255,668,229994,855,6,172,6,709,207,4,"Knox County",470313,647.866420872908,0.215206283840464,181.79382666437,70.5912870790304,21.5206283840464
2020-12-05,21563,289,20444,263,1119,26,22552,213,206587,714,229139,927,2,166,8,703,203,2,"Knox County",470313,610.657158105347,0.22610600087604,197.102780488738,61.4484396561439,22.610600087604
2020-12-04,21274,354,20181,322,1093,32,22339,297,205873,1091,228212,1388,5,164,11,695,201,5,"Knox County",470313,567.494413294976,0.223285922684172,295.122609836428,75.2690229698095,22.3285922684172
2020-12-03,20920,441,19859,424,1061,17,22042,448,204782,1215,226824,1663,2,159,10,684,196,2,"Knox County",470313,560.690433817479,0.231660610821958,353.594308471167,93.7673421742542,23.1660610821958
2020-12-02,20479,192,19435,170,1044,22,21594,185,203567,575,225161,760,2,157,7,674,194,5,"Knox County",470313,514.976196703047,0.226190476190476,161.594512590551,40.8238768649814,22.6190476190476
2020-12-01,20287,403,19265,380,1022,23,21409,409,202992,1832,224401,2241,5,155,7,667,189,3,"Knox County",470313,496.26525313993,0.221408572043937,476.491187783455,85.6876165447266,22.1408572043937
2020-11-30,19884,385,18885,371,999,14,21000,436,201160,1815,222160,2251,1,150,3,660,186,3,"Knox County",470313,509.44796337758,0.215666831928607,478.617431370173,81.8603780886346,21.5666831928607
2020-11-29,19499,226,18514,218,985,8,20564,260,199345,1464,219909,1724,0,149,5,657,183,6,"Knox County",470313,486.909781358372,0.205221836771955,366.564394350146,48.0531050598219,20.5221836771955
2020-11-28,19273,270,18296,256,977,14,20304,299,197881,1967,218185,2266,0,149,8,652,177,4,"Knox County",470313,482.869918543608,0.189864150329456,481.806796750249,57.4085768413801,18.9864150329456
2020-11-27,19003,235,18040,215,963,20,20005,249,195914,1247,215919,1496,3,149,12,644,173,3,"Knox County",470313,457.567619861667,0.184339972582856,318.08604057298,49.9667242878679,18.4339972582856
2020-11-26,18768,344,17825,341,943,3,19756,441,194667,1429,214423,1870,4,146,5,632,170,6,"Knox County",470313,436.943057070504,0.180758248730964,397.607550716225,73.1427793830917,18.0758248730964
2020-11-25,18424,219,17484,193,940,26,19315,123,193238,325,212553,448,0,142,3,627,164,2,"Knox County",470313,442.683914754642,0.18030253741054,95.2557126849566,46.5647345491194,18.030253741054
2020-11-24,18205,153,17291,130,914,23,19192,116,192913,673,212105,789,2,142,6,624,162,2,"Knox County",470313,389.527825086698,0.177425304315751,167.760618992033,32.5315268767821,17.7425304315751
2020-11-23,18052,167,17161,147,891,20,19076,100,192240,391,211316,491,3,140,7,618,160,7,"Knox County",470313,343.17571489625,0.174812857771907,104.398560107843,35.508267898187,17.4812857771907
2020-11-22,17885,220,17014,212,871,8,18976,258,191849,1804,210825,2062,2,137,5,611,153,2,"Knox County",470313,341.899968744219,0.168329441732116,438.431427581207,46.7773589077912,16.8329441732116
2020-11-21,17665,173,16802,169,863,4,18718,198,190045,1465,208763,1663,0,135,4,606,151,2,"Knox County",470313,321.275405953057,0.168386438371697,353.594308471167,36.7840140502176,16.8386438371697
2020-11-20,17492,178,16633,169,859,9,18520,163,188580,791,207100,954,7,135,5,602,149,4,"Knox County",470313,309.155817508765,0.169022592726833,202.843638172876,37.8471358435765,16.9022592726833
2020-11-19,17314,166,16464,148,850,18,18357,128,187789,663,206146,791,2,128,4,597,145,5,"Knox County",470313,271.308681665189,0.15087524312309,168.185867709377,35.2956435395152,15.087524312309
2020-11-18,17148,168,16316,163,832,5,18229,179,187126,874,205355,1053,0,126,7,593,140,2,"Knox County",470313,260.464839372928,0.146353966423171,223.893449681382,35.7208922568587,14.6353966423171
2020-11-17,16980,248,16153,240,827,8,18050,260,186252,1033,204302,1293,9,126,7,586,138,1,"Knox County",470313,280.664153446747,0.154809197062718,274.923295762609,52.730840950601,15.4809197062718
2020-11-16,16732,272,15913,261,819,11,17790,286,185219,1409,203009,1695,2,117,6,579,137,2,"Knox County",470313,302.989711107284,0.154768163179476,360.398287948664,57.8338255587237,15.4768163179476
2020-11-15,16460,274,15652,247,808,27,17504,295,183810,2278,201314,2573,2,115,3,573,135,4,"Knox County",470313,314.47142647556,0.150568748752744,547.082474862485,58.2590742760672,15.0568748752744
2020-11-14,16186,306,15405,293,781,13,17209,321,181532,1699,198741,2020,0,113,7,570,131,3,"Knox County",470313,342.750466178906,0.157240581944311,429.501204516992,65.0630537535641,15.7240581944311
2020-11-13,15880,219,15112,200,768,19,16888,190,179833,965,196721,1155,4,113,6,563,128,1,"Knox County",470313,351.468064884449,0.156805293005671,245.581134265904,46.5647345491194,15.6805293005671
2020-11-12,15661,143,14912,130,749,13,16698,136,178868,955,195566,1091,1,109,3,557,127,2,"Knox County",470313,346.577704634998,0.153216911764706,231.97317531091,30.4052832900643,15.3216911764706
2020-11-11,15518,191,14782,177,736,14,16562,191,177913,1229,194475,1420,3,108,7,554,125,2,"Knox County",470313,351.468064884449,0.149284253578732,301.926589313925,40.6112525063096,14.9284253578732
2020-11-10,15327,168,14605,163,722,5,16371,186,176684,1131,193055,1317,2,105,4,547,123,2,"Knox County",470313,334.458116190707,0.142400851743412,280.026280370732,35.7208922568587,14.2400851743412
2020-11-09,15159,135,14442,121,717,14,16185,131,175553,490,191738,621,1,103,2,543,121,2,"Knox County",470313,305.328579052673,0.142198685888006,132.039726735174,28.70428842069,14.2198685888006
2020-11-08,15024,215,14321,203,703,12,16054,252,175063,2624,191117,2876,1,102,3,541,119,5,"Knox County",470313,292.783741891039,0.134,611.507655540034,45.7142371144323,13.4
2020-11-07,14809,169,14118,161,691,8,15802,187,172439,1918,188241,2105,1,101,5,538,114,0,"Knox County",470313,263.654204753005,0.120264525271611,447.574275004093,35.9335166155305,12.0264525271611
2020-11-06,14640,155,13957,138,683,17,15615,160,170521,1235,186136,1395,0,100,5,533,114,3,"Knox County",470313,250.046245798011,0.114826789838337,296.61098034713,32.9567755941256,11.4826789838337
2020-11-05,14485,158,13819,142,666,16,15455,151,169286,613,184741,764,1,100,6,528,111,1,"Knox County",470313,253.235611178088,0.119832349018861,162.445010025239,33.594648670141,11.9832349018861
2020-11-04,14327,145,13677,133,650,12,15304,148,168673,934,183977,1082,-1,99,5,522,110,2,"Knox County",470313,243.454890679186,0.119586614173228,230.059556082864,30.8305320074078,11.9586614173228
2020-11-03,14182,196,13544,183,638,13,15156,195,167739,837,182895,1032,3,100,5,517,108,1,"Knox County",470313,249.408372721996,0.123949367088608,219.428338149275,41.6743742996685,12.3949367088608
2020-11-02,13986,116,13361,110,625,6,14961,115,166902,806,181863,921,1,97,2,512,107,2,"Knox County",470313,245.368509907232,0.118722358722359,195.827034336708,24.6644256059263,11.8722358722359
2020-11-01,13870,124,13251,116,619,8,14846,131,166096,1273,180942,1404,0,96,3,510,105,2,"Knox County",470313,226.0196932681,0.124899459956337,298.524599575177,26.3654204753005,12.4899459956337
2020-10-31,13746,5,13135,5,611,0,14715,7,164823,4,179538,11,0,96,0,507,103,1,"Knox County",470313,191.149298445929,0.137237100922984,2.33886794538956,1.06312179335889,13.7237100922984
2020-10-30,13741,156,13130,146,611,10,14708,148,164819,854,179527,1002,1,96,4,507,102,0,"Knox County",470313,191.3619228046,0.143983268983269,213.049607389122,33.1693999527974,14.3983268983269
2020-10-29,13585,152,12984,138,601,14,14560,136,163965,1569,178525,1705,0,95,4,503,102,1,"Knox County",470313,190.08617665257,0.122956546038843,362.524531535382,32.3189025181103,12.2956546038843
2020-10-28,13433,103,12846,96,587,7,14424,102,162396,1055,176820,1157,3,95,8,499,101,1,"Knox County",470313,181.155953588355,0.115320796460177,246.006382983247,21.9003089431931,11.5320796460177
2020-10-27,13330,119,12750,113,580,6,14322,127,161341,799,175663,926,1,92,3,491,100,2,"Knox County",470313,164.783877970628,0.107493685096829,196.890156130067,25.3022986819416,10.7493685096829
2020-10-26,13211,81,12637,74,574,7,14195,73,160542,372,174737,445,2,91,2,488,98,0,"Knox County",470313,157.342025417116,0.108872180451128,94.6178396089413,17.222573052414,10.8872180451128
2020-10-25,13130,132,12563,121,567,11,14122,151,160170,1365,174292,1516,0,89,3,486,98,1,"Knox County",470313,159.04302028649,0.11002661934339,322.338527746416,28.0664153446747,11.002661934339
2020-10-24,12998,172,12442,167,556,5,13971,202,158805,1788,172776,1990,0,89,5,483,97,1,"Knox County",470313,194.551288184677,0.107424779773481,423.122473756839,36.5713896915458,10.7424779773481
2020-10-23,12826,159,12275,148,551,11,13769,172,157017,1239,170786,1411,1,89,5,478,96,0,"Knox County",470313,195.189161260692,0.105245901639344,300.012970085879,33.8072730288127,10.5245901639344
2020-10-22,12667,182,12127,168,540,14,13597,169,155778,1607,169375,1776,1,88,5,473,96,0,"Knox County",470313,201.567892020846,0.108014315150201,377.620861001078,38.6976332782636,10.8014315150201
2020-10-21,12485,72,11959,68,526,4,13428,74,154171,682,167599,756,0,87,1,468,96,1,"Knox County",470313,194.976536902021,0.109750566893424,160.744015155864,15.308953824368,10.9750566893424
2020-10-20,12413,127,11891,121,522,6,13354,150,153489,739,166843,889,0,87,7,467,95,1,"Knox County",470313,196.677531771395,0.112831606512581,189.023054859211,27.0032935513158,11.2831606512581
2020-10-19,12286,112,11770,107,516,5,13204,117,152750,939,165954,1056,1,87,6,460,94,0,"Knox County",470313,203.26888689022,0.110176708537364,224.531322757398,23.8139281712392,11.0176708537364
2020-10-18,12174,140,11663,135,511,5,13087,168,151811,1431,164898,1599,0,86,7,454,94,1,"Knox County",470313,204.969881759594,0.111005592487074,339.986349516173,29.7674102140489,11.1005592487074
2020-10-17,12034,128,11528,125,506,3,12919,154,150380,1458,163299,1612,1,86,3,447,93,1,"Knox County",470313,195.614409978036,0.110341795801736,342.750466178906,27.2159179099876,11.0341795801736
2020-10-16,11906,72,11403,71,503,1,12765,61,148922,390,161687,451,1,85,3,444,92,2,"Knox County",470313,177.116090773591,0.109718638653397,95.893585760972,15.308953824368,10.9718638653397
2020-10-15,11834,74,11332,62,502,12,12704,66,148532,941,161236,1007,1,84,3,441,90,2,"Knox County",470313,154.152660037039,0.10719131614654,214.112729182481,15.7342025417116,10.719131614654
2020-10-14,11760,149,11270,143,490,6,12638,150,147591,1086,160229,1236,0,83,5,438,88,0,"Knox County",470313,170.524735654766,0.11031847133758,262.803707318318,31.6810294420949,11.031847133758
2020-10-13,11611,71,11127,68,484,3,12488,63,146505,581,158993,644,1,83,6,433,88,1,"Knox County",470313,158.617771569146,0.102432610124918,136.930086984625,15.0963294656962,10.2432610124918
2020-10-12,11540,79,11059,66,481,13,12425,87,145924,806,158349,893,0,82,5,427,87,2,"Knox County",470313,151.601167732978,0.100644987906477,189.873552293898,16.7973243350705,10.0644987906477
2020-10-11,11461,170,10993,163,468,7,12338,179,145118,1612,157456,1791,0,82,8,422,85,0,"Knox County",470313,157.979898493131,0.0995546240503013,380.810226381155,36.1461409742023,9.95546240503013
2020-10-10,11291,130,10830,122,461,8,12159,132,143506,1393,155665,1525,0,82,3,414,85,0,"Knox County",470313,158.405147210475,0.0977872002120048,324.252146974462,27.6411666273312,9.77872002120048
2020-10-09,11161,120,10708,118,453,2,12027,134,142113,1336,154140,1470,0,82,3,411,85,0,"Knox County",470313,168.61111642672,0.0946766285314032,312.557807247514,25.5149230406134,9.46766285314032
2020-10-08,11041,110,10590,102,451,8,11893,103,140777,943,152670,1046,1,82,4,408,85,0,"Knox County",470313,176.265593338904,0.0985473561882626,222.40507917068,23.3886794538956,9.85473561882626
2020-10-07,10931,104,10488,88,443,16,11790,95,139834,1649,151624,1744,0,81,5,404,85,1,"Knox County",470313,166.697497198674,0.087018544935806,370.816881523581,22.1129333018649,8.7018544935806
2020-10-06,10827,115,10400,102,427,13,11695,114,138185,1392,149880,1506,0,81,4,399,84,0,"Knox County",470313,176.052968980232,0.0846115288220551,320.212284159698,24.4518012472545,8.46115288220551
2020-10-05,10712,118,10298,109,414,9,11581,123,136793,1238,148374,1361,0,81,5,395,84,2,"Knox County",470313,184.345318968432,0.0842669730920234,289.38175215229,25.0896743232698,8.42669730920234
2020-10-04,10594,96,10189,89,405,7,11458,99,135555,1827,147013,1926,1,81,2,390,82,0,"Knox County",470313,168.61111642672,0.0756286632633768,409.514514801845,20.4119384324907,7.56286632633768
2020-10-03,10498,77,10100,76,398,1,11359,92,133728,1864,145087,1956,0,80,2,388,82,0,"Knox County",470313,157.342025417116,0.0690344263784177,415.893245561998,16.3720756177269,6.90344263784177
2020-10-02,10421,82,10024,79,397,3,11267,82,131864,602,143131,684,0,80,1,386,82,0,"Knox County",470313,149.262299787588,0.0692556001173824,145.435061331496,17.4351974110858,6.92556001173824
2020-10-01,10339,71,9945,68,394,3,11185,73,131262,683,142447,756,0,80,1,385,82,0,"Knox County",470313,140.969949799389,0.0682573240712776,160.744015155864,15.0963294656962,6.82573240712776
2020-09-30,10268,75,9877,72,391,3,11112,70,130579,675,141691,745,1,80,2,384,82,0,"Knox County",470313,134.803843397907,0.0730915603313186,158.405147210475,15.9468269003834,7.30915603313186
2020-09-29,10193,80,9805,75,388,5,11042,87,129904,1140,140946,1227,-1,79,2,382,82,1,"Knox County",470313,127.361990844395,0.0723281340265742,260.890088090272,17.0099486937423,7.23281340265742
2020-09-28,10113,57,9730,51,383,6,10955,49,128764,431,139719,480,1,80,3,380,81,2,"Knox County",470313,114.391904965417,0.0710059171597633,102.059692162454,12.1195884442914,7.10059171597633
2020-09-27,10056,72,9679,67,377,5,10906,79,128333,978,139239,1057,0,79,3,377,79,0,"Knox County",470313,109.288920357294,0.0770456191165822,224.74394711607,15.308953824368,7.70456191165822
2020-09-26,9984,127,9612,122,372,5,10827,136,127355,2087,138182,2223,4,79,5,374,79,0,"Knox County",470313,119.920138290883,0.0803123257110987,472.663949327363,27.0032935513158,8.03123257110987
2020-09-25,9857,102,9490,100,367,2,10691,103,125268,1439,135959,1542,0,75,1,369,79,3,"Knox County",470313,124.172625464318,0.074346201743462,327.866761071882,21.6876845845214,7.4346201743462
2020-09-24,9755,92,9390,89,365,3,10588,105,123829,1715,134417,1820,0,75,3,368,76,0,"Knox County",470313,128.637736996426,0.0691664833956455,386.976332782636,19.5614409978036,6.91664833956455
2020-09-23,9663,53,9301,52,362,1,10483,49,122114,432,132597,481,2,75,2,365,76,0,"Knox County",470313,123.960001105647,0.0688561721404304,102.272316521125,11.2690910096042,6.88561721404304
2020-09-22,9610,82,9249,75,361,7,10434,88,121682,1141,132116,1229,1,73,3,363,76,0,"Knox County",470313,124.38524982299,0.0689538043478261,261.315336807615,17.4351974110858,6.89538043478261
2020-09-21,9528,34,9174,30,354,4,10346,32,120541,379,130887,411,0,72,2,360,76,0,"Knox County",470313,119.494889573539,0.067556772794705,87.3886114141008,7.22922819484046,6.7556772794705
2020-09-20,9494,97,9144,78,350,19,10314,88,120162,707,130476,795,0,72,1,358,76,2,"Knox County",470313,124.810498540334,0.0706975649923538,169.036365144064,20.6245627911625,7.06975649923538
2020-09-19,9397,132,9066,129,331,3,10226,136,119455,1466,129681,1602,1,72,5,357,74,0,"Knox County",470313,125.873620333693,0.0762690355329949,340.624222592189,28.0664153446747,7.62690355329949
2020-09-18,9265,118,8937,114,328,4,10090,129,117989,1606,128079,1735,3,71,3,352,74,0,"Knox County",470313,129.275610072441,0.0776662950575994,368.903262295535,25.0896743232698,7.76662950575994
2020-09-17,9147,126,8823,119,324,7,9961,124,116383,1516,126344,1640,0,68,6,349,74,2,"Knox County",470313,136.504838267282,0.0818446724946155,348.703948221716,26.790669192644,8.18446724946155
2020-09-16,9021,99,8704,77,317,22,9837,117,114867,768,124704,885,1,68,3,343,72,1,"Knox County",470313,146.285558766183,0.0860552006749428,188.172557424524,21.049811508506,8.60552006749428
2020-09-15,8922,132,8627,126,295,6,9720,136,114099,1338,123819,1474,0,67,3,340,71,0,"Knox County",470313,156.916776699772,0.089206274877078,313.408304682201,28.0664153446747,8.9206274877078
2020-09-14,8790,127,8501,124,289,3,9584,136,112761,901,122345,1037,0,67,5,337,71,0,"Knox County",470313,176.690842056248,0.0944589877835951,220.491459942634,27.0032935513158,9.44589877835951
2020-09-13,8663,143,8377,136,286,7,9448,148,111860,1008,121308,1156,0,67,0,332,71,0,"Knox County",470313,186.471562555149,0.0971770385140099,245.793758624576,30.4052832900643,9.71770385140099
2020-09-12,8520,130,8241,123,279,7,9300,141,110852,1178,120152,1319,1,67,1,332,71,2,"Knox County",470313,186.046313837806,0.100692191217824,280.451529088075,27.6411666273312,10.0692191217824
2020-09-11,8390,103,8118,94,272,9,9159,105,109674,773,118833,878,0,66,5,331,69,2,"Knox County",470313,182.856948457729,0.108117773274526,186.684186913821,21.9003089431931,10.8117773274526
2020-09-10,8287,192,8024,189,263,3,9054,192,108901,1501,117955,1693,0,66,5,326,67,0,"Knox County",470313,196.890156130067,0.115493958777541,359.97303923132,40.8238768649814,11.5493958777541
2020-09-09,8095,91,7835,82,260,9,8862,93,107400,1710,116262,1803,0,66,2,321,67,0,"Knox County",470313,195.189161260692,0.101602564102564,383.361718685216,19.3488166391318,10.1602564102564
2020-09-08,8004,126,7753,124,251,2,8769,133,105690,702,114459,835,1,66,8,319,67,0,"Knox County",470313,193.913415108662,0.108703130374957,177.541339490935,26.790669192644,10.8703130374957
2020-09-07,7878,95,7629,92,249,3,8636,98,104988,347,113624,445,1,65,0,311,67,0,"Knox County",470313,187.109435631165,0.111944888670193,94.6178396089413,20.1993140738189,11.1944888670193
2020-09-06,7783,96,7537,92,246,4,8538,94,104641,476,113179,570,0,64,1,311,67,3,"Knox County",470313,177.116090773591,0.113482699191303,121.195884442914,20.4119384324907,11.3482699191303
2020-09-05,7687,284,7445,282,242,2,8444,295,104165,1506,112609,1801,0,64,4,310,64,0,"Knox County",470313,209.860242009045,0.125856697819315,382.936469967872,60.385317862785,12.5856697819315
2020-09-04,7403,93,7163,89,240,4,8149,97,102659,565,110808,662,1,64,0,306,64,0,"Knox County",470313,207.733998422327,0.12831348444103,140.757325440717,19.7740653564754,12.831348444103
2020-09-03,7310,190,7074,184,236,6,8052,198,102094,1798,110146,1996,2,63,6,306,64,1,"Knox County",470313,207.308749704984,0.124260355029586,424.398219908869,40.3986281476379,12.4260355029586
2020-09-02,7120,124,6890,120,230,4,7854,121,100296,1461,108150,1582,2,61,5,300,63,1,"Knox County",470313,214.325353541152,0.131288810036751,336.371735418753,26.3654204753005,13.1288810036751
2020-09-01,6996,153,6770,146,226,7,7733,158,98835,660,106568,818,2,59,4,295,62,3,"Knox County",470313,220.06621122529,0.134747269494539,173.926725393515,32.5315268767821,13.4747269494539
2020-08-31,6843,99,6624,93,219,6,7575,94,98175,431,105750,525,0,57,3,291,59,0,"Knox County",470313,220.916708659978,0.132889112396279,111.627788302684,21.049811508506,13.2889112396279
2020-08-30,6744,72,6531,71,213,1,7481,76,97744,423,105225,499,1,57,1,288,59,2,"Knox County",470313,215.813724051855,0.131802613218318,106.099554977217,15.308953824368,13.1802613218318
2020-08-29,6672,118,6460,113,212,5,7405,125,97321,1391,104726,1516,5,56,3,287,57,0,"Knox County",470313,180.51808051234,0.114372203211371,322.338527746416,25.0896743232698,11.4372203211371
2020-08-28,6554,89,6347,85,207,4,7280,91,95930,309,103210,400,0,51,3,284,57,0,"Knox County",470313,179.667583077653,0.117639040348964,85.0497434687113,18.9235679217883,11.7639040348964
2020-08-27,6465,116,6262,112,203,4,7189,134,95621,1986,102810,2120,0,51,2,281,57,1,"Knox County",470313,163.933380535941,0.107104557640751,450.76364038417,24.6644256059263,10.7104557640751
2020-08-26,6349,77,6150,76,199,1,7055,86,93635,794,100690,880,0,51,3,279,56,1,"Knox County",470313,153.940035678367,0.113051198579461,187.109435631165,16.3720756177269,11.3051198579461
2020-08-25,6272,87,6074,82,198,5,6969,96,92841,896,99810,992,2,51,3,276,55,0,"Knox County",470313,139.90682800603,0.101269474899019,210.923363802404,18.4983192044447,10.1269474899019
2020-08-24,6185,32,5992,28,193,4,6873,29,91945,261,98818,290,0,49,1,273,55,0,"Knox County",470313,125.660995975021,0.095117216664178,61.6610640148157,6.8039794774969,9.5117216664178
2020-08-23,6153,76,5964,75,189,1,6844,74,91684,565,98528,639,0,49,3,272,55,0,"Knox County",470313,126.511493409708,0.092876992833114,135.866965191266,16.1594512590551,9.28769928331139
2020-08-22,6077,136,5889,135,188,1,6770,153,91119,1892,97889,2045,0,49,4,269,55,0,"Knox County",470313,130.3387318658,0.0900081455335325,434.816813483786,28.9169127793618,9.00081455335325
2020-08-21,5941,30,5754,30,187,0,6617,41,89227,262,95844,303,1,49,1,265,55,0,"Knox County",470313,117.793894704165,0.0843307194937405,64.4251806775488,6.37873076015334,8.43307194937405
2020-08-20,5911,119,5724,117,187,2,6576,130,88965,2068,95541,2198,3,48,3,264,55,0,"Knox County",470313,118.43176778018,0.0828909759085341,467.348340360568,25.3022986819416,8.28909759085341
2020-08-19,5792,46,5607,41,185,5,6446,48,86897,608,93343,656,2,45,4,261,55,0,"Knox County",470313,111.840412661355,0.080162852730591,139.481579288686,9.7807204989018,8.0162852730591
2020-08-18,5746,134,5566,132,180,2,6398,152,86289,1163,92687,1315,0,43,4,257,55,1,"Knox County",470313,121.833757518929,0.0842062852538276,279.601031653388,28.4916640620183,8.42062852538276
2020-08-17,5612,50,5434,42,178,8,6246,50,85126,289,91372,339,1,43,0,253,54,1,"Knox County",470313,125.660995975021,0.0864576384256171,72.0796575897328,10.6312179335889,8.64576384256171
2020-08-16,5562,83,5392,78,170,5,6196,82,84837,587,91033,669,0,42,1,253,53,1,"Knox County",470313,127.149366485723,0.0871760797342193,142.24569595142,17.6478217697576,8.71760797342193
2020-08-15,5479,119,5314,116,165,3,6114,132,84250,1223,90364,1355,1,42,2,252,52,0,"Knox County",470313,123.534752388303,0.0929041697147037,288.106006000259,25.3022986819416,9.29041697147037
2020-08-14,5360,91,5198,83,162,8,5982,96,83027,1024,89009,1120,0,41,2,250,52,1,"Knox County",470313,136.504838267282,0.0901725039205436,238.139281712392,19.3488166391318,9.01725039205436
2020-08-13,5269,127,5115,126,154,1,5886,229,82003,1778,87889,2007,1,41,4,248,51,1,"Knox County",470313,138.205833136656,0.105749899477282,426.737087854259,27.0032935513158,10.5749899477282
2020-08-12,5142,79,4989,72,153,7,5657,88,80225,892,85882,980,0,40,1,244,50,0,"Knox County",470313,145.222436972824,0.106486833654464,208.371871498343,16.7973243350705,10.6486833654464
2020-08-11,5063,111,4917,108,146,3,5569,117,79333,1121,84902,1238,0,40,5,243,50,2,"Knox County",470313,140.332076723374,0.103009859885833,263.228956035661,23.6013038125674,10.3009859885833
2020-08-10,4952,37,4809,35,143,2,5452,35,78212,365,83664,400,1,40,0,238,48,0,"Knox County",470313,137.56796006064,0.100270305058566,85.0497434687113,7.86710127085579,10.0270305058566
2020-08-09,4915,85,4774,81,141,4,5417,109,77847,826,83264,935,1,39,4,238,48,1,"Knox County",470313,137.993208777984,0.10031113876789,198.803775358113,18.0730704871011,10.031113876789
2020-08-08,4830,157,4693,156,137,1,5308,176,77021,2284,82329,2460,1,38,4,234,47,2,"Knox County",470313,146.072934407512,0.0929978118161926,523.055922332574,33.3820243114692,9.29978118161926
2020-08-07,4673,50,4537,46,136,4,5132,44,74737,403,79869,447,0,37,0,230,45,2,"Knox County",470313,137.355335701969,0.0942482579426007,95.0430883262848,10.6312179335889,9.42482579426007
2020-08-06,4623,113,4491,105,132,8,5088,121,74334,1463,79422,1584,-1,37,5,230,43,1,"Knox County",470313,134.378594680564,0.0857782197911487,336.796984136097,24.0265525299109,8.57782197911487
2020-08-05,4510,99,4386,99,124,0,4967,100,72871,1107,77838,1207,1,38,3,225,42,1,"Knox County",470313,138.631081853999,0.0848748639825898,256.637600916836,21.049811508506,8.48748639825898
2020-08-04,4411,112,4287,111,124,1,4867,106,71764,1082,76631,1188,1,37,9,222,41,0,"Knox County",470313,138.843706212671,0.0840530349105948,252.597738102072,23.8139281712392,8.40530349105948
2020-08-03,4299,50,4176,50,123,0,4761,81,70682,593,75443,674,2,36,1,213,41,1,"Knox County",470313,141.607822875404,0.0867569158328429,143.308817744778,10.6312179335889,8.67569158328429
2020-08-02,4249,97,4126,91,123,6,4680,95,70089,692,74769,787,3,34,2,212,40,0,"Knox County",470313,144.159315179466,0.0866179465676291,167.335370274689,20.6245627911625,8.66179465676291
2020-08-01,4152,118,4035,110,117,8,4585,118,69397,1417,73982,1535,1,31,1,210,40,1,"Knox County",470313,135.866965191266,0.0895984909727836,326.37839056118,25.0896743232698,8.95984909727836
2020-07-31,4034,117,3925,114,109,3,4467,116,67980,1060,72447,1176,2,30,1,209,39,3,"Knox County",470313,150.112797222275,0.0904183535762483,250.046245798011,24.877049964598,9.04183535762483
2020-07-30,3917,189,3811,186,106,3,4351,227,66920,2420,71271,2647,1,28,7,208,36,2,"Knox County",470313,166.27224848133,0.0914912090297374,562.816677404197,40.1860037889661,9.14912090297373
2020-07-29,3728,75,3625,71,103,4,4124,60,64500,438,68624,498,0,27,3,201,34,4,"Knox County",470313,161.169263873208,0.0944150499706055,105.886930618546,15.9468269003834,9.44150499706055
2020-07-28,3653,154,3554,152,99,2,4064,186,64062,1211,68126,1397,1,27,3,198,30,0,"Knox County",470313,170.099486937423,0.101331191186596,297.036229064474,32.7441512354538,10.1331191186596
2020-07-27,3499,83,3402,76,97,7,3878,85,62851,677,66729,762,3,26,2,195,30,1,"Knox County",470313,177.116090773591,0.100772551692797,162.019761307895,17.6478217697576,10.0772551692797
2020-07-26,3416,118,3326,113,90,5,3793,132,62174,1472,65967,1604,0,23,2,193,29,1,"Knox County",470313,181.581202305699,0.0960598814845618,341.049471309532,25.0896743232698,9.60598814845618
2020-07-25,3298,175,3213,172,85,3,3661,197,60702,1949,64363,2146,2,23,3,191,28,3,"Knox County",470313,193.70079074999,0.0980449657869013,456.291873709636,37.2092627675612,9.80449657869013
2020-07-24,3123,106,3041,99,82,7,3464,113,58753,916,62217,1029,0,21,4,188,25,0,"Knox County",470313,191.3619228046,0.0991768322919766,218.79046507326,22.5381820192085,9.91768322919766
2020-07-23,3017,205,2942,197,75,8,3351,254,57837,2389,61188,2643,0,21,4,184,25,1,"Knox County",470313,194.763912543349,0.101895029268777,561.96617996951,43.5879935277145,10.1895029268777
2020-07-22,2812,69,2745,61,67,8,3097,63,55448,437,58545,500,3,21,3,180,24,0,"Knox County",470313,193.488166391318,0.102172403531396,106.312179335889,14.6710807483527,10.2172403531396
2020-07-21,2743,232,2684,228,59,4,3034,280,55011,1691,58045,1971,0,18,12,177,24,1,"Knox County",470313,210.072866367717,0.105490380103238,419.082610942075,49.3288512118525,10.5490380103238
2020-07-20,2511,74,2456,70,55,4,2754,57,53320,364,56074,421,0,18,4,165,23,1,"Knox County",470313,208.159247139671,0.106263331394221,89.5148550008186,15.7342025417116,10.6263331394221
2020-07-19,2437,84,2386,74,51,10,2697,74,52956,577,55653,651,0,18,0,161,22,2,"Knox County",470313,200.93001894483,0.110885589146459,138.418457495328,17.8604461284294,11.0885589146459
2020-07-18,2353,112,2312,109,41,3,2623,146,52379,2258,55002,2404,1,18,8,161,20,1,"Knox County",470313,187.534684348508,0.102609418858509,511.148958246955,23.8139281712392,10.2609418858509
2020-07-17,2241,74,2203,74,38,0,2477,80,50121,347,52598,427,0,17,6,153,19,2,"Knox County",470313,180.730704871011,0.105800155262282,90.7906011528493,15.7342025417116,10.5800155262282
2020-07-16,2167,187,2129,185,38,2,2397,228,49774,2033,52171,2261,2,17,3,147,17,0,"Knox County",470313,176.903466414919,0.107469600463231,480.74367495689,39.7607550716225,10.7469600463231
2020-07-15,1980,78,1944,78,36,0,2169,80,47741,511,49910,591,3,15,4,144,17,1,"Knox County",470313,178.817085642965,0.108297043318817,125.660995975021,16.5846999763987,10.8297043318817
2020-07-14,1902,95,1866,95,36,0,2089,127,47230,777,49319,904,2,12,1,140,16,1,"Knox County",470313,149.687548504932,0.103407755581669,192.212420239287,20.1993140738189,10.3407755581669
2020-07-13,1807,94,1771,92,36,2,1962,59,46453,655,48415,714,1,10,2,139,15,3,"Knox County",470313,153.940035678367,0.0998490945674044,151.81379209165,19.9866897151471,9.98490945674044
2020-07-12,1713,69,1679,67,34,2,1903,87,45798,916,47701,1003,0,9,4,137,12,1,"Knox County",470313,150.750670298291,0.0971820809248555,213.262231747793,14.6710807483527,9.71820809248555
2020-07-11,1644,28,1612,27,32,1,1816,36,44882,883,46698,919,0,9,2,133,11,1,"Knox County",470313,132.890224169861,0.102214400938554,195.401785619364,5.95348204280979,10.2214400938554
2020-07-10,1616,78,1585,74,31,4,1780,68,43999,418,45779,486,0,9,6,131,10,0,"Knox County",470313,133.740721604548,0.0995929049142193,103.335438314484,16.5846999763987,9.95929049142192
2020-07-09,1538,70,1511,66,27,4,1712,88,43581,1652,45293,1740,0,9,8,125,10,0,"Knox County",470313,108.86367163995,0.0857322636463741,369.966384088894,14.8837051070245,8.57322636463741
2020-07-08,1468,70,1445,65,23,5,1624,63,41929,594,43553,657,1,9,5,117,10,0,"Knox County",470313,107.162676770576,0.082204577300327,139.694203647358,14.8837051070245,8.2204577300327
2020-07-07,1398,79,1380,79,18,0,1561,104,41335,1303,42896,1407,0,8,7,112,10,1,"Knox County",470313,103.760687031828,0.0729136586774473,299.162472651192,16.7973243350705,7.29136586774473
2020-07-06,1319,35,1301,35,18,0,1457,34,40032,658,41489,692,1,8,6,105,9,0,"Knox County",470313,91.2158498701928,0.0695249130938586,147.13605620087,7.44185255351224,6.95249130938586
2020-07-05,1284,77,1266,77,18,0,1423,109,39374,1079,40797,1188,2,7,6,99,9,1,"Knox County",470313,92.916844739567,0.0708139370856256,252.597738102072,16.3720756177269,7.08139370856256
2020-07-04,1207,41,1189,40,18,1,1314,50,38295,1141,39609,1191,0,5,1,93,8,2,"Knox County",470313,95.6809614023002,0.0700991713082462,253.235611178088,8.7175987055429,7.00991713082462
2020-07-03,1166,62,1149,61,17,1,1264,49,37154,910,38418,959,0,5,4,92,6,0,"Knox County",470313,92.2789716635517,0.0634414092417667,203.906759966235,13.1827102376502,6.34414092417667
2020-07-02,1104,68,1088,68,16,0,1215,102,36244,1228,37459,1330,0,5,2,88,6,0,"Knox County",470313,91.8537229462082,0.0688308189655172,282.790397033465,14.4584563896809,6.88308189655172
2020-07-01,1036,49,1020,49,16,0,1113,34,35016,737,36129,771,0,5,4,86,6,1,"Knox County",470313,87.3886114141008,0.0639426903687981,163.933380535941,10.4185935749171,6.39426903687981
2020-06-30,987,40,971,39,16,1,1079,73,34279,1514,35358,1587,0,5,3,82,5,0,"Knox County",470313,79.0962614259015,0.0584348276755636,337.434857212112,8.50497434687113,5.84348276755636
2020-06-29,947,51,932,51,15,0,1006,79,32765,1333,33771,1412,0,5,3,79,5,0,"Knox County",470313,82.4982511646499,0.058781701825077,300.225594444551,10.8438422922607,5.8781701825077
2020-06-28,896,10,881,10,15,0,927,30,31432,684,32359,714,0,5,1,76,5,0,"Knox County",470313,68.2524191336408,0.0523606228026118,151.81379209165,2.12624358671778,5.23606228026117
2020-06-27,886,29,871,29,15,0,897,16,30748,111,31645,127,0,5,3,75,5,0,"Knox County",470313,65.7009268295794,0.0555072463768116,27.0032935513158,6.16610640148157,5.55072463768116
2020-06-26,857,37,842,37,15,0,881,14,30637,319,31518,333,0,5,8,72,5,0,"Knox County",470313,60.385317862785,0.0554670066942939,70.8039114377021,7.86710127085579,5.54670066942939
2020-06-25,820,32,805,32,15,0,867,52,30318,702,31185,754,0,5,1,64,5,0,"Knox County",470313,52.730840950601,0.0522990522990523,160.318766438521,6.8039794774969,5.22990522990523
2020-06-24,788,35,773,34,15,1,815,32,29616,272,30431,304,0,5,1,63,5,0,"Knox County",470313,49.7540999291961,0.0565857388644619,64.6378050362206,7.44185255351224,5.65857388644619
2020-06-23,753,27,739,24,14,3,783,25,29344,215,30127,240,0,5,4,62,5,0,"Knox County",470313,46.989983266463,0.0638516992790937,51.0298460812268,5.74085768413801,6.38516992790937
2020-06-22,726,36,715,36,11,0,758,31,29129,572,29887,603,0,5,0,58,5,0,"Knox County",470313,43.8006178863863,0.0650406504065041,128.212488279082,7.65447691218401,6.50406504065041
2020-06-21,690,31,679,31,11,0,727,37,28557,815,29284,852,0,5,1,58,5,0,"Knox County",470313,48.2657294184936,0.0644257703081232,181.155953588355,6.59135511882512,6.44257703081232
2020-06-20,659,17,648,17,11,0,690,9,27742,437,28432,446,0,5,2,57,5,0,"Knox County",470313,45.7142371144323,0.0566251415628539,94.8304639676131,3.61461409742023,5.66251415628539
2020-06-19,642,30,631,28,11,2,681,10,27305,334,27986,344,0,5,1,55,5,0,"Knox County",470313,44.2258666037299,0.0553203499858877,73.1427793830917,6.37873076015334,5.53203499858877
2020-06-18,612,15,603,15,9,0,671,18,26971,804,27642,822,0,5,0,54,5,0,"Knox County",470313,40.6112525063096,0.0448629188590418,174.777222828202,3.18936538007667,4.48629188590418
2020-06-17,597,17,588,17,9,0,653,13,26167,282,26820,295,0,5,0,54,5,0,"Knox County",470313,36.7840140502176,0.0397001665741255,62.7241858081746,3.61461409742023,3.97001665741255
2020-06-16,580,9,571,8,9,1,640,9,25885,178,26525,187,0,5,0,54,5,0,"Knox County",470313,32.9567755941256,0.0357847280924204,39.7607550716225,1.913619228046,3.57847280924204
2020-06-15,571,8,563,8,8,0,631,9,25707,218,26338,227,0,5,0,54,5,0,"Knox County",470313,27.0032935513158,0.0330917113142137,48.2657294184936,1.70099486937423,3.30917113142137
2020-06-14,563,8,555,8,8,0,622,9,25489,624,26111,633,0,5,0,54,5,0,"Knox County",470313,22.1129333018649,0.0260663507109005,134.591219039236,1.70099486937423,2.60663507109005
2020-06-13,555,10,547,8,8,2,613,9,24865,213,25478,222,0,5,3,54,5,0,"Knox County",470313,20.6245627911625,0.0282051282051282,47.2026076251348,2.12624358671778,2.82051282051282
2020-06-12,545,19,539,19,6,0,604,19,24652,750,25256,769,0,5,0,51,5,0,"Knox County",470313,18.2856948457729,0.0272583201267829,163.508131818597,4.03986281476378,2.72583201267829
2020-06-11,526,7,520,7,6,0,585,10,23902,379,24487,389,0,5,2,51,5,0,"Knox County",470313,16.5846999763987,0.0286554004408523,82.7108755233217,1.48837051070245,2.86554004408523
2020-06-10,519,12,513,12,6,0,575,12,23523,705,24098,717,0,5,0,49,5,0,"Knox County",470313,15.5215781830398,0.0244910941475827,152.451665167665,2.55149230406134,2.44910941475827
2020-06-09,507,16,501,16,6,0,563,19,22818,508,23381,527,0,5,1,49,5,0,"Knox County",470313,17.0099486937423,0.0249712973593571,112.053037020027,3.40198973874845,2.49712973593571
2020-06-08,491,8,485,8,6,0,544,8,22310,336,22854,344,0,5,1,48,5,0,"Knox County",470313,17.0099486937423,0.0238822549291863,73.1427793830917,1.70099486937423,2.38822549291863
2020-06-07,483,7,477,7,6,0,536,8,21974,847,22510,855,0,5,1,47,5,0,"Knox County",470313,16.7973243350705,0.0222338477635365,181.79382666437,1.48837051070245,2.22338477635365
2020-06-06,476,11,470,11,6,0,528,12,21127,478,21655,490,0,5,0,46,5,0,"Knox County",470313,17.0099486937423,0.0215106330970423,104.185935749171,2.33886794538956,2.15106330970423
2020-06-05,465,18,459,18,6,0,516,17,20649,518,21165,535,0,5,1,46,5,0,"Knox County",470313,16.7973243350705,0.0222971221156339,113.754031889401,3.82723845609201,2.22971221156339
2020-06-04,447,4,441,4,6,0,499,4,20131,338,20630,342,0,5,0,45,5,0,"Knox County",470313,16.1594512590551,0.020997375328084,72.7175306657481,0.850497434687113,2.0997375328084
2020-06-03,443,4,437,4,6,0,495,4,19793,399,20288,403,0,5,0,45,5,0,"Knox County",470313,14.4584563896809,0.0205949656750572,85.6876165447266,0.850497434687113,2.05949656750572
2020-06-02,439,26,433,25,6,1,491,24,19394,939,19885,963,0,5,2,45,5,0,"Knox County",470313,16.5846999763987,0.0195829094608342,204.757257400922,5.52823332546623,1.95829094608342
2020-06-01,413,17,408,17,5,0,467,20,18455,972,18922,992,0,5,0,43,5,0,"Knox County",470313,18.4983192044447,0.0194323144104804,210.923363802404,3.61461409742023,1.94323144104803
2020-05-31,396,7,391,7,5,0,447,7,17483,317,17930,324,0,5,0,43,5,0,"Knox County",470313,18.4983192044447,0.0217337614225735,68.8902922096561,1.48837051070245,2.17337614225735
2020-05-30,389,6,384,6,5,0,440,6,17166,294,17606,300,0,5,2,43,5,0,"Knox County",470313,17.4351974110858,0.0212490282456595,63.7873076015334,1.27574615203067,2.12490282456595
2020-05-29,383,8,378,8,5,0,434,7,16872,205,17306,212,0,5,0,41,5,0,"Knox County",470313,15.308953824368,0.0203619909502262,45.076364038417,1.70099486937423,2.03619909502262
2020-05-28,375,11,370,11,5,0,427,11,16667,336,17094,347,0,5,0,41,5,0,"Knox County",470313,16.7973243350705,0.022310081897769,73.780652459107,2.33886794538956,2.2310081897769
2020-05-27,364,5,359,5,5,0,416,6,16331,420,16747,426,0,5,1,41,5,0,"Knox County",470313,17.0099486937423,0.0227272727272727,90.5779767941775,1.06312179335889,2.27272727272727
2020-05-26,359,9,354,9,5,0,410,10,15911,1142,16321,1152,0,5,0,40,5,0,"Knox County",470313,13.395334596322,0.0178523847588596,244.943261189888,1.913619228046,1.78523847588596
2020-05-25,350,9,345,9,5,0,400,11,14769,381,15169,392,0,5,1,40,5,0,"Knox County",470313,11.6943397269478,0.018395179194418,83.348748599337,1.913619228046,1.8395179194418
2020-05-24,341,2,336,2,5,0,389,3,14388,273,14777,276,0,5,0,39,5,0,"Knox County",470313,10.6312179335889,0.0173913043478261,58.6843229934108,0.425248717343556,1.73913043478261
2020-05-23,339,7,334,7,5,0,386,10,14115,360,14501,370,0,5,2,39,5,0,"Knox County",470313,10.8438422922607,0.0182677165354331,78.6710127085579,1.48837051070245,1.82677165354331
2020-05-22,332,1,327,1,5,0,376,1,13755,253,14131,254,0,5,0,37,5,0,"Knox County",470313,9.35547178155824,0.0161641280696301,54.0065871026317,0.212624358671778,1.61641280696301
2020-05-21,331,0,326,0,5,0,375,0,13502,250,13877,250,0,5,0,37,5,0,"Knox County",470313,7.01660383616868,0.0131410256410256,53.1560896679445,0,1.31410256410256
2020-05-20,331,7,326,7,5,0,375,7,13252,360,13627,367,0,5,0,37,5,0,"Knox County",470313,7.44185255351224,0.0137210062071219,78.0331396325426,1.48837051070245,1.37210062071219
2020-05-19,324,7,319,7,5,0,368,7,12892,369,13260,376,0,5,2,37,5,0,"Knox County",470313,7.01660383616868,0.0170678336980306,79.9467588605886,1.48837051070245,1.70678336980306
2020-05-18,317,3,312,3,5,0,361,4,12523,478,12884,482,0,5,0,35,5,0,"Knox County",470313,5.74085768413801,0.0134736842105263,102.484940879797,0.637873076015334,1.34736842105263
2020-05-17,314,3,309,3,5,0,357,5,12045,216,12402,221,0,5,1,35,5,0,"Knox County",470313,5.95348204280979,0.0146551724137931,46.989983266463,0.637873076015334,1.46551724137931
2020-05-16,311,0,306,0,5,0,352,0,11829,349,12181,349,0,5,0,34,5,0,"Knox County",470313,4.46511153210734,0.0104393214441061,74.2059011764506,0,1.04393214441061
2020-05-15,311,1,306,1,5,0,352,4,11480,540,11832,544,0,5,0,34,5,0,"Knox County",470313,4.46511153210734,0.0104287369640788,115.667651117447,0.212624358671778,1.04287369640788
2020-05-14,310,3,305,3,5,0,348,7,10940,458,11288,465,0,5,0,34,5,0,"Knox County",470313,5.10298460812268,0.0121255349500713,98.8703267823768,0.637873076015334,1.21255349500713
2020-05-13,307,7,302,7,5,0,341,5,10482,341,10823,346,0,5,0,34,5,0,"Knox County",470313,5.10298460812268,0.011498383039885,73.5680281004352,1.48837051070245,1.1498383039885
2020-05-12,300,6,295,6,5,0,336,8,10141,401,10477,409,0,5,0,34,5,0,"Knox County",470313,4.8903602494509,0.01171875,86.9633626967573,1.27574615203067,1.171875
2020-05-11,294,16,289,16,5,0,328,12,9740,254,10068,266,0,5,1,34,5,0,"Knox County",470313,7.65447691218401,0.0157692307692308,56.558079406693,3.40198973874845,1.57692307692308
2020-05-10,278,5,273,5,5,0,316,5,9486,221,9802,226,0,5,1,33,5,0,"Knox County",470313,8.07972562952757,0.0157389635316699,48.0531050598219,1.06312179335889,1.57389635316699
2020-05-09,273,2,268,2,5,0,311,4,9265,352,9576,356,0,5,0,32,5,0,"Knox County",470313,8.50497434687113,0.0172281776416539,75.694271687153,0.425248717343556,1.72281776416539
2020-05-08,271,3,266,3,5,0,307,4,8913,265,9220,269,0,5,0,32,5,0,"Knox County",470313,8.93022306421468,0.0192554557124519,57.1959524827083,0.637873076015334,1.92554557124519
2020-05-07,268,3,263,3,5,0,303,3,8648,220,8951,223,0,5,0,32,5,0,"Knox County",470313,8.93022306421468,0.0195704057279236,47.4152319838065,0.637873076015334,1.95704057279236
2020-05-06,265,1,260,1,5,0,300,1,8428,185,8728,186,0,5,0,32,5,0,"Knox County",470313,7.65447691218401,0.0191214470284238,39.5481307129507,0.212624358671778,1.91214470284238
2020-05-05,264,4,259,4,5,0,299,5,8243,305,8542,310,0,5,0,32,5,0,"Knox County",470313,7.22922819484046,0.0185185185185185,65.9135511882512,0.850497434687113,1.85185185185185
2020-05-04,260,4,255,4,5,0,294,7,7938,259,8232,266,0,5,0,32,5,0,"Knox County",470313,4.67773589077912,0.0157952069716776,56.558079406693,0.850497434687113,1.57952069716776
2020-05-03,256,7,251,5,5,2,287,6,7679,290,7966,296,0,5,2,32,5,0,"Knox County",470313,5.10298460812268,0.0157397691500525,62.9368101668463,1.48837051070245,1.57397691500525
2020-05-02,249,3,246,3,3,0,281,5,7389,308,7670,313,0,5,1,30,5,0,"Knox County",470313,5.31560896679445,0.0166398282340311,66.5514242642666,0.637873076015334,1.66398282340311
2020-05-01,246,9,243,8,3,1,276,7,7081,354,7357,361,0,5,0,29,5,0,"Knox County",470313,6.59135511882512,0.0173913043478261,76.7573934805119,1.913619228046,1.73913043478261
2020-04-30,237,4,235,4,2,0,269,3,6727,119,6996,122,0,5,0,29,5,0,"Knox County",470313,6.8039794774969,0.0183387270765912,25.9401717579569,0.850497434687113,1.83387270765912
2020-04-29,233,8,231,8,2,0,266,10,6608,671,6874,681,0,5,0,29,5,0,"Knox County",470313,8.29234998819935,0.0183056619838229,144.797188255481,1.70099486937423,1.83056619838229
2020-04-28,225,8,223,8,2,0,256,10,5937,391,6193,401,1,5,0,29,5,0,"Knox County",470313,9.14284742288646,0.019672131147541,85.262367827383,1.70099486937423,1.9672131147541
2020-04-27,217,2,215,2,2,0,246,4,5546,161,5792,165,0,4,0,29,5,1,"Knox County",470313,8.7175987055429,0.0192389910218042,35.0830191808434,0.425248717343556,1.92389910218042
2020-04-26,215,1,213,1,2,0,242,1,5385,172,5627,173,0,4,0,29,4,0,"Knox County",470313,7.44185255351224,0.0180505415162455,36.7840140502176,0.212624358671778,1.80505415162455
2020-04-25,214,0,212,0,2,0,241,0,5213,53,5454,53,0,4,0,29,4,0,"Knox County",470313,6.8039794774969,0.0178936605316973,11.2690910096042,0,1.78936605316973
2020-04-24,214,8,212,8,2,0,241,10,5160,836,5401,846,0,4,1,29,4,0,"Knox County",470313,6.59135511882512,0.0155673904137649,179.880207436324,1.70099486937423,1.55673904137648
2020-04-23,206,1,204,1,2,0,231,2,4324,137,4555,139,0,4,0,28,4,0,"Knox County",470313,5.95348204280979,0.0150528885272579,29.5547858553772,0.212624358671778,1.50528885272579
2020-04-22,205,5,203,3,2,2,229,2,4187,189,4416,191,0,4,0,28,4,0,"Knox County",470313,5.31560896679445,0.0147357723577236,40.6112525063096,1.06312179335889,1.47357723577236
2020-04-21,200,4,200,4,0,0,227,5,3998,475,4225,480,0,4,1,28,4,0,"Knox County",470313,4.46511153210734,0.0117244748412311,102.059692162454,0.850497434687113,1.17244748412311
2020-04-20,196,3,196,3,0,0,222,2,3523,175,3745,177,0,4,1,27,4,0,"Knox County",470313,4.67773589077912,0.0106847984458475,37.6345114849047,0.637873076015334,1.06847984458475
2020-04-19,193,0,193,0,0,0,220,0,3348,72,3568,72,0,4,0,26,4,0,"Knox County",470313,4.46511153210734,0.0107252298263534,15.308953824368,0,1.07252298263534
2020-04-18,193,0,193,0,0,0,220,1,3276,135,3496,136,0,4,0,26,4,0,"Knox County",470313,4.46511153210734,0.0107790298873101,28.9169127793618,0,1.07790298873101
2020-04-17,193,2,193,2,0,0,219,3,3141,104,3360,107,0,4,1,26,4,0,"Knox County",470313,3.18936538007667,0.0115207373271889,22.7508063778803,0.425248717343556,1.15207373271889
2020-04-16,191,7,191,7,0,0,216,9,3037,213,3253,222,0,4,2,25,4,0,"Knox County",470313,4.46511153210734,0.015884476534296,47.2026076251348,1.48837051070245,1.5884476534296
2020-04-15,184,9,184,9,0,0,207,10,2824,84,3031,94,0,4,1,23,4,0,"Knox County",470313,5.31560896679445,0.0232919254658385,19.9866897151471,1.913619228046,2.32919254658385
2020-04-14,175,4,175,4,0,0,197,4,2740,102,2937,106,0,4,1,22,4,0,"Knox County",470313,5.31560896679445,0.0317286652078775,22.5381820192085,0.850497434687113,3.17286652078775
2020-04-13,171,4,171,4,0,0,193,9,2638,242,2831,251,0,4,1,21,4,0,"Knox County",470313,5.52823332546623,0.0364372469635627,53.3687140266163,0.850497434687113,3.64372469635628
2020-04-12,167,5,167,5,0,0,184,6,2396,166,2580,172,0,4,0,20,4,0,"Knox County",470313,6.59135511882512,0.0386029411764706,36.5713896915458,1.06312179335889,3.86029411764706
2020-04-11,162,5,162,5,0,0,178,8,2230,313,2408,321,1,4,1,20,4,0,"Knox County",470313,7.65447691218401,0.0384917517674784,68.2524191336408,1.06312179335889,3.84917517674784
2020-04-10,157,4,157,4,0,0,170,5,1917,123,2087,128,0,3,0,19,4,0,"Knox County",470313,8.07972562952757,0.0394126738794436,27.2159179099876,0.850497434687113,3.94126738794436
2020-04-09,153,1,153,1,0,0,165,1,1794,81,1959,82,0,3,0,19,4,0,"Knox County",470313,6.8039794774969,0.037261698440208,17.4351974110858,0.212624358671778,3.7261698440208
2020-04-08,152,8,152,8,0,0,164,12,1713,111,1877,123,0,3,1,19,4,1,"Knox County",470313,6.59135511882512,0.0380388841927303,26.1527961166287,1.70099486937423,3.80388841927303
2020-04-07,144,20,144,20,0,0,152,25,1602,366,1754,391,0,3,2,18,3,0,"Knox County",470313,9.99334485757357,0.0449591280653951,83.1361242406653,4.25248717343556,4.49591280653951
2020-04-06,124,8,124,8,0,0,127,14,1236,54,1363,68,2,3,1,16,3,0,"Knox County",470313,10.8438422922607,0.0552529182879377,14.4584563896809,1.70099486937423,5.52529182879377
2020-04-05,116,4,116,4,0,0,113,10,1182,75,1295,85,0,1,0,15,3,1,"Knox County",470313,10.6312179335889,0.0626043405676127,18.0730704871011,0.850497434687113,6.26043405676127
2020-04-04,112,15,112,15,0,0,103,6,1107,127,1210,133,0,1,1,15,2,1,"Knox County",470313,12.7574615203067,0.0722772277227723,28.2790397033465,3.18936538007667,7.22772277227723
2020-04-03,97,4,97,4,0,0,97,3,980,51,1077,54,0,1,1,14,1,0,"Knox County",470313,12.7574615203067,0.0758547008547008,11.481715368276,0.850497434687113,7.58547008547009
2020-04-02,93,7,93,7,0,0,94,7,929,106,1023,113,0,1,0,13,1,0,"Knox County",470313,14.0332076723374,0.0796277145811789,24.0265525299109,1.48837051070245,7.96277145811789
2020-04-01,86,15,86,15,0,0,87,15,823,140,910,155,0,0,1,13,1,0,"Knox County",470313,15.5215781830398,0.0800800800800801,32.9567755941256,3.18936538007667,8.00800800800801
2020-03-31,71,8,71,8,0,0,72,11,683,58,755,69,0,0,1,12,1,0,"Knox County",470313,12.9700858789785,0.0974889217134417,14.6710807483527,1.70099486937423,9.74889217134417
2020-03-30,63,13,63,13,0,0,61,15,625,130,686,145,0,0,2,11,1,0,"Knox County",470313,14.0332076723374,0.0888594164456233,30.8305320074078,2.76411666273312,8.88594164456233
2020-03-29,50,8,50,8,0,0,46,8,495,55,541,63,0,0,1,9,1,1,"Knox County",470313,14.8837051070245,0.0887978142076503,13.395334596322,1.70099486937423,8.87978142076503
2020-03-28,42,7,42,7,0,0,38,6,440,62,478,68,0,0,1,8,0,0,"Knox County",470313,13.1827102376502,0.0974512743628186,14.4584563896809,1.48837051070245,9.74512743628186
2020-03-27,35,2,35,2,0,0,32,2,378,54,410,56,0,0,1,7,0,0,"Knox County",470313,12.7574615203067,0.0956651718983558,11.9069640856196,0.425248717343556,9.56651718983558
2020-03-26,33,7,33,7,0,0,30,7,324,82,354,89,0,0,2,6,0,0,"Knox County",470313,12.7574615203067,0.0992248062015504,18.9235679217883,1.48837051070245,9.92248062015504
2020-03-25,26,6,26,6,0,0,23,7,242,68,265,75,0,0,1,4,0,0,"Knox County",470313,10.8438422922607,0.0991150442477876,15.9468269003834,1.27574615203067,9.91150442477876
2020-03-24,20,7,20,7,0,0,16,7,174,43,190,50,0,0,0,3,0,0,"Knox County",470313,10.6312179335889,0.0952380952380952,10.6312179335889,1.48837051070245,9.52380952380952
2020-03-23,13,4,13,4,0,0,9,4,131,22,140,26,0,0,2,3,0,0,"Knox County",470313,8.7175987055429,0.0960187353629977,5.52823332546623,0.850497434687113,9.60187353629976
2020-03-22,9,2,9,2,0,0,5,0,109,9,114,9,0,0,1,1,0,0,"Knox County",470313,7.44185255351224,0.0884718498659517,1.913619228046,0.425248717343556,8.84718498659517
2020-03-21,7,1,7,1,0,0,5,2,100,17,105,19,0,0,0,0,0,0,"Knox County",470313,6.16610640148157,0.0895061728395062,4.03986281476378,0.212624358671778,8.95061728395062
2020-03-20,6,5,6,5,0,0,3,2,83,38,86,40,0,0,0,0,0,0,"Knox County",470313,6.8039794774969,0.0941558441558442,8.50497434687113,1.06312179335889,9.41558441558442
2020-03-19,1,0,1,0,0,0,1,0,45,11,46,11,0,0,0,0,0,0,"Knox County",470313,5.31560896679445,0.0956521739130435,2.33886794538956,0,9.56521739130435
2020-03-18,1,0,1,0,0,0,1,0,34,15,35,15,0,0,0,0,0,0,"Knox County",470313,4.03986281476378,0.0882352941176471,3.18936538007667,0,8.82352941176471
2020-03-17,1,0,1,0,0,0,1,0,19,5,20,5,0,0,0,0,0,0,"Knox County",470313,2.55149230406134,0.064,1.06312179335889,0,6.4
2020-03-16,1,1,1,1,0,0,1,1,14,3,15,4,0,0,0,0,0,0,"Knox County",470313,1.913619228046,0.0485436893203883,0.850497434687113,0.212624358671778,4.85436893203883
2020-03-15,0,0,0,0,0,0,0,0,11,1,11,1,0,0,0,0,0,0,"Knox County",470313,1.48837051070245,0.0526315789473684,0.212624358671778,0,5.26315789473684
2020-03-14,0,0,0,0,0,0,0,0,10,8,10,8,0,0,0,0,0,0,"Knox County",470313,1.27574615203067,0.0357142857142857,1.70099486937423,0,3.57142857142857
2020-03-13,0,0,0,0,0,0,0,0,2,0,2,0,0,0,0,0,0,0,"Knox County",470313,0.212624358671778,0.0227272727272727,0,0,2.27272727272727
2020-03-12,0,0,0,0,0,0,0,0,2,2,2,2,0,0,0,0,0,0,"Knox County",470313,0.212624358671778,0.0285714285714286,0.425248717343556,0,2.85714285714286
2020-03-12,0,0,0,0,0,0,0,0,0,0,0,0,0,0,0,0,0,0,"Anderson",76978,NA,NA,0,0,NA
2020-03-13,0,0,0,0,0,0,0,0,1,1,1,1,0,0,0,0,0,0,"Anderson",76978,NA,NA,1.29907246226194,0,NA
2020-03-14,0,0,0,0,0,0,0,0,1,0,1,0,0,0,0,0,0,0,"Anderson",76978,NA,NA,0,0,NA
2020-03-15,0,0,0,0,0,0,0,0,1,0,1,0,0,0,0,0,0,0,"Anderson",76978,NA,NA,0,0,NA
2020-03-16,0,0,0,0,0,0,0,0,2,1,2,1,0,0,0,0,0,0,"Anderson",76978,NA,NA,1.29907246226194,0,NA
2020-03-17,0,0,0,0,0,0,0,0,4,2,4,2,0,0,0,0,0,0,"Anderson",76978,NA,NA,2.59814492452389,0,NA
2020-03-18,0,0,0,0,0,0,0,0,4,0,4,0,0,0,0,0,0,0,"Anderson",76978,0,0,0,0,0
2020-03-19,1,1,1,1,0,0,2,2,5,1,7,3,0,0,0,0,0,0,"Anderson",76978,1.29907246226194,0.285714285714286,3.89721738678583,1.29907246226194,28.5714285714286
2020-03-20,1,0,1,0,0,0,2,0,7,2,9,2,0,0,0,0,0,0,"Anderson",76978,1.29907246226194,0.25,2.59814492452389,0,25
2020-03-21,1,0,1,0,0,0,2,0,7,0,9,0,0,0,0,0,0,0,"Anderson",76978,1.29907246226194,0.25,0,0,25
2020-03-22,1,0,1,0,0,0,2,0,10,3,12,3,0,0,0,0,0,0,"Anderson",76978,1.29907246226194,0.181818181818182,3.89721738678583,0,18.1818181818182
2020-03-23,1,0,1,0,0,0,2,0,15,5,17,5,0,0,0,0,0,0,"Anderson",76978,1.29907246226194,0.133333333333333,6.49536231130973,0,13.3333333333333
2020-03-24,1,0,1,0,0,0,2,0,20,5,22,5,0,0,0,0,0,0,"Anderson",76978,1.29907246226194,0.111111111111111,6.49536231130973,0,11.1111111111111
2020-03-25,2,1,2,1,0,0,4,2,29,9,33,11,0,0,0,0,0,0,"Anderson",76978,2.59814492452389,0.137931034482759,14.2897970848814,1.29907246226194,13.7931034482759
2020-03-26,3,1,3,1,0,0,5,1,44,15,49,16,0,0,1,1,0,0,"Anderson",76978,2.59814492452389,0.0714285714285714,20.7851593961911,1.29907246226194,7.14285714285714
2020-03-27,4,1,4,1,0,0,6,1,53,9,59,10,0,0,0,1,0,0,"Anderson",76978,3.89721738678583,0.08,12.9907246226195,1.29907246226194,8
2020-03-28,7,3,7,3,0,0,9,3,72,19,81,22,0,0,1,2,0,0,"Anderson",76978,7.79443477357167,0.0972222222222222,28.5795941697628,3.89721738678583,9.72222222222222
2020-03-29,7,0,7,0,0,0,9,0,83,11,92,11,0,0,0,2,0,0,"Anderson",76978,7.79443477357167,0.0875,14.2897970848814,0,8.75
2020-03-30,8,1,8,1,0,0,10,1,127,44,137,45,0,0,0,2,0,0,"Anderson",76978,9.09350723583361,0.0666666666666667,58.4582608017875,1.29907246226194,6.66666666666667
2020-03-31,9,1,9,1,0,0,11,1,142,15,153,16,0,0,0,2,0,0,"Anderson",76978,10.3925796980956,0.0687022900763359,20.7851593961911,1.29907246226194,6.87022900763359
2020-04-01,9,0,9,0,0,0,11,0,163,21,174,21,0,0,0,2,0,0,"Anderson",76978,9.09350723583361,0.049645390070922,27.2805217075008,0,4.9645390070922
2020-04-02,9,0,9,0,0,0,11,0,179,16,190,16,0,0,0,2,0,0,"Anderson",76978,7.79443477357167,0.0425531914893617,20.7851593961911,0,4.25531914893617
2020-04-03,9,0,9,0,0,0,11,0,192,13,203,13,0,0,0,2,0,0,"Anderson",76978,6.49536231130972,0.0347222222222222,16.8879420094053,0,3.47222222222222
2020-04-04,9,0,9,0,0,0,11,0,219,27,230,27,0,0,0,2,0,0,"Anderson",76978,2.59814492452389,0.0134228187919463,35.0749564810725,0,1.34228187919463
2020-04-05,9,0,9,0,0,0,11,0,248,29,259,29,0,0,0,2,0,0,"Anderson",76978,2.59814492452389,0.0119760479041916,37.6731014055964,0,1.19760479041916
2020-04-06,9,0,9,0,0,0,11,0,262,14,273,14,0,0,0,2,0,0,"Anderson",76978,1.29907246226194,0.00735294117647059,18.1870144716672,0,0.735294117647059
2020-04-07,10,1,10,1,0,0,12,1,304,42,316,43,0,0,0,2,0,0,"Anderson",76978,1.29907246226194,0.00613496932515337,55.8601158772636,1.29907246226194,0.613496932515337
2020-04-08,10,0,10,0,0,0,12,0,322,18,334,18,1,1,0,2,1,1,"Anderson",76978,1.29907246226194,0.00625,23.383304320715,0,0.625
2020-04-09,10,0,10,0,0,0,12,0,350,28,362,28,0,1,0,2,1,0,"Anderson",76978,1.29907246226194,0.00581395348837209,36.3740289433345,0,0.581395348837209
2020-04-10,10,0,10,0,0,0,12,0,366,16,378,16,0,1,0,2,1,0,"Anderson",76978,1.29907246226194,0.00571428571428571,20.7851593961911,0,0.571428571428571
2020-04-11,10,0,10,0,0,0,12,0,439,73,451,73,0,1,0,2,1,0,"Anderson",76978,1.29907246226194,0.00452488687782805,94.832289745122,0,0.452488687782805
2020-04-12,12,2,12,2,0,0,14,2,477,38,491,40,0,1,0,2,1,0,"Anderson",76978,3.89721738678583,0.0129310344827586,51.9628984904778,2.59814492452389,1.29310344827586
2020-04-13,13,1,13,1,0,0,15,1,514,37,529,38,0,1,0,2,1,0,"Anderson",76978,5.19628984904778,0.015625,49.3647535659539,1.29907246226194,1.5625
2020-04-14,13,0,13,0,0,0,15,0,526,12,541,12,0,1,0,2,1,0,"Anderson",76978,3.89721738678583,0.0133333333333333,15.5888695471433,0,1.33333333333333
2020-04-15,13,0,13,0,0,0,15,0,544,18,559,18,0,1,0,2,1,0,"Anderson",76978,3.89721738678583,0.0133333333333333,23.383304320715,0,1.33333333333333
2020-04-16,13,0,13,0,0,0,15,0,566,22,581,22,0,1,0,2,1,0,"Anderson",76978,3.89721738678583,0.0136986301369863,28.5795941697628,0,1.36986301369863
2020-04-17,13,0,13,0,0,0,15,0,586,20,601,20,0,1,0,2,1,0,"Anderson",76978,3.89721738678583,0.0134529147982063,25.9814492452389,0,1.34529147982063
2020-04-18,13,0,13,0,0,0,15,0,616,30,631,30,0,1,0,2,1,0,"Anderson",76978,3.89721738678583,0.0166666666666667,38.9721738678584,0,1.66666666666667
2020-04-19,14,1,14,1,0,0,16,1,628,12,644,13,0,1,0,2,1,0,"Anderson",76978,2.59814492452389,0.0130718954248366,16.8879420094053,1.29907246226194,1.30718954248366
2020-04-20,19,5,18,4,1,1,19,3,648,20,667,23,0,1,0,2,1,0,"Anderson",76978,7.79443477357167,0.0289855072463768,29.8786666320247,6.49536231130973,2.89855072463768
2020-04-21,20,1,19,1,1,0,22,3,1071,423,1093,426,0,1,0,2,1,0,"Anderson",76978,9.09350723583361,0.0126811594202899,553.404868923589,1.29907246226194,1.26811594202899
2020-04-22,21,1,20,1,1,0,24,2,1141,70,1165,72,0,1,0,2,1,0,"Anderson",76978,10.3925796980956,0.0148514851485149,93.53321728286,1.29907246226194,1.48514851485149
2020-04-23,21,0,20,0,1,0,24,0,1191,50,1215,50,0,1,0,2,1,0,"Anderson",76978,10.3925796980956,0.0141955835962145,64.9536231130973,0,1.41955835962145
2020-04-24,22,1,21,1,1,0,25,1,1299,108,1324,109,0,1,0,2,1,0,"Anderson",76978,11.6916521603575,0.0138312586445367,141.598898386552,1.29907246226194,1.38312586445367
2020-04-25,22,0,21,0,1,0,25,0,1336,37,1361,37,0,1,0,2,1,0,"Anderson",76978,11.6916521603575,0.0136986301369863,48.065681103692,0,1.36986301369863
2020-04-26,22,0,21,0,1,0,25,0,1372,36,1397,36,0,1,0,2,1,0,"Anderson",76978,10.3925796980956,0.0119521912350598,46.76660864143,0,1.19521912350598
2020-04-27,22,0,21,0,1,0,25,0,1411,39,1436,39,0,1,0,2,1,0,"Anderson",76978,3.89721738678583,0.00780234070221066,50.6638260282159,0,0.780234070221066
2020-04-28,22,0,21,0,1,0,25,0,1690,279,1715,279,0,1,0,2,1,0,"Anderson",76978,2.59814492452389,0.00482315112540193,362.441216971083,0,0.482315112540193
2020-04-29,26,4,25,4,1,0,28,3,2068,378,2096,381,0,1,0,2,1,0,"Anderson",76978,6.49536231130972,0.00429645542427497,494.946608121801,5.19628984904778,0.429645542427497
2020-04-30,26,0,25,0,1,0,29,1,2100,32,2129,33,0,1,0,2,1,0,"Anderson",76978,6.49536231130972,0.00547045951859956,42.8693912546442,0,0.547045951859956
2020-05-01,26,0,25,0,1,0,29,0,2152,52,2181,52,0,1,0,2,1,0,"Anderson",76978,5.19628984904778,0.00466744457409568,67.5517680376211,0,0.466744457409568
2020-05-02,26,0,25,0,1,0,29,0,2219,67,2248,67,0,1,0,2,1,0,"Anderson",76978,5.19628984904778,0.00450958286358512,87.0378549715503,0,0.450958286358512
2020-05-03,27,1,26,1,1,0,30,1,2312,93,2342,94,0,1,0,2,1,0,"Anderson",76978,6.49536231130972,0.00529100529100529,122.112811452623,1.29907246226194,0.529100529100529
2020-05-04,27,0,26,0,1,0,30,0,2404,92,2434,92,0,1,0,2,1,0,"Anderson",76978,6.49536231130972,0.00501002004008016,119.514666528099,0,0.501002004008016
2020-05-05,28,1,27,1,1,0,30,0,2473,69,2503,69,0,1,0,2,1,0,"Anderson",76978,7.79443477357167,0.00634517766497462,89.6359998960742,1.29907246226194,0.634517766497462
2020-05-06,30,2,29,2,1,0,31,1,2523,50,2554,51,0,1,0,2,1,0,"Anderson",76978,5.19628984904778,0.00655021834061135,66.2526955753592,2.59814492452389,0.655021834061135
2020-05-07,30,0,29,0,1,0,33,2,2595,72,2628,74,0,1,0,2,1,0,"Anderson",76978,5.19628984904778,0.00801603206412826,96.1313622073839,0,0.801603206412826
2020-05-08,30,0,29,0,1,0,33,0,2650,55,2683,55,0,1,0,2,1,0,"Anderson",76978,5.19628984904778,0.00796812749003984,71.448985424407,0,0.796812749003984
2020-05-09,30,0,29,0,1,0,33,0,2732,82,2765,82,0,1,0,2,1,0,"Anderson",76978,5.19628984904778,0.00773694390715667,106.523941905479,0,0.773694390715667
2020-05-10,30,0,29,0,1,0,33,0,2825,93,2858,93,0,1,0,2,1,0,"Anderson",76978,3.89721738678583,0.00581395348837209,120.813738990361,0,0.581395348837209
2020-05-11,32,2,31,2,1,0,33,0,2907,82,2940,82,0,1,0,2,1,0,"Anderson",76978,6.49536231130972,0.00592885375494071,106.523941905479,2.59814492452389,0.592885375494071
2020-05-12,33,1,32,1,1,0,35,2,3040,133,3075,135,0,1,0,2,1,0,"Anderson",76978,6.49536231130972,0.00874125874125874,175.374782405363,1.29907246226194,0.874125874125874
2020-05-13,35,2,34,2,1,0,38,3,3218,178,3256,181,0,1,1,3,1,0,"Anderson",76978,6.49536231130972,0.00997150997150997,235.132115669412,2.59814492452389,0.997150997150997
2020-05-14,35,0,34,0,1,0,39,1,3344,126,3383,127,0,1,0,3,1,0,"Anderson",76978,6.49536231130972,0.00794701986754967,164.982202707267,0,0.794701986754967
2020-05-15,36,1,35,1,1,0,39,0,3415,71,3454,71,0,1,0,3,1,0,"Anderson",76978,7.79443477357167,0.00778210116731518,92.2341448205981,1.29907246226194,0.778210116731518
2020-05-16,36,0,35,0,1,0,41,2,3655,240,3696,242,0,1,0,3,1,0,"Anderson",76978,7.79443477357167,0.00859291084854995,314.375535867391,0,0.859291084854995
2020-05-17,36,0,35,0,1,0,41,0,3725,70,3766,70,0,1,0,3,1,0,"Anderson",76978,7.79443477357167,0.00881057268722467,90.9350723583361,0,0.881057268722467
2020-05-18,37,1,36,1,1,0,42,1,3802,77,3844,78,0,1,0,3,1,0,"Anderson",76978,6.49536231130972,0.00995575221238938,101.327652056432,1.29907246226194,0.995575221238938
2020-05-19,37,0,36,0,1,0,42,0,3854,52,3896,52,0,1,0,3,1,0,"Anderson",76978,5.19628984904778,0.00852618757612668,67.5517680376211,0,0.852618757612667
2020-05-20,37,0,36,0,1,0,43,1,3919,65,3962,66,0,1,0,3,1,0,"Anderson",76978,2.59814492452389,0.00708215297450425,85.7387825092884,0,0.708215297450425
2020-05-21,37,0,36,0,1,0,44,1,3999,80,4043,81,0,1,0,3,1,0,"Anderson",76978,2.59814492452389,0.00757575757575758,105.224869443218,0,0.757575757575758
2020-05-22,38,1,37,1,1,0,45,1,4027,28,4072,29,0,1,1,4,1,0,"Anderson",76978,2.59814492452389,0.00970873786407767,37.6731014055964,1.29907246226194,0.970873786407767
2020-05-23,38,0,37,0,1,0,46,1,4190,163,4236,164,0,1,0,4,1,0,"Anderson",76978,2.59814492452389,0.00925925925925926,213.047883810959,0,0.925925925925926
2020-05-24,38,0,37,0,1,0,46,0,4245,55,4291,55,0,1,0,4,1,0,"Anderson",76978,2.59814492452389,0.00952380952380952,71.448985424407,0,0.952380952380952
2020-05-25,38,0,37,0,1,0,47,1,4279,34,4326,35,0,1,0,4,1,0,"Anderson",76978,1.29907246226194,0.0103734439834025,45.4675361791681,0,1.03734439834025
2020-05-26,38,0,37,0,1,0,47,0,4410,131,4457,131,0,1,0,4,1,0,"Anderson",76978,1.29907246226194,0.0089126559714795,170.178492556315,0,0.89126559714795
2020-05-27,38,0,37,0,1,0,47,0,4513,103,4560,103,0,1,0,4,1,0,"Anderson",76978,1.29907246226194,0.00668896321070234,133.80446361298,0,0.668896321070234
2020-05-28,38,0,37,0,1,0,47,0,4561,48,4608,48,0,1,0,4,1,0,"Anderson",76978,1.29907246226194,0.00530973451327434,62.3554781885734,0,0.530973451327434
2020-05-29,39,1,38,1,1,0,47,0,4611,50,4658,50,0,1,0,4,1,0,"Anderson",76978,1.29907246226194,0.00341296928327645,64.9536231130973,1.29907246226194,0.341296928327645
2020-05-30,39,0,38,0,1,0,48,1,4663,52,4711,53,0,1,0,4,1,0,"Anderson",76978,1.29907246226194,0.00421052631578947,68.8508404998831,0,0.421052631578947
2020-05-31,40,1,39,1,1,0,49,1,4729,66,4778,67,0,1,0,4,1,0,"Anderson",76978,2.59814492452389,0.00616016427104723,87.0378549715503,1.29907246226194,0.616016427104723
2020-06-01,40,0,39,0,1,0,49,0,4853,124,4902,124,0,1,0,4,1,0,"Anderson",76978,2.59814492452389,0.00347222222222222,161.084985320481,0,0.347222222222222
2020-06-02,40,0,39,0,1,0,49,0,4980,127,5029,127,0,1,0,4,1,0,"Anderson",76978,2.59814492452389,0.0034965034965035,164.982202707267,0,0.34965034965035
2020-06-03,41,1,40,1,1,0,50,1,5040,60,5090,61,0,1,0,4,2,1,"Anderson",76978,3.89721738678583,0.00566037735849057,79.2434201979787,1.29907246226194,0.566037735849057
2020-06-04,41,0,40,0,1,0,50,0,5088,48,5138,48,1,2,0,4,2,0,"Anderson",76978,3.89721738678583,0.00566037735849057,62.3554781885734,0,0.566037735849057
2020-06-05,42,1,41,1,1,0,53,3,5145,57,5198,60,0,2,0,4,2,0,"Anderson",76978,3.89721738678583,0.0111111111111111,77.9443477357167,1.29907246226194,1.11111111111111
2020-06-06,43,1,42,1,1,0,54,1,5198,53,5252,54,0,2,0,4,2,0,"Anderson",76978,5.19628984904778,0.011090573012939,70.149912962145,1.29907246226194,1.1090573012939
2020-06-07,45,2,43,1,2,1,57,3,5293,95,5350,98,0,2,0,4,2,0,"Anderson",76978,6.49536231130972,0.013986013986014,127.309101301671,2.59814492452389,1.3986013986014
2020-06-08,46,1,44,1,2,0,57,0,5334,41,5391,41,0,2,0,4,2,0,"Anderson",76978,7.79443477357167,0.016359918200409,53.2619709527397,1.29907246226194,1.6359918200409
2020-06-09,47,1,45,1,2,0,60,3,5515,181,5575,184,0,2,0,4,2,0,"Anderson",76978,9.09350723583361,0.0201465201465201,239.029333056198,1.29907246226194,2.01465201465201
2020-06-10,52,5,50,5,2,0,63,3,5723,208,5786,211,0,2,0,4,2,0,"Anderson",76978,14.2897970848814,0.0186781609195402,274.10428953727,6.49536231130973,1.86781609195402
2020-06-11,55,3,53,3,2,0,66,3,5868,145,5934,148,0,2,1,5,2,0,"Anderson",76978,18.1870144716672,0.0201005025125628,192.262724414768,3.89721738678583,2.01005025125628
2020-06-12,57,2,55,2,2,0,70,4,5950,82,6020,86,0,2,0,5,2,0,"Anderson",76978,19.4860869339292,0.0206812652068127,111.720231754527,2.59814492452389,2.06812652068127
2020-06-13,58,1,55,0,3,1,70,0,5993,43,6063,43,0,2,0,5,2,0,"Anderson",76978,19.4860869339292,0.0197287299630086,55.8601158772636,1.29907246226194,1.97287299630086
2020-06-14,60,2,57,2,3,0,70,0,6168,175,6238,175,0,2,1,6,2,0,"Anderson",76978,19.4860869339292,0.0146396396396396,227.33768089584,2.59814492452389,1.46396396396396
2020-06-15,60,0,57,0,3,0,71,1,6226,58,6297,59,0,2,0,6,2,0,"Anderson",76978,18.1870144716672,0.0154525386313466,76.6452752734548,0,1.54525386313466
2020-06-16,64,4,61,4,3,0,75,4,6287,61,6362,65,0,2,0,6,2,0,"Anderson",76978,22.0842318584531,0.0190597204574333,84.4397100470264,5.19628984904778,1.90597204574333
2020-06-17,66,2,63,2,3,0,79,4,6324,37,6403,41,0,2,0,6,2,0,"Anderson",76978,18.1870144716672,0.0259319286871961,53.2619709527397,2.59814492452389,2.59319286871961
2020-06-18,70,4,67,4,3,0,84,5,6454,130,6538,135,0,2,0,6,2,0,"Anderson",76978,19.4860869339292,0.0298013245033113,175.374782405363,5.19628984904778,2.98013245033113
2020-06-19,72,2,69,2,3,0,86,2,6519,65,6605,67,0,2,0,6,2,0,"Anderson",76978,19.4860869339292,0.0273504273504274,87.0378549715503,2.59814492452389,2.73504273504274
2020-06-20,73,1,70,1,3,0,87,1,6557,38,6644,39,0,2,0,6,2,0,"Anderson",76978,19.4860869339292,0.0292598967297762,50.6638260282159,1.29907246226194,2.92598967297762
2020-06-21,74,1,71,1,3,0,88,1,6617,60,6705,61,0,2,0,6,2,0,"Anderson",76978,18.1870144716672,0.0385438972162741,79.2434201979787,1.29907246226194,3.85438972162741
2020-06-22,76,2,73,2,3,0,90,2,6709,92,6799,94,0,2,1,7,2,0,"Anderson",76978,20.7851593961911,0.0378486055776892,122.112811452623,2.59814492452389,3.78486055776892
2020-06-23,76,0,73,0,3,0,90,0,6798,89,6888,89,0,2,0,7,2,0,"Anderson",76978,15.5888695471433,0.0285171102661597,115.617449141313,0,2.85171102661597
2020-06-24,77,1,74,1,3,0,91,1,6829,31,6920,32,0,2,0,7,2,0,"Anderson",76978,14.2897970848814,0.02321083172147,41.5703187923822,1.29907246226194,2.321083172147
2020-06-25,81,4,78,4,3,0,92,1,6942,113,7034,114,0,2,0,7,2,0,"Anderson",76978,14.2897970848814,0.0161290322580645,148.094260697862,5.19628984904778,1.61290322580645
2020-06-26,86,5,83,5,3,0,98,6,6970,28,7068,34,0,2,0,7,2,0,"Anderson",76978,18.1870144716672,0.0259179265658747,44.1684637169061,6.49536231130973,2.59179265658747
2020-06-27,87,1,83,0,4,1,98,0,6982,12,7080,12,0,2,0,7,2,0,"Anderson",76978,18.1870144716672,0.0252293577981651,15.5888695471433,1.29907246226194,2.52293577981651
2020-06-28,91,4,87,4,4,0,106,8,7091,109,7197,117,0,2,0,7,2,0,"Anderson",76978,22.0842318584531,0.0365853658536585,151.991478084648,5.19628984904778,3.65853658536585
2020-06-29,97,6,92,5,5,1,114,8,7313,222,7427,230,0,2,1,8,2,0,"Anderson",76978,27.2805217075008,0.0382165605095541,298.786666320247,7.79443477357167,3.82165605095541
2020-06-30,102,5,96,4,6,1,120,6,7477,164,7597,170,0,2,0,8,2,0,"Anderson",76978,33.7758840188106,0.0423131170662905,220.842318584531,6.49536231130973,4.23131170662905
2020-07-01,104,2,98,2,6,0,124,4,7598,121,7722,125,0,2,0,8,2,0,"Anderson",76978,35.0749564810725,0.0411471321695761,162.384057782743,2.59814492452389,4.11471321695761
2020-07-02,110,6,104,6,6,0,130,6,7837,239,7967,245,0,2,0,8,2,0,"Anderson",76978,37.6731014055964,0.0407288317256163,318.272753254177,7.79443477357167,4.07288317256163
2020-07-03,120,10,113,9,7,1,142,12,7961,124,8103,136,0,2,0,8,2,0,"Anderson",76978,44.1684637169061,0.042512077294686,176.673854867625,12.9907246226195,4.2512077294686
2020-07-04,131,11,124,11,7,0,156,14,8145,184,8301,198,0,2,2,10,2,0,"Anderson",76978,57.1591883395256,0.0475020475020475,257.216347527865,14.2897970848814,4.75020475020475
2020-07-05,140,9,133,9,7,0,169,13,8301,156,8470,169,0,2,1,11,2,0,"Anderson",76978,63.6545506508353,0.0494893951296151,219.543246122269,11.6916521603575,4.94893951296151
2020-07-06,141,1,134,1,7,0,170,1,8328,27,8498,28,0,2,0,11,2,0,"Anderson",76978,57.1591883395256,0.0522875816993464,36.3740289433345,1.29907246226194,5.22875816993464
2020-07-07,157,16,150,16,7,0,190,20,8561,233,8751,253,0,2,0,11,2,0,"Anderson",76978,71.448985424407,0.0606585788561525,328.665332952272,20.7851593961911,6.06585788561525
2020-07-08,173,16,165,15,8,1,206,16,8701,140,8907,156,0,2,0,11,2,0,"Anderson",76978,89.6359998960742,0.0691983122362869,202.655304112863,20.7851593961911,6.91983122362869
2020-07-09,187,14,179,14,8,0,220,14,8969,268,9189,282,0,2,0,11,2,0,"Anderson",76978,100.02857959417,0.0736497545008183,366.338434357868,18.1870144716672,7.36497545008183
2020-07-10,193,6,185,6,8,0,227,7,8999,30,9226,37,0,2,1,12,2,0,"Anderson",76978,94.832289745122,0.0756901157613535,48.065681103692,7.79443477357167,7.56901157613535
2020-07-11,201,8,193,8,8,0,235,8,9168,169,9403,177,0,2,1,13,2,0,"Anderson",76978,90.9350723583361,0.0716878402903811,229.935825820364,10.3925796980956,7.16878402903811
2020-07-12,212,11,204,11,8,0,248,13,9351,183,9599,196,0,2,0,13,2,0,"Anderson",76978,93.53321728286,0.0699734278122232,254.618202603341,14.2897970848814,6.99734278122232
2020-07-13,218,6,209,5,9,1,255,7,9390,39,9645,46,0,2,2,15,2,0,"Anderson",76978,100.02857959417,0.0741063644289451,59.7573332640495,7.79443477357167,7.41063644289451
2020-07-14,229,11,219,10,10,1,266,11,9530,140,9796,151,0,2,0,15,2,0,"Anderson",76978,93.53321728286,0.0727272727272727,196.159941801554,14.2897970848814,7.27272727272727
2020-07-15,245,16,234,15,11,1,285,19,9632,102,9917,121,0,2,0,15,2,0,"Anderson",76978,93.53321728286,0.0782178217821782,157.187767933695,20.7851593961911,7.82178217821782
2020-07-16,263,18,252,18,11,0,308,23,9921,289,10229,312,0,2,1,16,2,0,"Anderson",76978,98.7295071319078,0.0846153846153846,405.310608225727,23.383304320715,8.46153846153846
2020-07-17,270,7,259,7,11,0,317,9,9992,71,10309,80,0,2,1,17,3,1,"Anderson",76978,100.02857959417,0.0831024930747922,103.925796980956,9.09350723583361,8.31024930747922
2020-07-18,277,7,266,7,11,0,328,11,10206,214,10534,225,0,2,0,17,3,0,"Anderson",76978,98.7295071319078,0.0822281167108753,292.291304008938,9.09350723583361,8.22281167108753
2020-07-19,285,8,274,8,11,0,337,9,10287,81,10624,90,0,2,2,19,3,0,"Anderson",76978,94.832289745122,0.0868292682926829,116.916521603575,10.3925796980956,8.68292682926829
2020-07-20,313,28,302,28,11,0,367,30,10456,169,10823,199,1,3,0,19,3,0,"Anderson",76978,123.411883914885,0.0950764006791171,258.515419990127,36.3740289433345,9.50764006791171
2020-07-21,336,23,324,22,12,1,391,24,10748,292,11139,316,0,3,1,20,3,0,"Anderson",76978,139.000753462028,0.0930752047654505,410.506898074775,29.8786666320247,9.30752047654505
2020-07-22,365,29,353,29,12,0,424,33,10883,135,11307,168,0,3,0,20,3,0,"Anderson",76978,155.888695471433,0.1,218.244173660007,37.6731014055964,10
2020-07-23,388,23,376,23,12,0,455,31,11310,427,11765,458,0,3,2,22,3,0,"Anderson",76978,162.384057782743,0.095703125,594.975187715971,29.8786666320247,9.5703125
2020-07-24,394,6,382,6,12,0,463,8,11422,112,11885,120,0,3,0,22,4,1,"Anderson",76978,161.084985320481,0.0926395939086294,155.888695471433,7.79443477357167,9.26395939086294
2020-07-25,426,32,413,31,13,1,499,36,11679,257,12178,293,1,4,1,23,4,0,"Anderson",76978,193.56179687703,0.104014598540146,380.62823144275,41.5703187923822,10.4014598540146
2020-07-26,465,39,451,38,14,1,541,42,12082,403,12623,445,0,4,2,25,4,0,"Anderson",76978,233.83304320715,0.102051025512756,578.087245706565,50.6638260282159,10.2051025512756
2020-07-27,483,18,468,17,15,1,562,21,12262,180,12824,201,0,4,1,26,4,0,"Anderson",76978,220.842318584531,0.0974512743628186,261.113564914651,23.383304320715,9.74512743628186
2020-07-28,523,40,508,40,15,0,608,46,12642,380,13250,426,0,4,1,27,5,1,"Anderson",76978,242.926550442984,0.10279488394126,553.404868923589,51.9628984904778,10.279488394126
2020-07-29,527,4,512,4,15,0,612,4,12678,36,13290,40,1,5,0,27,5,0,"Anderson",76978,210.449738886435,0.0948058497226425,51.9628984904778,5.19628984904778,9.48058497226425
2020-07-30,564,37,549,37,15,0,666,54,13163,485,13829,539,0,5,0,27,5,0,"Anderson",76978,228.636753358102,0.102228682170543,700.200057159188,48.065681103692,10.2228682170543
2020-07-31,576,12,561,12,15,0,680,14,13345,182,14025,196,0,5,0,27,5,0,"Anderson",76978,236.431188131674,0.101401869158878,254.618202603341,15.5888695471433,10.1401869158878
2020-08-01,599,23,584,23,15,0,705,25,13754,409,14459,434,0,5,1,28,5,0,"Anderson",76978,224.739535971316,0.0903112669881631,563.797448621684,29.8786666320247,9.03112669881631
2020-08-02,606,7,591,7,15,0,712,7,13882,128,14594,135,0,5,1,29,6,1,"Anderson",76978,183.169217178934,0.0867579908675799,175.374782405363,9.09350723583361,8.67579908675799
2020-08-03,631,25,615,24,16,1,743,31,14109,227,14852,258,0,5,0,29,6,0,"Anderson",76978,192.262724414768,0.0892504930966469,335.160695263582,32.4768115565486,8.92504930966469
2020-08-04,638,7,622,7,16,0,751,8,14352,243,15103,251,2,7,0,29,6,0,"Anderson",76978,149.393333160124,0.0771721532649757,326.067188027748,9.09350723583361,7.71721532649757
2020-08-05,653,15,637,15,16,0,770,19,14561,209,15331,228,-1,6,0,29,6,0,"Anderson",76978,163.683130245005,0.0774130328270456,296.188521395723,19.4860869339292,7.74130328270456
2020-08-06,675,22,659,22,16,0,800,30,14882,321,15682,351,0,6,1,30,6,0,"Anderson",76978,144.197043311076,0.0723151645979493,455.974434253943,28.5795941697628,7.23151645979493
2020-08-07,679,4,663,4,16,0,804,4,14963,81,15767,85,0,6,0,30,6,0,"Anderson",76978,133.80446361298,0.0711825487944891,110.421159292265,5.19628984904778,7.11825487944891
2020-08-08,690,11,674,11,16,0,820,16,15283,320,16103,336,0,6,0,30,6,0,"Anderson",76978,118.215594065837,0.0699513381995134,436.488347320014,14.2897970848814,6.99513381995134
2020-08-09,697,7,681,7,16,0,829,9,15420,137,16249,146,0,6,0,30,6,0,"Anderson",76978,118.215594065837,0.0706948640483384,189.664579490244,9.09350723583361,7.06948640483384
2020-08-10,702,5,686,5,16,0,835,6,15559,139,16394,145,0,6,0,30,6,0,"Anderson",76978,92.2341448205981,0.059662775616083,188.365507027982,6.49536231130973,5.9662775616083
2020-08-11,723,21,707,21,16,0,857,22,15762,203,16619,225,0,6,1,31,6,0,"Anderson",76978,110.421159292265,0.0699208443271768,292.291304008938,27.2805217075008,6.99208443271768
2020-08-12,731,8,715,8,16,0,865,8,16001,239,16866,247,0,6,0,31,6,0,"Anderson",76978,101.327652056432,0.0618892508143322,320.8708981787,10.3925796980956,6.18892508143322
2020-08-13,749,18,733,18,16,0,889,24,16229,228,17118,252,1,7,2,33,6,0,"Anderson",76978,96.1313622073839,0.0619777158774373,327.36626049001,23.383304320715,6.19777158774373
2020-08-14,766,17,749,16,17,1,911,22,16558,329,17469,351,0,7,0,33,6,0,"Anderson",76978,113.019304216789,0.0628672150411281,455.974434253943,22.0842318584531,6.28672150411281
2020-08-15,776,10,759,10,17,0,923,12,16781,223,17704,235,-1,6,0,33,6,0,"Anderson",76978,111.720231754527,0.0643347907557776,305.282028631557,12.9907246226195,6.43347907557776
2020-08-16,788,12,771,12,17,0,937,14,16923,142,17860,156,0,6,0,33,7,1,"Anderson",76978,118.215594065837,0.0670391061452514,202.655304112863,15.5888695471433,6.70391061452514
2020-08-17,792,4,775,4,17,0,940,3,16966,43,17906,46,0,6,0,33,7,0,"Anderson",76978,116.916521603575,0.0694444444444444,59.7573332640495,5.19628984904778,6.94444444444444
2020-08-18,806,14,789,14,17,0,957,17,17129,163,18086,180,0,6,0,33,7,0,"Anderson",76978,107.823014367741,0.0681663258350375,233.83304320715,18.1870144716672,6.81663258350375
2020-08-19,820,14,803,14,17,0,971,14,17303,174,18274,188,0,6,0,33,7,0,"Anderson",76978,115.617449141313,0.0752840909090909,244.225622905246,18.1870144716672,7.52840909090909
2020-08-20,835,15,818,15,17,0,987,16,17745,442,18732,458,0,6,0,33,8,1,"Anderson",76978,111.720231754527,0.0607187112763321,594.975187715971,19.4860869339292,6.07187112763321
2020-08-21,838,3,821,3,17,0,990,3,17781,36,18771,39,1,7,0,33,8,0,"Anderson",76978,93.53321728286,0.0606758832565284,50.6638260282159,3.89721738678583,6.06758832565284
2020-08-22,856,18,839,18,17,0,1009,19,18325,544,19334,563,1,8,1,34,8,0,"Anderson",76978,103.925796980956,0.052760736196319,731.377796253475,23.383304320715,5.2760736196319
2020-08-23,857,1,840,1,17,0,1010,1,18409,84,19419,85,0,8,0,34,8,0,"Anderson",76978,89.6359998960742,0.0468248877485568,110.421159292265,1.29907246226194,4.68248877485568
2020-08-24,858,1,840,0,18,1,1010,0,18448,39,19458,39,0,8,0,34,8,0,"Anderson",76978,85.7387825092884,0.0451030927835052,50.6638260282159,1.29907246226194,4.51030927835052
2020-08-25,866,8,848,8,18,0,1018,8,18600,152,19618,160,0,8,1,35,8,0,"Anderson",76978,77.9443477357167,0.0398172323759791,207.851593961911,10.3925796980956,3.98172323759791
2020-08-26,872,6,854,6,18,0,1024,6,18780,180,19804,186,0,8,0,35,8,0,"Anderson",76978,67.5517680376211,0.034640522875817,241.627477980722,7.79443477357167,3.4640522875817
2020-08-27,875,3,857,3,18,0,1027,3,19191,411,20218,414,0,8,0,35,8,0,"Anderson",76978,51.9628984904778,0.0269179004037685,537.815999376445,3.89721738678583,2.69179004037685
2020-08-28,875,0,857,0,18,0,1027,0,19229,38,20256,38,0,8,0,35,8,0,"Anderson",76978,48.065681103692,0.0249158249158249,49.3647535659539,0,2.49158249158249
2020-08-29,884,9,865,8,19,1,1035,8,19491,262,20526,270,0,8,0,35,8,0,"Anderson",76978,36.3740289433345,0.0218120805369128,350.749564810725,11.6916521603575,2.18120805369128
2020-08-30,900,16,881,16,19,0,1051,16,19574,83,20625,99,0,8,0,35,8,0,"Anderson",76978,55.8601158772636,0.0339966832504146,128.608173763933,20.7851593961911,3.39966832504146
2020-08-31,902,2,883,2,19,0,1053,2,19632,58,20685,60,0,8,0,35,8,0,"Anderson",76978,57.1591883395256,0.0350448247758761,77.9443477357167,2.59814492452389,3.50448247758761
2020-09-01,909,7,889,6,20,1,1059,6,19743,111,20802,117,0,8,0,35,8,0,"Anderson",76978,55.8601158772636,0.0346283783783784,151.991478084648,9.09350723583361,3.46283783783784
2020-09-02,917,8,895,6,22,2,1069,10,20059,316,21128,326,0,8,0,35,8,0,"Anderson",76978,58.4582608017875,0.033987915407855,423.497622697394,10.3925796980956,3.3987915407855
2020-09-03,933,16,909,14,24,2,1085,16,20383,324,21468,340,0,8,0,35,9,1,"Anderson",76978,75.3462028111928,0.0464,441.684637169061,20.7851593961911,4.64
2020-09-04,942,9,917,8,25,1,1095,10,20572,189,21667,199,0,8,0,35,9,0,"Anderson",76978,87.0378549715503,0.0481927710843374,258.515419990127,11.6916521603575,4.81927710843374
2020-09-05,961,19,936,19,25,0,1116,21,20841,269,21957,290,0,8,1,36,10,1,"Anderson",76978,100.02857959417,0.0566037735849057,376.731014055964,24.682376782977,5.66037735849057
2020-09-06,963,2,938,2,25,0,1118,2,20897,56,22015,58,0,8,0,36,10,0,"Anderson",76978,81.8415651225025,0.0482014388489209,75.3462028111928,2.59814492452389,4.82014388489209
2020-09-07,966,3,941,3,25,0,1123,5,20985,88,22108,93,0,8,0,36,10,0,"Anderson",76978,83.1406375847645,0.0491918482080112,120.813738990361,3.89721738678583,4.91918482080112
2020-09-08,975,9,944,3,31,6,1127,4,21160,175,22287,179,1,9,0,36,10,0,"Anderson",76978,85.7387825092884,0.0457912457912458,232.533970744888,11.6916521603575,4.57912457912458
2020-09-09,984,9,953,9,31,0,1136,9,21401,241,22537,250,0,9,1,37,11,1,"Anderson",76978,87.0378549715503,0.0475514549325763,324.768115565486,11.6916521603575,4.75514549325763
2020-09-10,1013,29,981,28,32,1,1166,30,21770,369,22936,399,1,10,0,37,11,0,"Anderson",76978,103.925796980956,0.0551771117166213,518.329912442516,37.6731014055964,5.51771117166213
2020-09-11,1014,1,982,1,32,0,1168,2,21903,133,23071,135,0,10,0,37,11,0,"Anderson",76978,93.53321728286,0.051994301994302,175.374782405363,1.29907246226194,5.1994301994302
2020-09-12,1017,3,985,3,32,0,1173,5,22045,142,23218,147,0,10,0,37,11,0,"Anderson",76978,72.7480578866689,0.0452022204599524,190.963651952506,3.89721738678583,4.52022204599524
2020-09-13,1038,21,1005,20,33,1,1194,21,22289,244,23483,265,0,10,1,38,11,0,"Anderson",76978,97.4304346696459,0.0517711171662125,344.254202499415,27.2805217075008,5.17711171662125
2020-09-14,1044,6,1010,5,34,1,1200,6,22395,106,23595,112,0,10,1,39,11,0,"Anderson",76978,101.327652056432,0.0517821116341627,145.496115773338,7.79443477357167,5.17821116341627
2020-09-15,1060,16,1026,16,34,0,1217,17,22635,240,23852,257,1,11,1,40,12,1,"Anderson",76978,110.421159292265,0.0575079872204473,333.86162280132,20.7851593961911,5.75079872204473
2020-09-16,1068,8,1034,8,34,0,1229,12,22771,136,24000,148,0,11,0,40,12,0,"Anderson",76978,109.122086830003,0.063568010936432,192.262724414768,10.3925796980956,6.3568010936432
2020-09-17,1090,22,1054,20,36,2,1249,20,23192,421,24441,441,0,11,1,41,12,0,"Anderson",76978,100.02857959417,0.0551495016611296,572.890955857518,28.5795941697628,5.51495016611296
2020-09-18,1109,19,1073,19,36,0,1267,18,23416,224,24683,242,0,11,0,41,12,0,"Anderson",76978,123.411883914885,0.0614143920595533,314.375535867391,24.682376782977,6.14143920595533
2020-09-19,1124,15,1088,15,36,0,1288,21,23698,282,24986,303,0,11,1,42,12,0,"Anderson",76978,139.000753462028,0.0650452488687783,393.618956065369,19.4860869339292,6.50452488687783
2020-09-20,1131,7,1095,7,36,0,1298,10,23850,152,25148,162,0,11,0,42,13,1,"Anderson",76978,120.813738990361,0.0624624624624625,210.449738886435,9.09350723583361,6.24624624624625
2020-09-21,1133,2,1097,2,36,0,1300,2,23883,33,25183,35,0,11,0,42,13,0,"Anderson",76978,115.617449141313,0.0629722921914358,45.4675361791681,2.59814492452389,6.29722921914358
2020-09-22,1147,14,1111,14,36,0,1317,17,24131,248,25448,265,0,11,1,43,13,0,"Anderson",76978,113.019304216789,0.06265664160401,344.254202499415,18.1870144716672,6.265664160401
2020-09-23,1147,0,1111,0,36,0,1317,0,24172,41,25489,41,0,11,0,43,13,0,"Anderson",76978,102.626724518694,0.0591000671591672,53.2619709527397,0,5.91000671591672
2020-09-24,1160,13,1124,13,36,0,1332,15,24496,324,25828,339,1,12,0,43,13,0,"Anderson",76978,90.9350723583361,0.0598413842826244,440.385564706799,16.8879420094053,5.98413842826244
2020-09-25,1174,14,1137,13,37,1,1345,13,24732,236,26077,249,1,13,0,43,13,0,"Anderson",76978,84.4397100470264,0.0559540889526542,323.469043103224,18.1870144716672,5.59540889526542
2020-09-26,1188,14,1151,14,37,0,1362,17,25031,299,26393,316,0,13,0,43,13,0,"Anderson",76978,83.1406375847645,0.0525941719971571,410.506898074775,18.1870144716672,5.25941719971571
2020-09-27,1207,19,1168,17,39,2,1378,16,25238,207,26616,223,0,13,0,43,13,0,"Anderson",76978,98.7295071319078,0.0544959128065395,289.693159084414,24.682376782977,5.44959128065395
2020-09-28,1210,3,1170,2,40,1,1380,2,25275,37,26655,39,0,13,0,43,13,0,"Anderson",76978,100.02857959417,0.0543478260869565,50.6638260282159,3.89721738678583,5.43478260869565
2020-09-29,1221,11,1180,10,41,1,1390,10,25569,294,26959,304,0,13,0,43,13,0,"Anderson",76978,96.1313622073839,0.0483123759099934,394.918028527631,14.2897970848814,4.83123759099934
2020-09-30,1233,12,1190,10,43,2,1400,10,25635,66,27035,76,0,13,0,43,13,0,"Anderson",76978,111.720231754527,0.0536869340232859,98.7295071319078,15.5888695471433,5.36869340232859
2020-10-01,1249,16,1204,14,45,2,1415,15,25915,280,27330,295,0,13,0,43,13,0,"Anderson",76978,115.617449141313,0.0552596537949401,383.226376367274,20.7851593961911,5.52596537949401
2020-10-02,1256,7,1210,6,46,1,1422,7,25997,82,27419,89,0,13,0,43,13,0,"Anderson",76978,106.523941905479,0.0573770491803279,115.617449141313,9.09350723583361,5.73770491803279
2020-10-03,1272,16,1226,16,46,0,1446,24,26261,264,27707,288,0,13,0,43,13,0,"Anderson",76978,109.122086830003,0.0639269406392694,374.13286913144,20.7851593961911,6.39269406392694
2020-10-04,1288,16,1240,14,48,2,1462,16,26598,337,28060,353,0,13,0,43,13,0,"Anderson",76978,105.224869443218,0.0581717451523546,458.572579178467,20.7851593961911,5.81717451523546
2020-10-05,1314,26,1265,25,49,1,1489,27,26809,211,28298,238,0,13,1,44,13,0,"Anderson",76978,135.103536075242,0.0663420572124163,309.179246018343,33.7758840188106,6.63420572124163
2020-10-06,1342,28,1292,27,50,1,1520,31,27146,337,28666,368,0,13,1,45,13,0,"Anderson",76978,157.187767933695,0.0761570005858231,478.058666112396,36.3740289433345,7.61570005858231
2020-10-07,1348,6,1298,6,50,0,1528,8,27381,235,28909,243,0,13,0,45,13,0,"Anderson",76978,149.393333160124,0.0683030949839915,315.674608329653,7.79443477357167,6.83030949839915
2020-10-08,1358,10,1306,8,52,2,1537,9,27620,239,29157,248,0,13,1,46,13,0,"Anderson",76978,141.598898386552,0.066776135741653,322.169970640962,12.9907246226195,6.6776135741653
2020-10-09,1373,15,1319,13,54,2,1553,16,27793,173,29346,189,0,13,0,46,13,0,"Anderson",76978,151.991478084648,0.0679813181110535,245.524695367508,19.4860869339292,6.79813181110535
2020-10-10,1389,16,1335,16,54,0,1573,20,28005,212,29578,232,0,13,1,47,14,1,"Anderson",76978,151.991478084648,0.0678781400320684,301.384811244771,20.7851593961911,6.78781400320684
2020-10-11,1417,28,1363,28,54,0,1604,31,28294,289,29898,320,0,13,0,47,14,0,"Anderson",76978,167.580347631791,0.0772578890097933,415.703187923822,36.3740289433345,7.72578890097933
2020-10-12,1433,16,1378,15,55,1,1620,16,28373,79,29993,95,0,13,0,47,14,0,"Anderson",76978,154.589623009171,0.0772861356932153,123.411883914885,20.7851593961911,7.72861356932153
2020-10-13,1453,20,1396,18,57,2,1638,18,28494,121,30132,139,0,13,0,47,14,0,"Anderson",76978,144.197043311076,0.0804911323328786,180.57107225441,25.9814492452389,8.04911323328786
2020-10-14,1475,22,1418,22,57,0,1662,24,28794,300,30456,324,0,13,0,47,14,0,"Anderson",76978,164.982202707267,0.0866192630898513,420.89947777287,28.5795941697628,8.66192630898513
2020-10-15,1497,22,1434,16,63,6,1676,14,28945,151,30621,165,0,13,1,48,14,0,"Anderson",76978,180.57107225441,0.0949453551912568,214.346956273221,28.5795941697628,9.49453551912568
2020-10-16,1504,7,1437,3,67,4,1680,4,29044,99,30724,103,0,13,0,48,15,1,"Anderson",76978,170.178492556315,0.0921625544267054,133.80446361298,9.09350723583361,9.21625544267054
2020-10-17,1532,28,1464,27,68,1,1710,30,29292,248,31002,278,0,13,2,50,15,0,"Anderson",76978,185.767362103458,0.0962078651685393,361.142144508821,36.3740289433345,9.62078651685393
2020-10-18,1551,19,1483,19,68,0,1732,22,29531,239,31263,261,0,13,0,50,15,0,"Anderson",76978,174.075709943101,0.0937728937728938,339.057912650368,24.682376782977,9.37728937728938
2020-10-19,1555,4,1487,4,68,0,1737,5,29608,77,31345,82,0,13,1,51,15,0,"Anderson",76978,158.486840395957,0.0865384615384615,106.523941905479,5.19628984904778,8.65384615384615
2020-10-20,1582,27,1514,27,68,0,1772,35,29807,199,31579,234,0,13,0,51,15,0,"Anderson",76978,167.580347631791,0.092605390463027,303.982956169295,35.0749564810725,9.2605390463027
2020-10-21,1599,17,1531,17,68,0,1791,19,30023,216,31814,235,0,13,1,52,15,0,"Anderson",76978,161.084985320481,0.0949926362297496,305.282028631557,22.0842318584531,9.49926362297496
2020-10-22,1620,21,1552,21,68,0,1816,25,30355,332,32171,357,1,14,0,52,15,0,"Anderson",76978,159.785912858219,0.0903225806451613,463.768869027514,27.2805217075008,9.03225806451613
2020-10-23,1635,15,1566,14,69,1,1832,16,30630,275,32462,291,0,14,0,52,15,0,"Anderson",76978,170.178492556315,0.0874568469505178,378.030086518226,19.4860869339292,8.74568469505178
2020-10-24,1666,31,1596,30,70,1,1865,33,31006,376,32871,409,0,14,2,54,17,2,"Anderson",76978,174.075709943101,0.082932049224184,531.320637065136,40.2712463301203,8.29320492241841
2020-10-25,1683,17,1612,16,71,1,1884,19,31202,196,33086,215,0,14,4,58,17,0,"Anderson",76978,171.477565018577,0.0833790455293472,279.300579386318,22.0842318584531,8.33790455293472
2020-10-26,1699,16,1627,15,72,1,1902,18,31336,134,33238,152,-1,13,1,59,17,0,"Anderson",76978,187.06643456572,0.0871632329635499,197.459014263816,20.7851593961911,8.71632329635499
2020-10-27,1728,29,1651,24,77,5,1926,24,31491,155,33417,179,1,14,2,61,17,0,"Anderson",76978,189.664579490244,0.0837867247007617,232.533970744888,37.6731014055964,8.37867247007617
2020-10-28,1784,56,1705,54,79,2,1985,59,31925,434,33910,493,0,14,0,61,17,0,"Anderson",76978,240.32840551846,0.092557251908397,640.442723895139,72.7480578866689,9.25572519083969
2020-10-29,1813,29,1726,21,87,8,2004,19,32131,206,34135,225,0,14,2,63,17,0,"Anderson",76978,250.720985216555,0.0957230142566191,292.291304008938,37.6731014055964,9.57230142566191
2020-10-30,1850,37,1760,34,90,3,2042,38,32282,151,34324,189,2,16,1,64,17,0,"Anderson",76978,279.300579386318,0.112781954887218,245.524695367508,48.065681103692,11.2781954887218
2020-10-31,1850,0,1760,0,90,0,2042,0,32283,1,34325,1,0,16,0,64,19,2,"Anderson",76978,239.029333056198,0.121733149931224,1.29907246226194,0,12.1733149931224
2020-11-01,1855,5,1765,5,90,0,2050,8,32527,244,34577,252,0,16,0,64,19,0,"Anderson",76978,223.440463509055,0.111334674714956,327.36626049001,6.49536231130973,11.1334674714956
2020-11-02,1888,33,1796,31,92,2,2085,35,32794,267,34879,302,0,16,0,64,20,1,"Anderson",76978,245.524695367508,0.111517367458867,392.319883603107,42.8693912546442,11.1517367458867
2020-11-03,1914,26,1821,25,93,1,2110,25,32974,180,35084,205,0,16,0,64,21,1,"Anderson",76978,241.627477980722,0.110377924415117,266.309854763699,33.7758840188106,11.0377924415117
2020-11-04,1932,18,1836,15,96,3,2128,18,33052,78,35180,96,2,18,1,65,21,0,"Anderson",76978,192.262724414768,0.11259842519685,124.710956377147,23.383304320715,11.259842519685
2020-11-05,1956,24,1854,18,102,6,2148,20,33151,99,35299,119,0,18,0,65,22,1,"Anderson",76978,185.767362103458,0.123711340206186,154.589623009171,31.1777390942867,12.3711340206186
2020-11-06,2005,49,1900,46,105,3,2197,49,33518,367,35715,416,0,18,2,67,23,1,"Anderson",76978,201.356231650601,0.111430625449317,540.414144300969,63.6545506508353,11.1430625449317
2020-11-07,2085,80,1977,77,108,3,2274,77,33965,447,36239,524,0,18,0,67,23,0,"Anderson",76978,305.282028631557,0.121212121212121,680.713970225259,103.925796980956,12.1212121212121
2020-11-08,2139,54,2028,51,111,3,2336,62,34575,610,36911,672,0,18,1,68,23,0,"Anderson",76978,368.936579282392,0.122536418166238,872.976694640027,70.149912962145,12.2536418166238
2020-11-09,2147,8,2035,7,112,1,2345,9,34649,74,36994,83,0,18,0,68,23,0,"Anderson",76978,336.459767725844,0.122931442080378,107.823014367741,10.3925796980956,12.2931442080378
2020-11-10,2166,19,2053,18,113,1,2367,22,34820,171,37187,193,0,18,1,69,23,0,"Anderson",76978,327.36626049001,0.122206371849738,250.720985216555,24.682376782977,12.2206371849738
2020-11-11,2205,39,2089,36,116,3,2409,42,35093,273,37502,315,1,19,1,70,23,0,"Anderson",76978,354.646782197511,0.121016365202412,409.207825612513,50.6638260282159,12.1016365202412
2020-11-12,2212,7,2095,6,117,1,2417,8,35291,198,37708,206,0,19,0,70,24,1,"Anderson",76978,332.562550339058,0.111664591116646,267.608927225961,9.09350723583361,11.1664591116646
2020-11-13,2268,56,2148,53,120,3,2476,59,35552,261,38028,320,2,21,2,72,24,0,"Anderson",76978,341.656057574892,0.120622568093385,415.703187923822,72.7480578866689,12.0622568093385
2020-11-14,2309,41,2188,40,121,1,2521,45,35948,396,38469,441,1,22,1,73,25,1,"Anderson",76978,290.992231546676,0.110762331838565,572.890955857518,53.2619709527397,11.0762331838565
2020-11-15,2407,98,2286,98,121,0,2629,108,36530,582,39159,690,1,23,1,74,25,0,"Anderson",76978,348.151419886201,0.130338078291815,896.359998960742,127.309101301671,13.0338078291815
2020-11-16,2456,49,2315,29,141,20,2658,29,36807,277,39465,306,0,23,1,75,25,0,"Anderson",76978,401.413390838941,0.126669364629705,397.516173452155,63.6545506508353,12.6669364629705
2020-11-17,2472,16,2330,15,142,1,2674,16,37012,205,39686,221,2,25,1,76,26,1,"Anderson",76978,397.516173452155,0.122849139655862,287.09501415989,20.7851593961911,12.2849139655862
2020-11-18,2502,30,2356,26,146,4,2700,26,37306,294,40006,320,0,25,0,76,27,1,"Anderson",76978,385.824521291798,0.116214057507987,415.703187923822,38.9721738678584,11.6214057507987
2020-11-19,2560,58,2410,54,150,4,2762,62,37722,416,40484,478,0,25,1,77,27,0,"Anderson",76978,452.077216867157,0.124279538904899,620.95663696121,75.3462028111928,12.4279538904899
2020-11-20,2590,30,2437,27,153,3,2793,31,37835,113,40628,144,0,25,0,77,28,1,"Anderson",76978,418.301332848346,0.121923076923077,187.06643456572,38.9721738678584,12.1923076923077
2020-11-21,2647,57,2486,49,161,8,2841,48,38179,344,41020,392,0,25,1,78,28,0,"Anderson",76978,439.086492244537,0.125441003528028,509.236405206682,74.0471303489309,12.5441003528028
2020-11-22,2703,56,2535,49,168,7,2898,57,38662,483,41560,540,0,25,1,79,31,3,"Anderson",76978,384.525448829536,0.112036651395252,701.49912962145,72.7480578866689,11.2036651395252
2020-11-23,2710,7,2541,6,169,1,2904,6,38684,22,41588,28,0,25,0,79,32,1,"Anderson",76978,329.964405414534,0.115873763542157,36.3740289433345,9.09350723583361,11.5873763542157
2020-11-24,2723,13,2553,12,170,1,2916,12,38841,157,41757,169,2,27,0,79,32,0,"Anderson",76978,326.067188027748,0.116851762433607,219.543246122269,16.8879420094053,11.6851762433607
2020-11-25,2751,28,2574,21,177,7,2937,21,38878,37,41815,58,1,28,0,79,32,0,"Anderson",76978,323.469043103224,0.131011608623549,75.3462028111928,36.3740289433345,13.1011608623549
2020-11-26,2796,45,2616,42,180,3,2982,45,39228,350,42210,395,0,28,1,80,33,1,"Anderson",76978,306.581101093819,0.127462340672074,513.133622593468,58.4582608017875,12.7462340672074
2020-11-27,2895,99,2706,90,189,9,3077,95,39654,426,42731,521,0,28,3,83,35,2,"Anderson",76978,396.217100989893,0.135045173561579,676.816752838473,128.608173763933,13.5045173561579
2020-11-28,2926,31,2731,25,195,6,3107,30,39797,143,42904,173,1,29,2,85,35,0,"Anderson",76978,362.441216971083,0.141188959660297,224.739535971316,40.2712463301203,14.1188959660297
2020-11-29,3017,91,2820,89,197,2,3203,96,40234,437,43437,533,0,29,1,86,35,0,"Anderson",76978,407.908753150251,0.162493340436867,692.405622385617,118.215594065837,16.2493340436867
2020-11-30,3087,70,2886,66,201,4,3276,73,40486,252,43762,325,0,29,0,86,37,2,"Anderson",76978,489.750318272753,0.171113155473781,422.198550235132,90.9350723583361,17.1113155473781
2020-12-01,3163,76,2952,66,211,10,3348,72,40916,430,44264,502,1,30,6,92,38,1,"Anderson",76978,571.591883395256,0.172317510969286,652.134376055496,98.7295071319078,17.2317510969286
2020-12-02,3178,15,2966,14,212,1,3364,16,41024,108,44388,124,0,30,0,92,38,0,"Anderson",76978,554.70394138585,0.165954139137194,161.084985320481,19.4860869339292,16.5954139137194
2020-12-03,3219,41,2995,29,224,12,3397,33,41249,225,44646,258,1,31,1,93,39,1,"Anderson",76978,549.507651536803,0.170361247947455,335.160695263582,53.2619709527397,17.0361247947455
2020-12-04,3286,67,3055,60,231,7,3460,63,41407,158,44867,221,1,32,0,93,39,0,"Anderson",76978,507.93733274442,0.179307116104869,287.09501415989,87.0378549715503,17.9307116104869
2020-12-05,3317,31,3074,19,243,12,3478,18,41474,67,44952,85,0,32,0,93,39,0,"Anderson",76978,507.93733274442,0.18115234375,110.421159292265,40.2712463301203,18.115234375
2020-12-06,3353,36,3103,29,250,7,3506,28,41682,208,45188,236,0,32,2,95,40,1,"Anderson",76978,436.488347320014,0.173043974871502,306.581101093819,46.76660864143,17.3043974871502
2020-12-07,3493,140,3227,124,266,16,3642,136,42275,593,45917,729,2,34,4,99,41,1,"Anderson",76978,527.42341967835,0.169837587006961,947.023824988958,181.870144716672,16.9837587006961
2020-12-08,3564,71,3276,49,288,22,3694,52,42573,298,46267,350,1,35,2,101,43,2,"Anderson",76978,520.92805736704,0.172740888667,454.675361791681,92.2341448205981,17.2740888666999
2020-12-09,3669,105,3367,91,302,14,3798,104,42834,261,46632,365,0,35,3,104,44,1,"Anderson",76978,637.844578970615,0.193404634581105,474.16144872561,136.402608537504,19.3404634581105
2020-12-10,3763,94,3445,78,318,16,3885,87,43365,531,47250,618,3,38,3,107,45,1,"Anderson",76978,706.695419470498,0.187403993855607,802.826781677882,122.112811452623,18.7403993855607
2020-12-11,3836,73,3498,53,338,20,3936,51,43531,166,47467,217,1,39,2,109,45,0,"Anderson",76978,714.48985424407,0.183076923076923,281.898724310842,94.832289745122,18.3076923076923
2020-12-12,3924,88,3559,61,365,27,4001,65,44044,513,48045,578,0,39,2,111,45,0,"Anderson",76978,788.536984593001,0.169091496928548,750.863883187404,114.318376679051,16.9091496928548
2020-12-13,4156,232,3742,183,414,49,4205,204,44916,872,49121,1076,1,40,0,111,47,2,"Anderson",76978,1043.15518719634,0.177726926010679,1397.80196939385,301.384811244771,17.7726926010679
2020-12-14,4271,115,3828,86,443,29,4304,99,45206,290,49510,389,0,40,1,112,48,1,"Anderson",76978,1010.67837563979,0.184247147230726,505.339187819897,149.393333160124,18.4247147230726
2020-12-15,4406,135,3913,85,493,50,4400,96,45733,527,50133,623,1,41,6,118,51,3,"Anderson",76978,1093.81901322456,0.182617692705639,809.322143989192,175.374782405363,18.2617692705639
2020-12-16,4475,69,3943,30,532,39,4436,36,46056,323,50492,359,2,43,4,122,52,1,"Anderson",76978,1047.05240458313,0.165284974093264,466.367013952038,89.6359998960742,16.5284974093264
2020-12-17,4676,201,4117,174,559,27,4630,194,46584,528,51214,722,2,45,2,124,54,2,"Anderson",76978,1186.05315804516,0.187941473259334,937.930317753124,261.113564914651,18.7941473259334
2020-12-18,4774,98,4193,76,581,22,4717,87,46950,366,51667,453,1,46,2,126,54,0,"Anderson",76978,1218.5299696017,0.185952380952381,588.479825404661,127.309101301671,18.5952380952381
2020-12-19,4879,105,4274,81,605,24,4804,87,47208,258,52012,345,0,46,1,127,55,1,"Anderson",76978,1240.61420146016,0.202419964708848,448.179999480371,136.402608537504,20.2419964708848
2020-12-20,5019,140,4396,122,623,18,4941,137,47672,464,52613,601,2,48,3,130,56,1,"Anderson",76978,1121.09953493206,0.210767468499427,780.742549819429,181.870144716672,21.0767468499427
2020-12-21,5066,47,4414,18,652,29,4964,23,47892,220,52856,243,3,51,2,132,59,3,"Anderson",76978,1032.76260749825,0.197250448296473,315.674608329653,61.0564057263114,19.7250448296473
2020-12-22,5136,70,4458,44,678,26,5011,47,47998,106,53009,153,1,52,2,134,64,5,"Anderson",76978,948.32289745122,0.212447844228095,198.758086726078,90.9350723583361,21.2447844228095
2020-12-23,5210,74,4500,42,710,32,5054,43,48314,316,53368,359,2,54,2,136,66,2,"Anderson",76978,954.81825976253,0.214881780250348,466.367013952038,96.1313622073839,21.4881780250348
2020-12-24,5268,58,4524,24,744,34,5081,27,48466,152,53547,179,1,55,1,137,71,5,"Anderson",76978,769.050897659071,0.193313330475782,232.533970744888,75.3462028111928,19.3313330475782
2020-12-25,5361,93,4601,77,760,16,5173,92,48875,409,54048,501,0,55,1,138,72,1,"Anderson",76978,762.555535347762,0.191516169676606,650.835303593234,120.813738990361,19.1516169676606
2020-12-26,5417,56,4630,29,787,27,5201,28,48994,119,54195,147,0,55,3,141,74,2,"Anderson",76978,698.900984696926,0.181859825927623,190.963651952506,72.7480578866689,18.1859825927623
2020-12-27,5477,60,4667,37,810,23,5237,36,49130,136,54367,172,1,56,6,147,75,1,"Anderson",76978,594.975187715971,0.168757126567845,223.440463509055,77.9443477357167,16.8757126567845
2020-12-28,5524,47,4688,21,836,26,5257,20,49199,69,54456,89,2,58,4,151,82,7,"Anderson",76978,594.975187715971,0.183125,115.617449141313,61.0564057263114,18.3125
2020-12-29,5620,96,4740,52,880,44,5305,48,49294,95,54599,143,2,60,5,156,85,3,"Anderson",76978,628.751071734781,0.184905660377358,185.767362103458,124.710956377147,18.4905660377358
2020-12-30,5655,35,4758,18,897,17,5322,17,49422,128,54744,145,6,66,1,157,88,3,"Anderson",76978,578.087245706566,0.194767441860465,188.365507027982,45.4675361791681,19.4767441860465
2020-12-31,5818,163,4858,100,960,63,5424,102,49726,304,55150,406,6,72,1,158,93,5,"Anderson",76978,714.48985424407,0.213973799126638,527.42341967835,211.748811348697,21.3973799126638
2021-01-01,5883,65,4900,42,983,23,5479,55,49953,227,55432,282,0,72,2,160,94,1,"Anderson",76978,678.115825300735,0.221098265895954,366.338434357868,84.4397100470264,22.1098265895954
2021-01-02,5976,93,4941,41,1035,52,5521,42,50114,161,55635,203,0,72,2,162,96,2,"Anderson",76978,726.181506404427,0.222222222222222,263.711709839175,120.813738990361,22.2222222222222
2021-01-03,6001,25,4953,12,1048,13,5537,16,50152,38,55689,54,0,72,1,163,99,3,"Anderson",76978,680.713970225259,0.226928895612708,70.149912962145,32.4768115565486,22.6928895612708
2021-01-04,6038,37,4977,24,1061,13,5568,31,50226,74,55794,105,1,73,0,163,104,5,"Anderson",76978,667.72324560264,0.232436472346786,136.402608537504,48.065681103692,23.2436472346786
2021-01-05,6110,72,5008,31,1102,41,5599,31,50323,97,55922,128,2,75,2,165,107,3,"Anderson",76978,636.545506508353,0.222222222222222,166.281275169529,93.53321728286,22.2222222222222
2021-01-06,6185,75,5049,41,1136,34,5643,44,50441,118,56084,162,5,80,2,167,109,2,"Anderson",76978,688.508404998831,0.23955223880597,210.449738886435,97.4304346696459,23.955223880597
2021-01-07,6290,105,5129,80,1161,25,5735,92,50607,166,56342,258,1,81,1,168,112,3,"Anderson",76978,613.162202187638,0.260906040268456,335.160695263582,136.402608537504,26.0906040268456
2021-01-08,6373,83,5180,51,1193,32,5787,52,50711,104,56498,156,5,86,2,170,115,3,"Anderson",76978,636.545506508353,0.288930581613508,202.655304112863,107.823014367741,28.8930581613508
2021-01-09,6483,110,5249,69,1234,41,5863,76,51031,320,56894,396,2,88,0,170,117,2,"Anderson",76978,658.629738366806,0.27164416203336,514.43269505573,142.897970848814,27.164416203336
2021-01-10,6543,60,5274,25,1269,35,5888,25,51088,57,56976,82,2,90,3,173,118,1,"Anderson",76978,704.097274545974,0.272727272727273,106.523941905479,77.9443477357167,27.2727272727273
2021-01-11,6576,33,5284,10,1292,23,5901,13,51142,54,57043,67,1,91,1,174,120,2,"Anderson",76978,698.900984696926,0.266613290632506,87.0378549715503,42.8693912546442,26.6613290632506
2021-01-12,6629,53,5318,34,1311,19,5939,38,51267,125,57206,163,2,93,1,175,120,0,"Anderson",76978,674.218607913949,0.264797507788162,211.748811348697,68.8508404998831,26.4797507788162
2021-01-13,6655,26,5335,17,1320,9,5958,19,51330,63,57288,82,3,96,0,175,121,1,"Anderson",76978,610.564057263114,0.261627906976744,106.523941905479,33.7758840188106,26.1627906976744
2021-01-14,6752,97,5397,62,1355,35,6032,74,51611,281,57643,355,5,101,2,177,123,2,"Anderson",76978,600.171477565019,0.228285933897002,461.17072410299,126.010028839409,22.8285933897002
2021-01-15,6786,34,5417,20,1369,14,6056,24,51731,120,57787,144,0,101,1,178,126,3,"Anderson",76978,536.516926914183,0.208688906128782,187.06643456572,44.1684637169061,20.8688906128782
2021-01-16,6851,65,5448,31,1403,34,6090,34,51888,157,57978,191,1,102,1,179,129,3,"Anderson",76978,478.058666112396,0.209409594095941,248.122840292031,84.4397100470264,20.9409594095941
2021-01-17,6888,37,5468,20,1420,17,6113,23,51971,83,58084,106,0,102,0,179,131,2,"Anderson",76978,448.179999480371,0.203068592057762,137.701680999766,48.065681103692,20.3068592057762
2021-01-18,6907,19,5476,8,1431,11,6123,10,52047,76,58170,86,1,103,0,179,132,1,"Anderson",76978,429.992985008704,0.19698314108252,111.720231754527,24.682376782977,19.698314108252
2021-01-19,6949,42,5493,17,1456,25,6143,20,52131,84,58274,104,1,104,0,179,134,2,"Anderson",76978,415.703187923822,0.191011235955056,135.103536075242,54.5610434150017,19.1011235955056
2021-01-20,6977,28,5509,16,1468,12,6162,19,52248,117,58410,136,3,107,0,179,137,3,"Anderson",76978,418.301332848346,0.181818181818182,176.673854867625,36.3740289433345,18.1818181818182
2021-01-21,7033,56,5549,40,1484,16,6201,39,52432,184,58633,223,5,112,2,181,138,1,"Anderson",76978,365.039361895607,0.170707070707071,289.693159084414,72.7480578866689,17.0707070707071
2021-01-22,7071,38,5567,18,1504,20,6223,22,52534,102,58757,124,2,114,0,181,141,3,"Anderson",76978,370.235651744654,0.172164948453608,161.084985320481,49.3647535659539,17.2164948453608
2021-01-23,7109,38,5581,14,1528,24,6236,13,52709,175,58945,188,0,114,1,182,141,0,"Anderson",76978,335.160695263582,0.150982419855222,244.225622905246,49.3647535659539,15.0982419855222
2021-01-24,7122,13,5593,12,1529,1,6250,14,52763,54,59013,68,0,114,0,182,143,2,"Anderson",76978,303.982956169295,0.147470398277718,88.3369274338123,16.8879420094053,14.7470398277718
2021-01-25,7139,17,5604,11,1535,6,6261,11,52813,50,59074,61,2,116,1,183,145,2,"Anderson",76978,301.384811244771,0.152654867256637,79.2434201979787,22.0842318584531,15.2654867256637
2021-01-26,7166,27,5625,21,1541,6,6286,25,52938,125,59224,150,0,116,1,184,148,3,"Anderson",76978,281.898724310842,0.150526315789474,194.860869339292,35.0749564810725,15.0526315789474
2021-01-27,7183,17,5633,8,1550,9,6295,9,52999,61,59294,70,4,120,0,184,150,2,"Anderson",76978,267.608927225961,0.150452488687783,90.9350723583361,22.0842318584531,15.0452488687783
2021-01-28,7270,87,5673,40,1597,47,6342,47,53147,148,59489,195,4,124,0,184,151,1,"Anderson",76978,307.880173556081,0.164719626168224,253.319130141079,113.019304216789,16.4719626168224
2021-01-29,7283,13,5677,4,1606,9,6347,5,53182,35,59529,40,1,125,1,185,151,0,"Anderson",76978,275.403361999532,0.160621761658031,51.9628984904778,16.8879420094053,16.0621761658031
2021-01-30,7323,40,5712,35,1611,5,6383,36,53392,210,59775,246,2,127,2,187,152,1,"Anderson",76978,278.001506924056,0.17710843373494,319.571825716438,51.9628984904778,17.710843373494
2021-01-31,7339,16,5719,7,1620,9,6394,11,53508,116,59902,127,1,128,0,187,154,2,"Anderson",76978,281.898724310842,0.161979752530934,164.982202707267,20.7851593961911,16.1979752530934
2021-02-01,7359,20,5732,13,1627,7,6407,13,53552,44,59959,57,1,129,1,188,156,2,"Anderson",76978,285.795941697628,0.164971751412429,74.0471303489309,25.9814492452389,16.4971751412429
2021-02-02,7366,7,5738,6,1628,1,6412,5,53602,50,60014,55,5,134,0,188,157,1,"Anderson",76978,259.814492452389,0.159493670886076,71.448985424407,9.09350723583361,15.9493670886076
2021-02-03,7388,22,5744,6,1644,16,6422,10,53730,128,60152,138,4,138,0,188,158,1,"Anderson",76978,266.309854763699,0.148018648018648,179.271999792148,28.5795941697628,14.8018648018648
2021-02-04,7419,31,5759,15,1660,16,6439,17,53967,237,60406,254,2,140,0,188,158,0,"Anderson",76978,193.56179687703,0.105779716466739,329.964405414534,40.2712463301203,10.5779716466739
2021-02-05,7437,18,5770,11,1667,7,6456,17,54079,112,60535,129,2,142,0,188,159,1,"Anderson",76978,200.05715918834,0.108349900596421,167.580347631791,23.383304320715,10.8349900596421
2021-02-06,7464,27,5786,16,1678,11,6476,20,54235,156,60711,176,1,143,1,189,159,0,"Anderson",76978,183.169217178934,0.0993589743589744,228.636753358102,35.0749564810725,9.93589743589744
2021-02-07,7477,13,5793,7,1684,6,6484,8,54317,82,60801,90,0,143,0,189,159,0,"Anderson",76978,179.271999792148,0.100111234705228,116.916521603575,16.8879420094053,10.0111234705228
2021-02-08,7502,25,5799,6,1703,19,6489,5,54333,16,60822,21,2,145,0,189,159,0,"Anderson",76978,185.767362103458,0.0950173812282735,27.2805217075008,32.4768115565486,9.50173812282735
2021-02-09,7526,24,5809,10,1717,14,6500,11,54462,129,60962,140,2,147,2,191,159,0,"Anderson",76978,207.851593961911,0.0928270042194093,181.870144716672,31.1777390942867,9.28270042194093
2021-02-10,7551,25,5824,15,1727,10,6519,19,54590,128,61109,147,1,148,1,192,159,0,"Anderson",76978,211.748811348697,0.101358411703239,190.963651952506,32.4768115565486,10.1358411703239
2021-02-11,7564,13,5832,8,1732,5,6530,11,54734,144,61264,155,-1,147,0,192,160,1,"Anderson",76978,188.365507027982,0.106060606060606,201.356231650601,16.8879420094053,10.6060606060606
2021-02-12,7591,27,5847,15,1744,12,6545,15,54873,139,61418,154,0,147,0,192,160,0,"Anderson",76978,200.05715918834,0.10079275198188,200.05715918834,35.0749564810725,10.079275198188
2021-02-13,7618,27,5858,11,1760,16,6555,10,54989,116,61544,126,0,147,0,192,160,0,"Anderson",76978,200.05715918834,0.0948379351740696,163.683130245005,35.0749564810725,9.48379351740696
2021-02-14,7631,13,5867,9,1764,4,6566,11,55034,45,61600,56,2,149,0,192,160,0,"Anderson",76978,200.05715918834,0.102628285356696,72.7480578866689,16.8879420094053,10.2628285356696
2021-02-15,7648,17,5875,8,1773,9,6575,9,55093,59,61668,68,0,149,1,193,161,1,"Anderson",76978,189.664579490244,0.101654846335697,88.3369274338123,22.0842318584531,10.1654846335697
2021-02-16,7677,29,5889,14,1788,15,6592,17,55157,64,61749,81,0,149,0,193,161,0,"Anderson",76978,196.159941801554,0.116899618805591,105.224869443218,37.6731014055964,11.6899618805591
2021-02-17,7696,19,5901,12,1795,7,6604,12,55238,81,61842,93,0,149,0,193,163,2,"Anderson",76978,188.365507027982,0.115961800818554,120.813738990361,24.682376782977,11.5961800818554
2021-02-18,7720,24,5923,22,1797,2,6630,26,55346,108,61976,134,0,149,0,193,163,0,"Anderson",76978,202.655304112863,0.140449438202247,174.075709943101,31.1777390942867,14.0449438202247
2021-02-19,7733,13,5934,11,1799,2,6645,15,55379,33,62024,48,0,149,0,193,164,1,"Anderson",76978,184.468289641196,0.165016501650165,62.3554781885734,16.8879420094053,16.5016501650165
2021-02-20,7752,19,5941,7,1811,12,6654,9,55472,93,62126,102,1,150,0,193,165,1,"Anderson",76978,174.075709943101,0.170103092783505,132.505391150718,24.682376782977,17.0103092783505
2021-02-21,7764,12,5948,7,1816,5,6661,7,55519,47,62180,54,2,152,1,194,165,0,"Anderson",76978,172.776637480839,0.163793103448276,70.149912962145,15.5888695471433,16.3793103448276
2021-02-22,7769,5,5950,2,1819,3,6667,6,55542,23,62209,29,1,153,0,194,166,1,"Anderson",76978,157.187767933695,0.170055452865065,37.6731014055964,6.49536231130973,17.0055452865065
2021-02-23,7793,24,5959,9,1834,15,6675,8,55644,102,62319,110,2,155,0,194,168,2,"Anderson",76978,150.692405622386,0.145614035087719,142.897970848814,31.1777390942867,14.5614035087719
2021-02-24,7825,32,5978,19,1847,13,6698,23,55771,127,62469,150,0,155,0,194,168,0,"Anderson",76978,167.580347631791,0.149920255183413,194.860869339292,41.5703187923822,14.9920255183413
2021-02-25,7842,17,5986,8,1856,9,6709,11,55867,96,62576,107,1,156,0,194,168,0,"Anderson",76978,158.486840395957,0.131666666666667,139.000753462028,22.0842318584531,13.1666666666667
2021-02-26,7854,12,5994,8,1860,4,6718,9,55941,74,62659,83,0,156,0,194,168,0,"Anderson",76978,157.187767933695,0.11496062992126,107.823014367741,15.5888695471433,11.496062992126
2021-02-27,7863,9,6001,7,1862,2,6724,6,56009,68,62733,74,0,156,0,194,168,0,"Anderson",76978,144.197043311076,0.115321252059308,96.1313622073839,11.6916521603575,11.5321252059308
2021-02-28,7877,14,6011,10,1866,4,6735,11,56064,55,62799,66,0,156,0,194,168,0,"Anderson",76978,146.7951882356,0.119547657512116,85.7387825092884,18.1870144716672,11.9547657512116
2021-03-01,7885,8,6016,5,1869,3,6742,7,56095,31,62837,38,0,156,0,194,169,1,"Anderson",76978,150.692405622386,0.119426751592357,49.3647535659539,10.3925796980956,11.9426751592357
2021-03-02,7908,23,6027,11,1881,12,6752,10,56188,93,62940,103,1,157,1,195,169,0,"Anderson",76978,149.393333160124,0.123993558776167,133.80446361298,29.8786666320247,12.3993558776167
2021-03-03,7941,33,6048,21,1893,12,6777,25,56286,98,63063,123,1,158,0,195,170,1,"Anderson",76978,150.692405622386,0.132996632996633,159.785912858219,42.8693912546442,13.2996632996633
2021-03-04,7966,25,6061,13,1905,12,6794,17,56406,120,63200,137,0,158,0,195,170,0,"Anderson",76978,161.084985320481,0.136217948717949,177.972927329886,32.4768115565486,13.6217948717949
2021-03-05,7999,33,6078,17,1921,16,6816,22,56497,91,63313,113,0,158,2,197,170,0,"Anderson",76978,188.365507027982,0.149847094801223,146.7951882356,42.8693912546442,14.9847094801223
2021-03-06,8010,11,6083,5,1927,6,6824,8,56570,73,63394,81,0,158,0,197,170,0,"Anderson",76978,190.963651952506,0.151285930408472,105.224869443218,14.2897970848814,15.1285930408472
2021-03-07,8016,6,6086,3,1930,3,6827,3,56600,30,63427,33,0,158,0,197,170,0,"Anderson",76978,180.57107225441,0.146496815286624,42.8693912546442,7.79443477357167,14.6496815286624
2021-03-08,8032,16,6093,7,1939,9,6836,9,56657,57,63493,66,1,159,0,197,170,0,"Anderson",76978,190.963651952506,0.143292682926829,85.7387825092884,20.7851593961911,14.3292682926829
2021-03-09,8053,21,6101,8,1952,13,6844,8,56710,53,63554,61,0,159,3,200,171,1,"Anderson",76978,188.365507027982,0.149837133550489,79.2434201979787,27.2805217075008,14.9837133550489
2021-03-10,8075,22,6114,13,1961,9,6860,16,56837,127,63697,143,0,159,1,201,171,0,"Anderson",76978,174.075709943101,0.130914826498423,185.767362103458,28.5795941697628,13.0914826498423
2021-03-11,8098,23,6124,10,1974,13,6870,10,56905,68,63775,78,0,159,1,202,172,1,"Anderson",76978,171.477565018577,0.132173913043478,101.327652056432,29.8786666320247,13.2173913043478
2021-03-12,8118,20,6141,17,1977,3,6890,20,56988,83,63878,103,0,159,0,202,172,0,"Anderson",76978,154.589623009171,0.130973451327434,133.80446361298,25.9814492452389,13.0973451327434
2021-03-13,8129,11,6145,4,1984,7,6894,4,57038,50,63932,54,0,159,1,203,172,0,"Anderson",76978,154.589623009171,0.130111524163569,70.149912962145,14.2897970848814,13.0111524163569
2021-03-14,8135,6,6149,4,1986,2,6900,6,57068,30,63968,36,0,159,1,204,172,0,"Anderson",76978,154.589623009171,0.134935304990758,46.76660864143,7.79443477357167,13.4935304990758
2021-03-15,8154,19,6155,6,1999,13,6906,6,57096,28,64002,34,0,159,1,205,172,0,"Anderson",76978,158.486840395957,0.137524557956778,44.1684637169061,24.682376782977,13.7524557956778
2021-03-16,8187,33,6168,13,2019,20,6921,15,57175,79,64096,94,0,159,2,207,172,0,"Anderson",76978,174.075709943101,0.142066420664207,122.112811452623,42.8693912546442,14.2066420664207
2021-03-17,8205,18,6180,12,2025,6,6934,13,57246,71,64180,84,0,159,0,207,173,1,"Anderson",76978,168.879420094053,0.153209109730849,109.122086830003,23.383304320715,15.3209109730849
2021-03-18,8221,16,6192,12,2029,4,6949,15,57306,60,64255,75,1,160,0,207,173,0,"Anderson",76978,159.785912858219,0.164583333333333,97.4304346696459,20.7851593961911,16.4583333333333
2021-03-19,8245,24,6206,14,2039,10,6962,13,57394,88,64356,101,0,160,1,208,173,0,"Anderson",76978,164.982202707267,0.150627615062762,131.206318688456,31.1777390942867,15.0627615062762
2021-03-20,8257,12,6212,6,2045,6,6970,8,57420,26,64390,34,0,160,1,209,173,0,"Anderson",76978,166.281275169529,0.165938864628821,44.1684637169061,15.5888695471433,16.5938864628821
2021-03-21,8267,10,6218,6,2049,4,6977,7,57452,32,64429,39,-1,159,0,209,173,0,"Anderson",76978,171.477565018577,0.167028199566161,50.6638260282159,12.9907246226195,16.7028199566161
2021-03-22,8275,8,6219,1,2056,7,6978,1,57502,50,64480,51,0,159,1,210,173,0,"Anderson",76978,157.187767933695,0.150627615062762,66.2526955753592,10.3925796980956,15.0627615062762
2021-03-23,8281,6,6220,1,2061,5,6979,1,57532,30,64511,31,0,159,0,210,174,1,"Anderson",76978,122.112811452623,0.139759036144578,40.2712463301203,7.79443477357167,13.9759036144578
2021-03-24,8289,8,6227,7,2062,1,6986,7,57629,97,64615,104,1,160,0,210,174,0,"Anderson",76978,109.122086830003,0.119540229885057,135.103536075242,10.3925796980956,11.9540229885057
2021-03-25,8299,10,6232,5,2067,5,6992,6,57709,80,64701,86,0,160,0,210,174,0,"Anderson",76978,101.327652056432,0.0964125560538117,111.720231754527,12.9907246226195,9.64125560538117
2021-03-26,8316,17,6244,12,2072,5,7003,11,57765,56,64768,67,0,160,0,210,175,1,"Anderson",76978,92.2341448205981,0.0995145631067961,87.0378549715503,22.0842318584531,9.95145631067961
2021-03-27,8320,4,6248,4,2072,0,7009,6,57814,49,64823,55,1,161,2,212,175,0,"Anderson",76978,81.8415651225025,0.0900692840646651,71.448985424407,5.19628984904778,9.00692840646651
2021-03-28,8323,3,6248,0,2075,3,7009,0,57830,16,64839,16,1,162,0,212,176,1,"Anderson",76978,72.7480578866689,0.0780487804878049,20.7851593961911,3.89721738678583,7.80487804878049
2021-03-29,8338,15,6252,4,2086,11,7013,4,57893,63,64906,67,1,163,0,212,177,1,"Anderson",76978,81.8415651225025,0.0821596244131455,87.0378549715503,19.4860869339292,8.21596244131455
2021-03-30,8343,5,6255,3,2088,2,7016,3,57937,44,64953,47,1,164,0,212,177,0,"Anderson",76978,80.5424926602406,0.083710407239819,61.0564057263114,6.49536231130973,8.3710407239819
2021-03-31,8366,23,6269,14,2097,9,7032,16,58069,132,65101,148,1,165,1,213,177,0,"Anderson",76978,100.02857959417,0.0946502057613169,192.262724414768,29.8786666320247,9.46502057613169
2021-04-01,8376,10,6274,5,2102,5,7036,4,58104,35,65140,39,0,165,0,213,177,0,"Anderson",76978,100.02857959417,0.100227790432802,50.6638260282159,12.9907246226195,10.0227790432802
2021-04-02,8384,8,6280,6,2104,2,7044,8,58156,52,65200,60,0,165,0,213,177,0,"Anderson",76978,88.3369274338123,0.0949074074074074,77.9443477357167,10.3925796980956,9.49074074074074
2021-04-03,8390,6,6285,5,2105,1,7050,6,58195,39,65245,45,0,165,0,213,177,0,"Anderson",76978,90.9350723583361,0.0971563981042654,58.4582608017875,7.79443477357167,9.71563981042654
2021-04-04,8392,2,6287,2,2105,0,7052,2,58227,32,65279,34,0,165,0,213,177,0,"Anderson",76978,89.6359998960742,0.0977272727272727,44.1684637169061,2.59814492452389,9.77272727272727
2021-04-05,8406,14,6290,3,2116,11,7054,2,58275,48,65329,50,0,165,2,215,177,0,"Anderson",76978,88.3369274338123,0.0969267139479905,64.9536231130973,18.1870144716672,9.69267139479905
2021-04-06,8411,5,6294,4,2117,1,7060,6,58305,30,65365,36,0,165,0,215,177,0,"Anderson",76978,88.3369274338123,0.106796116504854,46.76660864143,6.49536231130973,10.6796116504854
2021-04-07,8431,20,6307,13,2124,7,7074,14,58438,133,65512,147,0,165,2,217,177,0,"Anderson",76978,84.4397100470264,0.102189781021898,190.963651952506,25.9814492452389,10.2189781021898
2021-04-08,8434,3,6309,2,2125,1,7077,3,58499,61,65576,64,5,170,1,218,177,0,"Anderson",76978,75.3462028111928,0.0940366972477064,83.1406375847645,3.89721738678583,9.40366972477064
2021-04-09,8442,8,6315,6,2127,2,7086,9,58565,66,65651,75,-4,166,0,218,177,0,"Anderson",76978,75.3462028111928,0.0931263858093126,97.4304346696459,10.3925796980956,9.31263858093126
2021-04-10,8447,5,6320,5,2127,0,7091,5,58620,55,65711,60,0,166,0,218,177,0,"Anderson",76978,74.0471303489309,0.0879828326180258,77.9443477357167,6.49536231130973,8.79828326180258
2021-04-11,8454,7,6325,5,2129,2,7096,5,58655,35,65751,40,-1,165,0,218,177,0,"Anderson",76978,80.5424926602406,0.0932203389830508,51.9628984904778,9.09350723583361,9.32203389830508
2021-04-12,8457,3,6328,3,2129,0,7099,3,58709,54,65808,57,0,165,0,218,177,0,"Anderson",76978,66.2526955753592,0.0939457202505219,74.0471303489309,3.89721738678583,9.39457202505219
2021-04-13,8467,10,6333,5,2134,5,7105,6,58743,34,65848,40,5,170,0,218,177,0,"Anderson",76978,72.7480578866689,0.093167701863354,51.9628984904778,12.9907246226195,9.3167701863354
2021-04-14,8481,14,6342,9,2139,5,7116,11,58855,112,65971,123,0,170,0,218,177,0,"Anderson",76978,64.9536231130973,0.0915032679738562,159.785912858219,18.1870144716672,9.15032679738562
2021-04-15,8490,9,6347,5,2143,4,7121,5,58916,61,66037,66,0,170,0,218,177,0,"Anderson",76978,72.7480578866689,0.0954446854663774,85.7387825092884,11.6916521603575,9.54446854663774
2021-04-16,8503,13,6358,11,2145,2,7134,13,59038,122,66172,135,0,170,0,218,177,0,"Anderson",76978,79.2434201979786,0.0921305182341651,175.374782405363,16.8879420094053,9.21305182341651
2021-04-17,8508,5,6361,3,2147,2,7137,3,59091,53,66228,56,0,170,0,218,177,0,"Anderson",76978,79.2434201979786,0.0889748549323017,72.7480578866689,6.49536231130973,8.89748549323017
2021-04-18,8515,7,6367,6,2148,1,7143,6,59126,35,66269,41,0,170,0,218,177,0,"Anderson",76978,79.2434201979786,0.0907335907335907,53.2619709527397,9.09350723583361,9.07335907335907
2021-04-19,8521,6,6370,3,2151,3,7146,3,59144,18,66290,21,0,170,0,218,178,1,"Anderson",76978,83.1406375847645,0.0975103734439834,27.2805217075008,7.79443477357167,9.75103734439834
2021-04-20,8527,6,6373,3,2154,3,7149,3,59215,71,66364,74,0,170,0,218,178,0,"Anderson",76978,77.9443477357167,0.0852713178294574,96.1313622073839,7.79443477357167,8.52713178294574
2021-04-21,8539,12,6379,6,2160,6,7155,6,59335,120,66490,126,1,171,0,218,178,0,"Anderson",76978,75.3462028111928,0.0751445086705202,163.683130245005,15.5888695471433,7.51445086705202
2021-04-22,8557,18,6385,6,2172,12,7162,7,59424,89,66586,96,0,171,0,218,178,0,"Anderson",76978,87.0378549715503,0.0746812386156648,124.710956377147,23.383304320715,7.46812386156649
2021-04-23,8567,10,6390,5,2177,5,7168,6,59489,65,66657,71,0,171,0,218,178,0,"Anderson",76978,83.1406375847645,0.0701030927835052,92.2341448205981,12.9907246226195,7.01030927835052
2021-04-24,8579,12,6396,6,2183,6,7175,7,59535,46,66710,53,0,171,1,219,178,0,"Anderson",76978,92.2341448205981,0.0788381742738589,68.8508404998831,15.5888695471433,7.88381742738589
2021-04-25,8583,4,6398,2,2185,2,7177,2,59568,33,66745,35,0,171,0,219,178,0,"Anderson",76978,88.3369274338123,0.0714285714285714,45.4675361791681,5.19628984904778,7.14285714285714
2021-04-26,8592,9,6402,4,2190,5,7181,4,59619,51,66800,55,0,171,0,219,179,1,"Anderson",76978,92.2341448205981,0.0686274509803922,71.448985424407,11.6916521603575,6.86274509803922
2021-04-27,8602,10,6408,6,2194,4,7187,6,59663,44,66850,50,0,171,0,219,179,0,"Anderson",76978,97.4304346696459,0.0781893004115226,64.9536231130973,12.9907246226195,7.81893004115226
2021-04-28,8619,17,6420,12,2199,5,7200,13,59761,98,66961,111,0,171,1,220,180,1,"Anderson",76978,103.925796980956,0.0955414012738854,144.197043311076,22.0842318584531,9.55414012738854
2021-04-29,8625,6,6422,2,2203,4,7203,3,59864,103,67067,106,0,171,0,220,180,0,"Anderson",76978,88.3369274338123,0.0852390852390852,137.701680999766,7.79443477357167,8.52390852390852
2021-04-30,8633,8,6425,3,2208,5,7207,4,59938,74,67145,78,0,171,0,220,180,0,"Anderson",76978,85.7387825092884,0.0799180327868853,101.327652056432,10.3925796980956,7.99180327868853
2021-05-01,8638,5,6428,3,2210,2,7210,3,59982,44,67192,47,0,171,1,221,180,0,"Anderson",76978,76.6452752734548,0.0726141078838174,61.0564057263114,6.49536231130973,7.26141078838174
2021-05-02,8641,3,6429,1,2212,2,7211,1,60018,36,67229,37,0,171,0,221,180,0,"Anderson",76978,75.3462028111928,0.0702479338842975,48.065681103692,3.89721738678583,7.02479338842975
2021-05-03,8651,10,6434,5,2217,5,7216,5,60077,59,67293,64,0,171,0,221,180,0,"Anderson",76978,76.6452752734548,0.0709939148073022,83.1406375847645,12.9907246226195,7.09939148073022
2021-05-04,8653,2,6434,0,2219,2,7217,1,60106,29,67323,30,0,171,0,221,180,0,"Anderson",76978,66.2526955753592,0.0634249471458774,38.9721738678584,2.59814492452389,6.34249471458774
2021-05-05,8661,8,6438,4,2223,4,7220,3,60185,79,67405,82,0,171,0,221,180,0,"Anderson",76978,54.5610434150017,0.045045045045045,106.523941905479,10.3925796980956,4.5045045045045
2021-05-06,8666,5,6441,3,2225,2,7226,6,60226,41,67452,47,0,171,1,222,180,0,"Anderson",76978,53.2619709527397,0.0597402597402597,61.0564057263114,6.49536231130973,5.97402597402597
2021-05-07,8671,5,6443,2,2228,3,7229,3,60284,58,67513,61,0,171,0,222,180,0,"Anderson",76978,49.3647535659539,0.0597826086956522,79.2434201979787,6.49536231130973,5.97826086956522
2021-05-08,8677,6,6446,3,2231,3,7231,2,60328,44,67559,46,0,171,1,223,181,1,"Anderson",76978,50.6638260282159,0.0572207084468665,59.7573332640495,7.79443477357167,5.72207084468665
2021-05-09,8678,1,6446,0,2232,1,7232,1,60349,21,67581,22,0,171,0,223,181,0,"Anderson",76978,48.065681103692,0.0596590909090909,28.5795941697628,1.29907246226194,5.96590909090909
2021-05-10,8683,5,6446,0,2237,5,7232,0,60413,64,67645,64,0,171,0,223,181,0,"Anderson",76978,41.5703187923822,0.0454545454545455,83.1406375847645,6.49536231130973,4.54545454545455
2021-05-11,8691,8,6447,1,2244,7,7234,2,60434,21,67668,23,0,171,0,223,182,1,"Anderson",76978,49.3647535659539,0.0492753623188406,29.8786666320247,10.3925796980956,4.92753623188406
2021-05-12,8704,13,6454,7,2250,6,7240,6,60502,68,67742,74,0,171,2,225,182,0,"Anderson",76978,55.8601158772636,0.0593471810089021,96.1313622073839,16.8879420094053,5.93471810089021
2021-05-13,8708,4,6456,2,2252,2,7242,2,60564,62,67806,64,0,171,2,227,182,0,"Anderson",76978,54.5610434150017,0.0451977401129944,83.1406375847645,5.19628984904778,4.51977401129944
2021-05-14,8716,8,6459,3,2257,5,7247,5,60628,64,67875,69,0,171,0,227,182,0,"Anderson",76978,58.4582608017875,0.0497237569060773,89.6359998960742,10.3925796980956,4.97237569060773
2021-05-15,8721,5,6461,2,2260,3,7249,2,60671,43,67920,45,0,171,0,227,182,0,"Anderson",76978,57.1591883395256,0.0498614958448753,58.4582608017875,6.49536231130973,4.98614958448753
2021-05-16,8723,2,6462,1,2261,1,7250,1,60697,26,67947,27,0,171,0,227,182,0,"Anderson",76978,58.4582608017875,0.0491803278688525,35.0749564810725,2.59814492452389,4.91803278688525
2021-05-17,8729,6,6467,5,2262,1,7255,5,60742,45,67997,50,1,172,0,227,182,0,"Anderson",76978,59.7573332640495,0.0653409090909091,64.9536231130973,7.79443477357167,6.53409090909091
2021-05-18,8733,4,6467,0,2266,4,7255,0,60804,62,68059,62,0,172,1,228,182,0,"Anderson",76978,54.5610434150017,0.0537084398976982,80.5424926602406,5.19628984904778,5.37084398976982
2021-05-19,8740,7,6472,5,2268,2,7261,6,60892,88,68153,94,0,172,0,228,182,0,"Anderson",76978,46.76660864143,0.0510948905109489,122.112811452623,9.09350723583361,5.10948905109489
2021-05-20,8742,2,6474,2,2268,0,7263,2,60976,84,68239,86,0,172,0,228,182,0,"Anderson",76978,44.1684637169061,0.0484988452655889,111.720231754527,2.59814492452389,4.84988452655889
2021-05-21,8744,2,6474,0,2270,2,7263,0,61025,49,68288,49,0,172,0,228,182,0,"Anderson",76978,36.3740289433345,0.0387409200968523,63.6545506508353,2.59814492452389,3.87409200968523
2021-05-22,8749,5,6476,2,2273,3,7265,2,61050,25,68315,27,0,172,0,228,182,0,"Anderson",76978,36.3740289433345,0.040506329113924,35.0749564810725,6.49536231130973,4.05063291139241
2021-05-23,8749,0,6476,0,2273,0,7265,0,61071,21,68336,21,0,172,0,228,182,0,"Anderson",76978,33.7758840188106,0.038560411311054,27.2805217075008,0,3.8560411311054
2021-05-24,8757,8,6480,4,2277,4,7268,3,61117,46,68385,49,0,172,0,228,182,0,"Anderson",76978,36.3740289433345,0.0335051546391753,63.6545506508353,10.3925796980956,3.35051546391753
2021-05-25,8759,2,6480,0,2279,2,7269,1,61142,25,68411,26,0,172,0,228,182,0,"Anderson",76978,33.7758840188106,0.0397727272727273,33.7758840188106,2.59814492452389,3.97727272727273
2021-05-26,8766,7,6485,5,2281,2,7275,6,61210,68,68485,74,0,172,0,228,182,0,"Anderson",76978,33.7758840188106,0.0421686746987952,96.1313622073839,9.09350723583361,4.21686746987952
2021-05-27,8768,2,6486,1,2282,1,7276,1,61239,29,68515,30,0,172,1,229,182,0,"Anderson",76978,33.7758840188106,0.0471014492753623,38.9721738678584,2.59814492452389,4.71014492753623
2021-05-28,8773,5,6490,4,2283,1,7281,5,61291,52,68572,57,0,172,0,229,182,0,"Anderson",76978,37.6731014055964,0.0633802816901408,74.0471303489309,6.49536231130973,6.33802816901408
2021-05-29,8774,1,6490,0,2284,1,7281,0,61314,23,68595,23,0,172,0,229,182,0,"Anderson",76978,32.4768115565486,0.0571428571428571,29.8786666320247,1.29907246226194,5.71428571428571
2021-05-30,8777,3,6491,1,2286,2,7282,1,61342,28,68624,29,0,172,0,229,182,0,"Anderson",76978,36.3740289433345,0.0590277777777778,37.6731014055964,3.89721738678583,5.90277777777778
2021-05-31,8781,4,6494,3,2287,1,7285,3,61378,36,68663,39,0,172,0,229,182,0,"Anderson",76978,31.1777390942867,0.0611510791366906,50.6638260282159,5.19628984904778,6.11510791366906
2021-06-01,8784,3,6496,2,2288,1,7286,1,61408,30,68694,31,0,172,1,230,182,0,"Anderson",76978,32.4768115565486,0.0600706713780919,40.2712463301203,3.89721738678583,6.00706713780919
2021-06-02,8788,4,6497,1,2291,3,7288,2,61437,29,68725,31,0,172,0,230,182,0,"Anderson",76978,28.5795941697628,0.0541666666666667,40.2712463301203,5.19628984904778,5.41666666666667
2021-06-03,8789,1,6497,0,2292,1,7291,3,61485,48,68776,51,1,173,0,230,183,1,"Anderson",76978,27.2805217075008,0.0574712643678161,66.2526955753592,1.29907246226194,5.74712643678161
2021-06-04,8790,1,6498,1,2292,0,7293,2,61515,30,68808,32,-1,172,0,230,183,0,"Anderson",76978,22.0842318584531,0.0508474576271186,41.5703187923822,1.29907246226194,5.08474576271187
2021-06-05,8791,1,6499,1,2292,0,7294,1,61553,38,68847,39,0,172,0,230,183,0,"Anderson",76978,22.0842318584531,0.0515873015873016,50.6638260282159,1.29907246226194,5.15873015873016
2021-06-06,8791,0,6499,0,2292,0,7294,0,61573,20,68867,20,0,172,0,230,183,0,"Anderson",76978,18.1870144716672,0.0493827160493827,25.9814492452389,0,4.93827160493827
2021-06-07,8792,1,6499,0,2293,1,7294,0,61605,32,68899,32,0,172,0,230,183,0,"Anderson",76978,14.2897970848814,0.038135593220339,41.5703187923822,1.29907246226194,3.8135593220339
2021-06-08,8793,1,6499,0,2294,1,7294,0,61629,24,68923,24,0,172,1,231,184,1,"Anderson",76978,11.6916521603575,0.0349344978165939,31.1777390942867,1.29907246226194,3.49344978165939
2021-06-09,8793,0,6499,0,2294,0,7294,0,61683,54,68977,54,0,172,0,231,184,0,"Anderson",76978,6.49536231130972,0.0238095238095238,70.149912962145,0,2.38095238095238
2021-06-10,8797,4,6500,1,2297,3,7295,1,61726,43,69021,44,0,172,0,231,184,0,"Anderson",76978,10.3925796980956,0.0163265306122449,57.1591883395256,5.19628984904778,1.63265306122449
2021-06-11,8798,1,6500,0,2298,1,7296,1,61771,45,69067,46,1,173,0,231,184,0,"Anderson",76978,10.3925796980956,0.0115830115830116,59.7573332640495,1.29907246226194,1.15830115830116
2021-06-12,8799,1,6500,0,2299,1,7297,1,61792,21,69089,22,2,175,0,231,184,0,"Anderson",76978,10.3925796980956,0.012396694214876,28.5795941697628,1.29907246226194,1.2396694214876
2021-06-13,8800,1,6500,0,2300,1,7298,1,61820,28,69118,29,0,175,0,231,184,0,"Anderson",76978,11.6916521603575,0.0159362549800797,37.6731014055964,1.29907246226194,1.59362549800797
2021-06-14,8802,2,6502,2,2300,0,7300,2,61866,46,69166,48,0,175,0,231,184,0,"Anderson",76978,12.9907246226194,0.0224719101123595,62.3554781885734,2.59814492452389,2.24719101123596
2021-06-15,8802,0,6502,0,2300,0,7301,1,61888,22,69189,23,0,175,0,231,184,0,"Anderson",76978,11.6916521603575,0.0263157894736842,29.8786666320247,0,2.63157894736842
2021-06-16,8803,1,6503,1,2300,0,7302,1,61918,30,69220,31,0,175,0,231,184,0,"Anderson",76978,12.9907246226194,0.0329218106995885,40.2712463301203,1.29907246226194,3.29218106995885
2021-06-17,8803,0,6503,0,2300,0,7302,0,61973,55,69275,55,0,175,0,231,184,0,"Anderson",76978,7.79443477357167,0.0275590551181102,71.448985424407,0,2.75590551181102
2021-06-18,8805,2,6504,1,2301,1,7306,4,62005,32,69311,36,0,175,0,231,184,0,"Anderson",76978,9.09350723583361,0.040983606557377,46.76660864143,2.59814492452389,4.0983606557377
2021-06-19,8805,0,6504,0,2301,0,7306,0,62026,21,69332,21,0,175,0,231,184,0,"Anderson",76978,7.79443477357167,0.037037037037037,27.2805217075008,0,3.7037037037037
2021-06-20,8805,0,6504,0,2301,0,7307,1,62034,8,69341,9,0,175,0,231,184,0,"Anderson",76978,6.49536231130972,0.0403587443946188,11.6916521603575,0,4.03587443946188
2021-06-21,8806,1,6504,0,2302,1,7307,0,62058,24,69365,24,0,175,0,231,184,0,"Anderson",76978,5.19628984904778,0.0351758793969849,31.1777390942867,1.29907246226194,3.51758793969849
2021-06-22,8810,4,6505,1,2305,3,7307,0,62088,30,69395,30,0,175,1,232,184,0,"Anderson",76978,10.3925796980956,0.029126213592233,38.9721738678584,5.19628984904778,2.9126213592233
2021-06-23,8811,1,6506,1,2305,0,7308,1,62119,31,69427,32,0,175,0,232,184,0,"Anderson",76978,10.3925796980956,0.0289855072463768,41.5703187923822,1.29907246226194,2.89855072463768
2021-06-24,8811,0,6506,0,2305,0,7309,1,62145,26,69454,27,0,175,0,232,184,0,"Anderson",76978,10.3925796980956,0.0391061452513966,35.0749564810725,0,3.91061452513966
2021-06-25,8812,1,6507,1,2305,0,7310,1,62172,27,69482,28,0,175,0,232,184,0,"Anderson",76978,9.09350723583361,0.0233918128654971,36.3740289433345,1.29907246226194,2.33918128654971
2021-06-26,8813,1,6508,1,2305,0,7311,1,62187,15,69498,16,0,175,0,232,184,0,"Anderson",76978,10.3925796980956,0.0301204819277108,20.7851593961911,1.29907246226194,3.01204819277108
2021-06-27,8813,0,6508,0,2305,0,7311,0,62210,23,69521,23,0,175,0,232,184,0,"Anderson",76978,10.3925796980956,0.0222222222222222,29.8786666320247,0,2.22222222222222
2021-06-28,8814,1,6508,0,2306,1,7312,1,62225,15,69537,16,0,175,0,232,184,0,"Anderson",76978,10.3925796980956,0.0290697674418605,20.7851593961911,1.29907246226194,2.90697674418605
2021-06-29,8817,3,6511,3,2306,0,7315,3,62257,32,69572,35,0,175,0,232,184,0,"Anderson",76978,9.09350723583361,0.0451977401129944,45.4675361791681,3.89721738678583,4.51977401129944
2021-06-30,8817,0,6511,0,2306,0,7315,0,62286,29,69601,29,0,175,0,232,184,0,"Anderson",76978,7.79443477357167,0.0402298850574713,37.6731014055964,0,4.02298850574713
2021-07-01,8818,1,6512,1,2306,0,7316,1,62312,26,69628,27,0,175,0,232,184,0,"Anderson",76978,9.09350723583361,0.0402298850574713,35.0749564810725,1.29907246226194,4.02298850574713
2021-07-02,8818,0,6512,0,2306,0,7316,0,62339,27,69655,27,0,175,0,232,184,0,"Anderson",76978,7.79443477357167,0.0346820809248555,35.0749564810725,0,3.46820809248555
2021-07-03,8818,0,6512,0,2306,0,7316,0,62349,10,69665,10,0,175,0,232,184,0,"Anderson",76978,6.49536231130972,0.029940119760479,12.9907246226195,0,2.9940119760479
2021-07-04,8819,1,6512,0,2307,1,7317,1,62364,15,69681,16,0,175,0,232,184,0,"Anderson",76978,7.79443477357167,0.0375,20.7851593961911,1.29907246226194,3.75
2021-07-05,8819,0,6512,0,2307,0,7318,1,62378,14,69696,15,0,175,0,232,184,0,"Anderson",76978,6.49536231130972,0.0377358490566038,19.4860869339292,0,3.77358490566038
2021-07-06,8820,1,6512,0,2308,1,7318,0,62405,27,69723,27,1,176,0,232,184,0,"Anderson",76978,3.89721738678583,0.0198675496688742,35.0749564810725,1.29907246226194,1.98675496688742
2021-07-07,8821,1,6512,0,2309,1,7318,0,62434,29,69752,29,0,176,0,232,184,0,"Anderson",76978,5.19628984904778,0.0198675496688742,37.6731014055964,1.29907246226194,1.98675496688742
2021-07-08,8822,1,6513,1,2309,0,7319,1,62463,29,69782,30,0,176,0,232,184,0,"Anderson",76978,5.19628984904778,0.0194805194805195,38.9721738678584,1.29907246226194,1.94805194805195
2021-07-09,8824,2,6514,1,2310,1,7320,1,62491,28,69811,29,0,176,0,232,184,0,"Anderson",76978,7.79443477357167,0.0256410256410256,37.6731014055964,2.59814492452389,2.56410256410256
2021-07-10,8826,2,6515,1,2311,1,7321,1,62505,14,69826,15,0,176,1,233,184,0,"Anderson",76978,10.3925796980956,0.031055900621118,19.4860869339292,2.59814492452389,3.1055900621118
2021-07-11,8826,0,6515,0,2311,0,7321,0,62517,12,69838,12,0,176,0,233,184,0,"Anderson",76978,9.09350723583361,0.0254777070063694,15.5888695471433,0,2.54777070063694
2021-07-12,8834,8,6519,4,2315,4,7325,4,62536,19,69861,23,0,176,1,234,184,0,"Anderson",76978,19.4860869339292,0.0424242424242424,29.8786666320247,10.3925796980956,4.24242424242424
2021-07-13,8835,1,6519,0,2316,1,7325,0,62548,12,69873,12,0,176,0,234,186,2,"Anderson",76978,19.4860869339292,0.0466666666666667,15.5888695471433,1.29907246226194,4.66666666666667
2021-07-14,8840,5,6524,5,2316,0,7330,5,62584,36,69914,41,0,176,1,235,186,0,"Anderson",76978,24.682376782977,0.0740740740740741,53.2619709527397,6.49536231130973,7.40740740740741
2021-07-15,8843,3,6527,3,2316,0,7332,2,62606,22,69938,24,0,176,0,235,186,0,"Anderson",76978,27.2805217075008,0.0833333333333333,31.1777390942867,3.89721738678583,8.33333333333333
2021-07-16,8853,10,6529,2,2324,8,7333,1,62624,18,69957,19,0,176,0,235,186,0,"Anderson",76978,37.6731014055964,0.089041095890411,24.682376782977,12.9907246226195,8.9041095890411
2021-07-17,8858,5,6530,1,2328,4,7334,1,62651,27,69985,28,0,176,0,235,186,0,"Anderson",76978,41.5703187923822,0.0817610062893082,36.3740289433345,6.49536231130973,8.17610062893082
2021-07-18,8861,3,6532,2,2329,1,7336,2,62662,11,69998,13,0,176,0,235,186,0,"Anderson",76978,45.4675361791681,0.09375,16.8879420094053,3.89721738678583,9.375
2021-07-19,8866,5,6536,4,2330,1,7340,4,62686,24,70026,28,0,176,0,235,186,0,"Anderson",76978,41.5703187923822,0.0909090909090909,36.3740289433345,6.49536231130973,9.09090909090909
2021-07-20,8881,15,6547,11,2334,4,7351,11,62716,30,70067,41,0,176,1,236,186,0,"Anderson",76978,59.7573332640495,0.134020618556701,53.2619709527397,19.4860869339292,13.4020618556701
2021-07-21,8888,7,6551,4,2337,3,7356,5,62777,61,70133,66,0,176,0,236,187,1,"Anderson",76978,62.3554781885734,0.118721461187215,85.7387825092884,9.09350723583361,11.8721461187215
2021-07-22,8898,10,6556,5,2342,5,7360,4,62820,43,70180,47,0,176,0,236,187,0,"Anderson",76978,71.448985424407,0.115702479338843,61.0564057263114,12.9907246226195,11.5702479338843
2021-07-23,8908,10,6560,4,2348,6,7365,5,62852,32,70217,37,0,176,0,236,187,0,"Anderson",76978,71.448985424407,0.123076923076923,48.065681103692,12.9907246226195,12.3076923076923
2021-07-24,8916,8,6564,4,2352,4,7369,4,62890,38,70259,42,0,176,0,236,188,1,"Anderson",76978,75.3462028111928,0.127737226277372,54.5610434150017,10.3925796980956,12.7737226277372
2021-07-25,8921,5,6567,3,2354,2,7370,1,62904,14,70274,15,0,176,0,236,188,0,"Anderson",76978,77.9443477357167,0.123188405797101,19.4860869339292,6.49536231130973,12.3188405797101
2021-07-26,8944,23,6576,9,2368,14,7378,8,62934,30,70312,38,2,178,0,236,188,0,"Anderson",76978,101.327652056432,0.132867132867133,49.3647535659539,29.8786666320247,13.2867132867133
2021-07-27,8959,15,6581,5,2378,10,7383,5,62969,35,70352,40,0,178,0,236,188,0,"Anderson",76978,101.327652056432,0.112280701754386,51.9628984904778,19.4860869339292,11.2280701754386
2021-07-28,8980,21,6590,9,2390,12,7396,13,63030,61,70426,74,0,178,0,236,188,0,"Anderson",76978,119.514666528099,0.136518771331058,96.1313622073839,27.2805217075008,13.6518771331058
2021-07-29,8992,12,6600,10,2392,2,7408,12,63071,41,70479,53,0,178,0,236,188,0,"Anderson",76978,122.112811452623,0.160535117056856,68.8508404998831,15.5888695471433,16.0535117056856
2021-07-30,9023,31,6621,21,2402,10,7431,23,63104,33,70535,56,0,178,1,237,188,0,"Anderson",76978,149.393333160124,0.207547169811321,72.7480578866689,40.2712463301203,20.7547169811321
2021-07-31,9036,13,6627,6,2409,7,7437,6,63131,27,70568,33,0,178,0,237,188,0,"Anderson",76978,155.888695471433,0.220064724919094,42.8693912546442,16.8879420094053,22.0064724919094
2021-08-01,9055,19,6639,12,2416,7,7452,15,63163,32,70615,47,0,178,0,237,188,0,"Anderson",76978,174.075709943101,0.240469208211144,61.0564057263114,24.682376782977,24.0469208211144
2021-08-02,9067,12,6645,6,2422,6,7458,6,63221,58,70679,64,0,178,0,237,188,0,"Anderson",76978,159.785912858219,0.217983651226158,83.1406375847645,15.5888695471433,21.7983651226158
2021-08-03,9090,23,6656,11,2434,12,7471,13,63281,60,70752,73,0,178,1,238,188,0,"Anderson",76978,170.178492556315,0.22,94.832289745122,29.8786666320247,22
2021-08-04,9116,26,6678,22,2438,4,7492,21,63365,84,70857,105,0,178,0,238,188,0,"Anderson",76978,176.673854867625,0.222737819025522,136.402608537504,33.7758840188106,22.2737819025522
2021-08-05,9147,31,6695,17,2452,14,7508,16,63442,77,70950,93,0,178,1,239,188,0,"Anderson",76978,201.356231650601,0.212314225053079,120.813738990361,40.2712463301203,21.2314225053079
2021-08-06,9172,25,6711,16,2461,9,7526,18,63560,118,71086,136,0,178,1,240,188,0,"Anderson",76978,193.56179687703,0.172413793103448,176.673854867625,32.4768115565486,17.2413793103448
2021-08-07,9186,14,6718,7,2468,7,7534,8,63623,63,71157,71,0,178,0,240,188,0,"Anderson",76978,194.860869339292,0.164685908319185,92.2341448205981,18.1870144716672,16.4685908319185
2021-08-08,9200,14,6726,8,2474,6,7544,10,63658,35,71202,45,0,178,0,240,188,0,"Anderson",76978,188.365507027982,0.156729131175468,58.4582608017875,18.1870144716672,15.6729131175468
2021-08-09,9236,36,6745,19,2491,17,7563,19,63734,76,71297,95,0,178,0,240,188,0,"Anderson",76978,219.543246122269,0.169902912621359,123.411883914885,46.76660864143,16.9902912621359
2021-08-10,9275,39,6765,20,2510,19,7583,20,63811,77,71394,97,0,178,2,242,188,0,"Anderson",76978,240.32840551846,0.174454828660436,126.010028839409,50.6638260282159,17.4454828660436
2021-08-11,9330,55,6790,25,2540,30,7613,30,63901,90,71514,120,0,178,1,243,188,0,"Anderson",76978,278.001506924056,0.184170471841705,155.888695471433,71.448985424407,18.4170471841705
2021-08-12,9379,49,6827,37,2552,12,7651,38,64032,131,71683,169,0,178,0,243,190,2,"Anderson",76978,301.384811244771,0.195088676671214,219.543246122269,63.6545506508353,19.5088676671214
2021-08-13,9442,63,6862,35,2580,28,7689,38,64127,95,71816,133,2,180,1,244,191,1,"Anderson",76978,350.749564810725,0.223287671232877,172.776637480839,81.8415651225025,22.3287671232877
2021-08-14,9492,50,6897,35,2595,15,7721,32,64274,147,71995,179,0,180,0,244,191,0,"Anderson",76978,397.516173452155,0.223150357995227,232.533970744888,64.9536231130973,22.3150357995227
2021-08-15,9515,23,6910,13,2605,10,7736,15,64339,65,72075,80,0,180,0,244,191,0,"Anderson",76978,409.207825612513,0.219931271477663,103.925796980956,29.8786666320247,21.9931271477663
2021-08-16,9553,38,6934,24,2619,14,7760,24,64414,75,72174,99,0,180,0,244,192,1,"Anderson",76978,411.805970537037,0.224629418472064,128.608173763933,49.3647535659539,22.4629418472064
2021-08-17,9596,43,6955,21,2641,22,7784,24,64506,92,72290,116,1,181,0,244,192,0,"Anderson",76978,417.002260386084,0.224330357142857,150.692405622386,55.8601158772636,22.4330357142857
2021-08-18,9648,52,6982,27,2666,25,7815,31,64591,85,72406,116,0,181,0,244,193,1,"Anderson",76978,413.105042999299,0.226457399103139,150.692405622386,67.5517680376211,22.6457399103139
2021-08-19,9722,74,7015,33,2707,41,7851,36,64712,121,72563,157,0,181,0,244,193,0,"Anderson",76978,445.581854555847,0.227272727272727,203.954376575125,96.1313622073839,22.7272727272727
2021-08-20,9782,60,7057,42,2725,18,7895,44,64860,148,72755,192,0,181,2,246,193,0,"Anderson",76978,441.684637169061,0.219382321618743,249.421912754293,77.9443477357167,21.9382321618743
2021-08-21,9864,82,7091,34,2773,48,7929,34,65065,205,72994,239,0,181,1,247,193,0,"Anderson",76978,483.254955961444,0.208208208208208,310.478318480605,106.523941905479,20.8208208208208
2021-08-22,9886,22,7112,21,2774,1,7957,28,65190,125,73147,153,0,181,0,247,193,0,"Anderson",76978,481.955883499182,0.20615671641791,198.758086726078,28.5795941697628,20.615671641791
2021-08-23,9936,50,7127,15,2809,35,7975,18,65298,108,73273,126,0,181,2,249,194,1,"Anderson",76978,497.544753046325,0.195632393084622,163.683130245005,64.9536231130973,19.5632393084622
2021-08-24,9981,45,7155,28,2826,17,7999,24,65375,77,73374,101,1,182,0,249,195,1,"Anderson",76978,500.142897970849,0.198339483394834,131.206318688456,58.4582608017875,19.8339483394834
2021-08-25,10054,73,7182,27,2872,46,8022,23,65406,31,73428,54,0,182,1,250,195,0,"Anderson",76978,527.42341967835,0.202544031311155,70.149912962145,94.832289745122,20.2544031311155
2021-08-26,10122,68,7218,36,2904,32,8066,44,65555,149,73621,193,1,183,2,252,196,1,"Anderson",76978,519.628984904778,0.203213610586011,250.720985216555,88.3369274338123,20.3213610586011
2021-08-27,10200,78,7275,57,2925,21,8130,64,65694,139,73824,203,0,183,0,252,196,0,"Anderson",76978,543.012289225493,0.219831618334892,263.711709839175,101.327652056432,21.9831618334892
2021-08-28,10258,58,7306,31,2952,27,8170,40,65860,166,74030,206,0,183,0,252,196,0,"Anderson",76978,511.834550131206,0.232625482625483,267.608927225961,75.3462028111928,23.2625482625483
2021-08-29,10322,64,7355,49,2967,15,8222,52,66019,159,74241,211,0,183,1,253,197,1,"Anderson",76978,566.395593546208,0.242230347349177,274.10428953727,83.1406375847645,24.2230347349177
2021-08-30,10395,73,7402,47,2993,26,8271,49,66190,171,74461,220,0,183,3,256,197,0,"Anderson",76978,596.274260178233,0.249158249158249,285.795941697628,94.832289745122,24.9158249158249
2021-08-31,10529,134,7484,82,3045,52,8359,88,66394,204,74753,292,0,183,0,256,198,1,"Anderson",76978,711.891709319546,0.261058738216099,379.329158980488,174.075709943101,26.1058738216099
2021-09-01,10559,30,7506,22,3053,8,8383,24,66472,78,74855,102,0,183,0,256,199,1,"Anderson",76978,656.031593442282,0.252978276103714,132.505391150718,38.9721738678584,25.2978276103714
2021-09-02,10622,63,7535,29,3087,34,8415,32,66552,80,74967,112,1,184,0,256,199,0,"Anderson",76978,649.536231130973,0.259286775631501,145.496115773338,81.8415651225025,25.9286775631501
2021-09-03,10650,28,7552,17,3098,11,8432,17,66609,57,75041,74,0,184,0,256,199,0,"Anderson",76978,584.582608017875,0.248151191454396,96.1313622073839,36.3740289433345,24.8151191454396
2021-09-04,10757,107,7621,69,3136,38,8507,75,66873,264,75380,339,0,184,1,257,199,0,"Anderson",76978,648.23715866871,0.24962962962963,440.385564706799,139.000753462028,24.962962962963
2021-09-05,10870,113,7695,74,3175,39,8583,76,67168,295,75751,371,0,184,1,258,200,1,"Anderson",76978,711.891709319546,0.239072847682119,481.955883499182,146.7951882356,23.9072847682119
2021-09-06,10991,121,7776,81,3215,40,8674,91,67575,407,76249,498,0,184,4,262,201,1,"Anderson",76978,774.247187508119,0.225391498881432,646.938086206449,157.187767933695,22.5391498881432
2021-09-07,11028,37,7796,20,3232,17,8692,18,67674,99,76366,117,0,184,0,262,201,0,"Anderson",76978,648.23715866871,0.206447613143211,151.991478084648,48.065681103692,20.6447613143211
2021-09-08,11069,41,7828,32,3241,9,8726,34,67781,107,76507,141,0,184,2,264,204,3,"Anderson",76978,662.526955753592,0.207627118644068,183.169217178934,53.2619709527397,20.7627118644068
2021-09-09,11128,59,7849,21,3279,38,8744,18,67987,206,76731,224,0,184,1,265,207,3,"Anderson",76978,657.330665904544,0.186507936507937,290.992231546676,76.6452752734548,18.6507936507937
2021-09-10,11282,154,7923,74,3359,80,8825,81,68279,292,77104,373,1,185,2,267,208,1,"Anderson",76978,821.013796149549,0.190499272903539,484.554028423705,200.05715918834,19.0499272903539
2021-09-11,11402,120,7990,67,3412,53,8899,74,68625,346,77524,420,0,185,2,269,208,0,"Anderson",76978,837.901738158954,0.182835820895522,545.610434150017,155.888695471433,18.2835820895522
2021-09-12,11440,38,8022,32,3418,6,8934,35,68768,143,77702,178,0,185,4,273,209,1,"Anderson",76978,740.471303489309,0.179907739620707,231.234898282626,49.3647535659539,17.9907739620707
2021-09-13,11527,87,8056,34,3471,53,8968,34,68898,130,77866,164,4,189,3,276,209,0,"Anderson",76978,696.302839772403,0.181818181818182,213.047883810959,113.019304216789,18.1818181818182
2021-09-14,11589,62,8087,31,3502,31,9004,36,69057,159,78061,195,1,190,1,277,209,0,"Anderson",76978,728.779651328951,0.184070796460177,253.319130141079,80.5424926602406,18.4070796460177
2021-09-15,11629,40,8104,17,3525,23,9019,15,69118,61,78137,76,0,190,1,278,210,1,"Anderson",76978,727.480578866689,0.179754601226994,98.7295071319078,51.9628984904778,17.9754601226994
2021-09-16,11718,89,8161,57,3557,32,9078,59,69340,222,78418,281,0,190,1,279,210,0,"Anderson",76978,766.452752734548,0.197984588026082,365.039361895607,115.617449141313,19.7984588026082
2021-09-17,11789,71,8201,40,3588,31,9117,39,69503,163,78620,202,0,190,1,280,214,4,"Anderson",76978,658.629738366806,0.192612137203166,262.412637376913,92.2341448205981,19.2612137203166
2021-09-18,11841,52,8231,30,3610,22,9150,33,69656,153,78806,186,0,190,1,281,215,1,"Anderson",76978,570.292810932994,0.195787831513261,241.627477980722,67.5517680376211,19.5787831513261
2021-09-19,11864,23,8240,9,3624,14,9160,10,69724,68,78884,78,0,190,0,281,215,0,"Anderson",76978,550.806723999065,0.191201353637902,101.327652056432,29.8786666320247,19.1201353637902
2021-09-20,11928,64,8276,36,3652,28,9197,37,69910,186,79107,223,0,190,3,284,215,0,"Anderson",76978,520.92805736704,0.184528605962933,289.693159084414,83.1406375847645,18.4528605962933
2021-09-21,11982,54,8302,26,3680,28,9221,24,70028,118,79249,142,0,190,1,285,216,1,"Anderson",76978,510.535477668944,0.182659932659933,184.468289641196,70.149912962145,18.2659932659933
2021-09-22,12033,51,8336,34,3697,17,9261,40,70300,272,79561,312,0,190,0,285,219,3,"Anderson",76978,524.825274753826,0.169943820224719,405.310608225727,66.2526955753592,16.9943820224719
2021-09-23,12109,76,8384,48,3725,28,9312,51,70508,208,79820,259,2,192,1,286,219,0,"Anderson",76978,507.93733274442,0.166904422253923,336.459767725844,98.7295071319078,16.6904422253923
2021-09-24,12148,39,8404,20,3744,19,9336,24,70647,139,79983,163,2,194,1,287,222,3,"Anderson",76978,466.367013952038,0.160674981658107,211.748811348697,50.6638260282159,16.0674981658107
2021-09-25,12158,10,8408,4,3750,6,9342,6,70741,94,80083,100,0,194,0,287,222,0,"Anderson",76978,411.805970537037,0.150352388410337,129.907246226195,12.9907246226195,15.0352388410337
2021-09-26,12176,18,8423,15,3753,3,9360,18,70878,137,80238,155,1,195,0,287,222,0,"Anderson",76978,405.310608225727,0.147710487444609,201.356231650601,23.383304320715,14.7710487444609
2021-09-27,12227,51,8445,22,3782,29,9383,23,70962,84,80345,107,1,196,1,288,223,1,"Anderson",76978,388.422666216322,0.150242326332795,139.000753462028,66.2526955753592,15.0242326332795
2021-09-28,12276,49,8469,24,3807,25,9410,27,71054,92,80464,119,0,196,1,289,223,0,"Anderson",76978,381.927303905012,0.155555555555556,154.589623009171,63.6545506508353,15.5555555555556
2021-09-29,12315,39,8485,16,3830,23,9427,17,71243,189,80670,206,2,198,0,289,225,2,"Anderson",76978,366.338434357868,0.149684400360685,267.608927225961,50.6638260282159,14.9684400360685
2021-09-30,12377,62,8523,38,3854,24,9467,40,71415,172,80882,212,0,198,1,290,226,1,"Anderson",76978,348.151419886201,0.145951035781544,275.403361999532,80.5424926602406,14.5951035781544
2021-10-01,12428,51,8550,27,3878,24,9496,29,71566,151,81062,180,0,198,1,291,227,1,"Anderson",76978,363.740289433345,0.148285449490269,233.83304320715,66.2526955753592,14.8285449490269
2021-10-02,12445,17,8557,7,3888,10,9502,6,71646,80,81148,86,1,199,0,291,229,2,"Anderson",76978,372.833796669178,0.150234741784038,111.720231754527,22.0842318584531,15.0234741784038
2021-10-03,12459,14,8567,10,3892,4,9512,10,71744,98,81256,108,4,203,0,291,229,0,"Anderson",76978,367.63750682013,0.149312377210216,140.29982592429,18.1870144716672,14.9312377210216
2021-10-04,12504,45,8590,23,3914,22,9538,26,71864,120,81402,146,1,204,0,291,231,2,"Anderson",76978,359.843072046559,0.146641438032167,189.664579490244,58.4582608017875,14.6641438032166
2021-10-05,12557,53,8619,29,3938,24,9568,30,71991,127,81559,157,2,206,0,291,232,1,"Anderson",76978,365.039361895607,0.144292237442922,203.954376575125,68.8508404998831,14.4292237442922
2021-10-06,12586,29,8641,22,3945,7,9594,26,72156,165,81750,191,1,207,0,291,233,1,"Anderson",76978,352.048637272987,0.15462962962963,248.122840292031,37.6731014055964,15.462962962963
2021-10-07,12619,33,8662,21,3957,12,9618,24,72295,139,81913,163,0,207,0,291,235,2,"Anderson",76978,314.375535867391,0.146459747817653,211.748811348697,42.8693912546442,14.6459747817653
2021-10-08,12638,19,8667,5,3971,14,9627,9,72425,130,82052,139,1,208,1,292,235,0,"Anderson",76978,272.805217075008,0.132323232323232,180.57107225441,24.682376782977,13.2323232323232
2021-10-09,12653,15,8670,3,3983,12,9634,7,72487,62,82121,69,0,208,0,292,236,1,"Anderson",76978,270.207072150485,0.135662898252826,89.6359998960742,19.4860869339292,13.5662898252826
2021-10-10,12663,10,8678,8,3985,2,9643,9,72574,87,82217,96,0,208,0,292,236,0,"Anderson",76978,265.010782301437,0.136316337148803,124.710956377147,12.9907246226195,13.6316337148803
2021-10-11,12703,40,8692,14,4011,26,9656,13,72675,101,82331,114,0,208,1,293,236,0,"Anderson",76978,258.515419990127,0.127018299246502,148.094260697862,51.9628984904778,12.7018299246502
2021-10-12,12739,36,8717,25,4022,11,9679,23,72774,99,82453,122,2,210,3,296,236,0,"Anderson",76978,236.431188131674,0.124161073825503,158.486840395957,46.76660864143,12.4161073825503
2021-10-13,12765,26,8731,14,4034,12,9697,18,72886,112,82583,130,0,210,1,297,239,3,"Anderson",76978,232.533970744888,0.123649459783914,168.879420094053,33.7758840188106,12.3649459783914
2021-10-14,12785,20,8741,10,4044,10,9711,14,72989,103,82700,117,1,211,0,297,239,0,"Anderson",76978,215.646028735483,0.118170266836086,151.991478084648,25.9814492452389,11.8170266836086
2021-10-15,12808,23,8753,12,4055,11,9724,13,73110,121,82834,134,0,211,1,298,239,0,"Anderson",76978,220.842318584531,0.124040920716113,174.075709943101,29.8786666320247,12.4040920716113
2021-10-16,12818,10,8760,7,4058,3,9733,9,73165,55,82898,64,0,211,1,299,239,0,"Anderson",76978,214.346956273221,0.127413127413127,83.1406375847645,12.9907246226195,12.7413127413127
2021-10-17,12820,2,8761,1,4059,1,9734,1,73216,51,82950,52,0,211,0,299,239,0,"Anderson",76978,203.954376575125,0.124147339699864,67.5517680376211,2.59814492452389,12.4147339699864
2021-10-18,12844,24,8771,10,4073,14,9745,11,73283,67,83028,78,1,212,1,300,239,0,"Anderson",76978,183.169217178934,0.127690100430416,101.327652056432,31.1777390942867,12.7690100430416
2021-10-19,12874,30,8784,13,4090,17,9756,11,73394,111,83150,122,2,214,1,301,239,0,"Anderson",76978,175.374782405363,0.110473457675753,158.486840395957,38.9721738678584,11.0473457675753
2021-10-20,12909,35,8810,26,4099,9,9785,29,73505,111,83290,140,0,214,1,302,240,1,"Anderson",76978,187.06643456572,0.124469589816124,181.870144716672,45.4675361791681,12.4469589816124
2021-10-21,12941,32,8828,18,4113,14,9803,18,73598,93,83401,111,0,214,1,303,241,1,"Anderson",76978,202.655304112863,0.131241084165478,144.197043311076,41.5703187923822,13.1241084165478
2021-10-22,12951,10,8835,7,4116,3,9812,9,73674,76,83486,85,0,214,1,304,241,0,"Anderson",76978,185.767362103458,0.134969325153374,110.421159292265,12.9907246226195,13.4969325153374
2021-10-23,12968,17,8839,4,4129,13,9816,4,73727,53,83543,57,0,214,1,305,241,0,"Anderson",76978,194.860869339292,0.128682170542636,74.0471303489309,22.0842318584531,12.8682170542636
2021-10-24,12974,6,8844,5,4130,1,9823,7,73779,52,83602,59,0,214,0,305,242,1,"Anderson",76978,200.05715918834,0.136503067484663,76.6452752734548,7.79443477357167,13.6503067484663
2021-10-25,12999,25,8858,14,4141,11,9838,15,73850,71,83688,86,1,215,2,307,242,0,"Anderson",76978,201.356231650601,0.140909090909091,111.720231754527,32.4768115565486,14.0909090909091
2021-10-26,13011,12,8864,6,4147,6,9844,6,73914,64,83758,70,0,215,0,307,243,1,"Anderson",76978,177.972927329886,0.144736842105263,90.9350723583361,15.5888695471433,14.4736842105263
2021-10-27,13029,18,8874,10,4155,8,9857,13,74035,121,83892,134,1,216,2,309,245,2,"Anderson",76978,155.888695471433,0.119601328903654,174.075709943101,23.383304320715,11.9601328903654
2021-10-28,13051,22,8888,14,4163,8,9874,17,74117,82,83991,99,1,217,0,309,246,1,"Anderson",76978,142.897970848814,0.120338983050847,128.608173763933,28.5795941697628,12.0338983050847
2021-10-29,13072,21,8899,11,4173,10,9886,12,74230,113,84116,125,0,217,1,310,246,0,"Anderson",76978,157.187767933695,0.117460317460317,162.384057782743,27.2805217075008,11.7460317460317
2021-10-30,13084,12,8903,4,4181,8,9891,5,74317,87,84208,92,0,217,1,311,246,0,"Anderson",76978,150.692405622386,0.112781954887218,119.514666528099,15.5888695471433,11.2781954887218
2021-10-31,13087,3,8905,2,4182,1,9894,3,74356,39,84250,42,0,217,0,311,246,0,"Anderson",76978,146.7951882356,0.109567901234568,54.5610434150017,3.89721738678583,10.9567901234568
2021-11-01,13114,27,8910,5,4204,22,9898,4,74443,87,84341,91,1,218,1,312,247,1,"Anderson",76978,149.393333160124,0.0918836140888208,118.215594065837,35.0749564810725,9.18836140888208
2021-11-02,13134,20,8915,5,4219,15,9903,5,74519,76,84422,81,2,220,1,313,247,0,"Anderson",76978,159.785912858219,0.088855421686747,105.224869443218,25.9814492452389,8.8855421686747
2021-11-03,13164,30,8933,18,4231,12,9921,18,74719,200,84640,218,1,221,0,313,247,0,"Anderson",76978,175.374782405363,0.0855614973262032,283.197796773104,38.9721738678584,8.55614973262032
2021-11-04,13186,22,8948,15,4238,7,9937,16,74849,130,84786,146,0,221,0,313,247,0,"Anderson",76978,175.374782405363,0.0792452830188679,189.664579490244,28.5795941697628,7.92452830188679
2021-11-05,13196,10,8951,3,4245,7,9938,1,74968,119,84906,120,0,221,0,313,247,0,"Anderson",76978,161.084985320481,0.0658227848101266,155.888695471433,12.9907246226195,6.58227848101266
2021-11-06,13205,9,8955,4,4250,5,9943,5,75053,85,84996,90,0,221,3,316,248,1,"Anderson",76978,157.187767933695,0.065989847715736,116.916521603575,11.6916521603575,6.5989847715736
2021-11-07,13211,6,8960,5,4251,1,9949,6,75101,48,85050,54,0,221,0,316,248,0,"Anderson",76978,161.084985320481,0.06875,70.149912962145,7.79443477357167,6.875
2021-11-08,13236,25,8971,11,4265,14,9962,13,75187,86,85149,99,1,222,0,316,248,0,"Anderson",76978,158.486840395957,0.0792079207920792,128.608173763933,32.4768115565486,7.92079207920792
2021-11-09,13259,23,8978,7,4281,16,9968,6,75341,154,85309,160,1,223,0,316,249,1,"Anderson",76978,162.384057782743,0.0732807215332582,207.851593961911,29.8786666320247,7.32807215332582
2021-11-10,13277,18,8990,12,4287,6,9981,13,75455,114,85436,127,0,223,1,317,250,1,"Anderson",76978,146.7951882356,0.0753768844221105,164.982202707267,23.383304320715,7.53768844221105
2021-11-11,13300,23,9008,18,4292,5,9999,18,75645,190,85644,208,0,223,0,317,251,1,"Anderson",76978,148.094260697862,0.0722610722610723,270.207072150485,29.8786666320247,7.22610722610723
2021-11-12,13313,13,9016,8,4297,5,10007,8,75773,128,85780,136,0,223,1,318,251,0,"Anderson",76978,151.991478084648,0.0789473684210526,176.673854867625,16.8879420094053,7.89473684210526
2021-11-13,13320,7,9020,4,4300,3,10011,4,75824,51,85835,55,3,226,1,319,252,1,"Anderson",76978,149.393333160124,0.0810488676996424,71.448985424407,9.09350723583361,8.10488676996424
2021-11-14,13322,2,9022,2,4300,0,10014,3,75903,79,85917,82,0,226,0,319,252,0,"Anderson",76978,144.197043311076,0.0749711649365629,106.523941905479,2.59814492452389,7.49711649365629
2021-11-15,13354,32,9036,14,4318,18,10028,14,75987,84,86015,98,0,226,0,319,253,1,"Anderson",76978,153.29055054691,0.0762124711316397,127.309101301671,41.5703187923822,7.62124711316397
2021-11-16,13379,25,9049,13,4330,12,10041,13,76105,118,86146,131,1,227,0,319,254,1,"Anderson",76978,155.888695471433,0.0872162485065711,170.178492556315,32.4768115565486,8.72162485065711
2021-11-17,13396,17,9058,9,4338,8,10050,9,76219,114,86269,123,0,227,2,321,256,2,"Anderson",76978,154.589623009171,0.0828331332533013,159.785912858219,22.0842318584531,8.28331332533013
2021-11-18,13418,22,9071,13,4347,9,10067,17,76349,130,86416,147,4,231,0,321,258,2,"Anderson",76978,153.29055054691,0.0880829015544041,190.963651952506,28.5795941697628,8.80829015544041
2021-11-19,13432,14,9077,6,4355,8,10074,7,76458,109,86532,116,1,232,0,321,258,0,"Anderson",76978,154.589623009171,0.0890957446808511,150.692405622386,18.1870144716672,8.90957446808511
2021-11-20,13441,9,9082,5,4359,4,10079,5,76550,92,86629,97,0,232,0,321,259,1,"Anderson",76978,157.187767933695,0.0856423173803526,126.010028839409,11.6916521603575,8.56423173803526
2021-11-21,13453,12,9088,6,4365,6,10085,6,76590,40,86675,46,0,232,0,321,259,0,"Anderson",76978,170.178492556315,0.0936675461741425,59.7573332640495,15.5888695471433,9.36675461741425
2021-11-22,13481,28,9105,17,4376,11,10103,18,76712,122,86815,140,1,233,0,321,259,0,"Anderson",76978,164.982202707267,0.09375,181.870144716672,36.3740289433345,9.375
2021-11-23,13498,17,9111,6,4387,11,10108,5,76809,97,86917,102,0,233,1,322,261,2,"Anderson",76978,154.589623009171,0.0869001297016861,132.505391150718,22.0842318584531,8.69001297016861
2021-11-24,13523,25,9127,16,4396,9,10120,12,76919,110,87039,122,1,234,1,323,261,0,"Anderson",76978,164.982202707267,0.0909090909090909,158.486840395957,32.4768115565486,9.09090909090909
2021-11-25,13528,5,9129,2,4399,3,10121,1,76964,45,87085,46,0,234,2,325,261,0,"Anderson",76978,142.897970848814,0.0807174887892377,59.7573332640495,6.49536231130973,8.07174887892377
2021-11-26,13535,7,9135,6,4400,1,10130,9,77007,43,87137,52,0,234,0,325,262,1,"Anderson",76978,133.80446361298,0.0925619834710744,67.5517680376211,9.09350723583361,9.25619834710744
2021-11-27,13540,5,9137,2,4403,3,10132,2,77043,36,87175,38,0,234,0,325,262,0,"Anderson",76978,128.608173763933,0.0970695970695971,49.3647535659539,6.49536231130973,9.70695970695971
2021-11-28,13550,10,9138,1,4412,9,10133,1,77081,38,87214,39,0,234,0,325,262,0,"Anderson",76978,126.010028839409,0.0890538033395176,50.6638260282159,12.9907246226195,8.90538033395176
2021-11-29,13577,27,9153,15,4424,12,10149,16,77160,79,87309,95,0,234,0,325,262,0,"Anderson",76978,124.710956377147,0.0931174089068826,123.411883914885,35.0749564810725,9.31174089068826
2021-11-30,13603,26,9166,13,4437,13,10161,12,77262,102,87423,114,0,234,1,326,262,0,"Anderson",76978,136.402608537504,0.104743083003953,148.094260697862,33.7758840188106,10.4743083003953
2021-12-01,13635,32,9185,19,4450,13,10180,19,77369,107,87549,126,0,234,2,328,262,0,"Anderson",76978,145.496115773338,0.117647058823529,163.683130245005,41.5703187923822,11.7647058823529
2021-12-02,13677,42,9209,24,4468,18,10206,26,77507,138,87713,164,0,234,0,328,265,3,"Anderson",76978,193.56179687703,0.135350318471338,213.047883810959,54.5610434150017,13.5350318471338
2021-12-03,13708,31,9227,18,4481,13,10225,19,77694,187,87919,206,1,235,1,329,265,0,"Anderson",76978,224.739535971316,0.121483375959079,267.608927225961,40.2712463301203,12.1483375959079
2021-12-04,13728,20,9240,13,4488,7,10239,14,77763,69,88002,83,0,235,0,329,265,0,"Anderson",76978,244.225622905246,0.129383313180169,107.823014367741,25.9814492452389,12.9383313180169
2021-12-05,13741,13,9242,2,4499,11,10241,2,77805,42,88046,44,0,235,0,329,265,0,"Anderson",76978,248.122840292031,0.129807692307692,57.1591883395256,16.8879420094053,12.9807692307692
2021-12-06,13776,35,9262,20,4514,15,10263,22,77907,102,88170,124,2,237,1,330,265,0,"Anderson",76978,258.515419990127,0.132404181184669,161.084985320481,45.4675361791681,13.2404181184669
2021-12-07,13806,30,9277,15,4529,15,10279,16,78002,95,88281,111,0,237,0,330,265,0,"Anderson",76978,263.711709839175,0.137529137529138,144.197043311076,38.9721738678584,13.7529137529138
2021-12-08,13833,27,9298,21,4535,6,10299,20,78122,120,88421,140,0,237,2,332,265,0,"Anderson",76978,257.216347527865,0.136467889908257,181.870144716672,35.0749564810725,13.6467889908257
2021-12-09,13861,28,9314,16,4547,12,10316,17,78327,205,88643,222,0,237,1,333,265,0,"Anderson",76978,239.029333056198,0.118279569892473,288.394086622152,36.3740289433345,11.8279569892473
2021-12-10,13890,29,9331,17,4559,12,10333,17,78479,152,88812,169,0,237,2,335,265,0,"Anderson",76978,236.431188131674,0.120940649496081,219.543246122269,37.6731014055964,12.0940649496081
2021-12-11,13899,9,9336,5,4563,4,10339,6,78554,75,88893,81,0,237,0,335,266,1,"Anderson",76978,222.141391046793,0.112233445566779,105.224869443218,11.6916521603575,11.2233445566779
2021-12-12,13919,20,9347,11,4572,9,10350,11,78624,70,88974,81,0,237,0,335,266,0,"Anderson",76978,231.234898282626,0.117456896551724,105.224869443218,25.9814492452389,11.7456896551724
2021-12-13,13948,29,9353,6,4595,23,10357,7,78699,75,89056,82,0,237,0,335,269,3,"Anderson",76978,223.440463509055,0.106094808126411,106.523941905479,37.6731014055964,10.6094808126411
2021-12-14,13962,14,9358,5,4604,9,10363,6,78778,79,89141,85,3,240,1,336,269,0,"Anderson",76978,202.655304112863,0.0976744186046512,110.421159292265,18.1870144716672,9.76744186046512
2021-12-15,13988,26,9372,14,4616,12,10378,15,78907,129,89285,144,0,240,0,336,270,1,"Anderson",76978,201.356231650601,0.0914351851851852,187.06643456572,33.7758840188106,9.14351851851852
2021-12-16,14016,28,9382,10,4634,18,10393,15,79002,95,89395,110,0,240,2,338,270,0,"Anderson",76978,201.356231650601,0.102393617021277,142.897970848814,36.3740289433345,10.2393617021277
2021-12-17,14047,31,9405,23,4642,8,10415,22,79145,143,89560,165,1,241,0,338,271,1,"Anderson",76978,203.954376575125,0.109625668449198,214.346956273221,40.2712463301203,10.9625668449198
2021-12-18,14058,11,9414,9,4644,2,10425,10,79227,82,89652,92,0,241,0,338,271,0,"Anderson",76978,206.552521499649,0.1133069828722,119.514666528099,14.2897970848814,11.33069828722
2021-12-19,14072,14,9422,8,4650,6,10436,11,79307,80,89743,91,0,241,0,338,271,0,"Anderson",76978,198.758086726078,0.11183355006502,118.215594065837,18.1870144716672,11.183355006502
2021-12-20,14096,24,9438,16,4658,8,10450,14,79392,85,89842,99,0,241,0,338,272,1,"Anderson",76978,192.262724414768,0.118320610687023,128.608173763933,31.1777390942867,11.8320610687023
2021-12-21,14124,28,9446,8,4678,20,10461,11,79473,81,89934,92,0,241,0,338,272,0,"Anderson",76978,210.449738886435,0.123581336696091,119.514666528099,36.3740289433345,12.3581336696091
2021-12-22,14172,48,9460,14,4712,34,10472,11,79580,107,90052,118,19,260,1,339,273,1,"Anderson",76978,239.029333056198,0.122555410691004,153.29055054691,62.3554781885734,12.2555410691004
2021-12-23,14199,27,9475,15,4724,12,10489,17,79680,100,90169,117,-1,259,1,340,274,1,"Anderson",76978,237.730260593936,0.124031007751938,151.991478084648,35.0749564810725,12.4031007751938
2021-12-24,14225,26,9490,15,4735,11,10506,17,79767,87,90273,104,0,259,1,341,274,0,"Anderson",76978,231.234898282626,0.127629733520337,135.103536075242,33.7758840188106,12.7629733520337
2021-12-25,14239,14,9497,7,4742,7,10516,10,79825,58,90341,68,1,260,0,341,275,1,"Anderson",76978,235.132115669412,0.132075471698113,88.3369274338123,18.1870144716672,13.2075471698113
2021-12-26,14250,11,9501,4,4749,7,10522,6,79869,44,90391,50,1,261,0,341,275,0,"Anderson",76978,231.234898282626,0.132716049382716,64.9536231130973,14.2897970848814,13.2716049382716
2021-12-27,14297,47,9520,19,4777,28,10542,20,79968,99,90510,119,1,262,2,343,276,1,"Anderson",76978,261.113564914651,0.137724550898204,154.589623009171,61.0564057263114,13.7724550898204
2021-12-28,14384,87,9556,36,4828,51,10578,36,80077,109,90655,145,0,262,0,343,276,0,"Anderson",76978,337.758840188106,0.162274618585298,188.365507027982,113.019304216789,16.2274618585298
2021-12-29,14465,81,9600,44,4865,37,10625,47,80235,158,90860,205,2,264,0,343,276,0,"Anderson",76978,380.62823144275,0.189356435643564,266.309854763699,105.224869443218,18.9356435643564
2021-12-30,14558,93,9642,42,4916,51,10663,38,80352,117,91015,155,1,265,0,343,276,0,"Anderson",76978,466.367013952038,0.205673758865248,201.356231650601,120.813738990361,20.5673758865248
2021-12-31,14626,68,9683,41,4943,27,10708,45,80468,116,91176,161,0,265,0,343,277,1,"Anderson",76978,520.92805736704,0.223698781838317,209.150666424173,88.3369274338123,22.3698781838317
2022-01-01,14687,61,9717,34,4970,27,10745,37,80567,99,91312,136,0,265,0,343,277,0,"Anderson",76978,581.984463093351,0.235839340885685,176.673854867625,79.2434201979787,23.5839340885685
2022-01-02,14719,32,9740,23,4979,9,10778,33,80683,116,91461,149,0,265,0,343,278,1,"Anderson",76978,609.264984800852,0.239252336448598,193.56179687703,41.5703187923822,23.9252336448598
2022-01-03,14780,61,9761,21,5019,40,10801,23,80759,76,91560,99,1,266,0,343,278,0,"Anderson",76978,627.451999272519,0.246666666666667,128.608173763933,79.2434201979787,24.6666666666667
2022-01-04,14906,126,9826,65,5080,61,10864,63,80933,174,91797,237,1,267,0,343,279,1,"Anderson",76978,678.115825300735,0.250437828371278,307.880173556081,163.683130245005,25.0437828371278
2022-01-05,15073,167,9912,86,5161,81,10950,86,81079,146,92029,232,1,268,0,343,280,1,"Anderson",76978,789.836057055263,0.278015397775877,301.384811244771,216.945101197745,27.8015397775877
2022-01-06,15215,142,9984,72,5231,70,11021,71,81199,120,92220,191,1,269,1,344,280,0,"Anderson",76978,853.490607706098,0.297095435684647,248.122840292031,184.468289641196,29.7095435684647
2022-01-07,15357,142,10057,73,5300,69,11099,78,81339,140,92438,218,0,269,1,345,280,0,"Anderson",76978,949.621969913482,0.309825673534073,283.197796773104,184.468289641196,30.9825673534073
2022-01-08,15460,103,10099,42,5361,61,11144,45,81414,75,92558,120,0,269,2,347,282,2,"Anderson",76978,1004.18301332848,0.320224719101124,155.888695471433,133.80446361298,32.0224719101124
2022-01-09,15545,85,10155,56,5390,29,11206,62,81557,143,92763,205,0,269,1,348,282,0,"Anderson",76978,1073.03385382837,0.328725038402458,266.309854763699,110.421159292265,32.8725038402458
2022-01-10,15700,155,10229,74,5471,81,11284,78,81670,113,92954,191,1,270,3,351,284,2,"Anderson",76978,1195.14666528099,0.34648493543759,248.122840292031,201.356231650601,34.648493543759
2022-01-11,15875,175,10338,109,5537,66,11386,102,81811,141,93197,243,0,270,0,351,285,1,"Anderson",76978,1258.80121593182,0.372857142857143,315.674608329653,227.33768089584,37.2857142857143
2022-01-12,16134,259,10501,163,5633,96,11550,164,82002,191,93552,355,0,270,1,352,285,0,"Anderson",76978,1378.31588245992,0.393959290873276,461.17072410299,336.459767725844,39.3959290873276
2022-01-13,16366,232,10652,151,5714,81,11705,155,82234,232,93939,387,4,274,0,352,285,0,"Anderson",76978,1495.2324040635,0.397905759162304,502.741042895373,301.384811244771,39.7905759162304
2022-01-14,16620,254,10795,143,5825,111,11854,149,82390,156,94244,305,2,276,1,353,285,0,"Anderson",76978,1640.72851983684,0.418050941306755,396.217100989893,329.964405414534,41.8050941306755
2022-01-15,16717,97,10854,59,5863,38,11916,62,82508,118,94424,180,1,277,2,355,285,0,"Anderson",76978,1632.93408506326,0.413719185423365,233.83304320715,126.010028839409,41.3719185423366
2022-01-16,16869,152,10982,128,5887,24,12049,133,82705,197,94754,330,0,277,1,356,285,0,"Anderson",76978,1719.97194003482,0.42340532395781,428.693912546442,197.459014263816,42.340532395781
2022-01-17,17049,180,11094,112,5955,68,12165,116,82824,119,94989,235,0,277,2,358,285,0,"Anderson",76978,1752.44875159136,0.432923832923833,305.282028631557,233.83304320715,43.2923832923833
2022-01-18,17265,216,11234,140,6031,76,12308,143,82961,137,95269,280,0,277,0,358,287,2,"Anderson",76978,1805.7107225441,0.444980694980695,363.740289433345,280.59965184858,44.4980694980695
2022-01-19,17568,303,11446,212,6122,91,12523,215,83181,220,95704,435,3,280,0,358,287,0,"Anderson",76978,1862.86991088363,0.452137546468401,565.096521083946,393.618956065369,45.2137546468402
2022-01-20,17866,298,11689,243,6177,55,12785,262,83338,157,96123,419,1,281,2,360,288,1,"Anderson",76978,1948.60869339292,0.494505494505495,544.311361687755,387.12359375406,49.4505494505495
2022-01-21,18112,246,11904,215,6208,31,13010,225,83557,219,96567,444,2,283,1,361,290,2,"Anderson",76978,1938.21611369482,0.497632371932845,576.788173244304,319.571825716438,49.7632371932845
2022-01-22,18241,129,11996,92,6245,37,13114,104,83676,119,96790,223,0,283,0,361,290,0,"Anderson",76978,1979.7864324872,0.506339814032122,289.693159084414,167.580347631791,50.6339814032122
2022-01-23,18369,128,12107,111,6262,17,13228,114,83783,107,97011,221,0,283,0,361,291,1,"Anderson",76978,1948.60869339292,0.522374833850244,287.09501415989,166.281275169529,52.2374833850244
2022-01-24,18637,268,12257,150,6380,118,13389,161,83961,178,97350,339,1,284,1,362,292,1,"Anderson",76978,2062.92707007197,0.518424396442186,440.385564706799,348.151419886201,51.8424396442186
2022-01-25,18821,184,12390,133,6431,51,13534,145,84081,120,97615,265,1,285,0,362,293,1,"Anderson",76978,2021.35675127959,0.522591645353794,344.254202499415,239.029333056198,52.2591645353794
2022-01-26,19027,206,12545,155,6482,51,13701,167,84233,152,97934,319,1,286,2,364,293,0,"Anderson",76978,1895.34672244018,0.528251121076233,414.40411546156,267.608927225961,52.8251121076233
2022-01-27,19250,223,12719,174,6531,49,13881,180,84453,220,98334,400,0,286,0,364,293,0,"Anderson",76978,1797.91628777053,0.495703301673451,519.628984904778,289.693159084414,49.5703301673451
2022-01-28,19440,190,12857,138,6583,52,14025,144,84616,163,98641,307,1,287,1,365,294,1,"Anderson",76978,1725.16822988386,0.489392478302797,398.815245914417,246.82376782977,48.9392478302797
2022-01-29,19584,144,12958,101,6626,43,14131,106,84733,117,98864,223,0,287,0,365,296,2,"Anderson",76978,1744.65431681779,0.490356798457088,289.693159084414,187.06643456572,49.0356798457088
2022-01-30,19651,67,13004,46,6647,21,14181,50,84824,91,99005,141,0,287,2,367,297,1,"Anderson",76978,1665.41089661981,0.477933801404213,183.169217178934,87.0378549715503,47.7933801404213
2022-01-31,19847,196,13125,121,6722,75,14322,141,84974,150,99296,291,4,291,1,368,299,2,"Anderson",76978,1571.87767933695,0.479445015416238,378.030086518226,254.618202603341,47.9445015416238
2022-02-01,20010,163,13220,95,6790,68,14429,107,85094,120,99523,227,1,292,1,369,299,0,"Anderson",76978,1544.59715762945,0.469077568134172,294.889448933461,211.748811348697,46.9077568134172
2022-02-02,20155,145,13307,87,6848,58,14522,93,85235,141,99757,234,1,293,0,369,300,1,"Anderson",76978,1465.35373743147,0.450356555128908,303.982956169295,188.365507027982,45.0356555128908
2022-02-03,20789,634,13399,92,7390,542,14621,99,85443,208,100064,307,2,295,1,370,302,2,"Anderson",76978,1999.27251942113,0.427745664739884,398.815245914417,823.611941074073,42.7745664739884
2022-02-04,20936,147,13510,111,7426,36,14732,111,85567,124,100299,235,0,295,0,370,305,3,"Anderson",76978,1943.41240354387,0.426417370325694,305.282028631557,190.963651952506,42.6417370325694
2022-02-05,20985,49,13536,26,7449,23,14762,30,85643,76,100405,106,0,295,0,370,306,1,"Anderson",76978,1820.00051962898,0.409474367293965,137.701680999766,63.6545506508353,40.9474367293965
2022-02-06,21044,59,13580,44,7464,15,14811,49,85717,74,100528,123,0,295,1,371,308,2,"Anderson",76978,1809.60793993089,0.41365725541694,159.785912858219,76.6452752734548,41.365725541694
2022-02-07,21128,84,13631,51,7497,33,14867,56,85819,102,100686,158,3,298,0,371,309,1,"Anderson",76978,1664.11182415755,0.392086330935252,205.253449037387,109.122086830003,39.2086330935252
2022-02-08,21214,86,13679,48,7535,38,14925,58,85916,97,100841,155,0,298,0,371,309,0,"Anderson",76978,1564.08324456338,0.376327769347496,201.356231650601,111.720231754527,37.6327769347496
2022-02-09,21313,99,13743,64,7570,35,14999,74,86023,107,101022,181,0,298,0,371,310,1,"Anderson",76978,1504.32591129933,0.377075098814229,235.132115669412,128.608173763933,37.7075098814229
2022-02-10,21401,88,13793,50,7608,38,15053,54,86149,126,101202,180,2,300,0,371,311,1,"Anderson",76978,795.03234690431,0.379613356766257,233.83304320715,114.318376679051,37.9613356766257
2022-02-11,21461,60,13836,43,7625,17,15099,46,86251,102,101350,148,1,301,0,371,311,0,"Anderson",76978,682.013042687521,0.34919124643197,192.262724414768,77.9443477357167,34.919124643197
2022-02-12,21492,31,13859,23,7633,8,15124,25,86313,62,101437,87,0,301,1,372,311,0,"Anderson",76978,658.629738366806,0.35077519379845,113.019304216789,40.2712463301203,35.077519379845
2022-02-13,21513,21,13873,14,7640,7,15139,15,86360,47,101499,62,0,301,0,372,312,1,"Anderson",76978,609.264984800852,0.337796086508754,80.5424926602406,27.2805217075008,33.7796086508754
2022-02-14,21564,51,13900,27,7664,24,15175,36,86417,57,101592,93,1,302,0,372,312,0,"Anderson",76978,566.395593546208,0.339955849889625,120.813738990361,66.2526955753592,33.9955849889625
2022-02-15,21621,57,13939,39,7682,18,15220,45,86494,77,101714,122,0,302,0,372,313,1,"Anderson",76978,528.722492140612,0.337915234822451,158.486840395957,74.0471303489309,33.7915234822451
2022-02-16,21683,62,13972,33,7711,29,15251,31,86586,92,101837,123,0,302,0,372,313,0,"Anderson",76978,480.65681103692,0.30920245398773,159.785912858219,80.5424926602406,30.920245398773
2022-02-17,21731,48,14005,33,7726,15,15286,35,86680,94,101966,129,0,302,0,372,314,1,"Anderson",76978,428.693912546442,0.304973821989529,167.580347631791,62.3554781885734,30.4973821989529
2022-02-18,21779,48,14036,31,7743,17,15323,37,86752,72,102075,109,0,302,0,372,315,1,"Anderson",76978,413.105042999299,0.308965517241379,141.598898386552,62.3554781885734,30.8965517241379
2022-02-19,21805,26,14046,10,7759,16,15334,11,86807,55,102141,66,0,302,0,372,317,2,"Anderson",76978,406.609680687989,0.298295454545455,85.7387825092884,33.7758840188106,29.8295454545455
2022-02-20,21815,10,14049,3,7766,7,15336,2,86844,37,102180,39,0,302,0,372,317,0,"Anderson",76978,392.319883603107,0.28928046989721,50.6638260282159,12.9907246226195,28.928046989721
2022-02-21,21831,16,14058,9,7773,7,15346,10,86873,29,102219,39,0,302,2,374,318,1,"Anderson",76978,346.852347423939,0.272727272727273,50.6638260282159,20.7851593961911,27.2727272727273
2022-02-22,21866,35,14073,15,7793,20,15364,18,86950,77,102314,95,2,304,0,374,318,0,"Anderson",76978,318.272753254177,0.24,123.411883914885,45.4675361791681,24
2022-02-23,21902,36,14091,18,7811,18,15384,20,87016,66,102400,86,4,308,0,374,319,1,"Anderson",76978,284.496869235366,0.236234458259325,111.720231754527,46.76660864143,23.6234458259325
2022-02-24,21930,28,14105,14,7825,14,15401,17,87094,78,102495,95,1,309,0,374,320,1,"Anderson",76978,258.515419990127,0.217391304347826,123.411883914885,36.3740289433345,21.7391304347826
2022-02-25,21943,13,14111,6,7832,7,15407,6,87161,67,102568,73,-1,308,0,374,320,0,"Anderson",76978,213.047883810959,0.170385395537525,94.832289745122,16.8879420094053,17.0385395537525
2022-02-26,21956,13,14116,5,7840,8,15414,7,87206,45,102620,52,0,308,1,375,320,0,"Anderson",76978,196.159941801554,0.167014613778706,67.5517680376211,16.8879420094053,16.7014613778706
2022-02-27,21956,0,14116,0,7840,0,15415,1,87223,17,102638,18,0,308,0,375,320,0,"Anderson",76978,183.169217178934,0.172489082969432,23.383304320715,0,17.2489082969432
2022-02-28,21974,18,14125,9,7849,9,15427,12,87280,57,102707,69,0,308,0,375,320,0,"Anderson",76978,185.767362103458,0.165983606557377,89.6359998960742,23.383304320715,16.5983606557377
2022-03-01,21987,13,14132,7,7855,6,15435,8,87325,45,102760,53,-1,307,0,375,322,2,"Anderson",76978,157.187767933695,0.159192825112108,68.8508404998831,16.8879420094053,15.9192825112108
2022-03-02,21997,10,14138,6,7859,4,15443,8,87378,53,102821,61,2,309,0,375,323,1,"Anderson",76978,123.411883914885,0.140142517814727,79.2434201979787,12.9907246226195,14.0142517814727
2022-03-03,22007,10,14140,2,7867,8,15445,2,87422,44,102867,46,2,311,0,375,323,0,"Anderson",76978,100.02857959417,0.118279569892473,59.7573332640495,12.9907246226195,11.8279569892473
2022-03-04,22016,9,14143,3,7873,6,15450,5,87485,63,102935,68,0,311,0,375,324,1,"Anderson",76978,94.832289745122,0.11716621253406,88.3369274338123,11.6916521603575,11.716621253406
2022-03-05,22021,5,14144,1,7877,4,15451,1,87526,41,102977,42,0,311,0,375,325,1,"Anderson",76978,84.4397100470264,0.103641456582633,54.5610434150017,6.49536231130973,10.3641456582633
2022-03-06,22023,2,14145,1,7878,1,15452,1,87550,24,103002,25,0,311,1,376,326,1,"Anderson",76978,87.0378549715503,0.101648351648352,32.4768115565486,2.59814492452389,10.1648351648352
2022-03-07,22036,13,14147,2,7889,11,15454,2,87583,33,103037,35,1,312,0,376,326,0,"Anderson",76978,80.5424926602406,0.0818181818181818,45.4675361791681,16.8879420094053,8.18181818181818
2022-03-08,22087,51,14149,2,7938,49,15457,3,87613,30,103070,33,0,312,0,376,327,1,"Anderson",76978,129.907246226195,0.0709677419354839,42.8693912546442,66.2526955753592,7.09677419354839
2022-03-09,22094,7,14155,6,7939,1,15462,5,87651,38,103113,43,0,312,0,376,327,0,"Anderson",76978,126.010028839409,0.0650684931506849,55.8601158772636,9.09350723583361,6.50684931506849
2022-03-10,22099,5,14159,4,7940,1,15469,7,87697,46,103166,53,3,315,0,376,327,0,"Anderson",76978,119.514666528099,0.0802675585284281,68.8508404998831,6.49536231130973,8.02675585284281
2022-03-11,22105,6,14159,0,7946,6,15470,1,87736,39,103206,40,1,316,1,377,327,0,"Anderson",76978,115.617449141313,0.0738007380073801,51.9628984904778,7.79443477357167,7.38007380073801
2022-03-12,22105,0,14159,0,7946,0,15470,0,87758,22,103228,22,0,316,0,377,329,2,"Anderson",76978,109.122086830003,0.0756972111553785,28.5795941697628,0,7.56972111553785
2022-03-13,22108,3,14161,2,7947,1,15471,1,87802,44,103273,45,1,317,0,377,329,0,"Anderson",76978,110.421159292265,0.0701107011070111,58.4582608017875,3.89721738678583,7.01107011070111
2022-03-14,22115,7,14165,4,7950,3,15478,7,87828,26,103306,33,2,319,1,378,329,0,"Anderson",76978,102.626724518694,0.0892193308550186,42.8693912546442,9.09350723583361,8.92193308550186
2022-03-15,22119,4,14166,1,7953,3,15478,0,87850,22,103328,22,0,319,0,378,330,1,"Anderson",76978,41.5703187923822,0.0813953488372093,28.5795941697628,5.19628984904778,8.13953488372093
2022-03-16,22121,2,14168,2,7953,0,15481,3,87874,24,103355,27,1,320,0,378,330,0,"Anderson",76978,35.0749564810725,0.0785123966942149,35.0749564810725,2.59814492452389,7.85123966942149
2022-03-17,22121,0,14168,0,7953,0,15483,2,87903,29,103386,31,0,320,0,378,330,0,"Anderson",76978,28.5795941697628,0.0636363636363636,40.2712463301203,0,6.36363636363636
2022-03-18,22123,2,14170,2,7953,0,15485,2,87947,44,103432,46,0,320,0,378,331,1,"Anderson",76978,23.383304320715,0.0663716814159292,59.7573332640495,2.59814492452389,6.63716814159292
2022-03-19,22123,0,14170,0,7953,0,15485,0,87967,20,103452,20,0,320,0,378,331,0,"Anderson",76978,23.383304320715,0.0669642857142857,25.9814492452389,0,6.69642857142857
2022-03-20,22128,5,14174,4,7954,1,15490,5,87986,19,103476,24,0,320,0,378,332,1,"Anderson",76978,25.9814492452389,0.0935960591133005,31.1777390942867,6.49536231130973,9.35960591133005
2022-03-21,22129,1,14174,0,7955,1,15490,0,87999,13,103489,13,2,322,0,378,332,0,"Anderson",76978,18.1870144716672,0.0655737704918033,16.8879420094053,1.29907246226194,6.55737704918033
2022-03-22,22129,0,14174,0,7955,0,15491,1,88005,6,103496,7,0,322,0,378,332,0,"Anderson",76978,12.9907246226194,0.0773809523809524,9.09350723583361,0,7.73809523809524
2022-03-23,22131,2,14176,2,7955,0,15493,2,88030,25,103523,27,0,322,0,378,333,1,"Anderson",76978,12.9907246226194,0.0714285714285714,35.0749564810725,2.59814492452389,7.14285714285714
2022-03-24,22132,1,14176,0,7956,1,15494,1,88046,16,103540,17,0,322,0,378,334,1,"Anderson",76978,14.2897970848814,0.0714285714285714,22.0842318584531,1.29907246226194,7.14285714285714
2022-03-25,22133,1,14177,1,7956,0,15496,2,88069,23,103565,25,0,322,0,378,334,0,"Anderson",76978,12.9907246226194,0.0827067669172932,32.4768115565486,1.29907246226194,8.27067669172932
2022-03-26,22134,1,14178,1,7956,0,15497,1,88088,19,103585,20,0,322,0,378,334,0,"Anderson",76978,14.2897970848814,0.0902255639097744,25.9814492452389,1.29907246226194,9.02255639097744
2022-03-27,22134,0,14178,0,7956,0,15497,0,88099,11,103596,11,0,322,0,378,334,0,"Anderson",76978,7.79443477357167,0.0583333333333333,14.2897970848814,0,5.83333333333333
2022-03-28,22138,4,14181,3,7957,1,15500,3,88143,44,103643,47,1,323,0,378,336,2,"Anderson",76978,11.6916521603575,0.0649350649350649,61.0564057263114,5.19628984904778,6.49350649350649
2022-03-29,22138,0,14181,0,7957,0,15500,0,88156,13,103656,13,1,324,0,378,337,1,"Anderson",76978,11.6916521603575,0.05625,16.8879420094053,0,5.625
2022-03-30,22140,2,14181,0,7959,2,15501,1,88179,23,103680,24,1,325,0,378,337,0,"Anderson",76978,11.6916521603575,0.0509554140127389,31.1777390942867,2.59814492452389,5.09554140127389
2022-03-31,22142,2,14182,1,7960,1,15502,1,88199,20,103701,21,0,325,0,378,337,0,"Anderson",76978,12.9907246226194,0.0496894409937888,27.2805217075008,2.59814492452389,4.96894409937888
2022-04-01,22145,3,14183,1,7962,2,15503,1,88236,37,103739,38,3,328,0,378,337,0,"Anderson",76978,15.5888695471433,0.0402298850574713,49.3647535659539,3.89721738678583,4.02298850574713
2022-04-02,22146,1,14184,1,7962,0,15505,2,88256,20,103761,22,0,328,0,378,337,0,"Anderson",76978,15.5888695471433,0.0454545454545455,28.5795941697628,1.29907246226194,4.54545454545455
2022-04-03,22146,0,14184,0,7962,0,15505,0,88268,12,103773,12,0,328,0,378,337,0,"Anderson",76978,15.5888695471433,0.0451977401129944,15.5888695471433,0,4.51977401129944
2022-04-04,22148,2,14185,1,7963,1,15506,1,88287,19,103793,20,0,328,0,378,337,0,"Anderson",76978,12.9907246226194,0.04,25.9814492452389,2.59814492452389,4
2022-04-05,22154,6,14186,1,7968,5,15507,1,88306,19,103813,20,3,331,0,378,338,1,"Anderson",76978,20.7851593961911,0.0445859872611465,25.9814492452389,7.79443477357167,4.45859872611465
2022-04-06,22157,3,14189,3,7968,0,15511,4,88330,24,103841,28,0,331,0,378,338,0,"Anderson",76978,22.0842318584531,0.062111801242236,36.3740289433345,3.89721738678583,6.2111801242236
2022-04-07,22159,2,14189,0,7970,2,15511,0,88353,23,103864,23,1,332,0,378,338,0,"Anderson",76978,22.0842318584531,0.0552147239263804,29.8786666320247,2.59814492452389,5.52147239263804
2022-04-08,22160,1,14189,0,7971,1,15511,0,88384,31,103895,31,1,333,0,378,338,0,"Anderson",76978,19.4860869339292,0.0512820512820513,40.2712463301203,1.29907246226194,5.12820512820513
2022-04-09,22160,0,14189,0,7971,0,15511,0,88394,10,103905,10,0,333,0,378,338,0,"Anderson",76978,18.1870144716672,0.0416666666666667,12.9907246226195,0,4.16666666666667
2022-04-10,22160,0,14189,0,7971,0,15511,0,88404,10,103915,10,0,333,0,378,338,0,"Anderson",76978,18.1870144716672,0.0422535211267606,12.9907246226195,0,4.22535211267606
2022-04-11,22163,3,14189,0,7974,3,15511,0,88422,18,103933,18,0,333,0,378,338,0,"Anderson",76978,19.4860869339292,0.0357142857142857,23.383304320715,3.89721738678583,3.57142857142857
2022-04-12,22167,4,14192,3,7975,1,15515,4,88440,18,103955,22,1,334,0,378,339,1,"Anderson",76978,16.8879420094053,0.0563380281690141,28.5795941697628,5.19628984904778,5.63380281690141
2022-04-13,22170,3,14193,1,7977,2,15516,1,88462,22,103978,23,0,334,0,378,339,0,"Anderson",76978,16.8879420094053,0.0364963503649635,29.8786666320247,3.89721738678583,3.64963503649635
2022-04-14,22173,3,14193,0,7980,3,15516,0,88478,16,103994,16,0,334,0,378,339,0,"Anderson",76978,18.1870144716672,0.0384615384615385,20.7851593961911,3.89721738678583,3.84615384615385
2022-04-15,22177,4,14196,3,7981,1,15520,4,88498,20,104018,24,0,334,0,378,339,0,"Anderson",76978,22.0842318584531,0.0731707317073171,31.1777390942867,5.19628984904778,7.31707317073171
2022-04-16,22178,1,14196,0,7982,1,15520,0,88512,14,104032,14,0,334,0,378,339,0,"Anderson",76978,23.383304320715,0.0708661417322835,18.1870144716672,1.29907246226194,7.08661417322835
2022-04-17,22180,2,14196,0,7984,2,15521,1,88527,15,104048,16,0,334,0,378,339,0,"Anderson",76978,25.9814492452389,0.075187969924812,20.7851593961911,2.59814492452389,7.5187969924812
2022-04-18,22186,6,14198,2,7988,4,15523,2,88547,20,104070,22,-1,333,0,378,339,0,"Anderson",76978,29.8786666320247,0.0875912408759124,28.5795941697628,7.79443477357167,8.75912408759124
2022-04-19,22190,4,14199,1,7991,3,15524,1,88560,13,104084,14,0,333,0,378,339,0,"Anderson",76978,29.8786666320247,0.0697674418604651,18.1870144716672,5.19628984904778,6.97674418604651
2022-04-20,22196,6,14201,2,7995,4,15526,2,88593,33,104119,35,1,334,0,378,339,0,"Anderson",76978,33.7758840188106,0.0709219858156028,45.4675361791681,7.79443477357167,7.09219858156028
2022-04-21,22199,3,14202,1,7997,2,15527,1,88619,26,104146,27,0,334,0,378,339,0,"Anderson",76978,33.7758840188106,0.0723684210526316,35.0749564810725,3.89721738678583,7.23684210526316
2022-04-22,22201,2,14203,1,7998,1,15528,1,88651,32,104179,33,0,334,0,378,339,0,"Anderson",76978,31.1777390942867,0.0496894409937888,42.8693912546442,2.59814492452389,4.96894409937888
2022-04-23,22203,2,14205,2,7998,0,15529,1,88676,25,104205,26,0,334,0,378,339,0,"Anderson",76978,32.4768115565486,0.0520231213872832,33.7758840188106,2.59814492452389,5.20231213872832
2022-04-24,22206,3,14205,0,8001,3,15529,0,88693,17,104222,17,0,334,0,378,339,0,"Anderson",76978,33.7758840188106,0.0459770114942529,22.0842318584531,3.89721738678583,4.59770114942529
2022-04-25,22224,18,14207,2,8017,16,15531,2,88704,11,104235,13,0,334,0,378,340,1,"Anderson",76978,49.3647535659539,0.0484848484848485,16.8879420094053,23.383304320715,4.84848484848485
2022-04-26,22238,14,14212,5,8026,9,15537,6,88725,21,104262,27,0,334,0,378,340,0,"Anderson",76978,62.3554781885734,0.0730337078651685,35.0749564810725,18.1870144716672,7.30337078651685
2022-04-27,22252,14,14217,5,8035,9,15542,5,88761,36,104303,41,0,334,0,378,341,1,"Anderson",76978,72.7480578866689,0.0869565217391304,53.2619709527397,18.1870144716672,8.69565217391304
2022-04-28,22257,5,14219,2,8038,3,15544,2,88784,23,104328,25,0,334,0,378,341,0,"Anderson",76978,75.3462028111928,0.0934065934065934,32.4768115565486,6.49536231130973,9.34065934065934
2022-04-29,22263,6,14220,1,8043,5,15545,1,88805,21,104350,22,0,334,0,378,341,0,"Anderson",76978,80.5424926602406,0.0994152046783626,28.5795941697628,7.79443477357167,9.94152046783626
2022-04-30,22265,2,14221,1,8044,1,15545,0,88834,29,104379,29,0,334,0,378,341,0,"Anderson",76978,80.5424926602406,0.0919540229885057,37.6731014055964,2.59814492452389,9.19540229885057
2022-05-01,22267,2,14221,0,8046,2,15545,0,88842,8,104387,8,0,334,0,378,341,0,"Anderson",76978,79.2434201979786,0.096969696969697,10.3925796980956,2.59814492452389,9.6969696969697
2022-05-02,22275,8,14226,5,8049,3,15549,4,88873,31,104422,35,0,334,0,378,341,0,"Anderson",76978,66.2526955753592,0.0962566844919786,45.4675361791681,10.3925796980956,9.62566844919786
2022-05-03,22281,6,14231,5,8050,1,15554,5,88884,11,104438,16,0,334,0,378,341,0,"Anderson",76978,55.8601158772636,0.0965909090909091,20.7851593961911,7.79443477357167,9.65909090909091
2022-05-04,22293,12,14235,4,8058,8,15559,5,88908,24,104467,29,0,334,0,378,341,0,"Anderson",76978,53.2619709527397,0.103658536585366,37.6731014055964,15.5888695471433,10.3658536585366
2022-05-05,22301,8,14241,6,8060,2,15565,6,88926,18,104491,24,0,334,0,378,341,0,"Anderson",76978,57.1591883395256,0.128834355828221,31.1777390942867,10.3925796980956,12.8834355828221
2022-05-06,22302,1,14241,0,8061,1,15565,0,88950,24,104515,24,0,334,0,378,341,0,"Anderson",76978,50.6638260282159,0.121212121212121,31.1777390942867,1.29907246226194,12.1212121212121
2022-05-07,22311,9,14245,4,8066,5,15569,4,88966,16,104535,20,0,334,0,378,342,1,"Anderson",76978,59.7573332640495,0.153846153846154,25.9814492452389,11.6916521603575,15.3846153846154
2022-05-08,22312,1,14245,0,8067,1,15569,0,88980,14,104549,14,0,334,0,378,342,0,"Anderson",76978,58.4582608017875,0.148148148148148,18.1870144716672,1.29907246226194,14.8148148148148
2022-05-09,22318,6,14247,2,8071,4,15570,1,88995,15,104565,16,0,334,0,378,342,0,"Anderson",76978,55.8601158772636,0.146853146853147,20.7851593961911,7.79443477357167,14.6853146853147
2022-05-10,22328,10,14249,2,8079,8,15573,3,89027,32,104600,35,1,335,0,378,342,0,"Anderson",76978,61.0564057263114,0.117283950617284,45.4675361791681,12.9907246226195,11.7283950617284
2022-05-11,22341,13,14259,10,8082,3,15585,12,89045,18,104630,30,0,335,0,378,342,0,"Anderson",76978,62.3554781885734,0.159509202453988,38.9721738678584,16.8879420094053,15.9509202453988
2022-05-12,22347,6,14264,5,8083,1,15590,5,89073,28,104663,33,0,335,0,378,342,0,"Anderson",76978,59.7573332640495,0.145348837209302,42.8693912546442,7.79443477357167,14.5348837209302
2022-05-13,22355,8,14269,5,8086,3,15595,5,89109,36,104704,41,2,337,0,378,343,1,"Anderson",76978,68.8508404998831,0.158730158730159,53.2619709527397,10.3925796980956,15.8730158730159
2022-05-14,22358,3,14271,2,8087,1,15597,2,89118,9,104715,11,0,337,0,378,343,0,"Anderson",76978,61.0564057263114,0.155555555555556,14.2897970848814,3.89721738678583,15.5555555555556
2022-05-15,22362,4,14271,0,8091,4,15597,0,89132,14,104729,14,0,337,0,378,343,0,"Anderson",76978,64.9536231130973,0.155555555555556,18.1870144716672,5.19628984904778,15.5555555555556
2022-05-16,22372,10,14277,6,8095,4,15602,5,89155,23,104757,28,0,337,0,378,343,0,"Anderson",76978,70.149912962145,0.166666666666667,36.3740289433345,12.9907246226195,16.6666666666667
2022-05-17,22385,13,14286,9,8099,4,15612,10,89182,27,104794,37,2,339,0,378,343,0,"Anderson",76978,74.0471303489309,0.201030927835052,48.065681103692,16.8879420094053,20.1030927835052
2022-05-18,22393,8,14293,7,8100,1,15620,8,89209,27,104829,35,0,339,0,378,344,1,"Anderson",76978,67.5517680376211,0.175879396984925,45.4675361791681,10.3925796980956,17.5879396984925
2022-05-19,22403,10,14300,7,8103,3,15628,8,89236,27,104864,35,1,340,0,378,344,0,"Anderson",76978,72.7480578866689,0.189054726368159,45.4675361791681,12.9907246226195,18.9054726368159
2022-05-20,22415,12,14309,9,8106,3,15637,9,89265,29,104902,38,0,340,0,378,344,0,"Anderson",76978,77.9443477357167,0.212121212121212,49.3647535659539,15.5888695471433,21.2121212121212
2022-05-21,22421,6,14315,6,8106,0,15643,6,89291,26,104934,32,0,340,0,378,344,0,"Anderson",76978,81.8415651225025,0.210045662100457,41.5703187923822,7.79443477357167,21.0045662100457
2022-05-22,22430,9,14321,6,8109,3,15649,6,89316,25,104965,31,1,341,0,378,344,0,"Anderson",76978,88.3369274338123,0.220338983050847,40.2712463301203,11.6916521603575,22.0338983050847
2022-05-23,22441,11,14330,9,8111,2,15656,7,89349,33,105005,40,0,341,0,378,344,0,"Anderson",76978,89.6359998960742,0.217741935483871,51.9628984904778,14.2897970848814,21.7741935483871
2022-05-24,22462,21,14337,7,8125,14,15664,8,89370,21,105034,29,0,341,0,378,344,0,"Anderson",76978,100.02857959417,0.216666666666667,37.6731014055964,27.2805217075008,21.6666666666667
2022-05-25,22474,12,14343,6,8131,6,15670,6,89403,33,105073,39,1,342,0,378,344,0,"Anderson",76978,105.224869443218,0.204918032786885,50.6638260282159,15.5888695471433,20.4918032786885
2022-05-26,22491,17,14351,8,8140,9,15680,10,89444,41,105124,51,0,342,0,378,344,0,"Anderson",76978,114.318376679051,0.2,66.2526955753592,22.0842318584531,20
2022-05-27,22506,15,14360,9,8146,6,15689,9,89490,46,105179,55,0,342,0,378,344,0,"Anderson",76978,118.215594065837,0.187725631768953,71.448985424407,19.4860869339292,18.7725631768953
2022-05-28,22515,9,14366,6,8149,3,15695,6,89541,51,105236,57,0,342,0,378,344,0,"Anderson",76978,122.112811452623,0.172185430463576,74.0471303489309,11.6916521603575,17.2185430463576
2022-05-29,22523,8,14368,2,8155,6,15697,2,89563,22,105260,24,0,342,0,378,344,0,"Anderson",76978,120.813738990361,0.16271186440678,31.1777390942867,10.3925796980956,16.271186440678
2022-05-30,22528,5,14369,1,8159,4,15699,2,89578,15,105277,17,0,342,0,378,344,0,"Anderson",76978,113.019304216789,0.158088235294118,22.0842318584531,6.49536231130973,15.8088235294118
2022-05-31,22543,15,14376,7,8167,8,15705,6,89605,27,105310,33,0,342,0,378,344,0,"Anderson",76978,105.224869443218,0.148550724637681,42.8693912546442,19.4860869339292,14.8550724637681
2022-06-01,22567,24,14389,13,8178,11,15722,17,89632,27,105354,44,0,342,0,378,344,0,"Anderson",76978,120.813738990361,0.185053380782918,57.1591883395256,31.1777390942867,18.5053380782918
2022-06-02,22584,17,14398,9,8186,8,15730,8,89656,24,105386,32,0,342,0,378,344,0,"Anderson",76978,120.813738990361,0.190839694656489,41.5703187923822,22.0842318584531,19.0839694656489
2022-06-03,22598,14,14406,8,8192,6,15739,9,89706,50,105445,59,0,342,0,378,344,0,"Anderson",76978,119.514666528099,0.18796992481203,76.6452752734548,18.1870144716672,18.796992481203
2022-06-04,22605,7,14411,5,8194,2,15745,6,89735,29,105480,35,0,342,0,378,344,0,"Anderson",76978,116.916521603575,0.204918032786885,45.4675361791681,9.09350723583361,20.4918032786885
2022-06-05,22615,10,14418,7,8197,3,15753,8,89752,17,105505,25,0,342,0,378,344,0,"Anderson",76978,119.514666528099,0.228571428571429,32.4768115565486,12.9907246226195,22.8571428571429
2022-06-06,22641,26,14431,13,8210,13,15766,13,89775,23,105541,36,0,342,0,378,345,1,"Anderson",76978,146.7951882356,0.253787878787879,46.76660864143,33.7758840188106,25.3787878787879
2022-06-07,22663,22,14439,8,8224,14,15774,8,89795,20,105569,28,0,342,0,378,345,0,"Anderson",76978,155.888695471433,0.266409266409266,36.3740289433345,28.5795941697628,26.6409266409266
2022-06-08,22686,23,14454,15,8232,8,15792,18,89844,49,105636,67,0,342,0,378,345,0,"Anderson",76978,154.589623009171,0.24822695035461,87.0378549715503,29.8786666320247,24.822695035461
2022-06-09,22704,18,14466,12,8238,6,15805,13,89879,35,105684,48,0,342,1,379,346,1,"Anderson",76978,155.888695471433,0.251677852348993,62.3554781885734,23.383304320715,25.1677852348993
2022-06-10,22727,23,14482,16,8245,7,15822,17,89940,61,105762,78,0,342,0,379,346,0,"Anderson",76978,167.580347631791,0.261829652996845,101.327652056432,29.8786666320247,26.1829652996845
2022-06-11,22736,9,14486,4,8250,5,15827,5,89958,18,105785,23,0,342,0,379,346,0,"Anderson",76978,170.178492556315,0.268852459016393,29.8786666320247,11.6916521603575,26.8852459016393
2022-06-12,22744,8,14488,2,8256,6,15829,2,89972,14,105801,16,0,342,0,379,346,0,"Anderson",76978,167.580347631791,0.256756756756757,20.7851593961911,10.3925796980956,25.6756756756757
2022-06-13,22761,17,14494,6,8267,11,15835,6,89996,24,105831,30,0,342,0,379,346,0,"Anderson",76978,155.888695471433,0.237931034482759,38.9721738678584,22.0842318584531,23.7931034482759
2022-06-14,22791,30,14508,14,8283,16,15851,16,90033,37,105884,53,1,343,0,379,347,1,"Anderson",76978,166.281275169529,0.244444444444444,68.8508404998831,38.9721738678584,24.4444444444444
2022-06-15,22809,18,14520,12,8289,6,15865,14,90056,23,105921,37,1,344,1,380,347,0,"Anderson",76978,159.785912858219,0.256140350877193,48.065681103692,23.383304320715,25.6140350877193
2022-06-16,22834,25,14532,12,8302,13,15876,11,90084,28,105960,39,1,345,0,380,347,0,"Anderson",76978,168.879420094053,0.257246376811594,50.6638260282159,32.4768115565486,25.7246376811594
2022-06-17,22856,22,14544,12,8312,10,15891,15,90107,23,105998,38,0,345,0,380,348,1,"Anderson",76978,167.580347631791,0.292372881355932,49.3647535659539,28.5795941697628,29.2372881355932
2022-06-18,22867,11,14552,8,8315,3,15900,9,90130,23,106030,32,1,346,0,380,348,0,"Anderson",76978,170.178492556315,0.297959183673469,41.5703187923822,14.2897970848814,29.7959183673469
2022-06-19,22882,15,14557,5,8325,10,15905,5,90148,18,106053,23,0,346,0,380,348,0,"Anderson",76978,179.271999792148,0.301587301587302,29.8786666320247,19.4860869339292,30.1587301587302
2022-06-20,22894,12,14561,4,8333,8,15912,7,90164,16,106076,23,0,346,0,380,348,0,"Anderson",76978,172.776637480839,0.314285714285714,29.8786666320247,15.5888695471433,31.4285714285714
2022-06-21,22919,25,14570,9,8349,16,15919,7,90176,12,106095,19,0,346,0,380,348,0,"Anderson",76978,166.281275169529,0.322274881516588,24.682376782977,32.4768115565486,32.2274881516588
2022-06-22,22959,40,14600,30,8359,10,15949,30,90226,50,106175,80,0,346,0,380,348,0,"Anderson",76978,194.860869339292,0.330708661417323,103.925796980956,51.9628984904778,33.0708661417323
2022-06-23,22977,18,14611,11,8366,7,15963,14,90249,23,106212,37,0,346,0,380,349,1,"Anderson",76978,185.767362103458,0.345238095238095,48.065681103692,23.383304320715,34.5238095238095
2022-06-24,23010,33,14622,11,8388,22,15975,12,90282,33,106257,45,0,346,0,380,350,1,"Anderson",76978,200.05715918834,0.324324324324324,58.4582608017875,42.8693912546442,32.4324324324324
2022-06-25,23021,11,14625,3,8396,8,15981,6,90311,29,106292,35,0,346,0,380,350,0,"Anderson",76978,200.05715918834,0.309160305343511,45.4675361791681,14.2897970848814,30.9160305343511
2022-06-26,23031,10,14631,6,8400,4,15986,5,90337,26,106323,31,0,346,0,380,350,0,"Anderson",76978,193.56179687703,0.3,40.2712463301203,12.9907246226195,30
2022-06-27,23054,23,14643,12,8411,11,15998,12,90353,16,106351,28,1,347,0,380,350,0,"Anderson",76978,207.851593961911,0.312727272727273,36.3740289433345,29.8786666320247,31.2727272727273
2022-06-28,23084,30,14659,16,8425,14,16014,16,90382,29,106396,45,1,348,1,381,350,0,"Anderson",76978,214.346956273221,0.315614617940199,58.4582608017875,38.9721738678584,31.5614617940199
2022-06-29,23106,22,14668,9,8438,13,16025,11,90424,42,106449,53,1,349,0,381,350,0,"Anderson",76978,190.963651952506,0.277372262773723,68.8508404998831,28.5795941697628,27.7372262773723
2022-06-30,23142,36,14680,12,8462,24,16038,13,90469,45,106507,58,0,349,0,381,350,0,"Anderson",76978,214.346956273221,0.254237288135593,75.3462028111928,46.76660864143,25.4237288135593
2022-07-01,23164,22,14692,12,8472,10,16051,13,90509,40,106560,53,0,349,0,381,350,0,"Anderson",76978,200.05715918834,0.250825082508251,68.8508404998831,28.5795941697628,25.0825082508251
2022-07-02,23192,28,14706,14,8486,14,16066,15,90529,20,106595,35,0,349,0,381,350,0,"Anderson",76978,222.141391046793,0.280528052805281,45.4675361791681,36.3740289433345,28.0528052805281
2022-07-03,23203,11,14712,6,8491,5,16072,6,90546,17,106618,23,0,349,0,381,350,0,"Anderson",76978,223.440463509055,0.291525423728814,29.8786666320247,14.2897970848814,29.1525423728814
2022-07-04,23219,16,14717,5,8502,11,16077,5,90554,8,106631,13,0,349,0,381,351,1,"Anderson",76978,214.346956273221,0.282142857142857,16.8879420094053,20.7851593961911,28.2142857142857
2022-07-05,23240,21,14727,10,8513,11,16088,11,90579,25,106667,36,0,349,0,381,352,1,"Anderson",76978,202.655304112863,0.273062730627306,46.76660864143,27.2805217075008,27.3062730627306
2022-07-06,23254,14,14733,6,8521,8,16095,7,90608,29,106703,36,0,349,0,381,352,0,"Anderson",76978,192.262724414768,0.275590551181102,46.76660864143,18.1870144716672,27.5590551181102
2022-07-07,23286,32,14748,15,8538,17,16110,15,90634,26,106744,41,0,349,0,381,352,0,"Anderson",76978,187.06643456572,0.30379746835443,53.2619709527397,41.5703187923822,30.379746835443
2022-07-08,23320,34,14759,11,8561,23,16120,10,90661,27,106781,37,0,349,0,381,352,0,"Anderson",76978,202.655304112863,0.312217194570136,48.065681103692,44.1684637169061,31.2217194570136
2022-07-09,23348,28,14764,5,8584,23,16125,5,90675,14,106800,19,0,349,0,381,352,0,"Anderson",76978,202.655304112863,0.28780487804878,24.682376782977,36.3740289433345,28.780487804878
2022-07-10,23367,19,14768,4,8599,15,16128,3,90681,6,106809,9,0,349,0,381,352,0,"Anderson",76978,213.047883810959,0.293193717277487,11.6916521603575,24.682376782977,29.3193717277487
2022-07-11,23390,23,14778,10,8612,13,16141,13,90719,38,106860,51,0,349,0,381,352,0,"Anderson",76978,222.141391046793,0.279475982532751,66.2526955753592,29.8786666320247,27.9475982532751
2022-07-12,23435,45,14796,18,8639,27,16160,19,90753,34,106913,53,0,349,0,381,352,0,"Anderson",76978,253.319130141079,0.292682926829268,68.8508404998831,58.4582608017875,29.2682926829268
2022-07-13,23472,37,14814,18,8658,19,16179,19,90800,47,106979,66,0,349,0,381,353,1,"Anderson",76978,283.197796773104,0.304347826086957,85.7387825092884,48.065681103692,30.4347826086957
2022-07-14,23513,41,14826,12,8687,29,16191,12,90822,22,107013,34,0,349,1,382,353,0,"Anderson",76978,294.889448933461,0.301115241635688,44.1684637169061,53.2619709527397,30.1115241635688
2022-07-15,23545,32,14842,16,8703,16,16207,16,90848,26,107055,42,0,349,0,382,353,0,"Anderson",76978,292.291304008938,0.317518248175182,54.5610434150017,41.5703187923822,31.7518248175182
2022-07-16,23567,22,14849,7,8718,15,16214,7,90857,9,107071,16,0,349,0,382,353,0,"Anderson",76978,284.496869235366,0.328413284132841,20.7851593961911,28.5795941697628,32.8413284132841
2022-07-17,23577,10,14853,4,8724,6,16217,3,90869,12,107086,15,0,349,0,382,353,0,"Anderson",76978,272.805217075008,0.32129963898917,19.4860869339292,12.9907246226195,32.129963898917
2022-07-18,23623,46,14874,21,8749,25,16238,21,90919,50,107157,71,0,349,0,382,353,0,"Anderson",76978,302.683883707033,0.326599326599327,92.2341448205981,59.7573332640495,32.6599326599327
2022-07-19,23673,50,14897,23,8776,27,16264,26,90935,16,107199,42,3,352,0,382,353,0,"Anderson",76978,309.179246018343,0.363636363636364,54.5610434150017,64.9536231130973,36.3636363636364
2022-07-20,23709,36,14913,16,8796,20,16280,16,90965,30,107245,46,0,352,0,382,353,0,"Anderson",76978,307.880173556081,0.379699248120301,59.7573332640495,46.76660864143,37.9699248120301
2022-07-21,23752,43,14942,29,8810,14,16310,30,91017,52,107327,82,0,352,0,382,354,1,"Anderson",76978,310.478318480605,0.378980891719745,106.523941905479,55.8601158772636,37.8980891719745
2022-07-22,23790,38,14956,14,8834,24,16325,15,91052,35,107377,50,0,352,0,382,355,1,"Anderson",76978,318.272753254177,0.366459627329193,64.9536231130973,49.3647535659539,36.6459627329193
2022-07-23,23800,10,14959,3,8841,7,16329,4,91063,11,107392,15,0,352,0,382,355,0,"Anderson",76978,302.683883707033,0.358255451713396,19.4860869339292,12.9907246226195,35.8255451713396
2022-07-24,23823,23,14968,9,8855,14,16338,9,91077,14,107415,23,0,352,0,382,355,0,"Anderson",76978,319.571825716438,0.367781155015198,29.8786666320247,29.8786666320247,36.7781155015198
2022-07-25,23869,46,14994,26,8875,20,16365,27,91109,32,107474,59,0,352,0,382,355,0,"Anderson",76978,319.571825716438,0.400630914826498,76.6452752734548,59.7573332640495,40.0630914826498
2022-07-26,23916,47,15018,24,8898,23,16389,24,91142,33,107531,57,0,352,0,382,356,1,"Anderson",76978,315.674608329653,0.376506024096386,74.0471303489309,61.0564057263114,37.6506024096386
2022-07-27,23959,43,15036,18,8923,25,16410,21,91184,42,107594,63,0,352,0,382,356,0,"Anderson",76978,324.768115565486,0.372492836676218,81.8415651225025,55.8601158772636,37.2492836676218
2022-07-28,23995,36,15053,17,8942,19,16428,18,91223,39,107651,57,0,352,0,382,356,0,"Anderson",76978,315.674608329653,0.364197530864198,74.0471303489309,46.76660864143,36.4197530864198
2022-07-29,24028,33,15074,21,8954,12,16449,21,91258,35,107707,56,0,352,0,382,356,0,"Anderson",76978,309.179246018343,0.375757575757576,72.7480578866689,42.8693912546442,37.5757575757576
2022-07-30,24052,24,15088,14,8964,10,16463,14,91274,16,107737,30,0,352,0,382,356,0,"Anderson",76978,327.36626049001,0.388405797101449,38.9721738678584,31.1777390942867,38.8405797101449
2022-07-31,24058,6,15091,3,8967,3,16468,5,91290,16,107758,21,0,352,0,382,357,1,"Anderson",76978,305.282028631557,0.379008746355685,27.2805217075008,7.79443477357167,37.9008746355685
2022-08-01,24093,35,15107,16,8986,19,16486,18,91309,19,107795,37,0,352,0,382,357,0,"Anderson",76978,290.992231546676,0.376947040498442,48.065681103692,45.4675361791681,37.6947040498442
2022-08-02,24151,58,15152,45,8999,13,16530,44,91345,36,107875,80,1,353,0,382,357,0,"Anderson",76978,305.282028631557,0.409883720930233,103.925796980956,75.3462028111928,40.9883720930233
2022-08-03,24184,33,15171,19,9013,14,16553,23,91381,36,107934,59,0,353,0,382,358,1,"Anderson",76978,292.291304008938,0.420588235294118,76.6452752734548,42.8693912546442,42.0588235294118
2022-08-04,24225,41,15199,28,9026,13,16586,33,91476,95,108062,128,1,354,0,382,358,0,"Anderson",76978,298.786666320247,0.384428223844282,166.281275169529,53.2619709527397,38.4428223844282
2022-08-05,24257,32,15221,22,9036,10,16607,21,91508,32,108115,53,0,354,0,382,358,0,"Anderson",76978,297.487593857985,0.387254901960784,68.8508404998831,41.5703187923822,38.7254901960784
2022-08-06,24275,18,15229,8,9046,10,16615,8,91523,15,108138,23,0,354,0,382,358,0,"Anderson",76978,289.693159084414,0.379052369077307,29.8786666320247,23.383304320715,37.9052369077307
2022-08-07,24291,16,15239,10,9052,6,16625,10,91539,16,108164,26,0,354,0,382,358,0,"Anderson",76978,302.683883707033,0.386699507389163,33.7758840188106,20.7851593961911,38.6699507389163
2022-08-08,24348,57,15268,29,9080,28,16653,28,91551,12,108204,40,0,354,0,382,359,1,"Anderson",76978,331.263477876796,0.408312958435208,51.9628984904778,74.0471303489309,40.8312958435208
2022-08-09,24379,31,15286,18,9093,13,16672,19,91601,50,108273,69,3,357,0,382,360,1,"Anderson",76978,296.188521395723,0.35678391959799,89.6359998960742,40.2712463301203,35.678391959799
2022-08-10,24417,38,15312,26,9105,12,16701,29,91633,32,108334,61,0,357,0,382,360,0,"Anderson",76978,302.683883707033,0.37,79.2434201979787,49.3647535659539,37
2022-08-11,24451,34,15336,24,9115,10,16726,25,91664,31,108390,56,0,357,0,382,360,0,"Anderson",76978,293.5903764712,0.426829268292683,72.7480578866689,44.1684637169061,42.6829268292683
2022-08-12,24489,38,15358,22,9131,16,16750,24,91703,39,108453,63,0,357,0,382,361,1,"Anderson",76978,301.384811244771,0.423076923076923,81.8415651225025,49.3647535659539,42.3076923076923
2022-08-13,24506,17,15368,10,9138,7,16761,11,91733,30,108494,41,0,357,0,382,362,1,"Anderson",76978,300.085738782509,0.410112359550562,53.2619709527397,22.0842318584531,41.0112359550562
2022-08-14,24518,12,15376,8,9142,4,16769,8,91753,20,108522,28,0,357,0,382,362,0,"Anderson",76978,294.889448933461,0.402234636871508,36.3740289433345,15.5888695471433,40.2234636871508
2022-08-15,24571,53,15402,26,9169,27,16796,27,91775,22,108571,49,0,357,0,382,363,1,"Anderson",76978,289.693159084414,0.389645776566757,63.6545506508353,68.8508404998831,38.9645776566758
2022-08-16,24620,49,15432,30,9188,19,16828,32,91807,32,108635,64,1,358,0,382,363,0,"Anderson",76978,313.076463405129,0.430939226519337,83.1406375847645,63.6545506508353,43.0939226519337
2022-08-17,24666,46,15459,27,9207,19,16854,26,91840,33,108694,59,0,358,0,382,363,0,"Anderson",76978,323.469043103224,0.425,76.6452752734548,59.7573332640495,42.5
2022-08-18,24950,284,15502,43,9448,241,16896,42,91884,44,108780,86,0,358,0,382,363,0,"Anderson",76978,648.23715866871,0.435897435897436,111.720231754527,368.936579282392,43.5897435897436
2022-08-19,24982,32,15517,15,9465,17,16912,16,91921,37,108833,53,0,358,0,382,363,0,"Anderson",76978,640.442723895139,0.426315789473684,68.8508404998831,41.5703187923822,42.6315789473684
2022-08-20,24996,14,15524,7,9472,7,16920,8,91950,29,108870,37,0,358,0,382,363,0,"Anderson",76978,636.545506508353,0.422872340425532,48.065681103692,18.1870144716672,42.2872340425532
2022-08-21,25010,14,15530,6,9480,8,16927,7,91981,31,108908,38,0,358,0,382,363,0,"Anderson",76978,639.143651432877,0.409326424870466,49.3647535659539,18.1870144716672,40.9326424870466
2022-08-22,25074,64,15555,25,9519,39,16952,25,92018,37,108970,62,0,358,0,382,364,1,"Anderson",76978,653.433448517758,0.390977443609023,80.5424926602406,83.1406375847645,39.0977443609023
2022-08-23,25154,80,15587,32,9567,48,16985,33,92050,32,109035,65,3,361,0,382,365,1,"Anderson",76978,693.704694847879,0.3925,84.4397100470264,103.925796980956,39.25
2022-08-24,25219,65,15610,23,9609,42,17011,26,92088,38,109099,64,0,361,0,382,365,0,"Anderson",76978,718.387071630856,0.387654320987654,83.1406375847645,84.4397100470264,38.7654320987654
2022-08-25,25263,44,15633,23,9630,21,17036,25,92127,39,109163,64,1,362,0,382,366,1,"Anderson",76978,406.609680687989,0.365535248041775,83.1406375847645,57.1591883395256,36.5535248041775
2022-08-26,25295,32,15648,15,9647,17,17052,16,92184,57,109236,73,0,362,0,382,366,0,"Anderson",76978,406.609680687989,0.347394540942928,94.832289745122,41.5703187923822,34.7394540942928
2022-08-27,25335,40,15657,9,9678,31,17061,9,92220,36,109281,45,0,362,0,382,366,0,"Anderson",76978,440.385564706799,0.343065693430657,58.4582608017875,51.9628984904778,34.3065693430657
2022-08-28,25344,9,15661,4,9683,5,17065,4,92248,28,109313,32,0,362,0,382,366,0,"Anderson",76978,433.89020239549,0.340740740740741,41.5703187923822,11.6916521603575,34.0740740740741
2022-08-29,25379,35,15675,14,9704,21,17081,16,92259,11,109340,27,0,362,0,382,367,1,"Anderson",76978,396.217100989893,0.348648648648649,35.0749564810725,45.4675361791681,34.8648648648649
2022-08-30,25424,45,15691,16,9733,29,17098,17,92275,16,109373,33,2,364,0,382,367,0,"Anderson",76978,350.749564810725,0.334319526627219,42.8693912546442,58.4582608017875,33.4319526627219
2022-08-31,25471,47,15722,31,9749,16,17131,33,92324,49,109455,82,0,364,0,382,367,0,"Anderson",76978,327.36626049001,0.337078651685393,106.523941905479,61.0564057263114,33.7078651685393
2022-09-01,25501,30,15736,14,9765,16,17146,15,92352,28,109498,43,1,365,0,382,367,0,"Anderson",76978,309.179246018343,0.328358208955224,55.8601158772636,38.9721738678584,32.8358208955224
2022-09-02,25528,27,15750,14,9778,13,17160,14,92396,44,109556,58,0,365,0,382,367,0,"Anderson",76978,302.683883707033,0.3375,75.3462028111928,35.0749564810725,33.75
2022-09-03,25548,20,15761,11,9787,9,17171,11,92416,20,109587,31,0,365,0,382,368,1,"Anderson",76978,276.702434461794,0.359477124183007,40.2712463301203,25.9814492452389,35.9477124183007
2022-09-04,25560,12,15763,2,9797,10,17173,2,92430,14,109603,16,0,365,0,382,368,0,"Anderson",76978,280.59965184858,0.372413793103448,20.7851593961911,15.5888695471433,37.2413793103448
2022-09-05,25569,9,15765,2,9804,7,17175,2,92444,14,109619,16,0,365,0,382,368,0,"Anderson",76978,246.82376782977,0.336917562724014,20.7851593961911,11.6916521603575,33.6917562724014
2022-09-06,25605,36,15777,12,9828,24,17187,12,92461,17,109648,29,0,365,0,382,368,0,"Anderson",76978,235.132115669412,0.323636363636364,37.6731014055964,46.76660864143,32.3636363636364
2022-09-07,25644,39,15792,15,9852,24,17203,16,92495,34,109698,50,0,365,0,382,368,0,"Anderson",76978,224.739535971316,0.296296296296296,64.9536231130973,50.6638260282159,29.6296296296296
2022-09-08,25666,22,15801,9,9865,13,17212,9,92513,18,109725,27,0,365,0,382,369,1,"Anderson",76978,214.346956273221,0.290748898678414,35.0749564810725,28.5795941697628,29.0748898678414
2022-09-09,25680,14,15808,7,9872,7,17219,7,92558,45,109777,52,0,365,0,382,370,1,"Anderson",76978,197.459014263816,0.266968325791855,67.5517680376211,18.1870144716672,26.6968325791855
2022-09-10,25695,15,15815,7,9880,8,17228,9,92578,20,109806,29,0,365,0,382,370,0,"Anderson",76978,190.963651952506,0.26027397260274,37.6731014055964,19.4860869339292,26.027397260274
2022-09-11,25702,7,15817,2,9885,5,17231,3,92592,14,109823,17,0,365,0,382,370,0,"Anderson",76978,184.468289641196,0.263636363636364,22.0842318584531,9.09350723583361,26.3636363636364
2022-09-12,25715,13,15822,5,9893,8,17237,6,92604,12,109841,18,0,365,0,382,370,0,"Anderson",76978,189.664579490244,0.279279279279279,23.383304320715,16.8879420094053,27.9279279279279
2022-09-13,25741,26,15834,12,9907,14,17250,13,92626,22,109876,35,0,365,0,382,370,0,"Anderson",76978,176.673854867625,0.276315789473684,45.4675361791681,33.7758840188106,27.6315789473684
2022-09-14,25758,17,15842,8,9916,9,17258,8,92652,26,109910,34,1,366,0,382,370,0,"Anderson",76978,148.094260697862,0.259433962264151,44.1684637169061,22.0842318584531,25.9433962264151
2022-09-15,25816,58,15859,17,9957,41,17276,18,92694,42,109970,60,2,368,0,382,370,0,"Anderson",76978,194.860869339292,0.261224489795918,77.9443477357167,75.3462028111928,26.1224489795918
2022-09-16,25832,16,15863,4,9969,12,17280,4,92740,46,110020,50,0,368,0,382,370,0,"Anderson",76978,197.459014263816,0.251028806584362,64.9536231130973,20.7851593961911,25.1028806584362
2022-09-17,25842,10,15864,1,9978,9,17283,3,92753,13,110036,16,0,368,0,382,370,0,"Anderson",76978,190.963651952506,0.239130434782609,20.7851593961911,12.9907246226195,23.9130434782609
2022-09-18,25850,8,15865,1,9985,7,17284,1,92758,5,110042,6,0,368,0,382,370,0,"Anderson",76978,192.262724414768,0.242009132420091,7.79443477357167,10.3925796980956,24.2009132420091
2022-09-19,25866,16,15868,3,9998,13,17288,4,92778,20,110066,24,0,368,1,383,371,1,"Anderson",76978,196.159941801554,0.226666666666667,31.1777390942867,20.7851593961911,22.6666666666667
2022-09-20,25872,6,15873,5,9999,1,17294,6,92787,9,110081,15,0,368,0,383,371,0,"Anderson",76978,170.178492556315,0.214634146341463,19.4860869339292,7.79443477357167,21.4634146341463
2022-09-21,25882,10,15875,2,10007,8,17296,2,92810,23,110106,25,1,369,0,383,371,0,"Anderson",76978,161.084985320481,0.193877551020408,32.4768115565486,12.9907246226195,19.3877551020408
2022-09-22,25898,16,15881,6,10017,10,17302,6,92846,36,110148,42,0,369,0,383,371,0,"Anderson",76978,106.523941905479,0.146067415730337,54.5610434150017,20.7851593961911,14.6067415730337
2022-09-23,25919,21,15893,12,10026,9,17315,13,92891,45,110206,58,0,369,0,383,371,0,"Anderson",76978,113.019304216789,0.188172043010753,75.3462028111928,27.2805217075008,18.8172043010753
2022-09-24,25924,5,15897,4,10027,1,17318,3,92908,17,110226,20,0,369,0,383,371,0,"Anderson",76978,106.523941905479,0.184210526315789,25.9814492452389,6.49536231130973,18.4210526315789
2022-09-25,25929,5,15899,2,10030,3,17320,2,92923,15,110243,17,0,369,0,383,371,0,"Anderson",76978,102.626724518694,0.17910447761194,22.0842318584531,6.49536231130973,17.910447761194
2022-09-26,25944,15,15905,6,10039,9,17327,7,92934,11,110261,18,0,369,0,383,371,0,"Anderson",76978,101.327652056432,0.2,23.383304320715,19.4860869339292,20
2022-09-27,25951,7,15906,1,10045,6,17329,2,92955,21,110284,23,0,369,0,383,371,0,"Anderson",76978,102.626724518694,0.172413793103448,29.8786666320247,9.09350723583361,17.2413793103448
2022-09-28,25967,16,15910,4,10057,12,17334,5,92998,43,110332,48,1,370,0,383,371,0,"Anderson",76978,110.421159292265,0.168141592920354,62.3554781885734,20.7851593961911,16.8141592920354
2022-09-29,25977,10,15918,8,10059,2,17342,8,93020,22,110362,30,0,370,0,383,371,0,"Anderson",76978,102.626724518694,0.186915887850467,38.9721738678584,12.9907246226195,18.6915887850467
2022-09-30,25985,8,15922,4,10063,4,17346,4,93054,34,110400,38,0,370,0,383,371,0,"Anderson",76978,85.7387825092884,0.15979381443299,49.3647535659539,10.3925796980956,15.979381443299
2022-10-01,25990,5,15922,0,10068,5,17346,0,93058,4,110404,4,0,370,0,383,371,0,"Anderson",76978,85.7387825092884,0.157303370786517,5.19628984904778,6.49536231130973,15.7303370786517
2022-10-02,25992,2,15923,1,10069,1,17347,1,93061,3,110408,4,0,370,0,383,371,0,"Anderson",76978,81.8415651225025,0.163636363636364,5.19628984904778,2.59814492452389,16.3636363636364
2022-10-03,26003,11,15926,3,10077,8,17351,4,93067,6,110418,10,0,370,0,383,371,0,"Anderson",76978,76.6452752734548,0.152866242038217,12.9907246226195,14.2897970848814,15.2866242038217
2022-10-04,26005,2,15926,0,10079,2,17351,0,93104,37,110455,37,0,370,0,383,371,0,"Anderson",76978,70.149912962145,0.128654970760234,48.065681103692,2.59814492452389,12.8654970760234
2022-10-05,26010,5,15928,2,10082,3,17354,3,93120,16,110474,19,0,370,0,383,371,0,"Anderson",76978,55.8601158772636,0.140845070422535,24.682376782977,6.49536231130973,14.0845070422535
2022-10-06,26023,13,15935,7,10088,6,17362,8,93145,25,110507,33,0,370,0,383,371,0,"Anderson",76978,59.7573332640495,0.137931034482759,42.8693912546442,16.8879420094053,13.7931034482759
2022-10-07,26039,16,15946,11,10093,5,17373,11,93167,22,110540,33,0,370,0,383,371,0,"Anderson",76978,70.149912962145,0.192857142857143,42.8693912546442,20.7851593961911,19.2857142857143
2022-10-08,26039,0,15946,0,10093,0,17373,0,93185,18,110558,18,0,370,0,383,371,0,"Anderson",76978,63.6545506508353,0.175324675324675,23.383304320715,0,17.5324675324675
2022-10-09,26041,2,15947,1,10094,1,17374,1,93196,11,110570,12,0,370,0,383,371,0,"Anderson",76978,63.6545506508353,0.166666666666667,15.5888695471433,2.59814492452389,16.6666666666667
2022-10-10,26046,5,15949,2,10097,3,17376,2,93211,15,110587,17,0,370,0,383,372,1,"Anderson",76978,55.8601158772636,0.14792899408284,22.0842318584531,6.49536231130973,14.792899408284
2022-10-11,26059,13,15955,6,10104,7,17382,6,93245,34,110627,40,0,370,0,383,372,0,"Anderson",76978,70.149912962145,0.180232558139535,51.9628984904778,16.8879420094053,18.0232558139535
2022-10-12,26069,10,15958,3,10111,7,17385,3,93262,17,110647,20,0,370,0,383,372,0,"Anderson",76978,76.6452752734548,0.179190751445087,25.9814492452389,12.9907246226195,17.9190751445087
2022-10-13,26076,7,15963,5,10113,2,17390,5,93277,15,110667,20,0,370,1,384,372,0,"Anderson",76978,68.8508404998831,0.175,25.9814492452389,9.09350723583361,17.5
2022-10-14,26081,5,15964,1,10117,4,17391,1,93294,17,110685,18,0,370,0,384,372,0,"Anderson",76978,54.5610434150017,0.124137931034483,23.383304320715,6.49536231130973,12.4137931034483
2022-10-15,26084,3,15965,1,10119,2,17392,1,93306,12,110698,13,0,370,0,384,372,0,"Anderson",76978,58.4582608017875,0.135714285714286,16.8879420094053,3.89721738678583,13.5714285714286
2022-10-16,26085,1,15966,1,10119,0,17393,1,93310,4,110703,5,0,370,0,384,372,0,"Anderson",76978,57.1591883395256,0.142857142857143,6.49536231130973,1.29907246226194,14.2857142857143
2022-10-17,26095,10,15971,5,10124,5,17397,4,93314,4,110711,8,0,370,0,384,372,0,"Anderson",76978,63.6545506508353,0.169354838709677,10.3925796980956,12.9907246226195,16.9354838709677
2022-10-18,26101,6,15973,2,10128,4,17399,2,93329,15,110728,17,0,370,0,384,373,1,"Anderson",76978,54.5610434150017,0.168316831683168,22.0842318584531,7.79443477357167,16.8316831683168
2022-10-19,26110,9,15977,4,10133,5,17403,4,93343,14,110746,18,0,370,0,384,373,0,"Anderson",76978,53.2619709527397,0.181818181818182,23.383304320715,11.6916521603575,18.1818181818182
2022-10-20,26120,10,15979,2,10141,8,17406,3,93355,12,110761,15,1,371,0,384,373,0,"Anderson",76978,57.1591883395256,0.170212765957447,19.4860869339292,12.9907246226195,17.0212765957447
2022-10-21,26137,17,15993,14,10144,3,17421,15,93413,58,110834,73,0,371,0,384,373,0,"Anderson",76978,72.7480578866689,0.201342281879195,94.832289745122,22.0842318584531,20.1342281879195
2022-10-22,26142,5,15995,2,10147,3,17423,2,93421,8,110844,10,0,371,0,384,374,1,"Anderson",76978,75.3462028111928,0.212328767123288,12.9907246226195,6.49536231130973,21.2328767123288
2022-10-23,26152,10,16003,8,10149,2,17430,7,93425,4,110855,11,0,371,1,385,374,0,"Anderson",76978,87.0378549715503,0.243421052631579,14.2897970848814,12.9907246226195,24.3421052631579
2022-10-24,26162,10,16009,6,10153,4,17437,7,93442,17,110879,24,0,371,0,385,374,0,"Anderson",76978,87.0378549715503,0.238095238095238,31.1777390942867,12.9907246226195,23.8095238095238
2022-10-25,26174,12,16014,5,10160,7,17443,6,93461,19,110904,25,0,371,0,385,374,0,"Anderson",76978,94.832289745122,0.25,32.4768115565486,15.5888695471433,25
2022-10-26,26191,17,16025,11,10166,6,17454,11,93482,21,110936,32,1,372,0,385,374,0,"Anderson",76978,105.224869443218,0.268421052631579,41.5703187923822,22.0842318584531,26.8421052631579
2022-10-27,26208,17,16029,4,10179,13,17458,4,93498,16,110956,20,0,372,0,385,374,0,"Anderson",76978,114.318376679051,0.266666666666667,25.9814492452389,22.0842318584531,26.6666666666667
2022-10-28,26218,10,16033,4,10185,6,17461,3,93512,14,110973,17,0,372,0,385,374,0,"Anderson",76978,105.224869443218,0.287769784172662,22.0842318584531,12.9907246226195,28.7769784172662
2022-10-29,26223,5,16034,1,10189,4,17463,2,93531,19,110994,21,0,372,0,385,374,0,"Anderson",76978,105.224869443218,0.266666666666667,27.2805217075008,6.49536231130973,26.6666666666667
2022-10-30,26226,3,16037,3,10189,0,17466,3,93532,1,110998,4,0,372,0,385,374,0,"Anderson",76978,96.1313622073839,0.251748251748252,5.19628984904778,3.89721738678583,25.1748251748252
2022-10-31,26240,14,16043,6,10197,8,17473,7,93561,29,111034,36,0,372,0,385,374,0,"Anderson",76978,101.327652056432,0.232258064516129,46.76660864143,18.1870144716672,23.2258064516129
2022-11-01,26254,14,16052,9,10202,5,17481,8,93588,27,111069,35,0,372,0,385,374,0,"Anderson",76978,103.925796980956,0.23030303030303,45.4675361791681,18.1870144716672,23.030303030303
2022-11-02,26264,10,16057,5,10207,5,17486,5,93602,14,111088,19,0,372,0,385,376,2,"Anderson",76978,94.832289745122,0.210526315789474,24.682376782977,12.9907246226195,21.0526315789474
2022-11-03,26277,13,16066,9,10211,4,17495,9,93648,46,111143,55,1,373,0,385,377,1,"Anderson",76978,89.6359998960742,0.197860962566845,71.448985424407,16.8879420094053,19.7860962566845
2022-11-04,26294,17,16073,7,10221,10,17502,7,93681,33,111183,40,2,375,0,385,377,0,"Anderson",76978,98.7295071319078,0.195238095238095,51.9628984904778,22.0842318584531,19.5238095238095
2022-11-05,26301,7,16080,7,10221,0,17510,8,93687,6,111197,14,0,375,0,385,377,0,"Anderson",76978,101.327652056432,0.231527093596059,18.1870144716672,9.09350723583361,23.1527093596059
2022-11-06,26304,3,16081,1,10223,2,17511,1,93695,8,111206,9,0,375,0,385,377,0,"Anderson",76978,101.327652056432,0.216346153846154,11.6916521603575,3.89721738678583,21.6346153846154
2022-11-07,26325,21,16086,5,10239,16,17516,5,93714,19,111230,24,0,375,0,385,377,0,"Anderson",76978,110.421159292265,0.219387755102041,31.1777390942867,27.2805217075008,21.9387755102041
2022-11-08,26337,12,16094,8,10243,4,17523,7,93728,14,111251,21,0,375,0,385,377,0,"Anderson",76978,107.823014367741,0.230769230769231,27.2805217075008,15.5888695471433,23.0769230769231
2022-11-09,26353,16,16101,7,10252,9,17530,7,93785,57,111315,64,0,375,0,385,377,0,"Anderson",76978,115.617449141313,0.193832599118943,83.1406375847645,20.7851593961911,19.3832599118943
2022-11-10,26365,12,16107,6,10258,6,17537,7,93809,24,111346,31,0,375,0,385,378,1,"Anderson",76978,114.318376679051,0.206896551724138,40.2712463301203,15.5888695471433,20.6896551724138
2022-11-11,26373,8,16111,4,10262,4,17541,4,93838,29,111379,33,0,375,0,385,378,0,"Anderson",76978,102.626724518694,0.198979591836735,42.8693912546442,10.3925796980956,19.8979591836735
2022-11-12,26376,3,16113,2,10263,1,17543,2,93848,10,111391,12,0,375,0,385,378,0,"Anderson",76978,97.4304346696459,0.170103092783505,15.5888695471433,3.89721738678583,17.0103092783505
2022-11-13,26376,0,16113,0,10263,0,17543,0,93854,6,111397,6,0,375,0,385,379,1,"Anderson",76978,93.53321728286,0.167539267015707,7.79443477357167,0,16.7539267015707
2022-11-14,26384,8,16116,3,10268,5,17546,3,93883,29,111429,32,0,375,0,385,379,0,"Anderson",76978,76.6452752734548,0.150753768844221,41.5703187923822,10.3925796980956,15.0753768844221
2022-11-15,26398,14,16117,1,10281,13,17547,1,93930,47,111477,48,0,375,0,385,379,0,"Anderson",76978,79.2434201979786,0.106194690265487,62.3554781885734,18.1870144716672,10.6194690265487
2022-11-16,26406,8,16118,1,10288,7,17549,2,93948,18,111497,20,1,376,0,385,379,0,"Anderson",76978,68.8508404998831,0.104395604395604,25.9814492452389,10.3925796980956,10.4395604395604
2022-11-17,26414,8,16122,4,10292,4,17553,4,93980,32,111533,36,1,377,0,385,379,0,"Anderson",76978,63.6545506508353,0.0855614973262032,46.76660864143,10.3925796980956,8.55614973262032
2022-11-18,26425,11,16126,4,10299,7,17557,4,94032,52,111589,56,0,377,0,385,380,1,"Anderson",76978,67.5517680376211,0.0761904761904762,72.7480578866689,14.2897970848814,7.61904761904762
2022-11-19,26427,2,16126,0,10301,2,17557,0,94039,7,111596,7,0,377,0,385,380,0,"Anderson",76978,66.2526955753592,0.0682926829268293,9.09350723583361,2.59814492452389,6.82926829268293
2022-11-20,26429,2,16126,0,10303,2,17557,0,94052,13,111609,13,0,377,0,385,380,0,"Anderson",76978,68.8508404998831,0.0660377358490566,16.8879420094053,2.59814492452389,6.60377358490566
2022-11-21,26434,5,16129,3,10305,2,17560,3,94071,19,111631,22,0,377,0,385,380,0,"Anderson",76978,64.9536231130973,0.0693069306930693,28.5795941697628,6.49536231130973,6.93069306930693
2022-11-22,26443,9,16131,2,10312,7,17562,2,94108,37,111670,39,0,377,0,385,380,0,"Anderson",76978,58.4582608017875,0.077720207253886,50.6638260282159,11.6916521603575,7.7720207253886
2022-11-23,26451,8,16135,4,10316,4,17567,5,94127,19,111694,24,1,378,0,385,380,0,"Anderson",76978,58.4582608017875,0.0913705583756345,31.1777390942867,10.3925796980956,9.13705583756345
2022-11-24,26456,5,16138,3,10318,2,17570,3,94139,12,111709,15,0,378,0,385,380,0,"Anderson",76978,54.5610434150017,0.0965909090909091,19.4860869339292,6.49536231130973,9.65909090909091
2022-11-25,26460,4,16140,2,10320,2,17572,2,94147,8,111719,10,0,378,0,385,380,0,"Anderson",76978,45.4675361791681,0.115384615384615,12.9907246226195,5.19628984904778,11.5384615384615
2022-11-26,26463,3,16140,0,10323,3,17572,0,94158,11,111730,11,0,378,0,385,380,0,"Anderson",76978,46.76660864143,0.111940298507463,14.2897970848814,3.89721738678583,11.1940298507463
2022-11-27,26465,2,16141,1,10324,1,17573,1,94170,12,111743,13,0,378,0,385,381,1,"Anderson",76978,46.76660864143,0.119402985074627,16.8879420094053,2.59814492452389,11.9402985074627
2022-11-28,26471,6,16143,2,10328,4,17576,3,94199,29,111775,32,0,378,0,385,381,0,"Anderson",76978,48.065681103692,0.111111111111111,41.5703187923822,7.79443477357167,11.1111111111111
2022-11-29,26486,15,16150,7,10336,8,17584,8,94237,38,111821,46,0,378,0,385,381,0,"Anderson",76978,55.8601158772636,0.145695364238411,59.7573332640495,19.4860869339292,14.5695364238411
2022-11-30,26501,15,16161,11,10340,4,17596,12,94284,47,111880,59,0,378,0,385,381,0,"Anderson",76978,64.9536231130973,0.155913978494624,76.6452752734548,19.4860869339292,15.5913978494624
2022-12-01,26511,10,16164,3,10347,7,17599,3,94314,30,111913,33,1,379,0,385,381,0,"Anderson",76978,71.448985424407,0.142156862745098,42.8693912546442,12.9907246226195,14.2156862745098
2022-12-02,26527,16,16175,11,10352,5,17610,11,94398,84,112008,95,0,379,0,385,381,0,"Anderson",76978,87.0378549715503,0.131487889273356,123.411883914885,20.7851593961911,13.1487889273356
2022-12-03,26535,8,16177,2,10358,6,17612,2,94415,17,112027,19,0,379,0,385,381,0,"Anderson",76978,93.53321728286,0.134680134680135,24.682376782977,10.3925796980956,13.4680134680135
2022-12-04,26538,3,16179,2,10359,1,17614,2,94423,8,112037,10,0,379,0,385,381,0,"Anderson",76978,94.832289745122,0.139455782312925,12.9907246226195,3.89721738678583,13.9455782312925
2022-12-05,26552,14,16184,5,10368,9,17621,7,94442,19,112063,26,0,379,0,385,381,0,"Anderson",76978,105.224869443218,0.15625,33.7758840188106,18.1870144716672,15.625
2022-12-06,26565,13,16190,6,10375,7,17627,6,94483,41,112110,47,0,379,0,385,381,0,"Anderson",76978,102.626724518694,0.14878892733564,61.0564057263114,16.8879420094053,14.878892733564
2022-12-07,26586,21,16199,9,10387,12,17634,7,94534,51,112168,58,1,380,0,385,381,0,"Anderson",76978,110.421159292265,0.131944444444444,75.3462028111928,27.2805217075008,13.1944444444444
2022-12-08,26602,16,16205,6,10397,10,17640,6,94562,28,112202,34,1,381,0,385,381,0,"Anderson",76978,118.215594065837,0.141868512110727,44.1684637169061,20.7851593961911,14.1868512110727
2022-12-09,26622,20,16210,5,10412,15,17645,5,94577,15,112222,20,0,381,0,385,381,0,"Anderson",76978,123.411883914885,0.163551401869159,25.9814492452389,25.9814492452389,16.3551401869159
2022-12-10,26624,2,16211,1,10413,1,17646,1,94584,7,112230,8,0,381,0,385,381,0,"Anderson",76978,115.617449141313,0.167487684729064,10.3925796980956,2.59814492452389,16.7487684729064
2020-03-12,1,1,1,1,0,0,1,1,11,11,12,12,0,0,0,0,0,0,"East TN",2455501,NA,NA,0.488698640318208,0.040724886693184,NA
2020-03-13,1,0,1,0,0,0,1,0,23,12,24,12,0,0,0,0,0,0,"East TN",2455501,NA,NA,0.488698640318208,0,NA
2020-03-14,3,2,3,2,0,0,3,2,50,27,53,29,0,0,0,0,0,0,"East TN",2455501,NA,NA,1.18102171410234,0.081449773386368,NA
2020-03-15,3,0,3,0,0,0,3,0,53,3,56,3,0,0,0,0,0,0,"East TN",2455501,NA,NA,0.122174660079552,0,NA
2020-03-16,5,2,5,2,0,0,5,2,89,36,94,38,0,0,0,0,0,0,"East TN",2455501,NA,NA,1.54754569434099,0.081449773386368,NA
2020-03-17,6,1,6,1,0,0,5,0,130,41,135,41,0,0,0,0,0,0,"East TN",2455501,NA,NA,1.66972035442054,0.040724886693184,NA
2020-03-18,8,2,8,2,0,0,7,2,171,41,178,43,0,0,0,0,0,0,"East TN",2455501,0.325799093545472,0.0393258426966292,1.75117012780691,0.081449773386368,3.93258426966292
2020-03-19,11,3,11,3,0,0,11,4,238,67,249,71,0,0,0,0,0,0,"East TN",2455501,0.40724886693184,0.0421940928270042,2.89146695521606,0.122174660079552,4.21940928270042
2020-03-20,29,18,29,18,0,0,27,16,382,144,409,160,0,0,2,2,0,0,"East TN",2455501,1.14029682740915,0.0675324675324675,6.51598187090944,0.733047960477312,6.75324675324675
2020-03-21,38,9,38,9,0,0,38,11,610,228,648,239,0,0,1,3,1,1,"East TN",2455501,1.42537103426144,0.0588235294117647,9.73324791967098,0.366523980238656,5.88235294117647
2020-03-22,48,10,47,9,1,1,43,5,713,103,756,108,0,0,4,7,2,1,"East TN",2455501,1.83261990119328,0.0571428571428571,4.39828776286387,0.40724886693184,5.71428571428571
2020-03-23,64,16,63,16,1,0,56,13,846,133,902,146,0,0,4,11,2,0,"East TN",2455501,2.40276831489786,0.0631188118811881,5.94583345720486,0.651598187090944,6.31188118811881
2020-03-24,83,19,82,19,1,0,70,14,987,141,1057,155,0,0,5,16,2,0,"East TN",2455501,3.13581627537517,0.0704989154013015,6.31235743744352,0.773772847170496,7.04989154013015
2020-03-25,116,33,115,33,1,0,99,29,1288,301,1387,330,0,0,12,28,3,1,"East TN",2455501,4.39828776286387,0.076095947063689,13.4392126087507,1.34392126087507,7.6095947063689
2020-03-26,144,28,143,28,1,0,130,31,1774,486,1904,517,0,0,5,33,4,1,"East TN",2455501,5.41640993019347,0.0719033232628399,21.0547664203761,1.14029682740915,7.19033232628399
2020-03-27,166,22,165,22,1,0,147,17,2171,397,2318,414,0,0,6,39,4,0,"East TN",2455501,5.57930947696621,0.0628601361969618,16.8601030909782,0.895947507250048,6.28601361969618
2020-03-28,197,31,196,31,1,0,180,33,2608,437,2788,470,0,0,8,47,4,0,"East TN",2455501,6.47525698421626,0.0663551401869159,19.1406967457965,1.2624714874887,6.63551401869159
2020-03-29,213,16,212,16,1,0,196,16,2795,187,2991,203,0,0,3,50,7,3,"East TN",2455501,6.71960630437536,0.0684563758389262,8.26715199871635,0.651598187090944,6.84563758389262
2020-03-30,246,33,245,33,1,0,226,30,3345,550,3571,580,0,0,8,58,9,2,"East TN",2455501,7.41192937815949,0.0636942675159236,23.6204342820467,1.34392126087507,6.36942675159236
2020-03-31,295,49,294,49,1,0,278,52,3645,300,3923,352,0,0,12,70,10,1,"East TN",2455501,8.63367597895501,0.0725750174459177,14.3351601160008,1.99551944796602,7.25750174459177
2020-04-01,346,51,345,51,1,0,336,58,4243,598,4579,656,0,0,9,79,12,2,"East TN",2455501,9.36672393943232,0.0742481203007519,26.7155256707287,2.07696922135238,7.42481203007519
2020-04-02,391,45,390,45,1,0,383,47,4839,596,5222,643,2,7,5,84,14,2,"East TN",2455501,10.0590470132164,0.0762507534659433,26.1861021437173,1.83261990119328,7.62507534659433
2020-04-03,412,21,411,21,1,0,401,18,5124,285,5525,303,1,8,2,86,17,3,"East TN",2455501,10.0183221265233,0.0792017461802308,12.3396406680348,0.855222620556864,7.92017461802307
2020-04-04,447,35,446,35,1,0,431,30,5716,592,6147,622,3,11,5,91,19,2,"East TN",2455501,10.181221673296,0.0747246204227449,25.3308795231604,1.42537103426144,7.47246204227449
2020-04-05,473,26,472,26,1,0,464,33,6093,377,6557,410,-1,10,2,93,20,1,"East TN",2455501,10.5884705402278,0.0751542344363432,16.6972035442054,1.05884705402278,7.51542344363432
2020-04-06,514,41,513,41,1,0,514,50,6626,533,7140,583,8,18,5,98,20,0,"East TN",2455501,10.9142696337733,0.080694872513309,23.7426089421263,1.66972035442054,8.0694872513309
2020-04-07,570,56,569,56,1,0,592,78,7755,1129,8347,1207,0,18,7,105,21,1,"East TN",2455501,11.1993438406256,0.0709764918625678,49.1549382386731,2.2805936548183,7.09764918625678
2020-04-08,607,37,606,37,1,0,632,40,8162,407,8794,447,1,19,8,113,25,4,"East TN",2455501,10.629195426921,0.0702253855278766,18.2040243518532,1.50682080764781,7.02253855278766
2020-04-09,633,26,632,26,1,0,662,30,8613,451,9275,481,3,22,2,115,25,0,"East TN",2455501,9.85542257975053,0.0688378978534419,19.5886704994215,1.05884705402278,6.88378978534419
2020-04-10,655,22,654,22,1,0,682,20,8941,328,9623,348,0,22,4,119,25,0,"East TN",2455501,9.89614746644371,0.0685700341630063,14.172260569228,0.895947507250048,6.85700341630063
2020-04-11,679,24,678,24,1,0,728,46,10022,1081,10750,1127,2,24,5,124,27,2,"East TN",2455501,9.44817371281869,0.0645231370845101,45.8969473032184,0.977397280636416,6.45231370845101
2020-04-12,709,30,708,30,1,0,761,33,11472,1450,12233,1483,0,24,1,125,28,1,"East TN",2455501,9.61107325959142,0.0523255813953488,60.3950069659919,1.22174660079552,5.23255813953488
2020-04-13,738,29,737,29,1,0,803,42,12435,963,13238,1005,0,24,7,132,32,4,"East TN",2455501,9.12237461927321,0.0473925877336832,40.9285111266499,1.18102171410234,4.73925877336832
2020-04-14,749,11,748,11,1,0,823,20,12720,285,13543,305,4,28,1,133,33,1,"East TN",2455501,7.28975471807994,0.0444572748267898,12.4210904414211,0.447973753625024,4.44572748267898
2020-04-15,773,24,772,24,1,0,850,27,13132,412,13982,439,2,30,4,137,34,1,"East TN",2455501,6.76033119106854,0.0420200462606014,17.8782252583078,0.977397280636416,4.20200462606014
2020-04-16,801,28,800,28,1,0,886,36,13808,676,14694,712,1,31,6,143,34,0,"East TN",2455501,6.84178096445491,0.0413360398597527,28.996119325547,1.14029682740915,4.13360398597527
2020-04-17,823,22,821,21,2,1,916,30,14137,329,15053,359,0,31,4,147,35,1,"East TN",2455501,6.84178096445491,0.0430939226519337,14.6202343228531,0.895947507250048,4.30939226519337
2020-04-18,835,12,833,12,2,0,935,19,14918,781,15853,800,0,31,0,147,35,0,"East TN",2455501,6.3530823241367,0.0405643738977072,32.5799093545472,0.488698640318208,4.05643738977072
2020-04-19,914,79,912,79,2,0,1016,81,15604,686,16620,767,1,32,1,148,35,0,"East TN",2455501,8.34860177210272,0.0581262821974014,31.2359880936721,3.21726604876154,5.81262821974014
2020-04-20,939,25,931,19,8,6,1033,17,16567,963,17600,980,0,32,2,150,35,0,"East TN",2455501,8.18570222532998,0.0527281063732233,39.9103889593203,1.0181221673296,5.27281063732233
2020-04-21,1045,106,1037,106,8,0,1154,121,19273,2706,20427,2827,0,32,6,156,36,1,"East TN",2455501,12.0545664611825,0.0480825101685067,115.129254681631,4.3168379894775,4.80825101685067
2020-04-22,1247,202,1237,200,10,2,1354,200,21825,2552,23179,2752,2,34,2,158,36,0,"East TN",2455501,19.3035962925692,0.0548004784168751,112.074888179642,8.22642711202317,5.48004784168751
2020-04-23,1492,245,1480,243,12,2,1601,247,22932,1107,24533,1354,0,34,3,161,36,0,"East TN",2455501,28.1408967049901,0.0726699867872751,55.1414965825711,9.97759723983008,7.26699867872751
2020-04-24,1540,48,1527,47,13,1,1655,54,25621,2689,27276,2743,0,34,4,165,36,0,"East TN",2455501,29.1997437590129,0.0604597889225231,111.708364199404,1.95479456127283,6.04597889225231
2020-04-25,1563,23,1546,19,17,4,1674,19,26396,775,28070,794,0,34,3,168,37,1,"East TN",2455501,29.647717512638,0.0604894818695261,32.3355600343881,0.936672393943232,6.04894818695261
2020-04-26,1583,20,1565,19,18,1,1700,26,27513,1117,29213,1143,0,34,0,168,37,0,"East TN",2455501,27.2449491977401,0.0543158897800365,46.5485454903093,0.81449773386368,5.43158897800365
2020-04-27,1652,69,1633,68,19,1,1772,72,28428,915,30200,987,0,34,8,176,38,1,"East TN",2455501,29.0368442122402,0.0586507936507936,40.1954631661726,2.8100171818297,5.86507936507936
2020-04-28,1689,37,1667,34,22,3,1812,40,30602,2174,32414,2214,2,36,1,177,39,1,"East TN",2455501,26.2268270304105,0.0548928005339117,90.1648991387094,1.50682080764781,5.48928005339117
2020-04-29,1752,63,1729,62,23,1,1878,66,33345,2743,35223,2809,1,37,6,183,40,1,"East TN",2455501,20.5660677800579,0.0435071404848887,114.396206721154,2.56566786167059,4.35071404848887
2020-04-30,1774,22,1750,21,24,1,1900,22,33894,549,35794,571,0,37,1,184,40,0,"East TN",2455501,11.4844180474779,0.0265518160021312,23.2539103018081,0.895947507250048,2.65518160021312
2020-05-01,1814,40,1786,36,28,4,1929,29,35556,1662,37485,1691,0,37,0,184,40,0,"East TN",2455501,11.1586189539324,0.0268390635713586,68.8657833981741,1.62899546772736,2.68390635713586
2020-05-02,1835,21,1807,21,28,0,1966,37,37433,1877,39399,1914,0,37,3,187,40,0,"East TN",2455501,11.077169180546,0.0257745608615059,77.9474331307542,0.855222620556864,2.57745608615059
2020-05-03,1873,38,1840,33,33,5,2003,37,39553,2120,41556,2157,0,37,3,190,42,2,"East TN",2455501,11.8102171410234,0.0245483269869562,87.8435805971979,1.54754569434099,2.45483269869562
2020-05-04,1920,47,1884,44,36,3,2060,57,41499,1946,43559,2003,0,37,1,191,42,0,"East TN",2455501,10.9142696337733,0.0215584998877161,81.5719480464475,1.91406967457965,2.15584998877161
2020-05-05,1948,28,1911,27,37,1,2092,32,44409,2910,46501,2942,2,39,1,192,42,0,"East TN",2455501,10.5477456535347,0.0198764818627103,119.812616651347,1.14029682740915,1.98764818627103
2020-05-06,1985,37,1948,37,37,0,2135,43,45453,1044,47588,1087,1,40,0,192,42,0,"East TN",2455501,9.48889859951187,0.0207844723008492,44.267951835491,1.50682080764781,2.07844723008492
2020-05-07,2028,43,1989,41,39,2,2183,48,46845,1392,49028,1440,0,40,4,196,46,4,"East TN",2455501,10.3441212200687,0.0213843131328397,58.643836838185,1.75117012780691,2.13843131328397
2020-05-08,2047,19,2008,19,39,0,2219,36,48515,1670,50734,1706,1,41,0,196,47,1,"East TN",2455501,9.48889859951187,0.0218884444108989,69.4766566985719,0.773772847170496,2.18884444108989
2020-05-09,2063,16,2022,14,41,2,2237,18,51333,2818,53570,2836,0,41,1,197,48,1,"East TN",2455501,9.28527416604595,0.0191235622045022,115.49577866187,0.651598187090944,1.91235622045022
2020-05-10,2079,16,2037,15,42,1,2256,19,53897,2564,56153,2583,1,42,3,200,48,0,"East TN",2455501,8.3893266587959,0.0173323285606631,105.192382328494,0.651598187090944,1.73323285606631
2020-05-11,2140,61,2097,60,43,1,2307,51,55468,1571,57775,1622,3,45,5,205,50,2,"East TN",2455501,8.95947507250048,0.0173747889701744,66.0557662163444,2.48421808828422,1.73747889701745
2020-05-12,2193,53,2150,53,43,0,2373,66,59022,3554,61395,3620,3,48,3,208,50,0,"East TN",2455501,9.97759723983008,0.0188666577145159,147.424089829326,2.15841899473875,1.88666577145159
2020-05-13,2247,54,2201,51,46,3,2425,52,60647,1625,63072,1677,0,48,7,215,52,2,"East TN",2455501,10.6699203136142,0.0187290105915784,68.2956349844696,2.19914388143194,1.87290105915784
2020-05-14,2278,31,2232,31,46,0,2470,45,62356,1709,64826,1754,1,49,2,217,53,1,"East TN",2455501,10.181221673296,0.018166856564122,71.4314512598447,1.2624714874887,1.8166856564122
2020-05-15,2306,28,2260,28,46,0,2507,37,64675,2319,67182,2356,1,50,4,221,53,0,"East TN",2455501,10.5477456535347,0.0175097276264591,95.9478330491415,1.14029682740915,1.75097276264591
2020-05-16,2316,10,2270,10,46,0,2525,18,67443,2768,69968,2786,1,51,1,222,53,0,"East TN",2455501,10.3033963333756,0.017563117453348,113.459534327211,0.40724886693184,1.7563117453348
2020-05-17,2396,80,2350,80,46,0,2604,79,69670,2227,72274,2306,0,51,4,226,55,2,"East TN",2455501,12.9097890817393,0.0215867502016004,93.9115887144823,3.25799093545472,2.15867502016004
2020-05-18,2445,49,2398,48,47,1,2665,61,71548,1878,74213,1939,0,51,3,229,55,0,"East TN",2455501,12.4210904414211,0.0217788052074462,78.9655552980838,1.99551944796602,2.17788052074462
2020-05-19,2486,41,2438,40,48,1,2705,40,72672,1124,75377,1164,1,52,3,232,55,0,"East TN",2455501,11.9323918011029,0.0237448147618366,47.4037681108662,1.66972035442054,2.37448147618366
2020-05-20,2528,42,2480,42,48,0,2750,45,74412,1740,77162,1785,0,52,3,235,55,0,"East TN",2455501,11.4436931607847,0.0230660042583392,72.6939227473334,1.71044524111373,2.30660042583392
2020-05-21,2769,241,2720,240,49,1,2988,238,75874,1462,78862,1700,0,52,4,239,56,1,"East TN",2455501,19.9959193663533,0.0369051011684241,69.2323073784128,9.81469769305734,3.69051011684241
2020-05-22,2860,91,2808,88,52,3,3066,78,77398,1524,80464,1602,0,52,7,246,56,0,"East TN",2455501,22.5615872280239,0.0420870350850776,65.2412684824808,3.70596468907974,4.20870350850775
2020-05-23,2926,66,2870,62,56,4,3157,91,79612,2214,82769,2305,2,54,7,253,57,1,"East TN",2455501,24.8421808828422,0.0493711428794625,93.8708638277891,2.68784252175014,4.93711428794625
2020-05-24,2978,52,2922,52,56,0,3227,70,81732,2120,84959,2190,0,54,0,253,58,1,"East TN",2455501,23.7018840554331,0.0491131257390619,89.187501858073,2.11769410804557,4.91131257390619
2020-05-25,3062,84,3005,83,57,1,3321,94,84382,2650,87703,2744,1,55,2,255,58,0,"East TN",2455501,25.1272550896945,0.0486286137879911,111.749089086097,3.42089048222746,4.86286137879911
2020-05-26,3123,61,3057,52,66,9,3377,56,86768,2386,90145,2442,1,56,3,258,58,0,"East TN",2455501,25.9417528235582,0.0455037919826652,99.4501733047553,2.48421808828422,4.55037919826652
2020-05-27,3199,76,3130,73,69,3,3444,67,88635,1867,92079,1934,0,56,9,267,58,0,"East TN",2455501,27.3263989711265,0.0465241000201113,78.7619308646179,3.09509138868198,4.65241000201113
2020-05-28,3273,74,3204,74,69,0,3511,67,90034,1399,93545,1466,0,56,1,268,58,0,"East TN",2455501,20.5253428933647,0.0356194238234693,59.7026838922077,3.01364161529562,3.56194238234693
2020-05-29,3348,75,3278,74,70,1,3594,83,91312,1278,94906,1361,0,56,4,272,58,0,"East TN",2455501,19.8737447062738,0.0365600332363939,55.4265707894234,3.0543665019888,3.65600332363939
2020-05-30,3421,73,3350,72,71,1,3675,81,93557,2245,97232,2326,0,56,5,277,59,1,"East TN",2455501,20.1588189131261,0.0358155292816152,94.726086448346,2.97291672860243,3.58155292816152
2020-05-31,3533,112,3460,110,73,2,3769,94,96340,2783,100109,2877,0,56,1,278,60,1,"East TN",2455501,22.6023121147171,0.0357755775577558,117.16549901629,4.56118730963661,3.57755775577558
2020-06-01,3629,96,3553,93,76,3,3902,133,100171,3831,104073,3964,0,56,5,283,60,0,"East TN",2455501,23.0910107550353,0.0354917532070861,161.433450851781,3.90958912254566,3.54917532070861
2020-06-02,3736,107,3658,105,78,2,4017,115,104230,4059,108247,4174,1,57,3,286,64,4,"East TN",2455501,24.9643555429218,0.0353552093691305,169.98567705735,4.35756287617069,3.53552093691305
2020-06-03,3786,50,3708,50,78,0,4067,50,106161,1931,110228,1981,0,57,4,290,65,1,"East TN",2455501,23.905508488899,0.0343269601630944,80.6760005391975,2.0362443346592,3.43269601630944
2020-06-04,3837,51,3757,49,80,2,4128,61,107708,1547,111836,1608,6,63,5,295,66,1,"East TN",2455501,22.9688360949558,0.0337324367175113,65.4856178026399,2.07696922135238,3.37324367175113
2020-06-05,3936,99,3852,95,84,4,4210,82,109864,2156,114074,2238,1,64,4,299,67,1,"East TN",2455501,23.9462333755922,0.0321368948247078,91.1422964193458,4.03176378262522,3.21368948247079
2020-06-06,3989,53,3902,50,87,3,4285,75,112967,3103,117252,3178,1,65,4,303,67,0,"East TN",2455501,23.1317356417285,0.0304695304695305,129.423689910939,2.15841899473875,3.04695304695305
2020-06-07,4047,58,3958,56,89,2,4366,81,116924,3957,121290,4038,0,65,6,309,68,1,"East TN",2455501,20.9325917602966,0.0281856380718569,164.447092467077,2.36204342820467,2.81856380718569
2020-06-08,4207,160,4114,156,93,4,4523,157,119875,2951,124398,3108,0,65,6,315,68,0,"East TN",2455501,23.5389845086604,0.0305535055350553,126.572947842416,6.51598187090944,3.05535055350553
2020-06-09,4315,108,4221,107,94,1,4641,118,122202,2327,126843,2445,1,66,7,322,69,1,"East TN",2455501,23.5797093953535,0.0335556033555603,99.5723479648349,4.39828776286387,3.35556033555603
2020-06-10,4392,77,4295,74,97,3,4715,74,125038,2836,129753,2910,0,66,6,328,69,0,"East TN",2455501,24.6792813360695,0.0331882202304737,118.509420277165,3.13581627537517,3.31882202304738
2020-06-11,4656,264,4557,262,99,2,4995,280,127329,2291,132324,2571,1,67,8,336,69,0,"East TN",2455501,33.3536822017177,0.0423174541194846,104.703683688176,10.7513700870006,4.23174541194846
2020-06-12,4827,171,4727,170,100,1,5167,172,129955,2626,135122,2798,2,69,3,339,70,1,"East TN",2455501,36.2858740436269,0.0454675028506271,113.948232967529,6.96395562453446,4.54675028506271
2020-06-13,4975,148,4871,144,104,4,5335,168,132146,2191,137481,2359,0,69,4,343,71,1,"East TN",2455501,40.1547382794794,0.0519056799644075,96.0700077092211,6.02728323059123,5.19056799644075
2020-06-14,5091,116,4986,115,105,1,5470,135,136014,3868,141484,4003,0,69,4,347,72,1,"East TN",2455501,42.5167817076841,0.0546697038724374,163.021721432816,4.72408685640934,5.46697038724374
2020-06-15,5273,182,5157,171,116,11,5649,179,139187,3173,144836,3352,0,69,9,356,77,5,"East TN",2455501,43.4127292149341,0.0550934533711713,136.509820195553,7.41192937815949,5.50934533711713
2020-06-16,5427,154,5309,152,118,2,5807,158,140986,1799,146793,1957,3,72,4,360,80,3,"East TN",2455501,45.2860740028206,0.0584461152882206,79.6986032585611,6.27163255075034,5.84461152882206
2020-06-17,5560,133,5439,130,121,3,5929,122,142426,1440,148355,1562,3,75,6,366,82,2,"East TN",2455501,47.5666676576389,0.0652617998064724,63.6122730147534,5.41640993019347,6.52617998064724
2020-06-18,5738,178,5616,177,122,1,6135,206,146017,3591,152152,3797,1,76,12,378,82,0,"East TN",2455501,44.0643274020251,0.0574944522896913,154.63239477402,7.24902983138675,5.74944522896913
2020-06-19,5873,135,5747,131,126,4,6253,118,147480,1463,153733,1581,4,80,13,391,83,1,"East TN",2455501,42.5982314810705,0.058352587179625,64.3860458619239,5.49785970357984,5.8352587179625
2020-06-20,5939,66,5812,65,127,1,6348,95,149655,2175,156003,2270,0,80,7,398,83,0,"East TN",2455501,39.2587907722294,0.0546917179570241,92.4454927935277,2.68784252175014,5.46917179570241
2020-06-21,6027,88,5899,87,128,1,6467,119,153005,3350,159472,3469,1,81,3,401,86,3,"East TN",2455501,38.1184939448202,0.0554258394485212,141.274631938655,3.58379002900019,5.54258394485212
2020-06-22,6223,196,6088,189,135,7,6665,198,156416,3411,163081,3609,1,82,7,408,87,1,"East TN",2455501,38.6886423585248,0.0556864894491642,146.976116075701,7.98207779186406,5.56864894491642
2020-06-23,6413,190,6272,184,141,6,6849,184,158220,1804,165069,1988,4,86,15,423,87,0,"East TN",2455501,40.1547382794794,0.0570146640402714,80.9610747460498,7.73772847170496,5.70146640402714
2020-06-24,6591,178,6448,176,143,2,7032,183,159851,1631,166883,1814,2,88,9,432,87,0,"East TN",2455501,41.9873581806727,0.0595315198618307,73.8749444614358,7.24902983138675,5.95315198618307
2020-06-25,6760,169,6608,160,152,9,7216,184,163024,3173,170240,3357,0,88,8,440,87,0,"East TN",2455501,41.620834200434,0.0597633790358249,136.713444629019,6.8825058511481,5.97633790358249
2020-06-26,6974,214,6812,204,162,10,7388,172,164612,1588,172000,1760,1,89,16,456,87,0,"East TN",2455501,44.8381002491956,0.0621339026660097,71.6758005800038,8.71512575234138,6.21339026660097
2020-06-27,7048,74,6881,69,167,5,7434,46,164821,209,172255,255,-1,88,5,461,89,2,"East TN",2455501,45.1638993427411,0.0668225449175486,10.3848461067619,3.01364161529562,6.68225449175486
2020-06-28,7175,127,7006,125,169,2,7605,171,167908,3087,175513,3258,0,88,5,466,90,1,"East TN",2455501,46.7521699237752,0.0709432080294246,132.681680846393,5.17206061003437,7.09432080294246
2020-06-29,7518,343,7347,341,171,2,7945,340,173175,5267,181120,5607,1,89,22,488,91,1,"East TN",2455501,52.7387282676733,0.0709573701424691,228.344439688683,13.9686361357621,7.09573701424691
2020-06-30,7788,270,7613,266,175,4,8393,448,179461,6286,187854,6734,0,89,22,510,92,1,"East TN",2455501,55.996719203128,0.0677638797454466,274.241386991901,10.9957194071597,6.77638797454466
2020-07-01,8063,275,7885,272,178,3,8727,334,182665,3204,191392,3538,0,89,17,527,95,3,"East TN",2455501,59.9470332123668,0.0691582683912032,144.084649120485,11.1993438406256,6.91582683912032
2020-07-02,8543,480,8360,475,183,5,9333,606,189047,6382,198380,6988,2,91,25,552,98,3,"East TN",2455501,72.6124729739471,0.0752309879175551,284.58550821197,19.5479456127283,7.52309879175551
2020-07-03,8769,226,8580,220,189,6,9561,228,192402,3355,201963,3583,5,96,14,566,99,1,"East TN",2455501,73.1011716142653,0.0725227780929813,145.917269021678,9.20382439265958,7.25227780929813
2020-07-04,8989,220,8798,218,191,2,9841,280,197166,4764,207007,5044,2,98,15,581,105,6,"East TN",2455501,79.0470050714701,0.0692622007366483,205.41632848042,8.95947507250048,6.92622007366483
2020-07-05,9309,320,9117,319,192,1,10209,368,201011,3845,211220,4213,2,100,12,593,108,3,"East TN",2455501,86.9069082032546,0.0729268770829249,171.573947638384,13.0319637418189,7.29268770829249
2020-07-06,9543,234,9340,223,203,11,10419,210,202641,1630,213060,1840,4,104,26,619,108,0,"East TN",2455501,82.4678955536976,0.0774577332498435,74.9337915154586,9.52962348620506,7.74577332498435
2020-07-07,9991,448,9779,439,212,9,10985,566,208917,6276,219902,6842,0,104,32,651,109,1,"East TN",2455501,89.7169253850844,0.0808786819770344,278.639674754765,18.2447492385464,8.08786819770345
2020-07-08,10372,381,10150,371,222,10,11419,434,213085,4168,224504,4602,1,105,20,671,109,0,"East TN",2455501,94.0337633745619,0.0812998308770234,187.415928562033,15.5161818301031,8.12998308770234
2020-07-09,10821,449,10585,435,236,14,11891,472,219034,5949,230925,6421,1,106,24,695,113,4,"East TN",2455501,92.7712918870731,0.0785988631126133,261.494497456934,18.2854741252396,7.85988631126133
2020-07-10,11288,467,11040,455,248,12,12344,453,222318,3284,234662,3737,0,106,29,724,115,2,"East TN",2455501,102.58598958013,0.0851096363803174,152.188901572429,19.0185220857169,8.51096363803175
2020-07-11,11594,306,11339,299,255,7,12766,422,226796,4478,239562,4900,5,111,23,747,120,5,"East TN",2455501,106.088329835744,0.0898479496237137,199.551944796602,12.4618153281143,8.98479496237137
2020-07-12,12064,470,11801,462,263,8,13399,633,232725,5929,246124,6562,1,112,25,772,125,5,"East TN",2455501,112.197062839722,0.0913935365574146,267.236706480673,19.1406967457965,9.13935365574146
2020-07-13,12418,354,12142,341,276,13,13742,343,236158,3433,249900,3776,3,115,20,792,129,4,"East TN",2455501,117.084049242904,0.0902008686210641,153.777172153463,14.4166098893871,9.02008686210641
2020-07-14,12933,515,12652,510,281,5,14326,584,240646,4488,254972,5072,4,119,34,826,133,4,"East TN",2455501,119.812616651347,0.0952666096378671,206.556625307829,20.9733166469898,9.52666096378671
2020-07-15,13313,380,13026,374,287,6,14709,383,243742,3096,258451,3479,6,125,24,850,140,7,"East TN",2455501,119.771891764654,0.0969157804813386,141.681880805587,15.4754569434099,9.69157804813386
2020-07-16,14140,827,13838,812,302,15,15806,1097,253573,9831,269379,10928,6,131,44,894,142,2,"East TN",2455501,135.165898934678,0.101809954751131,445.041561783115,33.6794812952632,10.1809954751131
2020-07-17,14608,468,14292,454,316,14,16317,511,257892,4319,274209,4830,3,134,24,918,147,5,"East TN",2455501,135.206623821371,0.100462740536577,196.701202728079,19.0592469724101,10.0462740536577
2020-07-18,15117,509,14786,494,331,15,16985,668,265980,8088,282965,8756,6,140,27,945,150,3,"East TN",2455501,143.473775820087,0.097205262309057,356.587107885519,20.7289673268307,9.7205262309057
2020-07-19,15598,481,15248,462,350,19,17545,560,270832,4852,288377,5412,0,140,26,971,154,4,"East TN",2455501,143.921749573712,0.098123210186259,220.403086783512,19.5886704994215,9.8123210186259
2020-07-20,16033,435,15668,420,365,15,17956,411,273289,2457,291245,2868,2,142,29,1000,158,4,"East TN",2455501,147.22046539586,0.101922844358447,116.798975036052,17.715325711535,10.1922844358447
2020-07-21,17034,1001,16652,984,382,17,19168,1212,281667,8378,300835,9590,1,143,61,1061,161,3,"East TN",2455501,167.012760328748,0.105575300351046,390.551663387635,40.7656115798772,10.5575300351046
2020-07-22,17618,584,17220,568,398,16,19822,654,284967,3300,304789,3954,4,147,29,1090,166,5,"East TN",2455501,175.320637214157,0.11034140446286,161.02620198485,23.7833338288195,11.034140446286
2020-07-23,18412,794,17992,772,420,22,20821,999,295168,10201,315989,11200,4,151,50,1140,172,6,"East TN",2455501,173.976715953282,0.107594936708861,456.118730963661,32.3355600343881,10.7594936708861
2020-07-24,19015,603,18582,590,433,13,21505,684,300975,5807,322480,6491,2,153,34,1174,179,7,"East TN",2455501,179.474575656862,0.107476538708541,264.345239525457,24.55710667599,10.7476538708541
2020-07-25,19992,977,19547,965,445,12,22706,1201,310582,9607,333288,10808,10,163,29,1203,187,8,"East TN",2455501,198.533822629272,0.113685591081613,440.154575379933,39.7882142992408,11.3685591081613
2020-07-26,20767,775,20307,760,460,15,23603,897,318100,7518,341703,8415,1,164,21,1224,194,7,"East TN",2455501,210.506939317068,0.113603120429059,342.699921523143,31.5617871872176,11.3603120429059
2020-07-27,21412,645,20930,623,482,22,24308,705,322563,4463,346871,5168,6,170,38,1262,198,4,"East TN",2455501,219.059165522637,0.114191205551361,210.466214430375,26.2675519171037,11.4191205551361
2020-07-28,22227,815,21722,792,505,23,25280,972,330777,8214,356057,9186,7,177,50,1312,203,5,"East TN",2455501,211.484336597704,0.110680525877368,374.098809163588,33.190782654945,11.0680525877368
2020-07-29,22570,343,22054,332,516,11,25596,316,332347,1570,357943,1886,5,182,24,1336,212,9,"East TN",2455501,201.669638904647,0.108627760845844,76.807136303345,13.9686361357621,10.8627760845844
2020-07-30,23757,1187,23226,1172,531,15,26976,1380,344877,12530,371853,13910,5,187,46,1382,219,7,"East TN",2455501,217.674519375068,0.110178290133181,566.48317390219,48.3404405048094,11.0178290133181
2020-07-31,24379,622,23832,606,547,16,27630,654,348844,3967,376474,4621,6,193,27,1409,228,9,"East TN",2455501,218.448292222239,0.11343853020706,188.189701409203,25.3308795231604,11.343853020706
2020-08-01,24938,559,24374,542,564,17,28266,636,355819,6975,384085,7611,1,194,16,1425,231,3,"East TN",2455501,201.425289584488,0.109455282792291,309.957112621823,22.7652116614899,10.9455282792291
2020-08-02,25369,431,24794,420,575,11,28749,483,359614,3795,388363,4278,4,198,21,1446,236,5,"East TN",2455501,187.415928562033,0.110287183883412,174.221065273441,17.5524261647623,11.0287183883412
2020-08-03,25995,626,25402,608,593,18,29457,708,363758,4144,393215,4852,3,201,39,1485,244,8,"East TN",2455501,186.642155714862,0.111103918522355,197.597150235329,25.4937790699332,11.1103918522355
2020-08-04,26481,486,25868,466,613,20,29983,526,369128,5370,399111,5896,6,207,34,1519,253,9,"East TN",2455501,173.243667992805,0.109234914293678,240.113931943013,19.7922949328874,10.9234914293678
2020-08-05,26949,468,26328,460,621,8,30504,521,373340,4212,403844,4733,9,216,20,1539,259,6,"East TN",2455501,178.334278829453,0.106925775037581,192.75088871884,19.0592469724101,10.6925775037581
2020-08-06,27679,730,27020,692,659,38,31355,851,380409,7069,411764,7920,7,223,37,1576,265,6,"East TN",2455501,159.723005610668,0.109719125053243,322.541102610017,29.7291672860243,10.9719125053243
2020-08-07,28234,555,27561,541,673,14,31974,619,384377,3968,416351,4587,6,229,34,1610,278,13,"East TN",2455501,156.994438202224,0.108934975048273,186.805055261635,22.6023121147171,10.8934975048273
2020-08-08,28909,675,28224,663,685,12,32774,800,394454,10077,427228,10877,8,237,24,1634,289,11,"East TN",2455501,161.718525058634,0.104489720232714,442.964592561762,27.4892985178992,10.4489720232714
2020-08-09,29437,528,28740,516,697,12,33408,634,398755,4301,432163,4935,2,239,20,1654,296,7,"East TN",2455501,165.668839067873,0.106369863013699,200.977315830863,21.5027401740012,10.6369863013699
2020-08-10,29740,303,29032,292,708,11,33736,328,401044,2289,434780,2617,3,242,26,1680,300,4,"East TN",2455501,152.514700665974,0.102947191146397,106.577028476063,12.3396406680348,10.2947191146397
2020-08-11,30352,612,29627,595,725,17,34421,685,407141,6097,441562,6782,17,259,28,1708,305,5,"East TN",2455501,157.646036389315,0.104544062566253,276.196181553174,24.9236306562286,10.4544062566253
2020-08-12,30797,445,30051,424,746,21,34895,474,410889,3748,445784,4222,6,265,25,1733,310,5,"East TN",2455501,156.709363995372,0.104697186456843,171.940471618623,18.1225745784669,10.4697186456843
2020-08-13,31614,817,30855,804,759,13,36012,1117,419450,8561,455462,9678,6,271,44,1777,318,8,"East TN",2455501,160.252429137679,0.106572383175431,394.135453416635,33.2722324283313,10.6572383175431
2020-08-14,32075,461,31287,432,788,29,36546,534,424106,4656,460652,5190,4,275,18,1795,325,7,"East TN",2455501,156.42428978852,0.103203087966412,211.362161937625,18.7741727655578,10.3203087966412
2020-08-15,32725,650,31925,638,800,12,37423,877,431041,6935,468464,7812,4,279,17,1812,334,9,"East TN",2455501,155.40616762119,0.112741294014938,318.142814847153,26.4711763505696,11.2741294014938
2020-08-16,33199,474,32388,463,811,11,38016,593,436505,5464,474521,6057,2,281,10,1822,343,9,"East TN",2455501,153.207023739758,0.108787005996506,246.670638700615,19.3035962925692,10.8787005996506
2020-08-17,33472,273,32591,203,881,70,38243,227,437974,1469,476217,1696,8,289,12,1834,349,6,"East TN",2455501,151.985277138963,0.108767526606656,69.0694078316401,11.1178940672392,10.8767526606656
2020-08-18,34102,630,33156,565,946,65,39055,812,448566,10592,487621,11404,8,297,22,1856,352,3,"East TN",2455501,152.71832509944,0.100610087062246,464.42660784907,25.6566786167059,10.0610087062246
2020-08-19,34557,455,33590,434,967,21,39552,497,453349,4783,492901,5280,7,304,22,1878,359,7,"East TN",2455501,153.125573966372,0.0988390602118131,215.027401740011,18.5298234453987,9.88390602118131
2020-08-20,35333,776,34345,755,988,21,40424,872,464881,11532,505305,12404,6,310,27,1905,367,8,"East TN",2455501,151.455853611951,0.0885179463515438,505.151494542254,31.6025120739108,8.85179463515438
2020-08-21,35542,209,34542,197,1000,12,40637,213,467332,2451,507969,2664,17,327,17,1922,374,7,"East TN",2455501,141.193182165269,0.0864594120506372,108.491098150642,8.51150131887546,8.64594120506372
2020-08-22,36411,869,35399,857,1012,12,41609,972,480698,13366,522307,14338,2,329,20,1942,381,7,"East TN",2455501,150.111932351076,0.0777445536095686,583.913425406872,35.3899265363769,7.77445536095686
2020-08-23,36664,253,35641,242,1023,11,41863,254,485802,5104,527665,5358,0,329,20,1962,386,5,"East TN",2455501,141.111732391883,0.072388228210146,218.20394290208,10.3033963333756,7.2388228210146
2020-08-24,36856,192,35816,175,1040,17,42061,198,487145,1343,529206,1541,8,337,15,1977,396,10,"East TN",2455501,137.813016569735,0.072052690180981,62.7570503941965,7.81917824509133,7.2052690180981
2020-08-25,37470,614,36405,589,1065,25,42746,685,496872,9727,539618,10412,16,353,23,2000,405,9,"East TN",2455501,137.161418382644,0.0709848645114141,424.027520249432,25.005080429615,7.09848645114141
2020-08-26,37813,343,36723,318,1090,25,43129,383,500834,3962,543963,4345,6,359,11,2011,413,8,"East TN",2455501,132.600231073007,0.0700520935333516,176.949632681884,13.9686361357621,7.00520935333516
2020-08-27,38674,861,37567,844,1107,17,44105,976,511121,10287,555226,11263,8,367,29,2040,420,7,"East TN",2455501,136.061846441928,0.0737365036758078,458.684398825331,35.0641274428314,7.37365036758078
2020-08-28,39008,334,37881,314,1127,20,44443,338,513730,2609,558173,2947,12,379,10,2050,426,6,"East TN",2455501,141.152457278576,0.0758106923751096,120.016241084813,13.6021121555235,7.58106923751096
2020-08-29,39459,451,38316,435,1143,16,44971,528,520249,6519,565220,7047,8,387,16,2066,435,9,"East TN",2455501,124.129454640825,0.0783445575932701,286.988276526868,18.366923898626,7.83445575932701
2020-08-30,39722,263,38568,252,1154,11,45238,267,522130,1881,567368,2148,8,395,14,2080,438,3,"East TN",2455501,124.536703507757,0.0850061708183261,87.4770566169592,10.7106452003074,8.50061708183261
2020-08-31,40129,407,38946,378,1183,29,45688,450,525616,3486,571304,3936,2,397,17,2097,443,5,"East TN",2455501,133.292554146791,0.0861561119293078,160.293154024372,16.5750288841259,8.61561119293078
2020-09-01,40736,607,39511,565,1225,42,46362,674,531279,5663,577641,6337,6,403,28,2125,452,9,"East TN",2455501,133.007479939939,0.0951003340083634,258.073606974707,24.7200062227627,9.51003340083634
2020-09-02,41224,488,39970,459,1254,29,46815,453,536072,4793,582887,5246,7,410,22,2147,459,7,"East TN",2455501,138.912588510451,0.0946973589559141,213.642755592443,19.8737447062738,9.46973589559141
2020-09-03,41779,555,40492,522,1287,33,47462,647,544328,8256,591790,8903,6,416,22,2169,462,3,"East TN",2455501,126.450773182336,0.0918116179849032,362.573666229417,22.6023121147171,9.18116179849032
2020-09-04,42136,357,40835,343,1301,14,47810,348,547660,3332,595470,3680,7,423,11,2180,463,1,"East TN",2455501,127.38744557628,0.0902753572673405,149.867583030917,14.5387845494667,9.02753572673405
2020-09-05,43134,998,41818,983,1316,15,48900,1090,556971,9311,605871,10401,1,424,26,2206,469,6,"East TN",2455501,149.663958597451,0.0966519888809623,423.579546495807,40.6434369197976,9.66519888809623
2020-09-06,43397,263,42065,247,1332,16,49168,268,559595,2624,608763,2892,0,424,9,2215,483,14,"East TN",2455501,149.663958597451,0.0949390022949632,117.776372316688,10.7106452003074,9.49390022949632
2020-09-07,43601,204,42262,197,1339,7,49405,237,560931,1336,610336,1573,3,427,13,2228,487,4,"East TN",2455501,141.396806598735,0.0952295552367288,64.0602467683784,8.30787688540954,9.52295552367288
2020-09-08,43912,311,42551,289,1361,22,49725,320,564356,3425,614081,3745,7,434,24,2252,494,7,"East TN",2455501,129.342240137552,0.0922886937431394,152.514700665974,12.6654397615802,9.22886937431394
2020-09-09,44245,333,42867,316,1378,17,50099,374,569498,5142,619597,5516,6,440,16,2268,501,7,"East TN",2455501,123.029882700109,0.0894579133751022,224.638474999603,13.5613872688303,8.94579133751022
2020-09-10,44920,675,43505,638,1415,37,50806,707,577304,7806,628110,8513,18,458,39,2307,512,11,"East TN",2455501,127.916869103291,0.0920704845814978,346.690960419075,27.4892985178992,9.20704845814978
2020-09-11,45245,325,43807,302,1438,23,51160,354,581459,4155,632619,4509,17,475,26,2333,523,11,"East TN",2455501,126.613672729109,0.0901773937387278,183.628514099567,13.2355881752848,9.01773937387278
2020-09-12,45663,418,44207,400,1456,18,51671,511,588443,6984,640114,7495,10,485,14,2347,534,11,"East TN",2455501,102.993238447062,0.0809216482200742,305.233025765414,17.0230026377509,8.09216482200742
2020-09-13,46102,439,44626,419,1476,20,52171,500,594017,5574,646188,6074,2,487,21,2368,539,5,"East TN",2455501,110.160818505063,0.0802404809619238,247.3629617744,17.8782252583078,8.02404809619238
2020-09-14,46546,444,45055,429,1491,15,52656,485,598990,4973,651646,5458,9,496,25,2393,549,10,"East TN",2455501,119.934791311427,0.0786976519002663,222.276431571398,18.0818496917737,7.86976519002663
2020-09-15,47039,493,45511,456,1528,37,53196,540,607164,8174,660360,8714,7,503,20,2413,552,3,"East TN",2455501,127.346720689586,0.0750016206054582,354.876662644405,20.0773691397397,7.50016206054582
2020-09-16,47392,353,45821,310,1571,43,53590,394,610578,3414,664168,3808,6,509,17,2430,561,9,"East TN",2455501,128.16121842345,0.0783244710686321,155.080368527645,14.375885002694,7.83244710686321
2020-09-17,47943,551,46340,519,1603,32,54167,577,617753,7175,671920,7752,8,517,21,2451,572,11,"East TN",2455501,123.111332473495,0.0767176443734307,315.699321645562,22.4394125679444,7.67176443734307
2020-09-18,48477,534,46826,486,1651,48,54733,566,625866,8113,680599,8679,17,534,30,2481,578,6,"East TN",2455501,131.622833792371,0.074468528553564,353.451291610144,21.7470894941603,7.4468528553564
2020-09-19,48985,508,47311,485,1674,23,55306,573,634218,8352,689524,8925,3,537,30,2511,580,2,"East TN",2455501,135.288073594757,0.0735681036227484,363.469613736667,20.6882424401375,7.35681036227484
2020-09-20,49291,306,47592,281,1699,25,55635,329,639176,4958,694811,5287,1,538,13,2524,591,11,"East TN",2455501,129.871663664564,0.0712420048125373,215.312475946864,12.4618153281143,7.12420048125373
2020-09-21,49454,163,47725,133,1729,30,55787,152,640692,1516,696479,1668,3,541,9,2533,596,5,"East TN",2455501,118.427970503779,0.0698369504605982,67.9291110042309,6.63815653098899,6.98369504605982
2020-09-22,49914,460,48127,402,1787,58,56277,490,646841,6149,703118,6639,6,547,29,2562,603,7,"East TN",2455501,117.084049242904,0.0720566911455166,270.372522756049,18.7334478788646,7.20566911455166
2020-09-23,50208,294,48381,254,1827,40,56559,282,648934,2093,705493,2375,8,555,13,2575,612,9,"East TN",2455501,114.681280928006,0.0718451300665457,96.721605896312,11.9731166877961,7.18451300665457
2020-09-24,50671,463,48823,442,1848,21,57039,480,655824,6890,712863,7370,11,566,28,2603,617,5,"East TN",2455501,111.097490899006,0.0701463009549862,300.142414928766,18.8556225389442,7.01463009549862
2020-09-25,51125,454,49253,430,1872,24,57525,486,662498,6674,720023,7160,11,577,18,2621,624,7,"East TN",2455501,107.839499963551,0.0708198051948052,291.590188723197,18.4890985587055,7.08198051948052
2020-09-26,51683,558,49787,534,1896,24,58163,638,673052,10554,731215,11192,5,582,29,2650,631,7,"East TN",2455501,109.87574429821,0.0685279796598786,455.792931870115,22.7244867747967,6.85279796598786
2020-09-27,52076,393,50152,365,1924,28,58570,407,679069,6017,737639,6424,3,585,30,2680,638,7,"East TN",2455501,113.418809440517,0.0685299336882413,261.616672117014,16.0048804704213,6.85299336882413
2020-09-28,52310,234,50347,195,1963,39,58795,225,680755,1686,739550,1911,4,589,15,2695,645,7,"East TN",2455501,116.310276395733,0.0698381741775208,77.8252584706746,9.52962348620506,6.98381741775208
2020-09-29,52693,383,50687,340,2006,43,59192,397,686563,5808,745755,6205,9,598,33,2728,647,2,"East TN",2455501,113.174460120358,0.0683678495203696,252.697921931207,15.5976316034895,6.83678495203696
2020-09-30,53175,482,51137,450,2038,32,59668,476,690001,3438,749669,3914,6,604,23,2751,651,4,"East TN",2455501,120.830738818677,0.0703775805867439,159.397206517122,19.6293953861147,7.0377580586744
2020-10-01,53563,388,51486,349,2077,39,60047,379,693279,3278,753326,3657,11,615,31,2782,656,5,"East TN",2455501,117.776372316688,0.0743395200553592,148.930910636974,15.8012560369554,7.43395200553592
2020-10-02,54027,464,51922,436,2105,28,60509,462,696900,3621,757409,4083,2,617,17,2799,660,4,"East TN",2455501,118.18362118362,0.079815973893971,166.27971236827,18.8963474256374,7.9815973893971
2020-10-03,54432,405,52310,388,2122,17,60992,483,704358,7458,765350,7941,12,629,22,2821,666,6,"East TN",2455501,111.952713519563,0.082876812655632,323.396325230574,16.4935791107395,8.2876812655632
2020-10-04,54887,455,52735,425,2152,30,61531,539,714480,10122,776011,10661,4,633,27,2848,679,13,"East TN",2455501,114.47765649454,0.0771656416136766,434.168017036035,18.5298234453987,7.71656416136766
2020-10-05,55558,671,53347,612,2211,59,62282,751,721729,7249,784011,8000,5,638,42,2890,688,9,"East TN",2455501,132.274431979462,0.0784282854636648,325.799093545472,27.3263989711265,7.84282854636648
2020-10-06,56308,750,54013,666,2295,84,63021,739,728366,6637,791387,7376,8,646,46,2936,697,9,"East TN",2455501,147.22046539586,0.0839104137447405,300.386764248925,30.543665019888,8.39104137447405
2020-10-07,57045,737,54672,659,2373,78,63729,708,735117,6751,798846,7459,3,649,38,2974,703,6,"East TN",2455501,157.605311502622,0.0825792545295565,303.766929844459,30.0142414928766,8.25792545295565
2020-10-08,57763,718,55329,657,2434,61,64407,678,741575,6458,805982,7136,10,659,32,3006,709,6,"East TN",2455501,171.044524111373,0.082801580066849,290.612791442561,29.2404686457061,8.2801580066849
2020-10-09,58304,541,55828,499,2476,42,64967,560,747054,5479,812021,6039,4,663,20,3026,716,7,"East TN",2455501,174.180340386748,0.0816304108987036,245.937590740138,22.0321637010125,8.16304108987036
2020-10-10,58922,618,56416,588,2506,30,65636,669,755480,8426,821116,9095,12,675,20,3046,730,14,"East TN",2455501,182.854741252396,0.08327654843453,370.392844474508,25.1679799763877,8.327654843453
2020-10-11,59865,943,57328,912,2537,31,66665,1029,765906,10426,832571,11455,1,676,37,3083,737,7,"East TN",2455501,202.72848595867,0.0907708628005658,466.503577070423,38.4035681516725,9.07708628005658
2020-10-12,60221,356,57613,285,2608,71,66982,317,768827,2921,835809,3238,6,682,19,3102,748,11,"East TN",2455501,189.900146650317,0.0907370940962972,131.86718311253,14.4980596627735,9.07370940962972
2020-10-13,60726,505,58066,453,2660,52,67466,484,773208,4381,840674,4865,9,691,24,3126,755,7,"East TN",2455501,179.922549410487,0.0901860531174549,198.12657376234,20.5660677800579,9.01860531174549
2020-10-14,61600,874,58878,812,2722,62,68314,848,779392,6184,847706,7032,1,692,44,3170,762,7,"East TN",2455501,185.501858887453,0.0938395415472779,286.37740322647,35.5935509698428,9.38395415472779
2020-10-15,62109,509,59318,440,2791,69,68779,465,783545,4153,852324,4618,14,706,19,3189,771,9,"East TN",2455501,176.990357568578,0.0943420655129256,188.067526749124,20.7289673268307,9.43420655129256
2020-10-16,62748,639,59914,596,2834,43,69363,584,787634,4089,856997,4673,2,708,22,3211,783,12,"East TN",2455501,180.98139646451,0.097741017431519,190.307395517249,26.0232025969446,9.7741017431519
2020-10-17,63466,718,60595,681,2871,37,70223,860,796417,8783,866640,9643,6,714,37,3248,790,7,"East TN",2455501,185.053885133828,0.100760038660926,392.710082382373,29.2404686457061,10.0760038660926
2020-10-18,64270,804,61353,758,2917,46,71093,870,804525,8108,875618,8978,3,717,39,3287,798,8,"East TN",2455501,179.393125883476,0.102864311101819,365.628032731406,32.7428089013199,10.2864311101819
2020-10-19,65018,748,62038,685,2980,63,71852,759,809423,4898,881275,5657,3,720,67,3354,809,11,"East TN",2455501,195.357281467204,0.107113007522104,230.380684023342,30.4622152465016,10.7113007522104
2020-10-20,65704,686,62647,609,3057,77,72543,691,813037,3614,885580,4305,15,735,32,3386,822,13,"East TN",2455501,202.72848595867,0.113058388634036,175.320637214157,27.9372722715242,11.3058388634036
2020-10-21,66297,593,63199,552,3098,41,73159,616,816780,3743,889939,4359,5,740,27,3413,836,14,"East TN",2455501,191.284792797885,0.114720716027751,177.519781095589,24.1498578090581,11.4720716027751
2020-10-22,67427,1130,64235,1036,3192,94,74260,1101,825344,8564,899604,9665,10,750,43,3456,851,15,"East TN",2455501,216.574947434353,0.115926395939086,393.606029889623,46.0191219632979,11.5926395939086
2020-10-23,68398,971,65139,904,3259,67,75230,970,832460,7116,907690,8086,19,769,39,3495,859,8,"East TN",2455501,230.09560981649,0.115735900420176,329.301433801086,39.5438649790817,11.5735900420176
2020-10-24,69635,1237,66314,1175,3321,62,76557,1327,842981,10521,919538,11848,12,781,50,3545,876,17,"East TN",2455501,251.231826010252,0.119739876743922,482.508457540844,50.3766848394686,11.9739876743922
2020-10-25,70564,929,67186,872,3378,57,77604,1047,850856,7875,928460,8922,9,790,43,3588,887,11,"East TN",2455501,256.3224368469,0.123216380909125,363.347439076588,37.8334197379679,12.3216380909125
2020-10-26,71026,462,67592,406,3434,56,78038,434,853611,2755,931649,3189,6,796,21,3609,900,13,"East TN",2455501,244.675119252649,0.122801445189979,129.871663664564,18.814897652251,12.2801445189979
2020-10-27,71868,842,68304,712,3564,130,78821,783,857995,4384,936816,5167,12,808,54,3663,924,24,"East TN",2455501,251.028201576786,0.122531032867515,210.425489543682,34.2903545956609,12.2531032867515
2020-10-28,72865,997,69215,911,3650,86,79791,970,865211,7216,945002,8186,13,821,41,3704,938,14,"East TN",2455501,267.481055800833,0.120443855220384,333.373922470404,40.6027120331044,12.0443855220384
2020-10-29,73773,908,70008,793,3765,115,80625,834,871713,6502,952338,7336,11,832,40,3744,950,12,"East TN",2455501,258.440130954946,0.120700117571206,298.757768781198,36.9781971174111,12.0700117571206
2020-10-30,74673,900,70815,807,3858,93,81465,840,876569,4856,958034,5696,28,860,39,3783,966,16,"East TN",2455501,255.54866399973,0.123847926267281,231.968954604376,36.6523980238656,12.3847926267281
2020-10-31,74687,14,70829,14,3858,0,81481,16,876590,21,958071,37,5,865,0,3783,977,11,"East TN",2455501,205.742127573966,0.127786572548205,1.50682080764781,0.570148413704576,12.7786572548205
2020-11-01,75194,507,71219,390,3975,117,81951,470,883153,6563,965104,7033,0,865,27,3810,993,16,"East TN",2455501,188.556225389442,0.118627879052505,286.418128113163,20.6475175534443,11.8627879052505
2020-11-02,76004,810,71961,742,4043,68,82726,775,887381,4228,970107,5003,11,876,38,3848,1007,14,"East TN",2455501,202.72848595867,0.121899214727755,203.746608126,32.987158221479,12.1899214727755
2020-11-03,77044,1040,72921,960,4123,80,83802,1076,894243,6862,978045,7938,31,907,29,3877,1020,13,"East TN",2455501,210.79201352392,0.120813019961677,323.274150570495,42.3538821609114,12.0813019961677
2020-11-04,77955,911,73733,812,4222,99,84649,847,899128,4885,983777,5732,6,913,35,3912,1044,24,"East TN",2455501,207.289673268307,0.12528691166989,233.435050525331,37.1003717774906,12.528691166989
2020-11-05,78533,578,74217,484,4316,94,85150,501,901789,2661,986939,3162,17,930,27,3939,1058,14,"East TN",2455501,193.850460659556,0.130776567151238,128.772091723848,23.5389845086603,13.0776567151238
2020-11-06,79499,966,75066,849,4433,117,86077,927,908196,6407,994273,7334,10,940,37,3976,1082,24,"East TN",2455501,196.538303181306,0.127266204917354,298.676319007811,39.3402405456157,12.7266204917354
2020-11-07,80826,1327,76307,1241,4519,86,87496,1419,919116,10920,1006612,12339,21,961,52,4028,1092,10,"East TN",2455501,250.010079409457,0.123915864938918,502.504376907197,54.0419246418552,12.3915864938918
2020-11-08,82383,1557,77746,1439,4637,118,89163,1667,932015,12899,1021178,14566,3,964,52,4080,1109,17,"East TN",2455501,292.7712104373,0.128615757748689,593.198699572918,63.4086485812875,12.8615757748689
2020-11-09,83002,619,78285,539,4717,80,89743,580,935467,3452,1025210,4032,9,973,19,4099,1120,11,"East TN",2455501,284.992757078902,0.127343338838176,164.202743146918,25.2087048630809,12.7343338838176
2020-11-10,83941,939,79135,850,4806,89,90666,923,940468,5001,1031134,5924,27,1000,44,4143,1138,18,"East TN",2455501,280.87954352289,0.12929232044303,241.254228770422,38.2406686048998,12.929232044303
2020-11-11,85245,1304,80235,1100,5010,204,91835,1169,947015,6547,1038850,7716,26,1026,59,4202,1152,14,"East TN",2455501,296.884423993311,0.130481361102537,314.233225724608,53.1052522479119,13.0481361102537
2020-11-12,86082,837,80940,705,5142,132,92599,764,951228,4213,1043827,4977,15,1041,34,4236,1170,18,"East TN",2455501,307.432169646846,0.130941499085923,202.687761071977,34.086730162195,13.0941499085923
2020-11-13,87540,1458,82227,1287,5313,171,93898,1299,957087,5859,1050985,7158,27,1068,47,4283,1186,16,"East TN",2455501,327.468813899893,0.137907321201862,291.508738949811,59.3768847986623,13.7907321201862
2020-11-14,89015,1475,83618,1391,5397,84,95433,1535,965982,8895,1061415,10430,7,1075,52,4335,1215,29,"East TN",2455501,333.496097130484,0.144827837892086,424.760568209909,60.0692078724464,14.4827837892086
2020-11-15,90967,1952,85351,1733,5616,219,97393,1960,977151,11169,1074544,13129,7,1082,56,4391,1232,17,"East TN",2455501,349.582427374291,0.154218041449612,534.677037394813,79.4949788250952,15.4218041449612
2020-11-16,92492,1525,86750,1399,5742,126,98930,1537,984770,7619,1083700,9156,10,1092,41,4432,1251,19,"East TN",2455501,386.479174718316,0.157069584544367,372.877062562793,62.1054522071056,15.7069584544367
2020-11-17,93704,1212,87869,1119,5835,93,100151,1221,989913,5143,1090064,6364,31,1123,46,4478,1278,27,"East TN",2455501,397.597068785555,0.160953673850331,259.173178915423,49.358562672139,16.0953673850331
2020-11-18,94902,1198,88825,956,6077,242,101184,1033,995057,5144,1096241,6177,14,1137,53,4531,1293,15,"East TN",2455501,393.280230796078,0.162900106288442,251.557625103798,48.7884142584344,16.2900106288442
2020-11-19,95982,1080,89706,881,6276,199,102043,859,999718,4661,1101761,5520,45,1182,52,4583,1313,20,"East TN",2455501,403.176378262522,0.163013083854041,224.801374546376,43.9828776286387,16.3013083854041
2020-11-20,97108,1126,90669,963,6439,163,103066,1023,1004617,4899,1107683,5922,28,1210,36,4619,1339,26,"East TN",2455501,389.655715880384,0.161698825355392,241.172778997036,45.8562224165252,16.1698825355392
2020-11-21,98326,1218,91733,1064,6593,154,104165,1099,1011023,6406,1115188,7505,3,1213,47,4666,1363,24,"East TN",2455501,379.189420000236,0.162386327710933,305.640274632346,49.6029119922981,16.2386327710933
2020-11-22,99912,1586,93162,1429,6750,157,105831,1666,1020624,9601,1126455,11267,17,1230,57,4723,1390,27,"East TN",2455501,364.284111470531,0.162547436959411,458.847298372104,64.5896702953898,16.2547436959411
2020-11-23,100803,891,93920,758,6883,133,106533,702,1023740,3116,1130273,3818,18,1248,35,4758,1417,27,"East TN",2455501,338.464533307052,0.163249092822021,155.487617394577,36.2858740436269,16.3249092822021
2020-11-24,101714,911,94655,735,7059,176,107238,705,1026767,3027,1134005,3732,13,1261,57,4815,1445,28,"East TN",2455501,326.206342412404,0.161284449602877,151.985277138963,37.1003717774906,16.1284449602877
2020-11-25,102620,906,95341,686,7279,220,107783,545,1029075,2308,1136858,2853,38,1299,56,4871,1470,25,"East TN",2455501,314.314675497994,0.162468916955954,116.188101735654,36.8967473440247,16.2468916955954
2020-11-26,104085,1465,96728,1387,7357,78,109452,1669,1037440,8365,1146892,10034,18,1317,25,4896,1489,19,"East TN",2455501,329.99375687487,0.164166537413308,408.633513079408,59.6619590055146,16.4166537413308
2020-11-27,105788,1703,98294,1566,7494,137,111201,1749,1044979,7539,1156180,9288,5,1322,50,4946,1517,28,"East TN",2455501,353.492016496837,0.167742334577397,378.252747606293,69.3544820384923,16.7742334577397
2020-11-28,107412,1624,99674,1380,7738,244,112695,1494,1052509,7530,1165204,9024,2,1324,45,4991,1545,28,"East TN",2455501,370.02632049427,0.170545425463852,367.501377519292,66.1372159897308,17.0545425463852
2020-11-29,109699,2287,101794,2120,7905,167,115020,2325,1063204,10695,1178224,13020,4,1328,51,5042,1570,25,"East TN",2455501,398.574466066192,0.177500048291449,530.238024745256,93.1378158673118,17.7500048291449
2020-11-30,111933,2234,103799,2005,8134,229,117240,2220,1072654,9450,1189894,11670,15,1343,53,5095,1601,31,"East TN",2455501,453.267988895138,0.179584374633099,475.259427709457,90.979396872573,17.9584374633099
2020-12-01,114194,2261,105805,2006,8389,255,119378,2138,1081489,8835,1200867,10973,20,1363,63,5158,1629,28,"East TN",2455501,508.246585930936,0.181568005743173,446.874181684308,92.078968813289,18.1568005743172
2020-12-02,115251,1057,106718,913,8533,144,120254,876,1084397,2908,1204651,3784,15,1378,42,5200,1662,33,"East TN",2455501,514.396043821607,0.183957045712684,154.102971247008,43.0462052346955,18.3957045712684
2020-12-03,117059,1808,108287,1569,8772,239,121976,1722,1090388,5991,1212364,7713,33,1411,45,5245,1683,21,"East TN",2455501,528.364679957369,0.191287878787879,314.111051064528,73.6305951412767,19.1287878787879
2020-12-04,118788,1729,109675,1388,9113,341,123434,1458,1095908,5520,1219342,6978,37,1448,36,5281,1718,35,"East TN",2455501,529.423527011392,0.193676577689117,284.178259345038,70.4133290925151,19.3676577689117
2020-12-05,119921,1133,110584,909,9337,224,124363,929,1098972,3064,1223335,3993,5,1453,24,5305,1744,26,"East TN",2455501,509.427607645039,0.200719065558824,162.614472565884,46.1412966233775,20.0719065558824
2020-12-06,121390,1469,111847,1263,9543,206,125604,1241,1103464,4492,1229068,5733,20,1473,40,5345,1780,36,"East TN",2455501,476.114650330014,0.20816615529856,233.475775412024,59.8248585522873,20.816615529856
2020-12-07,124113,2723,114252,2405,9861,318,128175,2571,1113010,9546,1241185,12117,31,1504,51,5396,1802,22,"East TN",2455501,496.029119922981,0.2131952974206,493.46345206131,110.89386646554,21.31952974206
2020-12-08,126877,2764,116615,2363,10262,401,130706,2531,1121369,8359,1252075,10890,45,1549,71,5467,1826,24,"East TN",2455501,516.513737929653,0.221215435088267,443.494016088774,112.563586819961,22.1215435088267
2020-12-09,129521,2644,118998,2383,10523,261,133283,2577,1128467,7098,1261750,9675,21,1570,56,5523,1849,23,"East TN",2455501,581.144133111736,0.228182630168654,394.013278756555,107.676600416778,22.8182630168654
2020-12-10,132596,3075,121680,2682,10916,393,136233,2950,1139936,11469,1276169,14419,30,1600,74,5597,1886,37,"East TN",2455501,632.742564552,0.223446438366899,587.21214122902,125.229026581541,22.3446438366899
2020-12-11,134580,1984,123428,1748,11152,236,138023,1790,1147107,7171,1285130,8961,35,1635,50,5647,1911,25,"East TN",2455501,643.127410658762,0.221757767373989,364.935709657622,80.798175199277,22.1757767373989
2020-12-12,137841,3261,126155,2727,11686,534,140997,2974,1158339,11232,1299336,14206,21,1656,73,5720,1936,25,"East TN",2455501,729.789969541857,0.218865541242878,578.537740363372,132.803855506473,21.8865541242878
2020-12-13,142131,4290,130014,3859,12117,431,145361,4364,1175619,17280,1320980,21644,15,1671,62,5782,1970,34,"East TN",2455501,844.674874903329,0.214955609713639,881.449447587274,174.709763913759,21.4955609713639
2020-12-14,144990,2859,132471,2457,12519,402,148034,2673,1184897,9278,1332931,11951,37,1708,72,5854,2004,34,"East TN",2455501,850.213459493602,0.216456303272077,486.703120870242,116.432451055813,21.6456303272077
2020-12-15,149116,4126,136011,3540,13105,586,151897,3863,1199918,15021,1351815,18884,34,1742,94,5948,2035,31,"East TN",2455501,905.680755169719,0.212462402245839,769.048760314087,168.030882496077,21.2462402245839
2020-12-16,152334,3218,138268,2257,14066,961,154283,2386,1207814,7896,1362097,10282,19,1761,60,6008,2077,42,"East TN",2455501,929.056840131607,0.209273819845137,418.733284979318,131.052685378666,20.9273819845137
2020-12-17,156401,4067,141640,3372,14761,695,157890,3607,1218513,10699,1376403,14306,58,1819,75,6083,2116,39,"East TN",2455501,969.455927731245,0.216064409282279,582.61022903269,165.628114181179,21.6064409282279
2020-12-18,159608,3207,144376,2736,15232,471,160769,2879,1227202,8689,1387971,11568,43,1862,62,6145,2146,30,"East TN",2455501,1019.26246415701,0.221176379070604,471.105489266752,130.604711625041,22.1176379070604
2020-12-19,162248,2640,146618,2242,15630,398,163237,2468,1235565,8363,1398802,10831,27,1889,41,6186,2183,37,"East TN",2455501,993.972309520542,0.223593991916836,441.091247773876,107.513700870006,22.3593991916836
2020-12-20,165878,3630,149583,2965,16295,665,166553,3316,1249508,13943,1416061,17259,16,1905,55,6241,2217,34,"East TN",2455501,967.09388430304,0.222883646575026,702.870819437663,147.831338696258,22.2883646575026
2020-12-21,168191,2313,151325,1742,16866,571,168456,1903,1256420,6912,1424876,8815,14,1919,35,6276,2252,35,"East TN",2455501,944.858096168562,0.222111044646256,358.989876200417,94.1966629213346,22.2111044646256
2020-12-22,170845,2654,153026,1701,17819,953,170255,1799,1261473,5053,1431728,6852,62,1981,60,6336,2297,45,"East TN",2455501,884.911062956195,0.229724825748001,279.046923621697,108.08384928371,22.9724825748001
2020-12-23,173063,2218,154472,1446,18591,772,171795,1540,1267250,5777,1439045,7317,41,2022,35,6371,2337,40,"East TN",2455501,844.186176263011,0.227582263346676,297.983995934027,90.3277986854821,22.7582263346676
2020-12-24,175155,2092,155930,1458,19225,634,173393,1598,1273539,6289,1446932,7887,15,2037,30,6401,2375,38,"East TN",2455501,763.754525043973,0.219810290802365,321.197181349142,85.1964629621409,21.9810290802365
2020-12-25,177521,2366,157909,1979,19612,387,175559,2166,1282086,8547,1457645,10713,3,2040,27,6428,2411,36,"East TN",2455501,729.504895335005,0.212274306053908,436.28571114408,96.3550819160733,21.2274306053908
2020-12-26,179460,1939,159376,1467,20084,472,177171,1612,1287739,5653,1464910,7265,2,2042,43,6471,2449,38,"East TN",2455501,700.956749763083,0.210776305439584,295.866301825982,78.9655552980838,21.0776305439584
2020-12-27,180756,1296,160286,910,20470,386,178161,990,1290532,2793,1468693,3783,27,2069,41,6512,2480,31,"East TN",2455501,605.904864221191,0.220550235598115,154.062246360315,52.7794531543665,22.0550235598115
2020-12-28,182152,1396,161264,978,20888,418,179181,1020,1292351,1819,1471532,2839,25,2094,42,6554,2517,37,"East TN",2455501,568.560143123542,0.229873971193416,115.617953321949,56.8519418236849,22.9873971193416
2020-12-29,185057,2905,162990,1726,22067,1179,180959,1778,1296438,4087,1477397,5865,50,2144,64,6618,2559,42,"East TN",2455501,578.782089683531,0.234382184851869,238.851460455524,118.3057958437,23.4382184851869
2020-12-30,187385,2328,164606,1616,22779,712,182636,1677,1300917,4479,1483553,6156,40,2184,44,6662,2597,38,"East TN",2455501,583.261827219781,0.243574188909859,250.702402483241,94.8075362217323,24.3574188909859
2020-12-31,190830,3445,167286,2680,23544,765,185531,2895,1308040,7123,1493571,10018,52,2236,30,6692,2640,43,"East TN",2455501,638.362598915659,0.26025429361693,407.981914892317,140.297234658019,26.025429361693
2021-01-01,193068,2238,169001,1715,24067,523,187387,1856,1312896,4856,1500283,6712,24,2260,31,6723,2680,40,"East TN",2455501,633.149813418932,0.277405131572775,273.345439484651,91.1422964193458,27.7405131572775
2021-01-02,195792,2724,171112,2111,24680,613,189632,2245,1317581,4685,1507213,6930,4,2264,64,6787,2717,37,"East TN",2455501,665.118849473081,0.29456539725315,282.223464783765,110.934591352233,29.456539725315
2021-01-03,197106,1314,172017,905,25089,409,190568,936,1320236,2655,1510804,3591,15,2279,25,6812,2761,44,"East TN",2455501,665.851897433558,0.294626107192895,146.243068115224,53.5125011148438,29.4626107192895
2021-01-04,198662,1556,173143,1126,25519,430,191745,1177,1322014,1778,1513759,2955,46,2325,34,6846,2811,50,"East TN",2455501,672.367879304468,0.297534752646411,120.342040178359,63.3679236945943,29.7534752646411
2021-01-05,201557,2895,174876,1733,26681,1162,193567,1822,1325965,3951,1519532,5773,43,2368,60,6906,2855,44,"East TN",2455501,671.960630437536,0.299228669751988,235.104770879751,117.898546976768,29.9228669751988
2021-01-06,204097,2540,176668,1792,27429,748,195468,1901,1330186,4221,1525654,6122,52,2420,63,6969,2898,43,"East TN",2455501,680.594306416491,0.304790860074583,249.317756335672,103.441212200687,30.4790860074583
2021-01-07,206599,2502,178798,2130,27801,372,197784,2316,1335556,5370,1533340,7686,33,2453,45,7014,2930,32,"East TN",2455501,642.190738264818,0.308104302346048,313.011479123812,101.893666506346,30.8104302346048
2021-01-08,208942,2343,180651,1853,28291,490,199766,1982,1341286,5730,1541052,7712,50,2503,47,7061,2985,55,"East TN",2455501,646.466851367603,0.303637567759817,314.070326177835,95.4184095221301,30.3637567759817
2021-01-09,211511,2569,182649,1998,28862,571,201939,2173,1347337,6051,1549276,8224,27,2530,33,7094,3013,28,"East TN",2455501,640.154493930159,0.292584932125621,334.921468164745,104.62223391479,29.2584932125621
2021-01-10,213173,1662,183780,1131,29393,531,203187,1248,1351632,4295,1554819,5543,36,2566,41,7135,3053,40,"East TN",2455501,654.326754499387,0.286697716687493,225.738046940319,67.6847616840718,28.6697716687493
2021-01-11,214595,1422,184791,1011,29804,411,204284,1097,1354166,2534,1558450,3631,28,2594,40,7175,3093,40,"East TN",2455501,648.869619682501,0.280571032198877,147.872063582951,57.9107888777077,28.0571032198877
2021-01-12,216411,1816,185925,1134,30486,682,205472,1188,1357244,3078,1562716,4266,60,2654,39,7214,3132,39,"East TN",2455501,604.927466940555,0.275680807706558,173.732366633123,73.9563942348221,27.5680807706558
2021-01-13,217933,1522,186996,1071,30937,451,206603,1131,1360833,3589,1567436,4720,49,2703,32,7246,3159,27,"East TN",2455501,563.469532286894,0.266502321573883,192.221465191828,61.983277547026,26.6502321573883
2021-01-14,220183,2250,188777,1781,31406,469,208566,1963,1367276,6443,1575842,8406,38,2741,50,7296,3201,42,"East TN",2455501,553.206860840211,0.253682179662134,342.333397542905,91.630995059664,25.3682179662134
2021-01-15,221146,963,189447,670,31699,293,209261,695,1369574,2298,1578835,2993,23,2764,30,7326,3242,41,"East TN",2455501,497.006517203618,0.251303496281396,121.8895858727,39.2180658855362,25.1303496281396
2021-01-16,223576,2430,191195,1748,32381,682,211260,1999,1377863,8289,1589123,10288,13,2777,54,7380,3285,43,"East TN",2455501,491.345757953265,0.23391974301704,418.977634299477,98.9614746644371,23.391974301704
2021-01-17,224432,856,191801,606,32631,250,211931,671,1380577,2714,1592508,3385,13,2790,24,7404,3319,34,"East TN",2455501,458.521499278559,0.232004033006978,137.853741456428,34.8605030093655,23.2004033006978
2021-01-18,224999,567,192123,322,32876,245,212285,354,1382179,1602,1594464,1956,13,2803,21,7425,3350,31,"East TN",2455501,423.701721155886,0.222163603043261,79.6578783718679,23.0910107550353,22.2163603043261
2021-01-19,226679,1680,193096,973,33583,707,213343,1058,1385461,3282,1598804,4340,21,2824,53,7478,3390,40,"East TN",2455501,418.163136565613,0.218105741520727,176.746008248419,68.4178096445491,21.8105741520727
2021-01-20,227663,984,193754,658,33909,326,214039,696,1388548,3087,1602587,3783,32,2856,29,7507,3430,40,"East TN",2455501,396.25314752468,0.211544479531166,154.062246360315,40.073288506093,21.1544479531166
2021-01-21,229216,1553,194886,1132,34330,421,215308,1269,1393736,5188,1609044,6457,65,2921,36,7543,3476,46,"East TN",2455501,367.867901499531,0.203060056623095,262.960593377889,63.2457490345148,20.3060056623095
2021-01-22,230202,986,195590,704,34612,282,216122,814,1397641,3905,1613763,4719,32,2953,31,7574,3508,32,"East TN",2455501,368.804573893474,0.196432661475034,192.180740305135,40.1547382794794,19.6432661475034
2021-01-23,231632,1430,196557,967,35075,463,217222,1100,1403841,6200,1621063,7300,19,2972,41,7615,3534,26,"East TN",2455501,328.07968720029,0.186662492172824,297.291672860243,58.2365879712531,18.6662492172824
2021-01-24,232252,620,197045,488,35207,132,217764,542,1406417,2576,1624181,3118,19,2991,20,7635,3562,28,"East TN",2455501,318.468613940699,0.184163167366527,126.980196709348,25.2494297497741,18.4163167366527
2021-01-25,232991,739,197556,511,35435,228,218313,549,1407769,1352,1626082,1901,44,3035,20,7655,3593,31,"East TN",2455501,325.473294451927,0.190650895059776,77.4180096037428,30.095691266263,19.0650895059776
2021-01-26,234020,1029,198282,726,35738,303,219093,780,1410986,3217,1630079,3997,63,3098,26,7681,3616,23,"East TN",2455501,298.961393214664,0.183852917665867,162.777372112656,41.9059084072863,18.3852917665867
2021-01-27,234974,954,198987,705,35987,249,219848,755,1414376,3390,1634224,4145,55,3153,28,7709,3639,23,"East TN",2455501,297.739646613868,0.183614122704428,168.804655343248,38.8515419052975,18.3614122704428
2021-01-28,236302,1328,199702,715,36600,613,220640,792,1417654,3278,1638294,4070,46,3199,29,7738,3667,28,"East TN",2455501,288.576547107902,0.182290598290598,165.750288841259,54.0826495285484,18.2290598290598
2021-01-29,236897,595,200054,352,36843,243,221037,397,1419712,2058,1640749,2455,17,3216,17,7755,3688,21,"East TN",2455501,272.653116410867,0.18213147557993,99.9795968317667,24.2313075824445,18.213147557993
2021-01-30,238052,1155,201021,967,37031,188,222134,1097,1426537,6825,1648671,7922,44,3260,29,7784,3708,20,"East TN",2455501,261.453772570241,0.177919443639525,322.622552383404,47.0372441306275,17.7919443639525
2021-01-31,238729,677,201459,438,37270,239,222623,489,1429454,2917,1652077,3406,29,3289,30,7814,3727,19,"East TN",2455501,263.775091111753,0.174182678520218,138.708964076985,27.5707482912856,17.4182678520218
2021-02-01,239422,693,201869,410,37553,283,223066,443,1430769,1315,1653835,1758,39,3328,10,7824,3754,27,"East TN",2455501,261.901746323866,0.171260764602025,71.5943508066175,28.2223464783765,17.1260764602025
2021-02-02,239959,537,202216,347,37743,190,223425,359,1431592,823,1655017,1182,57,3385,13,7837,3770,16,"East TN",2455501,241.86510207082,0.173710802790921,48.1368160713435,21.8692641542398,17.3710802790921
2021-02-03,241069,1110,202974,758,38095,352,224249,824,1436004,4412,1660253,5236,46,3431,39,7876,3783,13,"East TN",2455501,248.218184394956,0.169080640823697,213.235506725511,45.2046242294342,16.9080640823697
2021-02-04,242163,1094,203754,780,38409,314,225111,862,1441739,5735,1666850,6597,58,3489,36,7912,3801,18,"East TN",2455501,238.688560908751,0.15656954755568,268.662077514935,44.5530260423433,15.656954755568
2021-02-05,242977,814,204310,556,38667,258,225712,601,1444576,2837,1670288,3438,67,3556,28,7940,3815,14,"East TN",2455501,247.607311094559,0.158265344121331,140.012160451167,33.1500577682518,15.8265344121331
2021-02-06,244201,1224,205124,814,39077,410,226673,961,1451019,6443,1677692,7404,27,3583,22,7962,3844,29,"East TN",2455501,250.417328276388,0.156403983322422,301.527061076334,49.8472613124572,15.6403983322422
2021-02-07,244717,516,205476,352,39241,164,227078,405,1453390,2371,1680468,2776,2,3585,10,7972,3861,17,"East TN",2455501,243.860621518786,0.156915924060442,113.052285460279,21.0140415336829,15.6915924060442
2021-02-08,245225,508,205771,295,39454,213,227393,315,1454401,1011,1681794,1326,32,3617,9,7981,3877,16,"East TN",2455501,236.326517480547,0.154762330555456,54.001199755162,20.6882424401375,15.4762330555456
2021-02-09,246249,1024,206400,629,39849,395,228056,663,1457618,3217,1685674,3880,16,3633,38,8019,3888,11,"East TN",2455501,256.159537300127,0.151058485827054,158.012560369554,41.7022839738204,15.1058485827054
2021-02-10,247095,846,206981,581,40114,265,228689,633,1461912,4294,1690601,4927,39,3672,30,8049,3901,13,"East TN",2455501,245.408167213127,0.14630288651641,200.651516737318,34.4532541424337,14.630288651641
2021-02-11,247962,867,207564,583,40398,284,229338,649,1466241,4329,1695579,4978,37,3709,31,8080,3919,18,"East TN",2455501,236.163617933774,0.147133558425285,202.72848595867,35.3084767629905,14.7133558425285
2021-02-12,248791,829,208154,590,40637,239,229983,645,1470316,4075,1700299,4720,34,3743,12,8092,3928,9,"East TN",2455501,236.774491234172,0.142314484688947,192.221465191828,33.7609310686495,14.2314484688947
2021-02-13,249383,592,208525,371,40858,221,230417,434,1473526,3210,1703943,3644,12,3755,17,8109,3940,12,"East TN",2455501,211.03636284408,0.142623138166165,148.401487109962,24.1091329223649,14.2623138166165
2021-02-14,249921,538,208937,412,40984,126,230869,452,1475834,2308,1706703,2760,15,3770,15,8124,3953,13,"East TN",2455501,211.93231035133,0.144501619973318,112.400687273188,21.909989040933,14.4501619973318
2021-02-15,250299,378,209147,210,41152,168,231097,228,1476838,1004,1707935,1232,5,3775,10,8134,3964,11,"East TN",2455501,206.638075081216,0.141693125741173,50.1730604060027,15.3940071700236,14.1693125741173
2021-02-16,251064,765,209575,428,41489,337,231571,474,1479273,2435,1710844,2909,8,3783,26,8160,3974,10,"East TN",2455501,196.090329427681,0.139650377433453,118.468695390472,31.1545383202858,13.9650377433453
2021-02-17,251684,620,209994,419,41690,201,232021,450,1481785,2512,1713806,2962,11,3794,11,8171,3991,17,"East TN",2455501,186.886505035021,0.143589743589744,120.627114385211,25.2494297497741,14.3589743589744
2021-02-18,252470,786,210538,544,41932,242,232620,599,1485983,4198,1718603,4797,42,3836,19,8190,4008,17,"East TN",2455501,183.587789212873,0.142546907574705,195.357281467204,32.0097609408426,14.2546907574705
2021-02-19,252945,475,210838,300,42107,175,232963,343,1488077,2094,1721040,2437,5,3841,11,8201,4017,9,"East TN",2455501,169.171179323486,0.143676775468878,99.2465488712894,19.3443211792624,14.3676775468878
2021-02-20,253568,623,211287,449,42281,174,233469,506,1492065,3988,1725534,4494,18,3859,18,8219,4027,10,"East TN",2455501,170.433650810975,0.141355194293919,183.017640799169,25.3716044098536,14.1355194293919
2021-02-21,253917,349,211515,228,42402,121,233732,263,1493732,1667,1727464,1930,7,3866,12,8231,4045,18,"East TN",2455501,162.736647225963,0.137902798516449,78.5990313178451,14.2129854559212,13.7902798516449
2021-02-22,254273,356,211709,194,42564,162,233958,226,1494799,1067,1728757,1293,7,3873,22,8253,4061,16,"East TN",2455501,161.840699718713,0.137402747094419,52.6572784942869,14.4980596627735,13.7402747094419
2021-02-23,254909,636,212051,342,42858,294,234319,361,1497008,2209,1731327,2570,26,3899,27,8280,4068,7,"East TN",2455501,156.587189335292,0.134160035151101,104.662958801483,25.901027936865,13.4160035151101
2021-02-24,255648,739,212599,548,43049,191,234927,608,1501686,4678,1736613,5286,19,3918,23,8303,4075,7,"East TN",2455501,161.433450851781,0.127417021090016,215.271751060171,30.095691266263,12.7417021090016
2021-02-25,256283,635,213044,445,43239,190,235423,496,1505384,3698,1740807,4194,21,3939,16,8319,4084,9,"East TN",2455501,155.283992961111,0.126238515582778,170.800174791214,25.8603030501718,12.6238515582778
2021-02-26,256743,460,213366,322,43377,138,235791,368,1507775,2391,1743566,2759,14,3953,11,8330,4089,5,"East TN",2455501,154.673119660713,0.125543816034804,112.359962386495,18.7334478788646,12.5543816034804
2021-02-27,257183,440,213593,227,43590,213,236066,275,1510866,3091,1746932,3366,7,3960,16,8346,4098,9,"East TN",2455501,147.22046539586,0.121366482848864,137.079968609257,17.918950145001,12.1366482848864
2021-02-28,257549,366,213867,274,43682,92,236379,313,1512801,1935,1749180,2248,5,3965,11,8357,4107,9,"East TN",2455501,147.912788469644,0.121891692761098,91.5495452862776,14.9053085297053,12.1891692761098
2021-03-01,257790,241,214013,146,43777,95,236533,154,1513394,593,1749927,747,4,3969,11,8368,4116,9,"East TN",2455501,143.229426499928,0.121634388285309,30.4214903598084,9.81469769305734,12.1634388285309
2021-03-02,258410,620,214403,390,44007,230,236980,447,1516152,2758,1753132,3205,7,3976,24,8392,4126,10,"East TN",2455501,142.577828312837,0.122036230222426,130.523261851655,25.2494297497741,12.2036230222426
2021-03-03,258888,478,214701,298,44187,180,237332,352,1519260,3108,1756592,3460,7,3983,17,8409,4129,3,"East TN",2455501,131.948632885916,0.120376395214976,140.908107958417,19.466495839342,12.0376395214976
2021-03-04,259496,608,215115,414,44381,194,237804,472,1522849,3589,1760653,4061,18,4001,21,8430,4134,5,"East TN",2455501,130.8490609452,0.119973798246498,165.38376486102,24.7607311094559,11.9973798246498
2021-03-05,259965,469,215425,310,44540,159,238157,353,1525579,2730,1763736,3083,15,4016,16,8446,4139,5,"East TN",2455501,131.215584925439,0.117302925136341,125.554825675086,19.0999718591033,11.7302925136341
2021-03-06,260426,461,215746,321,44680,140,238528,371,1528928,3349,1767456,3720,1,4017,10,8456,4145,6,"East TN",2455501,132.070807545996,0.119957123367765,151.496578498644,18.7741727655578,11.9957123367765
2021-03-07,260679,253,215909,163,44770,90,238711,183,1530266,1338,1768977,1521,1,4018,4,8460,4149,4,"East TN",2455501,127.468895349666,0.117795625599838,61.9425526603329,10.3033963333756,11.7795625599838
2021-03-08,261134,455,216202,293,44932,162,239023,312,1531512,1246,1770535,1558,3,4021,9,8469,4157,8,"East TN",2455501,136.184021102007,0.120826863354037,63.4493734679807,18.5298234453987,12.0826863354037
2021-03-09,261672,538,216483,281,45189,257,239341,318,1533525,2013,1772866,2331,6,4027,21,8490,4169,12,"East TN",2455501,132.844580393166,0.119641228336881,94.9297108818119,21.909989040933,11.9641228336881
2021-03-10,262322,650,216947,464,45375,186,239847,506,1537671,4146,1777518,4652,7,4034,28,8518,4179,10,"East TN",2455501,139.849260904394,0.120185415272866,189.452172896692,26.4711763505696,12.0185415272866
2021-03-11,262850,528,217283,336,45567,192,240210,363,1540112,2441,1780322,2804,5,4039,9,8527,4187,8,"East TN",2455501,136.591269968939,0.122324469978138,114.192582287688,21.5027401740012,12.2324469978138
2021-03-12,263310,460,217648,365,45662,95,240626,416,1542741,2629,1783367,3045,5,4044,12,8539,4195,8,"East TN",2455501,136.2247459887,0.12577046508074,124.007279980745,18.7334478788646,12.577046508074
2021-03-13,263755,445,217862,214,45893,231,240904,278,1545552,2811,1786456,3089,2,4046,21,8560,4202,7,"East TN",2455501,135.57314780161,0.125052631578947,125.799174995245,18.1225745784669,12.5052631578947
2021-03-14,264016,261,218037,175,45979,86,241115,211,1547008,1456,1788123,1667,0,4046,10,8570,4208,6,"East TN",2455501,135.898946895155,0.125561474981719,67.8883861175377,10.629195426921,12.5561474981719
2021-03-15,264372,356,218222,185,46150,171,241330,215,1547951,943,1789281,1158,4,4050,15,8585,4212,4,"East TN",2455501,131.86718311253,0.123066254134215,47.1594187907071,14.4980596627735,12.3066254134215
2021-03-16,265071,699,218673,451,46398,248,241826,496,1550501,2550,1792327,3046,4,4054,36,8621,4213,1,"East TN",2455501,138.423889870132,0.127691279995889,124.048004867438,28.4666957985356,12.7691279995889
2021-03-17,265497,426,219006,333,46491,93,242190,364,1553253,2752,1795443,3116,1,4055,16,8637,4222,9,"East TN",2455501,129.301515250859,0.13071129707113,126.898746935961,17.3488017312964,13.071129707113
2021-03-18,266047,550,219355,349,46692,201,242575,385,1555805,2552,1798380,2937,6,4061,31,8668,4229,7,"East TN",2455501,130.197462758109,0.130966884483331,119.608992217881,22.3986876812512,13.0966884483331
2021-03-19,266839,792,219885,530,46954,262,243135,560,1559545,3740,1802680,4300,15,4076,25,8693,4235,6,"East TN",2455501,143.718125140246,0.129912494174908,175.117012780691,32.2541102610017,12.9912494174908
2021-03-20,267111,272,220050,165,47061,107,243329,194,1561147,1602,1804476,1796,1,4077,15,8708,4237,2,"East TN",2455501,136.672719742325,0.13457269700333,73.1418965009585,11.077169180546,13.457269700333
2021-03-21,267392,281,220247,197,47145,84,243554,225,1562490,1343,1806044,1568,-17,4060,8,8716,4245,8,"East TN",2455501,137.487217476189,0.136097315997991,63.8566223349125,11.4436931607847,13.6097315997991
2021-03-22,267918,526,220588,341,47330,185,243910,356,1564154,1664,1808064,2020,14,4074,19,8735,4252,7,"East TN",2455501,144.41044821403,0.137358249480914,82.2642711202317,21.4212904006148,13.7358249480914
2021-03-23,268355,437,220836,248,47519,189,244175,265,1566008,1854,1810183,2119,11,4085,17,8752,4258,6,"East TN",2455501,133.740527900416,0.131552419354839,86.2960349028569,17.7967754849214,13.1552419354839
2021-03-24,268953,598,221296,460,47657,138,244668,493,1569527,3519,1814195,4012,4,4089,26,8778,4264,6,"East TN",2455501,140.745208411644,0.13214590443686,163.388245413054,24.353482242524,13.214590443686
2021-03-25,269352,399,221602,306,47750,93,245001,333,1571839,2312,1816840,2645,8,4097,23,8801,4268,4,"East TN",2455501,134.595750520973,0.131419284940412,107.717325303472,16.2492297905804,13.1419284940412
2021-03-26,269762,410,221925,323,47837,87,245346,345,1573953,2114,1819299,2459,7,4104,14,8815,4278,10,"East TN",2455501,119.038843804177,0.13304049581804,100.142496378539,16.6972035442054,13.304049581804
2021-03-27,269966,204,222106,181,47860,23,245556,210,1575821,1868,1821377,2078,2,4106,13,8828,4289,11,"East TN",2455501,116.26955150904,0.131767351044317,84.6263145484363,8.30787688540954,13.1767351044317
2021-03-28,270282,316,222325,219,47957,97,245801,245,1577483,1662,1823284,1907,5,4111,17,8845,4296,7,"East TN",2455501,117.694922543302,0.130336426914153,77.6623589239019,12.8690641950461,13.0336426914153
2021-03-29,270720,438,222561,236,48159,202,246054,253,1578961,1478,1825015,1731,18,4129,18,8863,4301,5,"East TN",2455501,114.111132514302,0.126482213438735,70.4947788659015,17.8375003716146,12.6482213438735
2021-03-30,271095,375,222819,258,48276,117,246376,322,1580847,1886,1827223,2208,5,4134,20,8883,4307,6,"East TN",2455501,111.586189539324,0.129166666666667,89.9205498185503,15.271832509944,12.9166666666667
2021-03-31,271755,660,223260,441,48495,219,246864,488,1584549,3702,1831413,4190,4,4138,18,8901,4312,5,"East TN",2455501,114.111132514302,0.127540945522128,170.637275244441,26.8784252175014,12.7540945522128
2021-04-01,272205,450,223583,323,48622,127,247213,349,1586726,2177,1833939,2526,1,4139,18,8919,4320,8,"East TN",2455501,116.188101735654,0.129364290309375,102.871063786983,18.3261990119328,12.9364290309375
2021-04-02,272551,346,223814,231,48737,115,247463,250,1588997,2271,1836460,2521,0,4139,12,8931,4325,5,"East TN",2455501,113.58170898729,0.123361109492454,102.667439353517,14.0908107958417,12.3361109492454
2021-04-03,272893,342,224064,250,48829,92,247737,274,1590843,1846,1838580,2120,0,4139,13,8944,4334,9,"East TN",2455501,119.20174335095,0.12678021275359,86.3367597895501,13.9279112490689,12.6780212753589
2021-04-04,273064,171,224187,123,48877,48,247878,141,1592083,1240,1839961,1381,6,4145,8,8952,4338,4,"East TN",2455501,113.296634780438,0.124542783474246,56.2410685232871,6.96395562453446,12.4542783474246
2021-04-05,273471,407,224422,235,49049,172,248101,223,1593036,953,1841137,1176,6,4151,40,8992,4344,6,"East TN",2455501,112.034163292949,0.126969358640367,47.8924667511844,16.5750288841259,12.6969358640367
2021-04-06,273899,428,224671,249,49228,179,248377,276,1594633,1597,1843010,1873,3,4154,27,9019,4349,5,"East TN",2455501,114.192582287688,0.126749857477672,76.2777127763336,17.4302515046828,12.6749857477672
2021-04-07,274528,629,225132,461,49396,168,248884,507,1598301,3668,1847185,4175,5,4159,24,9043,4353,4,"East TN",2455501,112.930110800199,0.12807506974385,170.026401944043,25.6159537300127,12.807506974385
2021-04-08,274933,405,225386,254,49547,151,249172,288,1600623,2322,1849795,2610,-1,4158,21,9064,4358,5,"East TN",2455501,111.097490899006,0.123549445005045,106.29195426921,16.4935791107395,12.3549445005045
2021-04-09,275451,518,225792,406,49659,112,249621,449,1603619,2996,1853240,3445,4,4162,31,9095,4361,3,"East TN",2455501,118.102171410234,0.128605482717521,140.297234658019,21.0954913070693,12.8605482717521
2021-04-10,275756,305,226008,216,49748,89,249869,248,1605813,2194,1855682,2442,1,4163,15,9110,4366,5,"East TN",2455501,116.595350602586,0.1246637820138,99.4501733047553,12.4210904414211,12.46637820138
2021-04-11,275993,237,226172,164,49821,73,250043,174,1607121,1308,1857164,1482,2,4165,10,9120,4370,4,"East TN",2455501,119.283193124336,0.12585014241702,60.3542820792987,9.65179814628461,12.585014241702
2021-04-12,276458,465,226495,323,49963,142,250373,330,1608549,1428,1858922,1758,3,4168,16,9136,4379,9,"East TN",2455501,121.645236552541,0.127748102333427,71.5943508066175,18.9370723123306,12.7748102333427
2021-04-13,276837,379,226736,241,50101,138,250623,250,1610047,1498,1860670,1748,3,4171,16,9152,4383,4,"East TN",2455501,119.649717104575,0.12718006795017,71.1871019396856,15.4347320567167,12.718006795017
2021-04-14,277515,678,227236,500,50279,178,251179,556,1613761,3714,1864940,4270,0,4171,29,9181,4386,3,"East TN",2455501,121.645236552541,0.129259363559561,173.895266179896,27.6114731779788,12.9259363559561
2021-04-15,278057,542,227604,368,50453,174,251559,380,1616177,2416,1867736,2796,2,4173,24,9205,4391,5,"East TN",2455501,127.224546029507,0.133047210300429,113.866783194142,22.0728885877057,13.3047210300429
2021-04-16,279030,973,228494,890,50536,83,252666,1107,1622230,6053,1874896,7160,3,4176,32,9237,4394,3,"East TN",2455501,145.754369474906,0.140607683782785,291.590188723197,39.625314752468,14.0607683782785
2021-04-17,279232,202,228641,147,50591,55,252838,172,1623965,1735,1876803,1907,0,4176,10,9247,4395,1,"East TN",2455501,141.559706145508,0.140570995691492,77.6623589239019,8.22642711202317,14.0570995691492
2021-04-18,279451,219,228829,188,50622,31,253040,202,1625399,1434,1878439,1636,6,4182,8,9255,4404,9,"East TN",2455501,140.82665818503,0.140869565217391,66.625914630049,8.9187501858073,14.0869565217391
2021-04-19,279778,327,229023,194,50755,133,253250,210,1626564,1165,1879814,1375,8,4190,15,9270,4411,7,"East TN",2455501,135.206623821371,0.137708213670304,55.996719203128,13.3170379486712,13.7708213670304
2021-04-20,280131,353,229300,277,50831,76,253529,279,1628490,1926,1882019,2205,4,4194,20,9290,4415,4,"East TN",2455501,134.147776767348,0.136118787765235,89.7983751584707,14.375885002694,13.6118787765235
2021-04-21,280644,513,229630,330,51014,183,253865,336,1631381,2891,1885246,3227,4,4198,15,9305,4421,6,"East TN",2455501,127.428170462973,0.132276174529696,131.419209358905,20.8918668736034,13.2276174529696
2021-04-22,281284,640,230027,397,51257,243,254311,446,1634512,3131,1888823,3577,3,4201,26,9331,4425,4,"East TN",2455501,131.419209358905,0.130506947408356,145.672919701519,26.0639274836378,13.0506947408356
2021-04-23,281666,382,230304,277,51362,105,254619,308,1636785,2273,1891404,2581,0,4201,11,9342,4430,5,"East TN",2455501,107.350801323233,0.118306275745093,105.110932555108,15.5569067167963,11.8306275745093
2021-04-24,281926,260,230492,188,51434,72,254828,209,1639134,2349,1893962,2558,0,4201,19,9361,4437,7,"East TN",2455501,109.712844751438,0.115974124366222,104.174260161165,10.5884705402278,11.5974124366222
2021-04-25,282124,198,230639,147,51485,51,254986,158,1640479,1345,1895465,1503,4,4205,17,9378,4442,5,"East TN",2455501,108.857622130881,0.11429578292024,61.2095046998555,8.06352756525043,11.429578292024
2021-04-26,282513,389,230886,247,51627,142,255237,251,1641980,1501,1897217,1752,6,4211,16,9394,4450,8,"East TN",2455501,111.382565105858,0.114175716830432,71.3500014864584,15.8419809236486,11.4175716830432
2021-04-27,282900,387,231088,202,51812,185,255456,219,1643831,1851,1899287,2070,3,4214,25,9419,4456,6,"East TN",2455501,112.767211253426,0.111593699328237,84.3005154548909,15.7605311502622,11.1593699328237
2021-04-28,283386,486,231432,344,51954,142,255837,381,1646990,3159,1902827,3540,6,4220,23,9442,4464,8,"East TN",2455501,111.667639312711,0.112166543427564,144.166098893871,19.7922949328874,11.2166543427564
2021-04-29,283778,392,231711,279,52067,113,256141,304,1649211,2221,1905352,2525,1,4221,22,9464,4469,5,"East TN",2455501,101.567867412801,0.110714501784742,102.83033890029,15.9641555837281,11.0714501784742
2021-04-30,284148,370,231939,228,52209,142,256380,239,1651727,2516,1908107,2755,0,4221,18,9482,4474,5,"East TN",2455501,101.079168772483,0.105430162246303,112.197062839722,15.0682080764781,10.5430162246303
2021-05-01,284383,235,232121,182,52262,53,256568,188,1653695,1968,1910263,2156,-1,4220,15,9497,4475,1,"East TN",2455501,100.061046605153,0.106741917673762,87.8028557105047,9.57034837289824,10.6741917673762
2021-05-02,284558,175,232249,128,52309,47,256701,133,1654843,1148,1911544,1281,1,4221,11,9508,4479,4,"East TN",2455501,99.1243742112099,0.106660861993905,52.1685798539687,7.1268551713072,10.6660861993905
2021-05-03,284771,213,232364,115,52407,98,256827,126,1655935,1092,1912762,1218,5,4226,17,9525,4483,4,"East TN",2455501,91.9567941532095,0.102283692505629,49.6029119922981,8.67440086564819,10.2283692505629
2021-05-04,285090,319,232583,219,52507,100,257072,245,1657798,1863,1914870,2108,7,4233,12,9537,4491,8,"East TN",2455501,89.187501858073,0.103702753000064,85.8480611492319,12.9912388551257,10.3702753000064
2021-05-05,285554,464,232876,293,52678,171,257383,311,1660955,3157,1918338,3468,5,4238,22,9559,4496,5,"East TN",2455501,88.2915543508229,0.0996712010831023,141.233907051962,18.8963474256374,9.96712010831023
2021-05-06,285839,285,233072,196,52767,89,257614,231,1662828,1873,1920442,2104,4,4242,10,9569,4502,6,"East TN",2455501,83.9339914746522,0.0976143141153081,85.6851616024591,11.6065927075574,9.76143141153081
2021-05-07,286204,365,233320,248,52884,117,257883,269,1665402,2574,1923285,2843,0,4242,15,9584,4507,5,"East TN",2455501,83.7303670411863,0.0990249044669917,115.780852868722,14.8645836430122,9.90249044669917
2021-05-08,286375,171,233423,103,52952,68,257997,114,1666869,1467,1924866,1581,0,4242,7,9591,4514,7,"East TN",2455501,81.1239742928225,0.0978566048072314,64.3860458619239,6.96395562453446,9.78566048072314
2021-05-09,286521,146,233538,115,52983,31,258129,132,1668277,1408,1926406,1540,3,4245,11,9602,4519,5,"East TN",2455501,79.9429525787202,0.0960839725474364,62.7163255075034,5.94583345720486,9.60839725474364
2021-05-10,286755,234,233673,135,53082,99,258274,145,1669501,1224,1927775,1369,7,4252,22,9624,4522,3,"East TN",2455501,80.798175199277,0.0963831346166656,55.7523698829689,9.52962348620506,9.63831346166656
2021-05-11,287070,315,233901,228,53169,87,258518,244,1671690,2189,1930208,2433,1,4253,19,9643,4526,4,"East TN",2455501,80.6352756525043,0.0942756552353631,99.0836493245167,12.828339308353,9.42756552353631
2021-05-12,287374,304,234118,217,53256,87,258767,249,1674939,3249,1933706,3498,3,4256,16,9659,4528,2,"East TN",2455501,74.1192937815949,0.0900572618427902,142.455653652758,12.3803655547279,9.00572618427902
2021-05-13,287584,210,234255,137,53329,73,258912,145,1677048,2109,1935960,2254,1,4257,9,9668,4533,5,"East TN",2455501,71.0649272796061,0.0836447995875757,91.7938946064367,8.55222620556864,8.36447995875757
2021-05-14,287885,301,234474,219,53411,82,259159,247,1679199,2151,1938358,2398,1,4258,21,9689,4538,5,"East TN",2455501,68.4585345312423,0.0846546805546341,97.6582782902552,12.2581908946484,8.46546805546341
2021-05-15,287993,108,234555,81,53438,27,259261,102,1680772,1573,1940033,1675,0,4258,6,9695,4542,4,"East TN",2455501,65.8928666695717,0.0833388277180721,68.2141852110832,4.39828776286387,8.33388277180721
2021-05-16,288093,100,234629,74,53464,26,259346,85,1681904,1132,1941250,1217,3,4261,4,9699,4546,4,"East TN",2455501,64.0195218816853,0.0819859876044193,49.5621871056049,4.0724886693184,8.19859876044193
2021-05-17,288291,198,234732,103,53559,95,259456,110,1683162,1258,1942618,1368,6,4267,10,9709,4553,7,"East TN",2455501,62.5534259607306,0.0796334972714411,55.7116449962757,8.06352756525043,7.96334972714411
2021-05-18,288502,211,234865,133,53637,78,259600,144,1684973,1811,1944573,1955,8,4275,23,9732,4559,6,"East TN",2455501,58.3180377446395,0.0753219631047685,79.6171534851747,8.59295109226182,7.53219631047685
2021-05-19,288720,218,235030,165,53690,53,259767,167,1687451,2478,1947218,2645,1,4276,21,9753,4562,3,"East TN",2455501,54.8156974890257,0.07400828892836,107.717325303472,8.87802529911411,7.400828892836
2021-05-20,288896,176,235163,133,53733,43,259921,154,1698408,10957,1958329,11111,3,4279,7,9760,4567,5,"East TN",2455501,53.4310513414574,0.0451070678170683,452.494216047967,7.16758005800038,4.51070678170683
2021-05-21,289059,163,235270,107,53789,56,260041,120,1700232,1824,1960273,1944,0,4279,10,9770,4570,3,"East TN",2455501,47.811016977798,0.0402464065708419,79.1691797315497,6.63815653098899,4.02464065708419
2021-05-22,289128,69,235316,46,53812,23,260102,61,1701508,1276,1961610,1337,0,4279,12,9782,4571,1,"East TN",2455501,46.2227463967638,0.0389766881401492,54.449173508787,2.8100171818297,3.89766881401492
2021-05-23,289202,74,235367,51,53835,23,260163,61,1702371,863,1962534,924,3,4282,5,9787,4574,3,"East TN",2455501,45.1638993427411,0.0383856417966548,37.629795304502,3.01364161529562,3.83856417966548
2021-05-24,289362,160,235478,111,53884,49,260289,126,1703996,1625,1964285,1751,0,4282,7,9794,4578,4,"East TN",2455501,43.6163536484001,0.0384455623759634,71.3092765997652,6.51598187090944,3.84455623759634
2021-05-25,289506,144,235574,96,53932,48,260376,87,1705409,1413,1965785,1500,0,4282,9,9803,4584,6,"East TN",2455501,40.8877862399567,0.0365830661889497,61.087330039776,5.8643836838185,3.65830661889497
2021-05-26,289692,186,235716,142,53976,44,260541,165,1707639,2230,1968180,2395,7,4289,14,9817,4589,5,"East TN",2455501,39.5845898657748,0.03692395763763,97.5361036301757,7.57482892493222,3.692395763763
2021-05-27,289815,123,235791,75,54024,48,260679,138,1709931,2292,1970610,2430,4,4293,11,9828,4593,4,"East TN",2455501,37.4261708710361,0.0617213581955867,98.9614746644371,5.00916106326163,6.17213581955867
2021-05-28,289931,116,235881,90,54050,26,260777,98,1711598,1667,1972375,1765,0,4293,9,9837,4596,3,"East TN",2455501,35.5121011964564,0.0608163939844654,71.8794250134698,4.72408685640934,6.08163939844654
2021-05-29,289982,51,235913,32,54069,19,260814,37,1712459,861,1973273,898,0,4293,7,9844,4599,3,"East TN",2455501,34.7790532359791,0.0610477578667581,36.5709482504792,2.07696922135238,6.10477578667581
2021-05-30,290037,55,235953,40,54084,15,260860,46,1713316,857,1974176,903,0,4293,7,9851,4604,5,"East TN",2455501,34.0052803888086,0.0598694382408521,36.7745726839452,2.23986876812512,5.98694382408521
2021-05-31,290117,80,236019,66,54098,14,260931,71,1714467,1151,1975398,1222,6,4299,4,9855,4609,5,"East TN",2455501,30.7472894533539,0.0577701790695582,49.7658115390708,3.25799093545472,5.77701790695582
2021-06-01,290248,131,236113,94,54135,37,261025,94,1715494,1027,1976519,1121,3,4302,11,9866,4612,3,"East TN",2455501,30.2178659263425,0.0604620831004285,45.6525979830593,5.3349601568071,6.04620831004285
2021-06-02,290367,119,236184,71,54183,48,261098,73,1717173,1679,1978271,1752,1,4303,9,9875,4616,4,"East TN",2455501,27.4892985178992,0.0551977009216133,71.3500014864584,4.8462615164889,5.51977009216133
2021-06-03,290454,87,236239,55,54215,32,261217,119,1719516,2343,1980733,2462,1,4304,7,9882,4621,5,"East TN",2455501,26.0232025969446,0.0531463005038032,100.264671038619,3.54306514230701,5.31463005038032
2021-06-04,290545,91,236298,59,54247,32,261295,78,1721233,1717,1982528,1795,0,4304,7,9889,4621,0,"East TN",2455501,25.005080429615,0.0510194031320792,73.1011716142653,3.70596468907974,5.10194031320792
2021-06-05,290586,41,236324,26,54262,15,261325,30,1722308,1075,1983633,1105,-1,4303,2,9891,4626,5,"East TN",2455501,24.5978315626831,0.0493243243243243,45.0009997959683,1.66972035442054,4.93243243243243
2021-06-06,290612,26,236340,16,54272,10,261344,19,1723028,720,1984372,739,-1,4302,2,9893,4629,3,"East TN",2455501,23.4168098485808,0.0474695959199686,30.095691266263,1.05884705402278,4.74695959199686
2021-06-07,290685,73,236375,35,54310,38,261396,52,1724020,992,1985416,1044,3,4305,10,9903,4631,2,"East TN",2455501,23.1317356417285,0.0464164503892993,42.5167817076841,2.97291672860243,4.64164503892993
2021-06-08,290772,87,236442,67,54330,20,261466,70,1725247,1227,1986713,1297,3,4308,4,9907,4634,3,"East TN",2455501,21.3398406272284,0.0432607416127134,52.8201780410596,3.54306514230701,4.32607416127134
2021-06-09,290820,48,236480,38,54340,10,261520,54,1727260,2013,1988780,2067,0,4308,3,9910,4637,3,"East TN",2455501,18.4483736720124,0.0401560567132934,84.1783407948113,1.95479456127283,4.01560567132934
2021-06-10,290895,75,236537,57,54358,18,261586,66,1728631,1371,1990217,1437,4,4312,4,9914,4640,3,"East TN",2455501,17.9596750316941,0.0389076339097427,58.5216621781054,3.0543665019888,3.89076339097427
2021-06-11,290965,70,236583,46,54382,24,261641,55,1729822,1191,1991463,1246,2,4314,4,9918,4641,1,"East TN",2455501,17.1044524111373,0.0387241186345831,50.7432088197073,2.85074206852288,3.87241186345831
2021-06-12,290994,29,236605,22,54389,7,261672,31,1730736,914,1992408,945,3,4317,1,9919,4644,3,"East TN",2455501,16.6157537708191,0.0395441595441595,38.4850179250589,1.18102171410234,3.95441595441595
2021-06-13,291013,19,236619,14,54394,5,261693,21,1731440,704,1993133,725,1,4318,1,9920,4645,1,"East TN",2455501,16.3306795639668,0.039835635201461,29.5255428525584,0.773772847170496,3.9835635201461
2021-06-14,291066,53,236652,33,54414,20,261734,41,1732427,987,1994161,1028,3,4321,3,9923,4647,2,"East TN",2455501,15.5161818301031,0.038650657518582,41.8651835205931,2.15841899473875,3.8650657518582
2021-06-15,291154,88,236721,69,54433,19,261822,88,1733999,1572,1995821,1660,0,4321,4,9927,4651,4,"East TN",2455501,15.5569067167963,0.0390865173473869,67.6033119106854,3.58379002900019,3.90865173473869
2021-06-16,291222,68,236762,41,54460,27,261860,38,1735398,1399,1997258,1437,2,4323,8,9935,4654,3,"East TN",2455501,16.37140445066,0.0401037980655815,58.5216621781054,2.76929229513651,4.01037980655815
2021-06-17,291273,51,236800,38,54473,13,261906,46,1737267,1869,1999173,1915,1,4324,1,9936,4658,4,"East TN",2455501,15.3940071700236,0.0357302367128182,77.9881580174473,2.07696922135238,3.57302367128182
2021-06-18,291335,62,236851,51,54484,11,261961,55,1738640,1373,2000601,1428,2,4326,4,9940,4660,2,"East TN",2455501,15.0682080764781,0.0350186036331801,58.1551381978667,2.52494297497741,3.50186036331801
2021-06-19,291363,28,236868,17,54495,11,261979,18,1739513,873,2001492,891,0,4326,5,9945,4662,2,"East TN",2455501,15.0274831897849,0.0337956847203875,36.2858740436269,1.14029682740915,3.37956847203875
2021-06-20,291388,25,236889,21,54499,4,261996,17,1740124,611,2002120,628,3,4329,2,9947,4665,3,"East TN",2455501,15.271832509944,0.0337153666407032,25.5752288433196,1.0181221673296,3.37153666407032
2021-06-21,291455,67,236929,40,54526,27,262048,52,1741158,1034,2003206,1086,6,4335,2,9949,4667,2,"East TN",2455501,15.8419809236486,0.0347153123272526,44.2272269487978,2.72856740844333,3.47153123272526
2021-06-22,291548,93,236975,46,54573,47,262099,51,1742353,1195,2004452,1246,5,4340,7,9956,4671,4,"East TN",2455501,16.0456053571145,0.0320936160352219,50.7432088197073,3.78741446246611,3.20936160352219
2021-06-23,291617,69,237023,48,54594,21,262154,55,1743676,1323,2005830,1378,2,4342,5,9961,4675,4,"East TN",2455501,16.0863302438077,0.0342977134857676,56.1188938632076,2.8100171818297,3.42977134857676
2021-06-24,291700,83,237075,52,54625,31,262216,62,1745157,1481,2007373,1543,3,4345,6,9967,4676,1,"East TN",2455501,17.3895266179896,0.0378048780487805,62.8385001675829,3.38016559553427,3.78048780487805
2021-06-25,291779,79,237131,56,54648,23,262285,69,1746584,1427,2008869,1496,0,4345,3,9970,4678,2,"East TN",2455501,18.0818496917737,0.0391872278664731,60.9244304930033,3.21726604876154,3.91872278664731
2021-06-26,291814,35,237149,18,54665,17,262306,21,1747456,872,2009762,893,0,4345,2,9972,4680,2,"East TN",2455501,18.366923898626,0.039540507859734,36.3673238170133,1.42537103426144,3.9540507859734
2021-06-27,291843,29,237169,20,54674,9,262330,24,1748025,569,2010355,593,2,4347,3,9975,4682,2,"East TN",2455501,18.5298234453987,0.0405585913782635,24.1498578090581,1.18102171410234,4.05585913782635
2021-06-28,291887,44,237193,24,54694,20,262355,25,1748497,472,2010852,497,4,4351,3,9978,4682,0,"East TN",2455501,17.5931510514555,0.0401517133141512,20.2402686865124,1.7918950145001,4.01517133141512
2021-06-29,292017,130,237278,85,54739,45,262450,95,1750072,1575,2012522,1670,0,4351,7,9985,4685,3,"East TN",2455501,19.0999718591033,0.0434944237918216,68.0105607776173,5.29423527011392,4.34944237918216
2021-06-30,292102,85,237341,63,54761,22,262525,75,1751377,1305,2013902,1380,3,4354,4,9989,4685,0,"East TN",2455501,19.7515700461942,0.0459613478691774,56.2003436365939,3.46161536892064,4.59613478691774
2021-07-01,292208,106,237394,53,54814,53,262589,64,1753357,1980,2015946,2044,1,4355,2,9991,4688,3,"East TN",2455501,20.6882424401375,0.0435086900734865,83.2416684008681,4.3168379894775,4.35086900734865
2021-07-02,292290,82,237457,63,54833,19,262663,74,1754623,1266,2017286,1340,0,4355,3,9994,4690,2,"East TN",2455501,20.810417100217,0.0449091125103956,54.5713481688666,3.33944070884109,4.49091125103956
2021-07-03,292338,48,237493,36,54845,12,262703,40,1755470,847,2018173,887,1,4356,3,9997,4693,3,"East TN",2455501,21.3398406272284,0.0472000951135418,36.1229744968542,1.95479456127283,4.72000951135418
2021-07-04,292365,27,237514,21,54851,6,262728,25,1755979,509,2018707,534,0,4356,1,9998,4694,1,"East TN",2455501,21.258390853842,0.0476532567049808,21.7470894941603,1.09957194071597,4.76532567049808
2021-07-05,292408,43,237538,24,54870,19,262753,25,1756368,389,2019121,414,0,4356,2,10000,4695,1,"East TN",2455501,21.2176659671489,0.0481315757649051,16.8601030909782,1.75117012780691,4.81315757649051
2021-07-06,292570,162,237642,104,54928,58,262864,111,1757521,1153,2020385,1264,5,4361,6,10006,4695,0,"East TN",2455501,22.5208623413308,0.052651659671881,51.4762567801846,6.59743164429581,5.2651659671881
2021-07-07,292713,143,237724,82,54989,61,262952,88,1758669,1148,2021621,1236,4,4365,6,10012,4697,2,"East TN",2455501,24.8829057695354,0.0553180463790646,50.3359599527754,5.82365879712531,5.53180463790646
2021-07-08,292853,140,237826,102,55027,38,263069,117,1760063,1394,2023132,1511,2,4367,3,10015,4699,2,"East TN",2455501,26.2675519171037,0.0667965488449763,61.535303793401,5.70148413704576,6.67965488449763
2021-07-09,293016,163,237947,121,55069,42,263199,130,1761405,1342,2024604,1472,0,4367,4,10019,4701,2,"East TN",2455501,29.5662677392516,0.073244055752938,59.9470332123668,6.63815653098899,7.3244055752938
2021-07-10,293120,104,238020,73,55100,31,263273,74,1762263,858,2025536,932,0,4367,13,10032,4702,1,"East TN",2455501,31.8468613940699,0.0774140975146,37.9555943980475,4.23538821609114,7.74140975146
2021-07-11,293168,48,238055,35,55113,13,263316,43,1762887,624,2026203,667,2,4369,7,10039,4702,0,"East TN",2455501,32.7020840146267,0.0784418356456777,27.1634994243537,1.95479456127283,7.84418356456777
2021-07-12,293341,173,238172,117,55169,56,263441,125,1763966,1079,2027407,1204,1,4370,14,10053,4703,1,"East TN",2455501,37.9963192847407,0.0830316195993242,49.0327635785935,7.04540539792083,8.30316195993242
2021-07-13,293555,214,238309,137,55246,77,263586,145,1765286,1320,2028872,1465,4,4374,17,10070,4707,4,"East TN",2455501,40.1140133927862,0.0850712854954637,59.6619590055146,8.71512575234138,8.50712854954637
2021-07-14,293728,173,238445,136,55283,37,263728,142,1766423,1137,2030151,1279,0,4374,12,10082,4708,1,"East TN",2455501,41.3357599935818,0.0909730363423212,52.0871300805823,7.04540539792083,9.09730363423212
2021-07-15,293948,220,238595,150,55353,70,263895,167,1767858,1435,2031753,1602,0,4374,15,10097,4708,0,"East TN",2455501,44.5937509290365,0.0958125507481731,65.2412684824808,8.95947507250048,9.58125507481731
2021-07-16,294178,230,238737,142,55441,88,264049,154,1769089,1231,2033138,1385,0,4374,10,10107,4712,4,"East TN",2455501,47.3223183374798,0.099601593625498,56.4039680700598,9.36672393943232,9.9601593625498
2021-07-17,294324,146,238839,102,55485,44,264161,112,1770101,1012,2034262,1124,0,4374,5,10112,4714,2,"East TN",2455501,49.0327635785935,0.101764840705936,45.7747726431388,5.94583345720486,10.1764840705936
2021-07-18,294468,144,238960,121,55508,23,264293,132,1770999,898,2035292,1030,0,4374,6,10118,4716,2,"East TN",2455501,52.9423527011392,0.107492573440422,41.9466332939795,5.8643836838185,10.7492573440422
2021-07-19,294771,303,239171,211,55600,92,264508,215,1772349,1350,2036857,1565,2,4376,14,10132,4717,1,"East TN",2455501,58.2365879712531,0.112910052910053,63.734447674833,12.3396406680348,11.2910052910053
2021-07-20,295127,356,239408,237,55719,119,264761,253,1773708,1359,2038469,1612,2,4378,22,10154,4719,2,"East TN",2455501,64.0195218816853,0.122434093987704,65.6485173494126,14.4980596627735,12.2434093987704
2021-07-21,295529,402,239702,294,55827,108,265070,309,1775279,1571,2040349,1880,3,4381,28,10182,4723,4,"East TN",2455501,73.3455209344244,0.131594430280447,76.5627869831859,16.37140445066,13.1594430280447
2021-07-22,296004,475,240036,334,55968,141,265438,368,1777198,1919,2042636,2287,5,4386,21,10203,4726,3,"East TN",2455501,83.7303670411863,0.141780758981898,93.1378158673118,19.3443211792624,14.1780758981898
2021-07-23,296464,460,240355,319,56109,141,265771,333,1778688,1490,2044459,1823,1,4387,28,10231,4732,6,"East TN",2455501,93.0970909806186,0.152106704354739,74.2414684416744,18.7334478788646,15.2106704354739
2021-07-24,296822,358,240605,250,56217,108,266037,266,1780116,1428,2046153,1694,0,4387,21,10252,4736,4,"East TN",2455501,101.730766959574,0.15776637793289,68.9879580582537,14.5795094361599,15.776637793289
2021-07-25,297050,228,240795,190,56255,38,266240,203,1781178,1062,2047418,1265,3,4390,17,10269,4741,5,"East TN",2455501,105.151657441801,0.16056407718951,51.5169816668778,9.28527416604595,16.056407718951
2021-07-26,297717,667,241258,463,56459,204,266725,485,1782589,1411,2049314,1896,10,4400,36,10305,4745,4,"East TN",2455501,119.97551619812,0.177972224452115,77.2143851702769,27.1634994243537,17.7972224452115
2021-07-27,298443,726,241747,489,56696,237,267237,512,1784487,1898,2051724,2410,2,4402,28,10333,4751,6,"East TN",2455501,135.043724274598,0.186797434930215,98.1469769305734,29.5662677392516,18.6797434930215
2021-07-28,299261,818,242295,548,56966,270,267851,614,1786689,2202,2054540,2816,2,4404,37,10370,4754,3,"East TN",2455501,151.985277138963,0.195969276301881,114.681280928006,33.3129573150245,19.5969276301881
2021-07-29,299950,689,242754,459,57196,230,268347,496,1788668,1979,2057015,2475,3,4407,24,10394,4758,4,"East TN",2455501,160.700402891304,0.202308922734543,100.79409456563,28.0594469316038,20.2308922734543
2021-07-30,300947,997,243502,748,57445,249,269150,803,1789836,1168,2058986,1971,4,4411,41,10435,4763,5,"East TN",2455501,182.569667045544,0.23260136297928,80.2687516722657,40.6027120331044,23.260136297928
2021-07-31,301481,534,243866,364,57615,170,269546,396,1791451,1615,2060997,2011,2,4413,32,10467,4773,10,"East TN",2455501,189.737247103544,0.236391808137968,81.897747139993,21.7470894941603,23.6391808137968
2021-08-01,302011,530,244286,420,57725,110,270007,461,1793217,1766,2063224,2227,3,4416,28,10495,4777,4,"East TN",2455501,202.036162884886,0.238327217512337,90.6943226657208,21.5841899473875,23.8327217512337
2021-08-02,302862,851,244825,539,58037,312,270544,537,1795118,1901,2065662,2438,9,4425,33,10528,4786,9,"East TN",2455501,209.529542036432,0.233606557377049,99.2872737579826,34.6568785758996,23.3606557377049
2021-08-03,304200,1338,245794,969,58406,369,271560,1016,1798198,3080,2069758,4096,4,4429,41,10569,4796,10,"East TN",2455501,234.45317269266,0.239713873793945,166.809135895282,54.4898983954802,23.9713873793945
2021-08-04,305287,1087,246629,835,58658,252,272446,886,1801051,2853,2073497,3739,8,4437,40,10609,4802,6,"East TN",2455501,245.408167213127,0.242390673629794,152.270351345815,44.267951835491,24.2390673629794
2021-08-05,306467,1180,247522,893,58945,287,273397,951,1804201,3150,2077598,4101,10,4447,43,10652,4809,7,"East TN",2455501,265.40408657948,0.245348102803284,167.012760328748,48.0553662979571,24.5348102803284
2021-08-06,307804,1337,248509,987,59295,350,274479,1082,1807881,3680,2082360,4762,3,4450,51,10703,4822,13,"East TN",2455501,279.250548055163,0.22798836313853,193.931910432942,54.449173508787,22.798836313853
2021-08-07,308528,724,249034,525,59494,199,275061,582,1810245,2364,2085306,2946,0,4450,28,10731,4831,9,"East TN",2455501,286.988276526868,0.226870706322761,119.97551619812,29.4848179658652,22.6870706322761
2021-08-08,309165,637,249486,452,59679,185,275585,524,1811929,1684,2087514,2208,5,4455,30,10761,4841,10,"East TN",2455501,291.345839403038,0.229641827912721,89.9205498185503,25.9417528235582,22.9641827912721
2021-08-09,310538,1373,250451,965,60087,408,276594,1009,1814769,2840,2091363,3849,13,4468,67,10828,4853,12,"East TN",2455501,312.60423025688,0.235399400801525,156.750088882065,55.9152694297416,23.5399400801525
2021-08-10,311863,1325,251300,849,60563,476,277509,915,1817425,2656,2094934,3571,6,4474,49,10877,4867,14,"East TN",2455501,312.074806729869,0.236296472831268,145.42857038136,53.9604748684688,23.6296472831268
2021-08-11,313751,1888,252613,1313,61138,575,278892,1383,1821696,4271,2100588,5654,8,4482,63,10940,4887,20,"East TN",2455501,344.695440971109,0.237938798863091,230.258509363262,76.8885860767314,23.7938798863091
2021-08-12,315213,1462,253680,1067,61533,395,280051,1159,1825118,3422,2105169,4581,10,4492,45,10985,4901,14,"East TN",2455501,356.179859018587,0.241340538972108,186.560705941476,59.539784345435,24.1340538972108
2021-08-13,316858,1645,254802,1122,62056,523,281223,1172,1829487,4369,2110710,5541,11,4503,30,11015,4925,24,"East TN",2455501,368.723124120088,0.237883597883598,225.656597166933,66.9924386102877,23.7883597883598
2021-08-14,318388,1530,255891,1089,62497,441,282422,1199,1833787,4300,2116209,5499,1,4504,27,11042,4939,14,"East TN",2455501,401.547382794794,0.23819693880853,223.946151925819,62.3090766405715,23.819693880853
2021-08-15,319532,1144,256858,967,62674,177,283481,1059,1836748,2961,2120229,4020,11,4515,21,11063,4952,13,"East TN",2455501,422.194900348238,0.24135717560752,163.7140445066,46.5892703770025,24.135717560752
2021-08-16,320965,1433,257777,919,63188,514,284443,962,1839246,2498,2123689,3460,17,4532,27,11090,4970,18,"East TN",2455501,424.63839354983,0.242807647095217,140.908107958417,58.3587626313327,24.2807647095217
2021-08-17,322701,1736,258991,1214,63710,522,285763,1320,1843273,4027,2129036,5347,10,4542,25,11115,4987,17,"East TN",2455501,441.376321980728,0.242038590112017,217.755969148455,70.6984032993674,24.2038590112017
2021-08-18,324791,2090,260383,1392,64408,698,287240,1477,1847550,4277,2134790,5754,13,4555,32,11147,5002,15,"East TN",2455501,449.602749092751,0.244079293608561,234.330998032581,85.1150131887546,24.4079293608561
2021-08-19,327181,2390,261884,1501,65297,889,288813,1573,1856421,8871,2145234,10444,23,4578,43,11190,5024,22,"East TN",2455501,487.395443944026,0.218694621240484,425.330716623614,97.3324791967098,21.8694621240484
2021-08-20,329635,2454,263863,1979,65772,475,290921,2108,1862001,5580,2152922,7688,4,4582,37,11227,5057,33,"East TN",2455501,520.341877278812,0.229745096181181,313.092928897199,99.9388719450735,22.9745096181181
2021-08-21,332563,2928,265841,1978,66722,950,293038,2117,1869079,7078,2162117,9195,0,4582,57,11284,5081,24,"East TN",2455501,577.275268875883,0.231245098893439,374.465333143827,119.242468237643,23.1245098893439
2021-08-22,334044,1481,267180,1339,66864,142,294555,1517,1873575,4496,2168130,6013,7,4589,17,11301,5100,19,"East TN",2455501,590.999555691486,0.231185152710799,244.878743686115,60.3135571926055,23.1185152710799
2021-08-23,335992,1948,268309,1129,67683,819,295740,1185,1876827,3252,2172567,4437,17,4606,38,11339,5121,21,"East TN",2455501,611.972872338476,0.231126478170138,180.696322257657,79.3320792783224,23.1126478170138
2021-08-24,337967,1975,269699,1390,68268,585,297173,1433,1879926,3099,2177099,4532,15,4621,25,11364,5159,38,"East TN",2455501,621.706120258147,0.237396750098829,184.56518649351,80.4316512190384,23.7396750098829
2021-08-25,340190,2223,270912,1213,69278,1010,298417,1244,1883245,3319,2181662,4563,17,4638,39,11403,5198,39,"East TN",2455501,627.12253018834,0.238457927974057,185.827657980999,90.531423118948,23.8457927974057
2021-08-26,342844,2654,272748,1836,70096,818,300372,1955,1888805,5560,2189177,7515,24,4662,40,11443,5228,30,"East TN",2455501,637.873900275341,0.263045308695355,306.047523499278,108.08384928371,26.3045308695355
2021-08-27,345849,3005,275026,2278,70823,727,302743,2371,1894493,5688,2197236,8059,19,4681,44,11487,5250,22,"East TN",2455501,660.313312843285,0.26677799341066,328.20186186037,122.378284513018,26.677799341066
2021-08-28,347991,2142,276566,1540,71425,602,304414,1671,1899145,4652,2203559,6323,1,4682,33,11520,5285,35,"East TN",2455501,628.303551902443,0.274504126248733,257.503458561002,87.2327072968001,27.4504126248733
2021-08-29,350323,2332,278395,1829,71928,503,306437,2023,1904783,5638,2211220,7661,9,4691,45,11565,5316,31,"East TN",2455501,662.960430478342,0.275748433511255,311.993356956483,94.9704357685051,27.5748433511256
2021-08-30,353562,3239,280811,2416,72751,823,309043,2606,1912196,7413,2221239,10019,21,4712,71,11636,5356,40,"East TN",2455501,715.536259199243,0.27331936226167,408.02263977901,131.907907999223,27.331936226167
2021-08-31,357148,3586,283221,2410,73927,1176,311651,2608,1919141,6945,2230792,9553,7,4719,80,11716,5392,36,"East TN",2455501,781.144051661962,0.269644087683683,389.044842579987,146.039443681758,26.9644087683683
2021-09-01,358578,1430,284173,952,74405,478,312636,985,1921059,1918,2233695,2903,14,4733,32,11748,5434,42,"East TN",2455501,748.849216514267,0.273268887052448,118.224346070313,58.2365879712531,27.3268887052448
2021-09-02,360891,2313,285668,1495,75223,818,314152,1516,1924584,3525,2238736,5041,19,4752,44,11792,5464,30,"East TN",2455501,734.962030151892,0.278052422365262,205.294153820341,94.1966629213346,27.8052422365262
2021-09-03,362644,1753,286893,1225,75751,528,315444,1292,1927887,3303,2243331,4595,17,4769,32,11824,5494,30,"East TN",2455501,683.974472012025,0.275539646382471,187.13085435518,71.3907263731516,27.5539646382471
2021-09-04,365899,3255,289232,2339,76667,916,318015,2571,1934385,6498,2252400,9069,3,4772,56,11880,5525,31,"East TN",2455501,729.301270901539,0.278475051698368,369.333997420486,132.559506186314,27.8475051698368
2021-09-05,370354,4455,292490,3258,77864,1197,321504,3489,1946474,12089,2267978,15578,8,4780,58,11938,5580,55,"East TN",2455501,815.760205351169,0.265460375629867,634.41228490642,181.429370218135,26.5460375629867
2021-09-06,375261,4907,296426,3936,78835,971,325793,4289,1962102,15628,2287895,19917,11,4791,102,12040,5617,37,"East TN",2455501,883.6893163554,0.251290206433029,811.117568268146,199.837019003454,25.1290206433029
2021-09-07,377335,2074,297881,1455,79454,619,327309,1516,1966522,4420,2293831,5936,34,4825,64,12104,5649,32,"East TN",2455501,822.113287675305,0.248385919827408,241.74292741074,84.4634150016636,24.8385919827408
2021-09-08,379012,1677,299057,1176,79955,501,328570,1261,1970892,4370,2299462,5631,19,4844,60,12164,5690,41,"East TN",2455501,832.172334688522,0.242279562698618,229.321836969319,68.2956349844696,24.2279562698618
2021-09-09,380922,1910,300064,1007,80858,903,329648,1078,1974557,3665,2304205,4743,8,4852,55,12219,5730,40,"East TN",2455501,815.760205351169,0.236692174922482,193.158137585772,77.7845335839814,23.6692174922482
2021-09-10,386411,5489,303904,3840,82507,1649,333788,4140,1986662,12105,2320450,16245,23,4875,144,12363,5766,36,"East TN",2455501,967.908382036904,0.237866154903461,661.575784330774,223.538903058887,23.7866154903461
2021-09-11,390686,4275,307003,3099,83683,1176,337102,3314,1998481,11819,2335583,15133,8,4883,119,12482,5810,44,"East TN",2455501,1009.44776646395,0.229457942127598,616.289710327953,174.098890613362,22.9457942127598
2021-09-12,392262,1576,308424,1421,83838,155,338655,1553,2003722,5241,2342377,6794,23,4906,50,12532,5854,44,"East TN",2455501,892.200817674275,0.230527292033495,276.684880193492,64.182421428458,23.0527292033495
2021-09-13,394609,2347,309872,1448,84737,899,340156,1501,2008845,5123,2349001,6624,63,4969,84,12616,5904,50,"East TN",2455501,787.945107739724,0.235050567865676,269.761649455651,95.5813090689028,23.5050567865676
2021-09-14,397418,2809,311825,1953,85593,856,342230,2074,2015065,6220,2357295,8294,43,5012,63,12679,5948,44,"East TN",2455501,817.877899459214,0.235109668473465,337.772210233268,114.396206721154,23.5109668473465
2021-09-15,399211,1793,313022,1197,86189,596,343446,1216,2018835,3770,2362281,4986,23,5035,36,12715,5987,39,"East TN",2455501,822.601986315624,0.236807335360321,203.054285052215,73.0197218408789,23.6807335360321
2021-09-16,401851,2640,314875,1853,86976,787,345405,1959,2025489,6654,2370894,8613,23,5058,65,12780,6024,37,"East TN",2455501,852.331153601648,0.236275847591057,350.763449088394,107.513700870006,23.6275847591057
2021-09-17,404525,2674,316746,1871,87779,803,347407,2002,2032685,7196,2380092,9198,23,5081,82,12862,6079,55,"East TN",2455501,737.690597560335,0.228345796586298,374.587507803906,108.898347017574,22.8345796586298
2021-09-18,405972,1447,317919,1173,88053,274,348741,1334,2038158,5473,2386899,6807,3,5084,39,12901,6137,58,"East TN",2455501,622.52061799201,0.226810351547276,277.214303720503,58.9289110450372,22.6810351547276
2021-09-19,406614,642,318364,445,88250,197,349253,512,2040235,2077,2389488,2589,17,5101,25,12926,6180,43,"East TN",2455501,584.483573820577,0.224958077731315,105.436731648653,26.1453772570241,22.4958077731315
2021-09-20,408592,1978,319616,1252,88976,726,350622,1369,2045867,5632,2396489,7001,48,5149,70,12996,6224,44,"East TN",2455501,569.456090630792,0.220392520215633,285.114931738981,80.553825879118,22.0392520215633
2021-09-21,410459,1867,320716,1100,89743,767,351757,1135,2050169,4302,2401926,5437,31,5180,61,13057,6272,48,"East TN",2455501,531.093247365813,0.213461495373171,221.421208950841,76.0333634561745,21.3461495373171
2021-09-22,412051,1592,321833,1117,90218,475,352978,1221,2055524,5355,2408502,6576,14,5194,45,13102,6312,40,"East TN",2455501,522.907545140483,0.206226606953549,267.806854894378,64.8340196155489,20.6226606953549
2021-09-23,414398,2347,323340,1507,91058,840,354643,1665,2061873,6349,2416516,8014,32,5226,60,13162,6350,38,"East TN",2455501,510.97515333938,0.202490026741484,326.369241959177,95.5813090689028,20.2490026741484
2021-09-24,415935,1537,324321,981,91614,556,355741,1098,2066745,4872,2422486,5970,37,5263,40,13202,6400,50,"East TN",2455501,464.670957169229,0.196584422323914,243.127573558308,62.5941508474238,19.6584422323914
2021-09-25,416632,697,324810,489,91822,208,356303,562,2069757,3012,2426060,3574,2,5265,21,13223,6442,42,"East TN",2455501,434.127292149341,0.193100278338143,145.55074504144,28.3852460251492,19.3100278338143
2021-09-26,417492,860,325438,628,92054,232,357026,723,2073732,3975,2430758,4698,6,5271,26,13249,6478,36,"East TN",2455501,443.005317448456,0.188345044826751,191.325517684578,35.0234025561382,18.8345044826751
2021-09-27,418949,1457,326268,830,92681,627,357947,921,2077307,3575,2435254,4496,46,5317,45,13294,6512,34,"East TN",2455501,421.787651481307,0.188959112601574,183.099090572555,59.3361599119691,18.8959112601574
2021-09-28,420233,1284,327049,781,93184,503,358798,851,2080947,3640,2439745,4491,14,5331,34,13328,6548,36,"East TN",2455501,398.04504253918,0.186176260609746,182.895466139089,52.2907545140483,18.6176260609746
2021-09-29,421903,1670,328053,1004,93850,666,359931,1133,2086424,5477,2446355,6610,30,5361,51,13379,6593,45,"East TN",2455501,401.221583701249,0.183684252238924,269.191501041946,68.0105607776173,18.3684252238924
2021-09-30,423113,1210,328815,762,94298,448,360752,821,2091093,4669,2451845,5490,11,5372,40,13419,6628,35,"East TN",2455501,354.917387531099,0.172917433270118,223.57962794558,49.2771128987526,17.2917433270118
2021-10-01,424479,1366,329785,970,94694,396,361825,1073,2096064,4971,2457889,6044,14,5386,47,13466,6657,29,"East TN",2455501,347.953431906564,0.171849843233624,246.141215173604,55.6301952228893,17.1849843233624
2021-10-02,425032,553,330136,351,94896,202,362220,395,2098732,2668,2460952,3063,11,5397,19,13485,6695,38,"East TN",2455501,342.089048222746,0.16958041958042,124.740327941223,22.5208623413308,16.958041958042
2021-10-03,425572,540,330603,467,94969,73,362744,524,2101822,3090,2464566,3614,13,5410,15,13500,6728,33,"East TN",2455501,329.057084480927,0.169131566493138,147.179740509167,21.9914388143194,16.9131566493138
2021-10-04,426913,1341,331456,853,95457,488,363685,941,2105959,4137,2469644,5078,22,5432,29,13529,6751,23,"East TN",2455501,324.332997624517,0.166850828729282,206.800974627988,54.6120730555597,16.6850828729282
2021-10-05,428176,1263,332212,756,95964,507,364500,815,2110420,4461,2474920,5276,17,5449,41,13570,6791,40,"East TN",2455501,323.47777500396,0.162103766879886,214.864502193239,51.4355318934914,16.2103766879886
2021-10-06,429110,934,332917,705,96193,229,365280,780,2114839,4419,2480119,5199,18,5467,26,13596,6826,35,"East TN",2455501,293.504258397777,0.15842317260988,211.728685917864,38.0370441714339,15.842317260988
2021-10-07,430224,1114,333708,791,96516,323,366136,856,2119621,4782,2485757,5638,24,5491,26,13622,6857,31,"East TN",2455501,289.594669275231,0.158763859400802,229.606911176171,45.367523776207,15.8763859400802
2021-10-08,431271,1047,334296,588,96975,459,366778,642,2123866,4245,2490644,4887,9,5500,31,13653,6878,21,"East TN",2455501,276.603430420106,0.151213555182415,199.02252126959,42.6389563677636,15.1213555182415
2021-10-09,431811,540,334649,353,97162,187,367194,416,2126665,2799,2493859,3215,4,5504,32,13685,6908,30,"East TN",2455501,276.074006893094,0.151153250068375,130.930510718587,21.9914388143194,15.1153250068375
2021-10-10,432128,317,334914,265,97214,52,367505,311,2128897,2232,2496402,2543,6,5510,16,13701,6932,24,"East TN",2455501,266.992357160514,0.149547681869582,103.563386860767,12.9097890817393,14.9547681869582
2021-10-11,433343,1215,335452,538,97891,677,368052,547,2132343,3446,2500395,3993,52,5562,33,13734,6946,14,"East TN",2455501,261.861021437173,0.142011641897824,162.614472565884,49.4807373322186,14.2011641897824
2021-10-12,434277,934,336089,637,98188,297,369057,1005,2135988,3645,2505045,4650,29,5591,32,13766,6980,34,"East TN",2455501,248.462533715116,0.151269709543568,189.370723123306,38.0370441714339,15.1269709543568
2021-10-13,435122,845,336638,549,98484,296,369706,649,2139851,3863,2509557,4512,25,5616,37,13803,7003,23,"East TN",2455501,244.838018799422,0.150349887899993,183.750688759646,34.4125292557405,15.0349887899993
2021-10-14,436070,948,337291,653,98779,295,370427,721,2143854,4003,2514281,4724,31,5647,33,13836,7035,32,"East TN",2455501,238.077687608354,0.150434721637919,192.384364738601,38.6071925851384,15.0434721637919
2021-10-15,436873,803,337804,513,99069,290,371002,575,2147747,3893,2518749,4468,24,5671,30,13866,7060,25,"East TN",2455501,228.140815255217,0.150293542074364,181.958793745146,32.7020840146267,15.0293542074364
2021-10-16,437181,308,338043,239,99138,69,371273,271,2149977,2230,2521250,2501,7,5678,12,13878,7075,15,"East TN",2455501,218.692641542398,0.148917527655069,101.852941619653,12.5432651015007,14.8917527655069
2021-10-17,437433,252,338253,210,99180,42,371521,248,2151640,1663,2523161,1911,7,5685,14,13892,7091,16,"East TN",2455501,216.045523907341,0.150080346799208,77.8252584706746,10.2626714466824,15.0080346799208
2021-10-18,438218,785,338718,465,99500,320,372036,515,2154820,3180,2526856,3695,23,5708,37,13929,7112,21,"East TN",2455501,198.533822629272,0.150561203280299,150.478456331315,31.9690360541494,15.0561203280299
2021-10-19,439049,831,339159,441,99890,390,372510,474,2158148,3328,2530658,3802,25,5733,23,13952,7128,16,"East TN",2455501,194.339159299874,0.134814352086831,154.836019207486,33.8423808420359,13.4814352086831
2021-10-20,439811,762,339648,489,100163,273,373049,539,2162170,4022,2535219,4561,15,5748,21,13973,7147,19,"East TN",2455501,190.95899370434,0.130270438781077,185.746208207612,31.0323636602062,13.0270438781077
2021-10-21,440442,631,340072,424,100370,207,373520,471,2165805,3635,2539325,4106,17,5765,21,13994,7165,18,"East TN",2455501,178.0492046226,0.123502635361763,167.216384762213,25.6974035033991,12.3502635361763
2021-10-22,440985,543,340414,342,100571,201,373906,386,2168910,3105,2542816,3491,6,5771,18,14012,7183,18,"East TN",2455501,167.460734082373,0.120663148709852,142.170579445905,22.1136134743989,12.0663148709852
2021-10-23,441341,356,340658,244,100683,112,374179,273,2171295,2385,2545474,2658,0,5771,15,14027,7203,20,"East TN",2455501,169.415528643645,0.119963672391017,108.246748830483,14.4980596627735,11.9963672391017
2021-10-24,441584,243,340820,162,100764,81,374375,196,2173191,1896,2547566,2092,7,5778,14,14041,7215,12,"East TN",2455501,169.049004663407,0.116943249334153,85.1964629621409,9.89614746644371,11.6943249334153
2021-10-25,442006,422,341068,248,100938,174,374645,270,2175622,2431,2550267,2701,28,5806,21,14062,7226,11,"East TN",2455501,154.265870793781,0.111443338601512,109.99791895829,17.1859021845236,11.1443338601512
2021-10-26,442531,525,341396,328,101135,197,374983,338,2178263,2641,2553246,2979,12,5818,28,14090,7237,11,"East TN",2455501,141.804055465667,0.109482911280326,121.319437458995,21.3805655139216,10.9482911280326
2021-10-27,443151,620,341790,394,101361,226,375407,424,2182461,4198,2557868,4622,10,5828,21,14111,7258,21,"East TN",2455501,136.021121555235,0.104110556757473,188.230426295896,25.2494297497741,10.4110556757473
2021-10-28,443567,416,342046,256,101521,160,375698,291,2185253,2792,2560951,3083,16,5844,15,14126,7273,15,"East TN",2455501,127.2652709162,0.100712105798576,125.554825675086,16.9415528643645,10.0712105798576
2021-10-29,444026,459,342350,304,101676,155,376030,332,2188758,3505,2564788,3837,4,5848,10,14136,7290,17,"East TN",2455501,123.844380433973,0.0966684871654833,156.261390241747,18.6927229921715,9.66684871654834
2021-10-30,444289,263,342552,202,101737,61,376259,229,2191332,2574,2567591,2803,0,5848,16,14152,7305,15,"East TN",2455501,120.056965971506,0.0940453045168875,114.151857400995,10.7106452003074,9.40453045168875
2021-10-31,444460,171,342679,127,101781,44,376405,146,2192956,1624,2569361,1770,0,5848,5,14157,7316,11,"East TN",2455501,117.124774129597,0.0931406285845377,72.0830494469357,6.96395562453446,9.31406285845377
2021-11-01,445056,596,343039,360,102017,236,376794,389,2196058,3102,2572852,3491,14,5862,23,14180,7325,9,"East TN",2455501,124.210904414211,0.0951516493247731,142.170579445905,24.2720324691377,9.51516493247731
2021-11-02,445469,413,343260,221,102209,192,377021,227,2198269,2211,2575290,2438,25,5887,16,14196,7348,23,"East TN",2455501,119.649717104575,0.0924514607149338,99.2872737579826,16.819378204285,9.24514607149338
2021-11-03,446042,573,343640,380,102402,193,377415,394,2202846,4577,2580261,4971,6,5893,14,14210,7359,11,"East TN",2455501,117.735647429995,0.0896708792926361,202.443411751818,23.3353600751944,8.96708792926361
2021-11-04,446459,417,343942,302,102517,115,377745,330,2206374,3528,2584119,3858,13,5906,9,14219,7370,11,"East TN",2455501,117.776372316688,0.0883546270718232,157.116612862304,16.9822777510577,8.83546270718232
2021-11-05,446894,435,344227,285,102667,150,378069,324,2209949,3575,2588018,3899,2,5908,13,14232,7376,6,"East TN",2455501,116.798975036052,0.0877744296168747,158.786333216724,17.715325711535,8.77744296168747
2021-11-06,447127,233,344398,171,102729,62,378257,188,2212183,2234,2590440,2422,0,5908,13,14245,7384,8,"East TN",2455501,115.577228435256,0.0874436518009541,98.6356755708916,9.48889859951187,8.74436518009541
2021-11-07,447326,199,344526,128,102800,71,378410,153,2214085,1902,2592495,2055,6,5914,8,14253,7396,12,"East TN",2455501,116.717525262665,0.0866689720757327,83.6896421544931,8.10425245194362,8.66689720757327
2021-11-08,447867,541,344872,346,102995,195,378795,385,2217597,3512,2596392,3897,25,5939,25,14278,7408,12,"East TN",2455501,114.47765649454,0.0850042480883602,158.704883443338,22.0321637010125,8.50042480883602
2021-11-09,448731,864,345486,614,103245,250,379592,797,2224860,7263,2604452,8060,10,5949,27,14305,7423,15,"East TN",2455501,132.844580393166,0.0881626774569645,328.242586747063,35.186302102911,8.81626774569645
2021-11-10,449356,625,345923,437,103433,188,380092,500,2230096,5236,2610188,5736,7,5956,28,14333,7435,12,"East TN",2455501,134.962274501212,0.0894509974270725,233.597950072103,25.45305418324,8.94509974270725
2021-11-11,449860,504,346307,384,103553,120,380498,406,2234383,4287,2614881,4693,5,5961,10,14343,7448,13,"East TN",2455501,138.505339643519,0.0894935309797802,191.121893251113,20.5253428933647,8.94935309797802
2021-11-12,450339,479,346627,320,103712,159,380829,331,2237817,3434,2618646,3765,2,5963,24,14367,7458,10,"East TN",2455501,140.297234658019,0.0901136215227896,153.329198399838,19.5072207260351,9.01136215227896
2021-11-13,450576,237,346769,142,103807,95,380978,149,2239815,1998,2620793,2147,4,5967,11,14378,7467,9,"East TN",2455501,140.460134204792,0.0896451751062498,87.436331730266,9.65179814628461,8.96451751062498
2021-11-14,450937,361,347085,316,103852,45,381323,345,2242793,2978,2624116,3323,1,5968,14,14392,7475,8,"East TN",2455501,147.057565849087,0.0921223237721767,135.32879848145,14.7016840962394,9.21223237721767
2021-11-15,451514,577,347376,291,104138,286,381624,301,2245534,2741,2627158,3042,26,5994,20,14412,7485,10,"East TN",2455501,148.523661770042,0.0919521549762725,123.885105320666,23.4982596219672,9.19521549762725
2021-11-16,452185,671,347808,432,104377,239,382085,461,2249115,3581,2631200,4042,24,6018,17,14429,7495,10,"East TN",2455501,140.663758638258,0.0932032301480484,164.60999201385,27.3263989711265,9.32032301480485
2021-11-17,452897,712,348274,466,104623,246,382593,508,2253731,4616,2636324,5124,5,6023,27,14456,7505,10,"East TN",2455501,144.206823780565,0.0956917661463116,208.674319415875,28.996119325547,9.56917661463116
2021-11-18,453521,624,348684,410,104837,214,383071,478,2258562,4831,2641633,5309,12,6035,19,14475,7514,9,"East TN",2455501,149.093810183747,0.0961797248803828,216.208423454114,25.4123292965468,9.61797248803828
2021-11-19,454134,613,349126,442,105008,171,383531,460,2263036,4474,2646567,4934,7,6042,13,14488,7522,8,"East TN",2455501,154.550945000633,0.0967730382149636,200.93659094417,24.9643555429218,9.67730382149636
2021-11-20,454456,322,349373,247,105083,75,383818,287,2265735,2699,2649553,2986,0,6042,14,14502,7530,8,"East TN",2455501,158.012560369554,0.0987482614742698,121.604511665847,13.1134135152052,9.87482614742698
2021-11-21,454720,264,349525,152,105195,112,383982,164,2267218,1483,2651200,1647,9,6051,11,14513,7541,11,"East TN",2455501,154.062246360315,0.0981760448973564,67.073888383674,10.7513700870006,9.81760448973564
2021-11-22,455472,752,350020,495,105452,257,384494,512,2271084,3866,2655578,4378,20,6071,38,14551,7547,6,"East TN",2455501,161.189101531622,0.100985221674877,178.29355394276,30.6251147932744,10.0985221674877
2021-11-23,456147,675,350489,469,105658,206,384982,488,2274384,3300,2659366,3788,21,6092,20,14571,7554,7,"East TN",2455501,161.352001078395,0.102854505432081,154.265870793781,27.4892985178992,10.2854505432081
2021-11-24,456883,736,351021,532,105862,204,385555,573,2278412,4028,2663967,4601,6,6098,21,14592,7564,10,"East TN",2455501,162.329398359031,0.107151901023767,187.37520367534,29.9735166061834,10.7151901023767
2021-11-25,457169,286,351179,158,105990,128,385729,174,2280047,1635,2665776,1809,1,6099,12,14604,7573,9,"East TN",2455501,148.564386656735,0.110094023112289,73.6713200279699,11.6473175942506,11.0094023112289
2021-11-26,457399,230,351381,202,106018,28,385973,244,2281724,1677,2667697,1921,1,6100,15,14619,7577,4,"East TN",2455501,132.966755053246,0.115570279223852,78.2325073376065,9.36672393943232,11.5570279223852
2021-11-27,457683,284,351609,228,106074,56,386227,254,2283319,1595,2669546,1849,0,6100,14,14633,7588,11,"East TN",2455501,131.419209358905,0.120492172260291,75.3003154956972,11.5658678208643,12.0492172260291
2021-11-28,457999,316,351821,212,106178,104,386444,217,2284830,1511,2671274,1728,7,6107,20,14653,7599,11,"East TN",2455501,133.53690346695,0.122646209026602,70.3726042058219,12.8690641950461,12.2646209026602
2021-11-29,459096,1097,352536,715,106560,382,387182,738,2289377,4547,2676559,5285,19,6126,36,14689,7607,8,"East TN",2455501,147.586989376099,0.128115914398742,215.231026173477,44.6752007024228,12.8115914398742
2021-11-30,459934,838,353045,509,106889,329,387689,507,2292744,3367,2680433,3874,64,6190,26,14715,7619,12,"East TN",2455501,154.225145907088,0.128494802297432,157.768211049395,34.1274550488882,12.8494802297432
2021-12-01,461017,1083,353816,771,107201,312,388497,808,2297913,5169,2686410,5977,48,6238,33,14748,7640,21,"East TN",2455501,168.356681589623,0.131087644254333,243.412647765161,44.1050522887183,13.1087644254333
2021-12-02,461920,903,354440,624,107480,279,389163,666,2302574,4661,2691737,5327,39,6277,18,14766,7658,18,"East TN",2455501,193.483936679317,0.132275336081045,216.941471414591,36.7745726839452,13.2275336081045
2021-12-03,462938,1018,355175,735,107763,283,389945,782,2307551,4977,2697496,5759,21,6298,26,14792,7671,13,"East TN",2455501,225.575147393546,0.133293063525622,234.534622466047,41.4579346536613,13.3293063525622
2021-12-04,463361,423,355509,334,107852,89,390326,381,2310303,2752,2700629,3133,3,6301,29,14821,7683,12,"East TN",2455501,231.235906643899,0.131872727857671,127.591070009745,17.2266270712168,13.1872727857671
2021-12-05,463746,385,355725,216,108021,169,390557,231,2312234,1931,2702791,2162,12,6313,15,14836,7691,8,"East TN",2455501,234.045923825728,0.130500999460609,88.0472050306638,15.6790813768758,13.0500999460609
2021-12-06,464697,951,356370,645,108327,306,391246,689,2316418,4184,2707664,4873,69,6382,32,14868,7705,14,"East TN",2455501,228.100090368524,0.130654235653432,198.452372855886,38.729367245218,13.0654235653432
2021-12-07,465539,842,356902,532,108637,310,391786,540,2319893,3475,2711679,4015,8,6390,28,14896,7710,5,"East TN",2455501,228.262989915296,0.131120783460283,163.510420073134,34.2903545956609,13.1120783460283
2021-12-08,466585,1046,357539,637,109046,409,392443,657,2324494,4601,2716937,5258,4,6394,29,14925,7727,17,"East TN",2455501,226.756169107649,0.129262619975759,214.131454232761,42.5982314810705,12.9262619975759
2021-12-09,467504,919,358159,620,109345,299,393110,667,2329406,4912,2722516,5579,19,6413,34,14959,7741,14,"East TN",2455501,227.407767294739,0.128236784820819,227.204142861274,37.4261708710361,12.8236784820819
2021-12-10,468300,796,358707,548,109593,248,393711,601,2333901,4495,2727612,5096,5,6418,22,14981,7755,14,"East TN",2455501,218.366842448853,0.125049807411343,207.534022588466,32.4170098077745,12.5049807411343
2021-12-11,468696,396,358993,286,109703,110,394036,325,2336821,2920,2730857,3245,0,6418,19,15000,7764,9,"East TN",2455501,217.267270508137,0.122733889109435,132.152257319382,16.1270551305009,12.2733889109435
2021-12-12,469127,431,359256,263,109871,168,394330,294,2339338,2517,2733668,2811,9,6427,18,15018,7771,7,"East TN",2455501,219.140615296023,0.122194513715711,114.47765649454,17.5524261647623,12.2194513715711
2021-12-13,470008,881,359831,575,110177,306,394934,604,2343935,4597,2738869,5201,23,6450,24,15042,7780,9,"East TN",2455501,216.2898732275,0.11818618811088,211.81013569125,35.8786251766951,11.818618811088
2021-12-14,470768,760,360290,459,110478,301,395420,486,2347953,4018,2743373,4504,36,6486,24,15066,7788,8,"East TN",2455501,212.950432518659,0.114658925979681,183.424889666101,30.9509138868198,11.4658925979681
2021-12-15,471636,868,360879,589,110757,279,396048,628,2352758,4805,2748806,5433,19,6505,23,15089,7803,15,"East TN",2455501,205.701402687272,0.113119332266466,221.258309404069,35.3492016496837,11.3119332266466
2021-12-16,472430,794,361391,512,111039,282,396593,545,2356578,3820,2753171,4365,19,6524,22,15111,7820,17,"East TN",2455501,200.610791850624,0.113619311694666,177.764130415748,32.3355600343881,11.3619311694666
2021-12-17,473239,809,361926,535,111313,274,397178,585,2361196,4618,2758374,5203,24,6548,34,15145,7834,14,"East TN",2455501,201.140215377636,0.112703985436578,211.891585464636,32.9464333347859,11.2703985436578
2021-12-18,473809,570,362307,381,111502,189,397604,426,2364541,3345,2762145,3771,0,6548,29,15174,7847,13,"East TN",2455501,208.22634566225,0.114037330605983,153.573547719997,23.2131854151149,11.4037330605983
2021-12-19,474229,420,362587,280,111642,140,397914,310,2367202,2661,2765116,2971,6,6554,16,15190,7856,9,"East TN",2455501,207.778371908625,0.113965911981684,120.99363836545,17.1044524111373,11.3965911981684
2021-12-20,475161,932,363209,622,111952,310,398552,638,2371142,3940,2769694,4578,40,6594,31,15221,7868,12,"East TN",2455501,209.855341129977,0.117372262773723,186.438531281396,37.9555943980475,11.7372262773723
2021-12-21,476171,1010,363865,656,112306,354,399221,669,2375525,4383,2774746,5052,30,6624,29,15250,7878,10,"East TN",2455501,220.036562803273,0.121155133394957,205.742127573966,41.1321355601158,12.1155133394957
2021-12-22,477656,1485,364596,731,113060,754,399969,748,2379854,4329,2779823,5077,852,7476,40,15290,7894,16,"East TN",2455501,245.163817892968,0.126414546861399,206.760249741295,60.4764567393782,12.6414546861399
2021-12-23,478821,1165,365401,805,113420,360,400832,863,2384337,4483,2785169,5346,27,7503,35,15325,7911,17,"East TN",2455501,260.272750856139,0.132477029814363,217.715244261762,47.4444929975594,13.2477029814363
2021-12-24,479759,938,366051,650,113708,288,401540,708,2388171,3834,2789711,4542,0,7503,18,15343,7933,22,"East TN",2455501,265.52626123956,0.13919647700801,184.972435360442,38.1999437182066,13.919647700801
2021-12-25,480239,480,366334,283,113905,197,401873,333,2390290,2119,2792163,2452,8,7511,19,15362,7941,8,"East TN",2455501,261.861021437173,0.142214671197282,99.8574221716871,19.5479456127283,14.2214671197282
2021-12-26,480582,343,366611,277,113971,66,402193,320,2392165,1875,2794358,2195,62,7573,19,15381,7958,17,"East TN",2455501,258.725205161798,0.146330620340606,89.3911262915389,13.9686361357621,14.6330620340606
2021-12-27,482457,1875,367873,1262,114584,613,403504,1311,2396887,4722,2800391,6033,64,7637,36,15417,7977,19,"East TN",2455501,297.12877331347,0.16131869563801,245.693241419979,76.35916254972,16.131869563801
2021-12-28,484880,2423,369316,1443,115564,980,404989,1485,2401261,4374,2806250,5859,18,7655,27,15444,7990,13,"East TN",2455501,354.673038210939,0.183087861858812,238.607111135365,98.6764004575848,18.3087861858812
2021-12-29,487764,2884,371243,1927,116521,957,406993,2004,2406551,5290,2813544,7294,37,7692,30,15474,8005,15,"East TN",2455501,411.647154694704,0.208297500074138,297.047323540084,117.450573223143,20.8297500074138
2021-12-30,490587,2823,373027,1784,117560,1039,408815,1822,2411011,4460,2819826,6282,14,7706,34,15508,8020,15,"East TN",2455501,479.169016832003,0.230343076434775,255.833738206582,114.966355134858,23.0343076434775
2021-12-31,493110,2523,374841,1814,118269,709,410762,1947,2415837,4826,2826599,6773,0,7706,25,15533,8039,19,"East TN",2455501,543.7179622407,0.25,275.829657572935,102.748889126903,25
2022-01-01,494569,1459,376072,1231,118497,228,412101,1339,2419486,3649,2831587,4988,0,7706,34,15567,8047,8,"East TN",2455501,583.587626313327,0.259435876623377,203.135734825602,59.4176096853555,25.9435876623377
2022-01-02,496032,1463,377035,963,118997,500,413325,1224,2422503,3017,2835828,4241,6,7712,27,15594,8067,20,"East TN",2455501,629.199499409693,0.268435013262599,172.714244465793,59.5805092321282,26.8435013262599
2022-01-03,498924,2892,379219,2184,119705,708,415551,2226,2426673,4170,2842224,6396,33,7745,38,15632,8081,14,"East TN",2455501,670.616709176661,0.287978390266058,260.476375289605,117.776372316688,28.7978390266058
2022-01-04,503094,4170,381675,2456,121419,1714,417941,2390,2431910,5237,2849851,7627,14,7759,43,15675,8099,18,"East TN",2455501,741.763086229653,0.297057406940208,310.608710808914,169.822777510577,29.7057406940208
2022-01-05,508023,4929,385082,3407,122941,1522,421439,3498,2437144,5234,2858583,8732,15,7774,44,15719,8124,25,"East TN",2455501,825.045479517215,0.320744243877528,355.609710604883,200.732966510704,32.0744243877528
2022-01-06,513173,5150,388548,3466,124625,1684,425084,3645,2442750,5606,2867834,9251,11,7785,43,15762,8144,20,"East TN",2455501,919.812290852254,0.338881019830028,376.745926798645,209.733166469898,33.8881019830028
2022-01-07,517543,4370,391772,3224,125771,1146,428363,3279,2447434,4684,2875797,7963,12,7797,40,15802,8166,22,"East TN",2455501,995.031156574565,0.357758445465263,324.292272737824,177.967754849214,35.7758445465263
2022-01-08,520684,3141,394194,2422,126490,719,430967,2604,2452198,4764,2883165,7368,1,7798,43,15845,8186,20,"East TN",2455501,1063.5304159925,0.365776106091745,300.06096515538,127.916869103291,36.5776106091745
2022-01-09,524187,3503,396877,2683,127310,820,433867,2900,2457200,5002,2891067,7902,15,7813,42,15887,8204,18,"East TN",2455501,1146.6091848466,0.371874943427651,321.80805464954,142.659278086224,37.1874943427651
2022-01-10,528826,4639,399949,3072,128877,1567,437106,3239,2461980,4780,2899086,8019,29,7842,63,15950,8237,33,"East TN",2455501,1217.75556189959,0.379075656853435,326.572866392642,188.922749369681,37.9075656853435
2022-01-11,534427,5601,403987,4038,130440,1563,441240,4134,2467169,5189,2908409,9323,30,7872,50,16000,8262,25,"East TN",2455501,1276.03287475753,0.397879025923016,379.678118640554,228.100090368524,39.7879025923016
2022-01-12,540111,5684,407966,3979,132145,1705,445405,4165,2471938,4769,2917343,8934,16,7888,32,16032,8284,22,"East TN",2455501,1306.78016421089,0.40786249149081,363.836137716906,231.480255964058,40.786249149081
2022-01-13,547435,7324,413212,5246,134223,2078,450881,5476,2478863,6925,2929744,12401,65,7953,50,16082,8300,16,"East TN",2455501,1395.31606788187,0.416685511225973,505.029319882175,298.26907014088,41.6685511225973
2022-01-14,553930,6495,417988,4776,135942,1719,455809,4928,2484742,5879,2940551,10807,68,8021,39,16121,8333,33,"East TN",2455501,1481.85645210489,0.42385026407635,440.113850493239,264.50813907223,42.385026407635
2022-01-15,558471,4541,421373,3385,137098,1156,459422,3613,2489831,5089,2949253,8702,9,8030,38,16159,8348,15,"East TN",2455501,1538.87129347534,0.43056228059557,354.387964004087,184.931710473749,43.056228059557
2022-01-16,562323,3852,424688,3315,137635,537,462913,3491,2494479,4648,2957392,8139,7,8037,40,16199,8366,18,"East TN",2455501,1553.08427893126,0.437934413871089,331.459852795825,156.872263542145,43.7934413871089
2022-01-17,566960,4637,428015,3327,138945,1310,466383,3470,2499214,4735,2965597,8205,15,8052,43,16242,8390,24,"East TN",2455501,1553.00282915788,0.440182826900813,334.147695317575,188.841299596294,44.0182826900813
2022-01-18,572913,5953,431690,3675,141223,2278,470120,3737,2502677,3463,2972797,7200,49,8101,48,16290,8422,32,"East TN",2455501,1567.33798927388,0.448530782133317,293.219184190925,242.435250484524,44.8530782133317
2022-01-19,581213,8300,437691,6001,143522,2299,476294,6174,2508525,5848,2984819,12022,22,8123,53,16343,8454,32,"East TN",2455501,1673.87429286325,0.457777580176655,489.594587825458,338.016559553427,45.7777580176655
2022-01-20,589504,8291,443754,6063,145750,2228,482570,6276,2514242,5717,2996812,11993,44,8167,43,16386,8488,34,"East TN",2455501,1713.25525829556,0.472490606548578,488.413566111356,337.650035573189,47.2490606548578
2022-01-21,596802,7298,449365,5611,147437,1687,488452,5882,2519964,5722,3008416,11604,53,8220,31,16417,8519,31,"East TN",2455501,1745.95734231018,0.480999042216164,472.571585187707,297.210223086857,48.0999042216164
2022-01-22,602800,5998,454228,4863,148572,1135,493614,5162,2526053,6089,3019667,11251,0,8220,57,16474,8546,27,"East TN",2455501,1805.29350222215,0.485585252932655,458.195700185013,244.267870385718,48.5585252932655
2022-01-23,606395,3595,457202,2974,149193,621,496759,3145,2529322,3269,3026081,6414,6,8226,31,16505,8578,32,"East TN",2455501,1794.82720634201,0.492742651661838,261.209423250082,146.405967661996,49.2742651661838
2022-01-24,613083,6688,461884,4682,151199,2006,501724,4965,2534702,5380,3036426,10345,37,8263,46,16551,8613,35,"East TN",2455501,1878.35394894973,0.498962289457708,421.298952840988,272.368042204015,49.8962289457708
2022-01-25,618782,5699,465962,4078,152820,1621,505989,4265,2539355,4653,3045344,8918,30,8293,36,16587,8642,29,"East TN",2455501,1868.00982772966,0.494424304244145,363.184539529815,232.091129264456,49.4424304244145
2022-01-26,624581,5799,470384,4422,154197,1377,510667,4678,2544248,4893,3054915,9571,26,8319,37,16624,8676,34,"East TN",2455501,1766.15688611,0.490370349235334,389.777890540464,236.163617933774,49.0370349235334
2022-01-27,631832,7251,476152,5768,155680,1483,516808,6141,2551401,7153,3068209,13294,29,8348,52,16676,8723,47,"East TN",2455501,1723.80300394909,0.479543958429626,541.396643699188,295.296153412277,47.9543958429626
2022-01-28,636785,4953,479851,3699,156934,1254,520731,3923,2556241,4840,3076972,8763,38,8386,42,16718,8757,34,"East TN",2455501,1628.30314465358,0.47084135597176,356.872182092371,201.71036379134,47.084135597176
2022-01-29,640848,4063,483119,3268,157729,795,524276,3545,2561672,5431,3085948,8976,5,8391,32,16750,8795,38,"East TN",2455501,1549.50048890226,0.462606176732397,365.54658295802,165.465214634407,46.2606176732397
2022-01-30,642913,2065,484627,1508,158286,557,525871,1595,2564149,2477,3090020,4072,17,8408,24,16774,8841,46,"East TN",2455501,1487.19141226169,0.45530896635856,165.831738614645,84.096891021425,45.530896635856
2022-01-31,646825,3912,487095,2468,159730,1444,528445,2574,2567080,2931,3095525,5505,68,8476,38,16812,8879,38,"East TN",2455501,1374.13912680141,0.452139630112185,224.190501245978,159.315756743736,45.2139630112185
2022-02-01,651781,4956,490613,3518,161168,1438,532347,3902,2572339,5259,3104686,9161,28,8504,40,16852,8911,32,"East TN",2455501,1343.88053598838,0.444171076134947,373.080686996259,201.83253845142,44.4171076134947
2022-02-02,656491,4710,494124,3511,162367,1199,536101,3754,2577238,4899,3113339,8653,21,8525,48,16900,8953,42,"East TN",2455501,1299.5311343795,0.435334793920307,352.392444556121,191.814216324897,43.5334793920307
2022-02-03,665418,8927,496803,2679,168615,6248,538929,2828,2581591,4353,3120520,7181,26,8551,41,16941,8981,28,"East TN",2455501,1367.78604447728,0.42287472998031,292.445411343754,363.551063510054,42.287472998031
2022-02-04,668949,3531,499325,2522,169624,1009,541676,2747,2586181,4590,3127857,7337,12,8563,38,16979,9010,29,"East TN",2455501,1309.87525559957,0.411614424683109,298.798493667891,143.799574913633,41.1614424683109
2022-02-05,670626,1677,500509,1184,170117,493,543013,1337,2588804,2623,3131817,3960,3,8566,26,17005,9054,44,"East TN",2455501,1212.70567594963,0.408489393708169,161.270551305009,68.2956349844696,40.8489393708169
2022-02-06,671931,1305,501455,946,170476,359,544099,1086,2591457,2653,3135556,3739,1,8567,36,17041,9086,32,"East TN",2455501,1181.75476206281,0.400298664792691,152.270351345815,53.1459771346051,40.0298664792692
2022-02-07,674740,2809,503288,1833,171452,976,546074,1975,2594343,2886,3140417,4861,50,8617,46,17087,9118,32,"East TN",2455501,1136.83521204023,0.392698030829546,197.963674215567,114.396206721154,39.2698030829546
2022-02-08,677399,2659,504994,1706,172405,953,547963,1889,2597011,2668,3144974,4557,21,8638,43,17130,9155,37,"East TN",2455501,1043.29014730599,0.387609213661636,185.58330866084,108.287473717176,38.7609213661636
2022-02-09,680302,2903,507072,2078,173230,825,550276,2313,2600682,3671,3150958,5984,26,8664,28,17158,9188,33,"East TN",2455501,969.700277051404,0.37680427443579,243.697721972013,118.224346070313,37.680427443579
2022-02-10,682806,2504,508850,1778,173956,726,552248,1972,2603891,3209,3156139,5181,28,8692,30,17188,9226,38,"East TN",2455501,708.124329821083,0.373929644290968,210.995637957386,101.975116279733,37.3929644290968
2022-02-11,685100,2294,510574,1724,174526,570,554145,1897,2607255,3364,3161400,5261,31,8723,41,17229,9257,31,"East TN",2455501,657.747644981615,0.371731806934383,214.253628892841,93.4228900741641,37.1731806934383
2022-02-12,686031,931,511259,685,174772,246,554925,780,2609758,2503,3164683,3283,3,8726,17,17246,9300,43,"East TN",2455501,627.366879508499,0.362441428832228,133.699803013723,37.9148695113543,36.2441428832228
2022-02-13,686607,576,511675,416,174932,160,555409,484,2611158,1400,3166567,1884,35,8761,11,17257,9324,24,"East TN",2455501,597.678437109168,0.36470929670117,76.7256865299587,23.457534735274,36.470929670117
2022-02-14,688846,2239,513103,1428,175743,811,557027,1618,2614166,3008,3171193,4626,146,8907,26,17283,9356,32,"East TN",2455501,574.465251694053,0.355894203275279,188.393325842669,91.183021306039,35.5894203275279
2022-02-15,690735,1889,514497,1394,176238,495,558562,1535,2617031,2865,3175593,4400,37,8944,30,17313,9386,30,"East TN",2455501,543.107088940302,0.346157614553055,179.18950145001,76.9293109634246,34.6157614553055
2022-02-16,692500,1765,515731,1234,176769,531,559933,1371,2620236,3205,3180169,4576,14,8958,20,17333,9408,22,"East TN",2455501,496.762167883458,0.330594639005854,186.35708150801,71.8794250134698,33.0594639005854
2022-02-17,694270,1770,516982,1251,177288,519,561315,1382,2623758,3522,3185073,4904,13,8971,23,17356,9432,24,"East TN",2455501,466.870101050661,0.313368355567844,199.714844343374,72.0830494469357,31.3368355567844
2022-02-18,695447,1177,517706,724,177741,453,562151,836,2626723,2965,3188874,3801,8,8979,10,17366,9460,28,"East TN",2455501,421.380402614375,0.291402780810949,154.795294320792,47.9331916378776,29.1402780810949
2022-02-19,695982,535,518049,343,177933,192,562563,412,2628824,2101,3191387,2513,1,8980,15,17381,9494,34,"East TN",2455501,405.253347483874,0.286024565608149,102.341640259971,21.7878143808534,28.6024565608149
2022-02-20,696350,368,518281,232,178069,136,562835,272,2630259,1435,3193094,1707,8,8988,5,17386,9510,16,"East TN",2455501,396.782571051692,0.279941191993064,69.5173815852651,14.9867583030917,27.9941191993064
2022-02-21,697071,721,518690,409,178381,312,563280,445,2631810,1551,3195090,1996,7,8995,14,17400,9530,20,"East TN",2455501,334.962193051438,0.261664644097585,81.2868738395953,29.3626433057857,26.1664644097586
2022-02-22,698245,1174,519341,651,178904,523,564007,727,2634160,2350,3198167,3077,44,9039,23,17423,9549,19,"East TN",2455501,305.843899065812,0.241206697971117,125.310476354927,47.811016977798,24.1206697971117
2022-02-23,699106,861,519812,471,179294,390,564539,532,2636757,2597,3201296,3129,79,9118,10,17433,9577,28,"East TN",2455501,269.028601495174,0.218014862498225,127.428170462973,35.0641274428314,21.8014862498225
2022-02-24,699962,856,520299,487,179663,369,565106,567,2639259,2502,3204365,3069,50,9168,13,17446,9598,21,"East TN",2455501,231.806055057603,0.196506323864814,124.984677261382,34.8605030093655,19.6506323864814
2022-02-25,700726,764,520752,453,179974,311,565612,506,2641637,2378,3207249,2884,5,9173,25,17471,9614,16,"East TN",2455501,214.986676853318,0.188353741496599,117.450573223143,31.1138134335926,18.8353741496599
2022-02-26,700981,255,520932,180,180049,75,565829,217,2643373,1736,3209202,1953,0,9173,6,17477,9632,18,"East TN",2455501,203.583708579227,0.18332865562728,79.5357037117883,10.3848461067619,18.332865562728
2022-02-27,701004,23,520954,22,180050,1,565859,30,2643729,356,3209588,386,4,9177,2,17479,9653,21,"East TN",2455501,189.533622670078,0.183339396144052,15.719806263569,0.936672393943232,18.3339396144052
2022-02-28,701868,864,521412,458,180456,406,566372,513,2646417,2688,3212789,3201,27,9204,19,17498,9674,21,"East TN",2455501,195.357281467204,0.174699135544381,130.360362304882,35.186302102911,17.4699135544381
2022-03-01,702630,762,521774,362,180856,400,566775,403,2648636,2219,3215411,2622,28,9232,17,17515,9690,16,"East TN",2455501,178.578628149612,0.160519601020645,106.780652909528,31.0323636602062,16.0519601020645
2022-03-02,703086,456,522037,263,181049,193,567085,310,2650949,2313,3218034,2623,8,9240,11,17526,9713,23,"East TN",2455501,162.085049038872,0.152108973593022,106.821377796222,18.5705483320919,15.2108973593022
2022-03-03,703441,355,522223,186,181218,169,567306,221,2652905,1956,3220211,2177,15,9255,11,17537,9729,16,"East TN",2455501,141.681880805587,0.138836299381547,88.6580783310616,14.4573347760803,13.8836299381547
2022-03-04,703777,336,522436,213,181341,123,567571,265,2655147,2242,3222718,2507,10,9265,10,17547,9739,10,"East TN",2455501,124.251629300904,0.126640377529252,102.097290939812,13.6835619289098,12.6640377529252
2022-03-05,703919,142,522538,102,181381,40,567687,116,2656859,1712,3224546,1828,0,9265,7,17554,9756,17,"East TN",2455501,119.649717104575,0.121089676746611,74.4450928751403,5.78293391043213,12.1089676746611
2022-03-06,704018,99,522597,59,181421,40,567759,72,2658070,1211,3225829,1283,2,9267,4,17558,9766,10,"East TN",2455501,122.744808493257,0.116987870205037,52.2500296273551,4.03176378262522,11.6987870205037
2022-03-07,704288,270,522773,176,181515,94,567974,215,2659778,1708,3227752,1923,13,9280,12,17570,9777,11,"East TN",2455501,98.5542257975053,0.107064091425516,78.3139571109928,10.9957194071597,10.7064091425516
2022-03-08,704550,262,522872,99,181678,163,568097,123,2661530,1752,3229627,1875,27,9307,9,17579,9793,16,"East TN",2455501,78.1917824509133,0.0929938097917839,76.35916254972,10.6699203136142,9.29938097917839
2022-03-09,704843,293,522999,127,181844,166,568246,149,2663541,2011,3231787,2160,23,9330,7,17586,9803,10,"East TN",2455501,71.5536259199243,0.0844179451755981,87.9657552572774,11.9323918011029,8.44179451755981
2022-03-10,705029,186,523098,99,181931,87,568375,129,2665637,2096,3234012,2225,75,9405,3,17589,9812,9,"East TN",2455501,64.6711200687762,0.0774581552061445,90.6128728923344,7.57482892493222,7.74581552061445
2022-03-11,705240,211,523189,91,182051,120,568479,104,2667827,2190,3236306,2294,79,9484,5,17594,9828,16,"East TN",2455501,59.5805092321282,0.066823667942302,93.4228900741641,8.59295109226182,6.6823667942302
2022-03-12,705309,69,523224,35,182085,34,568520,41,2669112,1285,3237632,1326,0,9484,3,17597,9837,9,"East TN",2455501,56.6075925035258,0.0636558153752101,54.001199755162,2.8100171818297,6.36558153752101
2022-03-13,705400,91,523277,53,182123,38,568590,70,2670721,1609,3239311,1679,4,9488,5,17602,9843,6,"East TN",2455501,56.2817934099803,0.0616377392078327,68.3770847578559,3.70596468907974,6.16377392078327
2022-03-14,705557,157,523360,83,182197,74,568696,106,2671806,1085,3240502,1191,69,9557,3,17605,9854,11,"East TN",2455501,51.6798812136505,0.0566274509803922,48.5033400515821,6.39380721082989,5.66274509803922
2022-03-15,705743,186,523439,79,182304,107,568787,91,2673240,1434,3242027,1525,4,9561,1,17606,9862,8,"East TN",2455501,48.5847898249685,0.0556451612903226,62.1054522071056,7.57482892493222,5.56451612903226
2022-03-16,705898,155,523531,92,182367,63,568896,109,2674807,1567,3243703,1676,10,9571,5,17611,9868,6,"East TN",2455501,42.9647554613091,0.0545485062101376,68.2549100977764,6.31235743744352,5.45485062101376
2022-03-17,706039,141,523626,95,182413,46,569012,116,2676106,1299,3245118,1415,7,9578,1,17612,9877,9,"East TN",2455501,41.1321355601158,0.0573563839366108,57.6257146708554,5.74220902373894,5.73563839366108
2022-03-18,706182,143,523714,88,182468,55,569106,94,2677598,1492,3246704,1586,2,9580,1,17613,9888,11,"East TN",2455501,38.3628432649793,0.0603000577034045,64.5896702953898,5.82365879712531,6.03000577034045
2022-03-19,706255,73,523772,58,182483,15,569172,66,2678771,1173,3247943,1239,0,9580,1,17614,9893,5,"East TN",2455501,38.5257428117521,0.0632334400155174,50.458134612855,2.97291672860243,6.32334400155174
2022-03-20,706321,66,523821,49,182500,17,569230,58,2679426,655,3248656,713,3,9583,0,17614,9899,6,"East TN",2455501,37.5076206444225,0.06848582129481,29.0368442122402,2.68784252175014,6.848582129481
2022-03-21,706418,97,523887,66,182531,31,569308,78,2680314,888,3249622,966,16,9599,1,17615,9905,6,"East TN",2455501,35.0641274428314,0.0671052631578947,39.3402405456157,3.95031400923885,6.71052631578947
2022-03-22,706502,84,523942,55,182560,29,569371,63,2681318,1004,3250689,1067,2,9601,5,17620,9912,7,"East TN",2455501,30.9101890001267,0.0674209189563611,43.4534541016273,3.42089048222746,6.74209189563611
2022-03-23,706597,95,524015,73,182582,22,569450,79,2682761,1443,3252211,1522,11,9612,0,17620,9922,10,"East TN",2455501,28.4666957985356,0.0651151857075693,61.983277547026,3.86886423585248,6.51151857075693
2022-03-24,706700,103,524049,34,182651,69,569493,43,2683845,1084,3253338,1127,5,9617,0,17620,9930,8,"East TN",2455501,26.9191501041946,0.0585158150851582,45.8969473032184,4.19466332939795,5.85158150851581
2022-03-25,706764,64,524095,46,182669,18,569550,57,2685299,1454,3254849,1511,0,9617,2,17622,9934,4,"East TN",2455501,23.7018840554331,0.05451197053407,61.535303793401,2.60639274836378,5.451197053407
2022-03-26,706805,41,524128,33,182677,8,569589,39,2686296,997,3255885,1036,0,9617,1,17623,9943,9,"East TN",2455501,22.3986876812512,0.0525056660790733,42.1909826141386,1.66972035442054,5.25056660790733
2022-03-27,706826,21,524143,15,182683,6,569606,17,2686742,446,3256348,463,2,9619,3,17626,9947,4,"East TN",2455501,20.5660677800579,0.0488819552782111,18.8556225389442,0.855222620556864,4.88819552782111
2022-03-28,706939,113,524192,49,182747,64,569668,62,2688164,1422,3257832,1484,30,9649,2,17628,9953,6,"East TN",2455501,21.2176659671489,0.0438489646772229,60.435731852685,4.60191219632979,4.38489646772229
2022-03-29,707053,114,524247,55,182806,59,569728,60,2689274,1110,3259002,1170,6,9655,0,17628,9964,11,"East TN",2455501,22.4394125679444,0.0429447852760736,47.6481174310253,4.64263708302298,4.29447852760736
2022-03-30,707152,99,524305,58,182847,41,569792,64,2690654,1380,3260446,1444,6,9661,4,17632,9970,6,"East TN",2455501,22.6023121147171,0.0415300546448087,58.8067363849577,4.03176378262522,4.15300546448087
2022-03-31,707236,84,524360,55,182876,29,569859,67,2691837,1183,3261696,1250,8,9669,0,17632,9971,1,"East TN",2455501,21.8285392675466,0.0437903804737976,50.90610836648,3.42089048222746,4.37903804737976
2022-04-01,707332,96,524413,53,182919,43,569922,63,2693114,1277,3263036,1340,15,9684,0,17632,9974,3,"East TN",2455501,23.1317356417285,0.0454378893367534,54.5713481688666,3.90958912254566,4.54378893367534
2022-04-02,707418,86,524439,26,182979,60,569953,31,2693916,802,3263869,833,0,9684,1,17633,9979,5,"East TN",2455501,24.9643555429218,0.0455911823647295,33.9238306154223,3.50234025561382,4.55911823647295
2022-04-03,707442,24,524451,12,182991,12,569970,17,2694396,480,3264366,497,10,9694,0,17633,9982,3,"East TN",2455501,25.0865302030013,0.0453978548266401,20.2402686865124,0.977397280636416,4.53978548266401
2022-04-04,707532,90,524502,51,183030,39,570029,59,2695404,1008,3265433,1067,51,9745,4,17637,9984,2,"East TN",2455501,24.1498578090581,0.0474937508222602,43.4534541016273,3.66523980238656,4.74937508222602
2022-04-05,707628,96,524542,40,183086,56,570078,49,2696419,1015,3266497,1064,36,9781,1,17638,9988,4,"East TN",2455501,23.4168098485808,0.0466977985323549,43.3312794415478,3.90958912254566,4.66977985323549
2022-04-06,707727,99,524596,54,183131,45,570140,62,2697586,1167,3267726,1229,0,9781,0,17638,9993,5,"East TN",2455501,23.4168098485808,0.0478021978021978,50.0508857459231,4.03176378262522,4.78021978021978
2022-04-07,707911,184,524642,46,183269,138,570194,54,2698699,1113,3268893,1167,53,9834,1,17639,9993,0,"East TN",2455501,27.4892985178992,0.0465471724329582,47.5259427709457,7.49337915154586,4.65471724329582
2022-04-08,707980,69,524693,51,183287,18,570249,55,2699918,1219,3270167,1274,6,9840,0,17639,9995,2,"East TN",2455501,26.3897265771832,0.0458561211611275,51.8835056471164,2.8100171818297,4.58561211611275
2022-04-09,708034,54,524723,30,183311,24,570290,41,2700779,861,3271069,902,0,9840,0,17639,9998,3,"East TN",2455501,25.0865302030013,0.0468055555555556,36.733847797252,2.19914388143194,4.68055555555556
2022-04-10,708100,66,524758,35,183342,31,570332,42,2701412,633,3271744,675,1,9841,1,17640,9999,1,"East TN",2455501,26.7969754441151,0.0490647872052047,27.4892985178992,2.68784252175014,4.90647872052047
2022-04-11,708204,104,524824,66,183380,38,570407,75,2702319,907,3272726,982,5,9846,2,17642,10003,4,"East TN",2455501,27.3671238578196,0.0518305224187577,39.9918387327067,4.23538821609114,5.18305224187577
2022-04-12,708295,91,524880,56,183415,35,570476,69,2703332,1013,3273808,1082,26,9872,2,17644,10007,4,"East TN",2455501,27.1634994243537,0.0544385173026946,44.0643274020251,3.70596468907974,5.44385173026946
2022-04-13,708419,124,524959,79,183460,45,570561,85,2704525,1193,3275086,1278,0,9872,1,17645,10011,4,"East TN",2455501,28.1816215916833,0.0572010869565217,52.0464051938891,5.04988594995482,5.72010869565217
2022-04-14,708522,103,525006,47,183516,56,570613,52,2705559,1034,3276172,1086,3,9875,1,17646,10014,3,"East TN",2455501,24.8829057695354,0.0575628520401154,44.2272269487978,4.19466332939795,5.75628520401154
2022-04-15,708598,76,525057,51,183541,25,570675,62,2706592,1033,3277267,1095,1,9876,1,17647,10015,1,"East TN",2455501,25.1679799763877,0.06,44.5937509290365,3.09509138868198,6
2022-04-16,708658,60,525103,46,183555,14,570728,53,2707336,744,3278064,797,0,9876,1,17648,10016,1,"East TN",2455501,25.4123292965468,0.0626161543959971,32.4577346944676,2.44349320159104,6.26161543959971
2022-04-17,708696,38,525130,27,183566,11,570761,33,2707937,601,3278698,634,0,9876,0,17648,10018,2,"East TN",2455501,24.2720324691377,0.0616911130284728,25.8195781634787,1.54754569434099,6.16911130284728
2022-04-18,708928,232,525258,128,183670,104,570899,138,2708820,883,3279719,1021,-1,9875,2,17650,10018,0,"East TN",2455501,29.4848179658652,0.0703560703560704,41.5801093137409,9.44817371281869,7.03560703560704
2022-04-19,709044,116,525320,62,183724,54,570962,63,2709778,958,3280740,1021,2,9877,2,17652,10021,3,"East TN",2455501,30.5029401331948,0.0701096364685516,41.5801093137409,4.72408685640934,7.01096364685516
2022-04-20,709184,140,525411,91,183773,49,571063,101,2711207,1429,3282270,1530,8,9885,1,17653,10023,2,"East TN",2455501,31.1545383202858,0.0698775055679287,62.3090766405715,5.70148413704576,6.98775055679287
2022-04-21,709302,118,525491,80,183811,38,571151,88,2712349,1142,3283500,1230,5,9890,1,17654,10026,3,"East TN",2455501,31.7654116206835,0.0734170305676856,50.0916106326163,4.80553662979571,7.34170305676856
2022-04-22,709425,123,525575,84,183850,39,571241,90,2713429,1080,3284670,1170,3,9893,0,17654,10029,3,"East TN",2455501,33.6794812952632,0.0764554910171552,47.6481174310253,5.00916106326163,7.64554910171552
2022-04-23,709500,75,525622,47,183878,28,571289,48,2714286,857,3285575,905,0,9893,0,17654,10030,1,"East TN",2455501,34.2903545956609,0.0746904540007988,36.8560224573315,3.0543665019888,7.46904540007988
2022-04-24,709571,71,525662,40,183909,31,571335,46,2714953,667,3286288,713,2,9895,1,17655,10035,5,"East TN",2455501,35.634275856536,0.0756258234519104,29.0368442122402,2.89146695521606,7.56258234519104
2022-04-25,709760,189,525761,99,183999,90,571433,98,2715688,735,3287121,833,0,9895,5,17660,10038,3,"East TN",2455501,33.8831057287291,0.0721426641448257,33.9238306154223,7.69700358501178,7.21426641448257
2022-04-26,709935,175,525874,113,184061,62,571554,121,2716923,1235,3288477,1356,0,9895,0,17660,10043,5,"East TN",2455501,36.2858740436269,0.0765154452630218,55.2229463559575,7.1268551713072,7.65154452630218
2022-04-27,710127,192,525973,99,184154,93,571656,102,2718118,1195,3289774,1297,0,9895,2,17662,10046,3,"East TN",2455501,38.4035681516725,0.0790245202558635,52.8201780410596,7.81917824509133,7.90245202558635
2022-04-28,710279,152,526062,89,184217,63,571755,99,2719279,1161,3291034,1260,4,9899,1,17663,10051,5,"East TN",2455501,39.7882142992408,0.080169896469339,51.3133572334118,6.19018277736397,8.0169896469339
2022-04-29,710417,138,526148,86,184269,52,571847,92,2720441,1162,3292288,1254,2,9901,0,17663,10053,2,"East TN",2455501,40.3990875996385,0.0795484379102127,51.0690079132527,5.62003436365939,7.95484379102127
2022-04-30,710492,75,526204,56,184288,19,571909,62,2721171,730,3293080,792,0,9901,0,17663,10053,0,"East TN",2455501,40.3990875996385,0.0826115922718188,32.2541102610017,3.0543665019888,8.26115922718188
2022-05-01,710548,56,526237,33,184311,23,571942,33,2721664,493,3293606,526,0,9901,0,17663,10056,3,"East TN",2455501,39.7882142992408,0.0829461601530473,21.4212904006148,2.2805936548183,8.29461601530473
2022-05-02,710733,185,526366,129,184367,56,572088,146,2722690,1026,3294778,1172,6,9907,2,17665,10057,1,"East TN",2455501,39.625314752468,0.085542640720909,47.7295672044116,7.53410403823904,8.5542640720909
2022-05-03,710917,184,526474,108,184443,76,572208,120,2723637,947,3295845,1067,2,9909,1,17666,10058,1,"East TN",2455501,39.9918387327067,0.0887622149837134,43.4534541016273,7.49337915154586,8.87622149837133
2022-05-04,711180,263,526642,168,184538,95,572384,176,2724912,1275,3297296,1451,3,9912,2,17668,10058,0,"East TN",2455501,42.8833056879227,0.0967827705397501,59.09181059181,10.7106452003074,9.67827705397501
2022-05-05,711398,218,526785,143,184613,75,572535,151,2726033,1121,3298568,1272,1,9913,2,17670,10060,2,"East TN",2455501,45.5711482096729,0.103530661003451,51.80205587373,8.87802529911411,10.3530661003451
2022-05-06,711620,222,526927,142,184693,80,572688,153,2727251,1218,3299939,1371,1,9914,2,17672,10063,3,"East TN",2455501,48.9920386919003,0.109920271859888,55.8338196563553,9.04092484588685,10.9920271859888
2022-05-07,711738,118,527005,78,184733,40,572780,92,2728123,872,3300903,964,0,9914,2,17674,10064,1,"East TN",2455501,50.7432088197073,0.11133836124249,39.2587907722294,4.80553662979571,11.133836124249
2022-05-08,711848,110,527085,80,184763,30,572865,85,2728774,651,3301639,736,0,9914,1,17675,10065,1,"East TN",2455501,52.9423527011392,0.114901033237894,29.9735166061834,4.47973753625024,11.4901033237894
2022-05-09,712078,230,527215,130,184863,100,573003,138,2729756,982,3302759,1120,13,9927,2,17677,10066,1,"East TN",2455501,54.7749726023325,0.114647287307355,45.6118730963661,9.36672393943232,11.4647287307355
2022-05-10,712372,294,527385,170,184987,124,573185,182,2731267,1511,3304452,1693,9,9936,4,17681,10068,2,"East TN",2455501,59.2547101385827,0.113512257464854,68.9472331715605,11.9731166877961,11.3512257464854
2022-05-11,712653,281,527581,196,185072,85,573395,210,2732352,1085,3305747,1295,1,9937,0,17681,10069,1,"East TN",2455501,59.98775809906,0.119630812921548,52.7387282676733,11.4436931607847,11.9630812921548
2022-05-12,712888,235,527745,164,185143,71,573572,177,2733628,1276,3307200,1453,2,9939,2,17683,10070,1,"East TN",2455501,60.6800811728442,0.120134383688601,59.1732603651963,9.57034837289824,12.0134383688601
2022-05-13,713167,279,527940,195,185227,84,573779,207,2734979,1351,3308758,1558,0,9939,0,17683,10072,2,"East TN",2455501,63.0013997143556,0.123710171221227,63.4493734679807,11.3622433873983,12.3710171221227
2022-05-14,713276,109,528019,79,185257,30,573862,83,2735706,727,3309568,810,0,9939,1,17684,10076,4,"East TN",2455501,62.634875734117,0.124870167339873,32.987158221479,4.43901264955706,12.4870167339873
2022-05-15,713460,184,528151,132,185309,52,574006,144,2736558,852,3310564,996,0,9939,3,17687,10079,3,"East TN",2455501,65.6485173494126,0.127843137254902,40.5619871464113,7.49337915154586,12.7843137254902
2022-05-16,713767,307,528345,194,185422,113,574204,198,2737917,1359,3312121,1557,2,9941,3,17690,10083,4,"East TN",2455501,68.7843336247878,0.128284554582354,63.4086485812875,12.5025402148075,12.8284554582354
2022-05-17,714179,412,528567,222,185612,190,574440,236,2739165,1248,3313605,1484,16,9957,0,17690,10086,3,"East TN",2455501,73.5898702545835,0.137113514694636,60.435731852685,16.7786533175918,13.7113514694636
2022-05-18,714543,364,528789,222,185754,142,574678,238,2740554,1389,3315232,1627,7,9964,3,17693,10087,1,"East TN",2455501,76.9700358501178,0.135266209804955,66.2593906498104,14.823858756319,13.5266209804955
2022-05-19,714963,420,529067,278,185896,142,574968,290,2741974,1420,3316942,1710,31,9995,4,17697,10089,2,"East TN",2455501,84.5041398883568,0.143297064257853,69.6395562453446,17.1044524111373,14.3297064257853
2022-05-20,715400,437,529336,269,186064,168,575249,281,2743374,1400,3318623,1681,0,9995,5,17702,10090,1,"East TN",2455501,90.9386719858799,0.149011657374557,68.4585345312423,17.7967754849214,14.9011657374557
2022-05-21,715615,215,529477,141,186138,74,575403,154,2744416,1042,3319819,1196,0,9995,4,17706,10091,1,"East TN",2455501,95.2555099753574,0.150326797385621,48.7069644850481,8.75585063903456,15.0326797385621
2022-05-22,715786,171,529610,133,186176,38,575546,143,2745431,1015,3320977,1158,5,10000,5,17711,10092,1,"East TN",2455501,94.726086448346,0.147892058004418,47.1594187907071,6.96395562453446,14.7892058004418
2022-05-23,716169,383,529855,245,186314,138,575793,247,2746623,1192,3322416,1439,6,10006,4,17715,10095,3,"East TN",2455501,97.821177837028,0.154346770276833,58.6031119514918,15.5976316034895,15.4346770276833
2022-05-24,716739,570,530156,301,186583,269,576107,314,2748061,1438,3324168,1752,0,10006,3,17718,10096,1,"East TN",2455501,104.255709934551,0.157815014673862,71.3500014864584,23.2131854151149,15.7815014673862
2022-05-25,717215,476,530482,326,186733,150,576460,353,2749547,1486,3326007,1839,18,10024,2,17720,10098,2,"East TN",2455501,108.816897244188,0.16538283062645,74.8930666287654,19.3850460659556,16.538283062645
2022-05-26,717707,492,530785,303,186922,189,576776,316,2751045,1498,3327821,1814,12,10036,3,17723,10104,6,"East TN",2455501,111.749089086097,0.16619174556485,73.8749444614358,20.0366442530465,16.619174556485
2022-05-27,718124,417,531055,270,187069,147,577053,277,2752995,1950,3330048,2227,4,10040,5,17728,10105,1,"East TN",2455501,110.934591352233,0.157899343544858,90.6943226657208,16.9822777510577,15.7899343544858
2022-05-28,718408,284,531273,218,187135,66,577280,227,2754055,1060,3331335,1287,0,10040,0,17728,10107,2,"East TN",2455501,113.744608534063,0.162990621743661,52.4129291741278,11.5658678208643,16.2990621743661
2022-05-29,718660,252,531422,149,187238,103,577440,160,2754943,888,3332383,1048,0,10040,2,17730,10111,4,"East TN",2455501,117.043324356211,0.166052954585306,42.6796812544568,10.2626714466824,16.6052954585306
2022-05-30,718872,212,531564,142,187308,70,577592,152,2755654,711,3333246,863,0,10040,5,17735,10111,0,"East TN",2455501,110.079368731676,0.166112650046168,35.1455772162178,8.63367597895501,16.6112650046168
2022-05-31,719390,518,531861,297,187529,221,577891,299,2756581,927,3334472,1226,2,10042,4,17739,10111,0,"East TN",2455501,107.961674623631,0.173136645962733,49.9287110858436,21.0954913070693,17.3136645962733
2022-06-01,720059,669,532256,395,187803,274,578324,433,2757939,1358,3336263,1791,1,10043,5,17744,10112,1,"East TN",2455501,115.821577755415,0.181747269890796,72.9382720674925,27.2449491977401,18.1747269890796
2022-06-02,720624,565,532644,388,187980,177,578742,418,2759472,1533,3338214,1951,0,10043,3,17747,10113,1,"East TN",2455501,118.794494484018,0.189165784662754,79.454253938402,23.009560981649,18.9165784662754
2022-06-03,721251,627,533045,401,188206,226,579167,425,2761031,1559,3340198,1984,1,10044,4,17751,10116,3,"East TN",2455501,127.346720689586,0.208275862068966,80.798175199277,25.5345039566264,20.8275862068966
2022-06-04,721560,309,533290,245,188270,64,579433,266,2762187,1156,3341620,1422,0,10044,1,17752,10118,2,"East TN",2455501,128.364842856916,0.209333981526495,57.9107888777077,12.5839899881939,20.9333981526495
2022-06-05,721894,334,533521,231,188373,103,579677,244,2763181,994,3342858,1238,3,10047,3,17755,10118,0,"East TN",2455501,131.704283565757,0.213556085918854,50.4174097261618,13.6021121555235,21.3556085918854
2022-06-06,722439,545,533828,307,188611,238,579997,320,2764273,1092,3344270,1412,0,10047,4,17759,10120,2,"East TN",2455501,145.265670834587,0.218160377358491,57.5035400107758,22.1950632477853,21.8160377358491
2022-06-07,723081,642,534182,354,188899,288,580358,361,2765326,1053,3345684,1414,3,10050,6,17765,10121,1,"East TN",2455501,150.315556784542,0.220032108455227,57.5849897841622,26.1453772570241,22.0032108455227
2022-06-08,723724,643,534606,424,189118,219,580817,459,2766939,1613,3347756,2072,0,10050,4,17769,10122,1,"East TN",2455501,149.256709730519,0.216914643696163,84.3819652282772,26.1861021437173,21.6914643696163
2022-06-09,724339,615,535008,402,189331,213,581243,426,2768428,1489,3349671,1915,10,10060,3,17772,10126,4,"East TN",2455501,151.292954065179,0.218294492450031,77.9881580174473,25.0458053163082,21.8294492450031
2022-06-10,724955,616,535372,364,189583,252,581639,396,2770116,1688,3351755,2084,1,10061,2,17774,10127,1,"East TN",2455501,150.844980311554,0.213896339880592,84.8706638685955,25.0865302030013,21.3896339880592
2022-06-11,725324,369,535674,302,189650,67,581979,340,2771210,1094,3353189,1434,0,10061,6,17780,10129,2,"East TN",2455501,153.288473513145,0.220070879073386,58.3994875180259,15.0274831897849,22.0070879073386
2022-06-12,725639,315,535829,155,189810,160,582144,165,2771772,562,3353916,727,2,10063,3,17783,10134,5,"East TN",2455501,152.514700665974,0.223096400795804,29.6069926259448,12.828339308353,22.3096400795804
2022-06-13,726222,583,536157,328,190065,255,582479,335,2772544,772,3355023,1107,5,10068,7,17790,10139,5,"East TN",2455501,154.062246360315,0.230819306240119,45.0824495693547,23.7426089421263,23.0819306240119
2022-06-14,726928,706,536544,387,190384,319,582898,419,2773830,1286,3356728,1705,3,10071,5,17795,10141,2,"East TN",2455501,156.668639108679,0.229989134371604,69.4359318118787,28.7517700053879,22.9989134371604
2022-06-15,727635,707,537005,461,190630,246,583387,489,2775272,1442,3358659,1931,11,10082,11,17806,10146,5,"East TN",2455501,159.275031857043,0.23571494084197,78.6397562045383,28.7924948920811,23.571494084197
2022-06-16,728304,669,537438,433,190866,236,583837,450,2776575,1303,3360412,1753,6,10088,4,17810,10148,2,"East TN",2455501,161.474175738475,0.241504515408249,71.3907263731516,27.2449491977401,24.1504515408249
2022-06-17,728887,583,537787,349,191100,234,584215,378,2777812,1237,3362027,1615,7,10095,5,17815,10153,5,"East TN",2455501,160.1302544776,0.250778816199377,65.7706920094922,23.7426089421263,25.0778816199377
2022-06-18,729240,353,538066,279,191174,74,584516,301,2778786,974,3363302,1275,0,10095,6,17821,10154,1,"East TN",2455501,159.478656290509,0.250865222980322,51.9242305338096,14.375885002694,25.0865222980322
2022-06-19,729632,392,538293,227,191339,165,584761,245,2779649,863,3364410,1108,1,10096,2,17823,10155,1,"East TN",2455501,162.614472565884,0.249380598437202,45.1231744560479,15.9641555837281,24.9380598437202
2022-06-20,730279,647,538648,355,191631,292,585129,368,2780475,826,3365604,1194,1,10097,7,17830,10158,3,"East TN",2455501,165.220865314247,0.250448917871657,48.6255147116617,26.34900169049,25.0448917871657
2022-06-21,731122,843,539104,456,192018,387,585609,480,2781467,992,3367076,1472,1,10098,5,17835,10158,0,"East TN",2455501,170.800174791214,0.261982991882489,59.9470332123668,34.3310794823541,26.1982991882489
2022-06-22,732072,950,539753,649,192319,301,586295,686,2783047,1580,3369342,2266,0,10098,5,17840,10160,2,"East TN",2455501,180.696322257657,0.272208181222503,92.2825932467549,38.6886423585248,27.2208181222503
2022-06-23,732912,840,540290,537,192622,303,586852,557,2784444,1397,3371296,1954,1,10099,5,17845,10165,5,"East TN",2455501,187.660277882192,0.277012127894157,79.5764285984815,34.2089048222746,27.7012127894157
2022-06-24,733643,731,540784,494,192859,237,587382,530,2786083,1639,3373465,2169,0,10099,9,17854,10170,5,"East TN",2455501,193.687561112783,0.276884070641721,88.3322792375161,29.7698921727175,27.6884070641721
2022-06-25,734100,457,541041,257,193059,200,587667,285,2787091,1008,3374758,1293,1,10100,2,17856,10171,1,"East TN",2455501,197.922949328874,0.275052374301676,52.6572784942869,18.6112732187851,27.5052374301676
2022-06-26,734552,452,541318,277,193234,175,587953,286,2787996,905,3375949,1191,1,10101,4,17860,10172,1,"East TN",2455501,200.366442530465,0.276627090735766,48.5033400515821,18.4076487853192,27.6627090735766
2022-06-27,735305,753,541741,423,193564,330,588390,437,2788938,942,3377328,1379,8,10109,7,17867,10174,2,"East TN",2455501,204.683280519943,0.278147389969294,56.1596187499007,30.6658396799676,27.8147389969294
2022-06-28,736283,978,542330,589,193953,389,589004,614,2790248,1310,3379252,1924,3,10112,7,17874,10177,3,"East TN",2455501,210.181140223523,0.278827201051248,78.354681997686,39.828939185934,27.8827201051248
2022-06-29,737262,979,542880,550,194382,429,589588,584,2791691,1443,3381279,2027,16,10128,5,17879,10182,5,"East TN",2455501,211.362161937625,0.275864957694563,82.549345327084,39.8696640726271,27.5864957694563
2022-06-30,738160,898,543385,505,194775,393,590131,543,2793117,1426,3383248,1969,2,10130,5,17884,10186,4,"East TN",2455501,213.72420536583,0.274347389558233,80.1873018988793,36.5709482504792,27.4347389558233
2022-07-01,738978,818,543898,513,195080,305,590659,528,2794611,1494,3385270,2022,1,10131,7,17891,10189,3,"East TN",2455501,217.267270508137,0.277594239728928,82.345720893618,33.3129573150245,27.7594239728928
2022-07-02,739466,488,544196,298,195270,190,590984,325,2795589,978,3386573,1303,0,10131,3,17894,10196,7,"East TN",2455501,218.529741995625,0.280744815911976,53.0645273612188,19.8737447062738,28.0744815911976
2022-07-03,740021,555,544531,335,195490,220,591339,355,2796527,938,3387866,1293,0,10131,3,17897,10199,3,"East TN",2455501,222.724405325023,0.284131912394059,52.6572784942869,22.6023121147171,28.4131912394059
2022-07-04,740442,421,544791,260,195651,161,591609,270,2797173,646,3388782,916,1,10132,4,17901,10203,4,"East TN",2455501,209.203742942886,0.28103719224725,37.3039962109565,17.1451772978305,28.103719224725
2022-07-05,741333,891,545364,573,195969,318,592183,574,2798010,837,3390193,1411,2,10134,7,17908,10207,4,"East TN",2455501,205.660677800579,0.290558449867471,57.4628151240826,36.2858740436269,29.0558449867471
2022-07-06,742489,1156,546088,724,196401,432,592923,740,2799348,1338,3392271,2078,14,10148,15,17923,10211,4,"East TN",2455501,212.868982745273,0.303402474526929,84.6263145484363,47.0779690173207,30.3402474526929
2022-07-07,743545,1056,546686,598,196859,458,593541,618,2800868,1520,3394409,2138,0,10148,8,17931,10222,11,"East TN",2455501,219.303514842796,0.305528178478631,87.0698077500274,43.0054803480023,30.5528178478631
2022-07-08,744615,1070,547356,670,197259,400,594254,713,2802662,1794,3396916,2507,3,10151,7,17938,10226,4,"East TN",2455501,229.566186289478,0.308689678859694,102.097290939812,43.5756287617069,30.8689678859694
2022-07-09,745235,620,547697,341,197538,279,594600,346,2803435,773,3398035,1119,0,10151,3,17941,10229,3,"East TN",2455501,234.941871332978,0.315477229104868,45.5711482096729,25.2494297497741,31.5477229104868
2022-07-10,745635,400,547905,208,197730,192,594810,210,2804046,611,3398856,821,2,10153,5,17946,10235,6,"East TN",2455501,228.629513895535,0.315832575068244,33.4351319751041,16.2899546772736,31.5832575068244
2022-07-11,746821,1186,548567,662,198254,524,595506,696,2805476,1430,3400982,2126,6,10159,12,17958,10236,1,"East TN",2455501,259.784052215821,0.319426229508197,86.5811091097092,48.2997156181162,31.9426229508197
2022-07-12,747998,1177,549234,667,198764,510,596210,704,2806921,1445,3403131,2149,21,10180,6,17964,10241,5,"East TN",2455501,271.431369810071,0.311253671355696,87.5177815036524,47.9331916378776,31.1253671355696
2022-07-13,749297,1299,550015,781,199282,518,597026,816,2808499,1578,3405525,2394,1,10181,7,17971,10247,6,"East TN",2455501,277.255028607197,0.309566923192998,97.4953787434825,52.901627814446,30.9566923192998
2022-07-14,750397,1100,550658,643,199739,457,597697,671,2809850,1351,3407547,2022,1,10182,8,17979,10253,6,"East TN",2455501,279.046923621697,0.316334297457756,82.345720893618,44.7973753625024,31.6334297457756
2022-07-15,751454,1057,551300,642,200154,415,598358,661,2811413,1563,3409771,2224,0,10182,15,17994,10259,6,"East TN",2455501,278.517500094685,0.319253208868145,90.5721480056412,43.0462052346955,31.9253208868145
2022-07-16,752003,549,551602,302,200401,247,598672,314,2812132,719,3410804,1033,1,10183,6,18000,10269,10,"East TN",2455501,275.626033139469,0.31889732946981,42.0688079540591,22.357962794558,31.889732946981
2022-07-17,752359,356,551861,259,200498,97,598947,275,2812707,575,3411654,850,1,10184,4,18004,10276,7,"East TN",2455501,273.834138124969,0.323253633380216,34.6161536892064,14.4980596627735,32.3253633380216
2022-07-18,753949,1590,552712,851,201237,739,599867,920,2814320,1613,3414187,2533,5,10189,10,18014,10280,4,"East TN",2455501,290.286992349016,0.330253691783415,103.156137993835,64.7525698421626,33.0253691783415
2022-07-19,755335,1386,553521,809,201814,577,600694,827,2815674,1354,3416368,2181,17,10206,17,18031,10289,9,"East TN",2455501,298.798493667891,0.338747450328624,88.8209778778343,56.444692956753,33.8747450328624
2022-07-20,756580,1245,554264,743,202316,502,601463,769,2817161,1487,3418624,2256,14,10220,14,18045,10292,3,"East TN",2455501,296.599349786459,0.338728147186808,91.8753443798231,50.7024839330141,33.8728147186808
2022-07-21,757936,1356,555108,844,202828,512,602356,893,2818830,1669,3421186,2562,2,10222,11,18056,10302,10,"East TN",2455501,307.024920779914,0.341593958501356,104.337159707937,55.2229463559575,34.1593958501356
2022-07-22,759309,1373,555928,820,203381,553,603207,851,2820340,1510,3423547,2361,0,10222,5,18061,10308,6,"East TN",2455501,319.89398497496,0.351988966318235,96.1514574826074,55.9152694297416,35.1988966318235
2022-07-23,759823,514,556253,325,203570,189,603551,344,2821137,797,3424688,1141,0,10222,6,18067,10310,2,"East TN",2455501,318.468613940699,0.351411696917315,46.4670957169229,20.9325917602966,35.1411696917315
2022-07-24,760420,597,556680,427,203740,170,603995,444,2822017,880,3426012,1324,0,10222,8,18075,10315,5,"East TN",2455501,328.283311633756,0.351581000139295,53.9197499817756,24.3127573558308,35.1581000139295
2022-07-25,761817,1397,557452,772,204365,625,604815,820,2823255,1238,3428070,2058,3,10225,9,18084,10319,4,"East TN",2455501,320.423408501972,0.356407116617446,83.8118168145727,56.892666710378,35.6407116617446
2022-07-26,763351,1534,558471,1019,204880,515,605869,1054,2824693,1438,3430562,2492,9,10234,13,18097,10329,10,"East TN",2455501,326.450691732563,0.364590672114978,101.486417639415,62.4719761873443,36.4590672114978
2022-07-27,764512,1161,559182,711,205330,450,606615,746,2825981,1288,3432596,2034,10,10244,4,18101,10330,1,"East TN",2455501,323.029801250335,0.3687374749499,82.8344195339362,47.2815934507866,36.87374749499
2022-07-28,765906,1394,560101,919,205805,475,607582,967,2827611,1630,3435193,2597,10,10254,6,18107,10334,4,"East TN",2455501,324.577346944676,0.373099164703363,105.762530742199,56.7704920502985,37.3099164703363
2022-07-29,767070,1164,560914,813,206156,351,608425,843,2829052,1441,3437477,2284,0,10254,14,18121,10340,6,"East TN",2455501,316.065845625801,0.374587221823403,93.0156412072322,47.4037681108662,37.4587221823403
2022-07-30,767629,559,561321,407,206308,152,608867,442,2830037,985,3438904,1427,0,10254,4,18125,10344,4,"East TN",2455501,317.898465526994,0.373944850872257,58.1144133111736,22.7652116614899,37.3944850872257
2022-07-31,768209,580,561713,392,206496,188,609295,428,2830816,779,3440111,1207,0,10254,7,18132,10350,6,"East TN",2455501,317.20614245321,0.375913185332293,49.1549382386731,23.6204342820467,37.5913185332293
2022-08-01,769218,1009,562269,556,206949,453,609889,594,2831594,778,3441483,1372,9,10263,8,18140,10353,3,"East TN",2455501,301.404886416255,0.378289718929397,55.8745445430484,41.0914106734227,37.8289718929397
2022-08-02,770730,1512,563230,961,207500,551,610888,999,2833222,1628,3444110,2627,12,10275,12,18152,10356,3,"East TN",2455501,300.508938909005,0.370460584588131,106.984277342994,61.5760286800942,37.0460584588131
2022-08-03,771888,1158,563996,766,207892,392,611691,803,2834766,1544,3446457,2347,1,10276,6,18158,10366,10,"East TN",2455501,300.386764248925,0.36620734434745,95.5813090689028,47.1594187907071,36.620734434745
2022-08-04,773135,1247,564829,833,208306,414,612562,871,2836198,1432,3448760,2303,8,10284,10,18168,10376,10,"East TN",2455501,294.400205905027,0.367067148227316,93.7894140544027,50.7839337064004,36.7067148227316
2022-08-05,774312,1177,565587,758,208725,419,613349,787,2837695,1497,3451044,2284,6,10290,4,18172,10384,8,"East TN",2455501,294.929629432038,0.362939485516326,93.0156412072322,47.9331916378776,36.2939485516326
2022-08-06,774794,482,565921,334,208873,148,613706,357,2838339,644,3452045,1001,0,10290,3,18175,10389,5,"East TN",2455501,291.793813156663,0.368236816071836,40.7656115798772,19.6293953861147,36.8236816071836
2022-08-07,775155,361,566181,260,208974,101,613976,270,2838947,608,3452923,878,3,10293,4,18179,10396,7,"East TN",2455501,282.875062970856,0.365360599438027,35.7564505166156,14.7016840962394,36.5360599438027
2022-08-08,776438,1283,566946,765,209492,518,614773,797,2840094,1147,3454867,1944,5,10298,9,18188,10402,6,"East TN",2455501,294.033681924788,0.364913329348476,79.1691797315497,52.2500296273551,36.4913329348476
2022-08-09,777958,1520,567976,1030,209982,490,615852,1079,2841784,1690,3457636,2769,19,10317,9,18197,10411,9,"East TN",2455501,294.359481018334,0.366996894869141,112.767211253426,61.9018277736397,36.6996894869141
2022-08-10,779226,1268,568822,846,210404,422,616735,883,2843303,1519,3460038,2402,14,10331,10,18207,10414,3,"East TN",2455501,298.839218554584,0.371401222295854,97.821177837028,51.6391563269573,37.1401222295855
2022-08-11,780297,1071,569555,733,210742,338,617494,759,2844427,1124,3461921,1883,2,10333,4,18211,10420,6,"East TN",2455501,291.671638496584,0.374743560519717,76.6849616432655,43.6163536484001,37.4743560519717
2022-08-12,781605,1308,570414,859,211191,449,618384,890,2846225,1798,3464609,2688,1,10334,12,18223,10424,4,"East TN",2455501,297.006598653391,0.371175820125323,109.468495431279,53.2681517946847,37.1175820125323
2022-08-13,782166,561,570831,417,211335,144,618843,459,2847162,937,3466005,1396,0,10334,3,18226,10434,10,"East TN",2455501,300.223864702152,0.36797994269341,56.8519418236849,22.8466614348762,36.797994269341
2022-08-14,782674,508,571223,392,211451,116,619258,415,2847901,739,3467159,1154,1,10335,4,18230,10439,5,"East TN",2455501,306.21042304605,0.371031188536106,46.9965192439343,20.6882424401375,37.1031188536106
2022-08-15,784278,1604,572175,952,212103,652,620235,977,2849020,1119,3469255,2096,8,10343,10,18240,10452,13,"East TN",2455501,319.283111674563,0.379621907144843,85.3593625089137,65.3227182558671,37.9621907144843
2022-08-16,785812,1534,573184,1009,212628,525,621289,1054,2850613,1593,3471902,2647,19,10362,11,18251,10455,3,"East TN",2455501,319.853260088267,0.381115939997196,107.798775076858,62.4719761873443,38.1115939997196
2022-08-17,787139,1327,574055,871,213084,456,622205,916,2852301,1688,3474506,2604,16,10378,12,18263,10463,8,"East TN",2455501,322.256028403165,0.378075753386785,106.047604949051,54.0419246418552,37.8075753386785
2022-08-18,791939,4800,575064,1009,216875,3791,623241,1036,2854161,1860,3477402,2896,0,10378,11,18274,10468,5,"East TN",2455501,474.119130882048,0.37122924875654,117.939271863461,195.479456127283,37.122924875654
2022-08-19,793295,1356,575889,825,217406,531,624089,848,2855904,1743,3479993,2591,2,10380,7,18281,10473,5,"East TN",2455501,476.073925443321,0.370839833593344,105.51818142204,55.2229463559575,37.0839833593344
2022-08-20,793731,436,576227,338,217504,98,624448,359,2856741,837,3481189,1196,0,10380,5,18286,10482,9,"East TN",2455501,470.983314606673,0.36913856691254,48.7069644850481,17.7560505982282,36.913856691254
2022-08-21,794395,664,576726,499,217669,165,624990,542,2857905,1164,3482895,1706,1,10381,5,18291,10488,6,"East TN",2455501,477.33639693081,0.364260294865277,69.4766566985719,27.0413247642742,36.4260294865277
2022-08-22,795965,1570,577553,827,218412,743,625835,845,2859356,1451,3485191,2296,1,10382,5,18296,10491,3,"East TN",2455501,475.951750783241,0.35140562248996,93.5043398475505,63.9380721082989,35.140562248996
2022-08-23,797842,1877,578647,1094,219195,783,627004,1169,2861619,2263,3488623,3432,20,10402,14,18310,10493,2,"East TN",2455501,489.920386919003,0.341785778362538,139.767811131007,76.4406123231064,34.1785778362538
2022-08-24,799616,1774,579612,965,220004,809,627990,986,2863682,2063,3491672,3049,6,10408,13,18323,10499,6,"East TN",2455501,508.124411270857,0.337003378771991,124.170179527518,72.2459489937084,33.7003378771991
2022-08-25,801047,1431,580431,819,220616,612,628848,858,2865654,1972,3494502,2830,15,10423,7,18330,10504,5,"East TN",2455501,370.92226800152,0.327894736842105,115.251429341711,58.2773128579463,32.7894736842105
2022-08-26,802272,1225,581175,744,221097,481,629632,784,2867571,1917,3497203,2701,5,10428,4,18334,10508,4,"East TN",2455501,365.587307844713,0.322080185938408,109.99791895829,49.8879861991504,32.2080185938408
2022-08-27,802984,712,581554,379,221430,333,630033,401,2868730,1159,3498763,1560,0,10428,4,18338,10511,3,"East TN",2455501,376.827376572032,0.317799021281438,63.530823241367,28.996119325547,31.7799021281438
2022-08-28,803481,497,581866,312,221615,185,630372,339,2869539,809,3499911,1148,3,10431,8,18346,10520,9,"East TN",2455501,370.02632049427,0.316290550070522,46.7521699237752,20.2402686865124,31.6290550070522
2022-08-29,804558,1077,582392,526,222166,551,630925,553,2870570,1031,3501495,1584,3,10434,9,18355,10530,10,"East TN",2455501,349.94895135453,0.312193326790972,64.5082205220035,43.8607029685592,31.2193326790972
2022-08-30,805825,1267,583115,723,222710,544,631681,756,2872011,1441,3503692,2197,19,10453,7,18362,10535,5,"East TN",2455501,325.106770471688,0.310372287477603,89.4725760649252,51.5984314402641,31.0372287477603
2022-08-31,807126,1301,583904,789,223222,512,632510,829,2873869,1858,3506379,2687,3,10456,4,18366,10541,6,"East TN",2455501,305.843899065812,0.307336642415176,109.427770544585,52.9830775878324,30.7336642415176
2022-09-01,808166,1040,584488,584,223678,456,633135,625,2875311,1442,3508446,2067,11,10467,7,18373,10546,5,"East TN",2455501,289.920468368777,0.307444061962134,84.1783407948113,42.3538821609114,30.7444061962134
2022-09-02,809142,976,585122,634,224020,342,633793,658,2877051,1740,3510844,2398,2,10469,7,18380,10551,5,"East TN",2455501,279.779971582174,0.305036287662195,97.6582782902552,39.7474894125476,30.5036287662195
2022-09-03,809623,481,585382,260,224241,221,634073,280,2877979,928,3512052,1208,0,10469,1,18381,10557,6,"East TN",2455501,270.372522756049,0.304010836029799,49.1956631253663,19.5886704994215,30.4010836029799
2022-09-04,810033,410,585592,210,224441,200,634288,215,2878697,718,3512985,933,0,10469,3,18384,10565,8,"East TN",2455501,266.829457613742,0.299525776350008,37.9963192847407,16.6972035442054,29.9525776350008
2022-09-05,810329,296,585730,138,224599,158,634438,150,2879226,529,3513664,679,2,10471,8,18392,10569,4,"East TN",2455501,235.023321106365,0.288684361903197,27.6521980646719,12.0545664611825,28.8684361903197
2022-09-06,811252,923,586226,496,225026,427,634941,503,2880229,1003,3515170,1506,2,10473,14,18406,10574,5,"East TN",2455501,221.01396008391,0.284021606551664,61.3316793599351,37.5890704178088,28.4021606551664
2022-09-07,812189,937,586721,495,225468,442,635472,531,2881549,1320,3517021,1851,2,10475,16,18422,10583,9,"East TN",2455501,206.190101327591,0.278331140763014,75.3817652690836,38.1592188315134,27.8331140763014
2022-09-08,813121,932,587236,515,225885,417,636005,533,2883048,1499,3519053,2032,2,10477,13,18435,10585,2,"East TN",2455501,201.791813564727,0.27057603469407,82.7529697605499,37.9555943980475,27.057603469407
2022-09-09,813794,673,587604,368,226190,305,636403,398,2884454,1406,3520857,1804,0,10477,5,18440,10592,7,"East TN",2455501,189.452172896692,0.260661140517327,73.4676955945039,27.4078487445128,26.0661140517327
2022-09-10,814115,321,587805,201,226310,120,636620,217,2885296,842,3521916,1059,0,10477,1,18441,10597,5,"East TN",2455501,182.936191025783,0.258211678832117,43.1276550080819,13.0726886285121,25.8211678832117
2022-09-11,814381,266,587936,131,226445,135,636761,141,2885870,574,3522631,715,0,10477,9,18450,10602,5,"East TN",2455501,177.071807341964,0.256375699771926,29.1182939856266,10.8328198603869,25.6375699771926
2022-09-12,815005,624,588241,305,226764,319,637091,330,2886727,857,3523818,1187,6,10483,10,18460,10605,3,"East TN",2455501,190.429570177328,0.261276344297814,48.3404405048094,25.4123292965468,26.1276344297814
2022-09-13,815674,669,588628,387,227046,282,637497,406,2887915,1188,3525412,1594,2,10485,11,18471,10608,3,"East TN",2455501,180.08544895726,0.249560632688928,64.9154693889353,27.2449491977401,24.9560632688928
2022-09-14,816269,595,588953,325,227316,270,637845,348,2889165,1250,3527010,1598,15,10500,10,18481,10611,3,"East TN",2455501,166.157537708191,0.237561317449194,65.078368935708,24.2313075824445,23.7561317449194
2022-09-15,816939,670,589343,390,227596,280,638259,414,2890512,1347,3528771,1761,20,10520,4,18485,10616,5,"East TN",2455501,155.487617394577,0.231940728544968,71.716525466697,27.2856740844333,23.1940728544968
2022-09-16,817458,519,589564,221,227894,298,638497,238,2891893,1381,3530390,1619,3,10523,4,18489,10618,2,"East TN",2455501,149.215984843826,0.219658030001049,65.9335915562649,21.1362161937625,21.9658030001049
2022-09-17,817662,204,589672,108,227990,96,638614,117,2892560,667,3531174,784,0,10523,3,18492,10624,6,"East TN",2455501,144.451173100724,0.215381291855692,31.9283111674563,8.30787688540954,21.5381291855692
2022-09-18,817862,200,589780,108,228082,92,638732,118,2893141,581,3531873,699,2,10525,5,18497,10631,7,"East TN",2455501,141.763330578973,0.21326552694222,28.4666957985356,8.1449773386368,21.326552694222
2022-09-19,818456,594,590083,303,228373,291,639053,321,2894066,925,3533119,1246,5,10530,7,18504,10639,8,"East TN",2455501,140.541583978178,0.210945059671003,50.7432088197073,24.1905826957513,21.0945059671003
2022-09-20,818969,513,590390,307,228579,206,639373,320,2895120,1054,3534493,1374,4,10534,5,18509,10649,10,"East TN",2455501,134.188501654041,0.20658517784385,55.9559943164348,20.8918668736034,20.658517784385
2022-09-21,819554,585,590754,364,228800,221,639764,391,2896276,1156,3536040,1547,28,10562,6,18515,10653,4,"East TN",2455501,133.781252787109,0.212513842746401,63.0013997143556,23.8240587155126,21.2513842746401
2022-09-22,820132,578,591155,401,228977,177,640185,421,2897592,1316,3537777,1737,13,10575,6,18521,10654,1,"East TN",2455501,130.034563211337,0.213857428381079,70.7391281860606,23.5389845086603,21.3857428381079
2022-09-23,820595,463,591455,300,229140,163,640511,326,2898722,1130,3539233,1456,11,10586,1,18522,10660,6,"East TN",2455501,127.753969556518,0.227750763315617,59.2954350252759,18.8556225389442,22.7750763315617
2022-09-24,820700,105,591536,81,229164,24,640602,91,2899397,675,3539999,766,0,10586,0,18522,10663,3,"East TN",2455501,123.722205773893,0.225269121813031,31.1952632069789,4.27611310278432,22.5269121813031
2022-09-25,820901,201,591656,120,229245,81,640732,130,2900289,892,3541021,1022,0,10586,1,18523,10669,6,"East TN",2455501,123.762930660586,0.218627022299956,41.620834200434,8.18570222532998,21.8627022299956
2022-09-26,821243,342,591799,143,229444,199,640886,154,2900981,692,3541867,846,2,10588,5,18528,10676,7,"East TN",2455501,113.500259213904,0.209533607681756,34.4532541424337,13.9279112490689,20.9533607681756
2022-09-27,821697,454,592054,255,229643,199,641162,276,2902103,1122,3543265,1398,3,10591,6,18534,10680,4,"East TN",2455501,111.097490899006,0.203944368445052,56.9333915970712,18.4890985587055,20.3944368445052
2022-09-28,822149,452,592270,216,229879,236,641389,227,2903423,1320,3544812,1547,16,10607,3,18537,10681,1,"East TN",2455501,105.681080968812,0.185248518011856,63.0013997143556,18.4076487853192,18.5248518011856
2022-09-29,822554,405,592470,200,230084,205,641596,207,2904535,1112,3546131,1319,2,10609,3,18540,10685,4,"East TN",2455501,98.6356755708916,0.16890112520948,53.7161255483097,16.4935791107395,16.890112520948
2022-09-30,822959,405,592703,233,230256,172,641845,249,2905684,1149,3547529,1398,18,10627,1,18541,10689,4,"East TN",2455501,96.273632142687,0.160800385728062,56.9333915970712,16.4935791107395,16.0800385728062
2022-10-01,823067,108,592775,72,230292,36,641923,78,2906196,512,3548119,590,0,10627,0,18541,10692,3,"East TN",2455501,96.3958068027665,0.162684729064039,24.0276831489786,4.39828776286387,16.2684729064039
2022-10-02,823175,108,592851,76,230324,32,642005,82,2906900,704,3548905,786,2,10629,2,18543,10698,6,"East TN",2455501,92.6083923403004,0.161466260781329,32.0097609408426,4.39828776286387,16.1466260781329
2022-10-03,823728,553,593054,203,230674,350,642220,215,2907620,720,3549840,935,11,10640,3,18546,10702,4,"East TN",2455501,101.201343432562,0.167314687068857,38.077769058127,22.5208623413308,16.7314687068857
2022-10-04,824012,284,593210,156,230802,128,642378,158,2909083,1463,3551461,1621,2,10642,4,18550,10707,5,"East TN",2455501,94.278112694721,0.148365056124939,66.0150413296513,11.5658678208643,14.8365056124939
2022-10-05,824398,386,593402,192,230996,194,642581,203,2910132,1049,3552713,1252,0,10642,2,18552,10710,3,"East TN",2455501,91.5902701729708,0.150866978863435,50.9875581398664,15.719806263569,15.0866978863435
2022-10-06,824865,467,593685,283,231180,184,642884,303,2911239,1107,3554123,1410,19,10661,3,18555,10711,1,"East TN",2455501,94.1152131479482,0.161161161161161,57.4220902373894,19.0185220857169,16.1161161161161
2022-10-07,825252,387,593927,242,231325,145,643141,257,2912586,1347,3555727,1604,6,10667,3,18558,10716,5,"East TN",2455501,93.3821651874709,0.158087338375213,65.3227182558671,15.7605311502622,15.8087338375213
2022-10-08,825370,118,593992,65,231378,53,643209,68,2913319,733,3556528,801,0,10667,3,18561,10721,5,"East TN",2455501,93.7894140544027,0.152931383041979,32.6206342412404,4.80553662979571,15.2931383041979
2022-10-09,825542,172,594099,107,231443,65,643325,116,2914136,817,3557461,933,0,10667,8,18569,10723,2,"East TN",2455501,96.3958068027665,0.154277699859748,37.9963192847407,7.00468051122765,15.4277699859748
2022-10-10,825877,335,594288,189,231589,146,643524,199,2915009,873,3558533,1072,2,10669,5,18574,10725,2,"East TN",2455501,87.5177815036524,0.150005751754285,43.6570785350932,13.6428370422166,15.0005751754285
2022-10-11,826267,390,594497,209,231770,181,643748,224,2915991,982,3559739,1206,9,10678,1,18575,10731,6,"East TN",2455501,91.8346194931299,0.165498912780865,49.1142133519799,15.8827058103418,16.5498912780865
2022-10-12,826632,365,594728,231,231904,134,643992,244,2917100,1109,3561092,1353,7,10685,2,18577,10735,4,"East TN",2455501,90.979396872573,0.168397183434777,55.100771695878,14.8645836430122,16.8397183434777
2022-10-13,826932,300,594917,189,232015,111,644191,199,2918083,983,3562274,1182,7,10692,4,18581,10738,3,"East TN",2455501,84.1783407948113,0.160348423506318,48.1368160713435,12.2174660079552,16.0348423506318
2022-10-14,827170,238,595058,141,232112,97,644339,148,2919035,952,3563374,1100,0,10692,6,18587,10743,5,"East TN",2455501,78.1103326775269,0.156662743559566,44.7973753625024,9.69252303297779,15.6662743559566
2022-10-15,827284,114,595138,80,232146,34,644424,85,2919704,669,3564128,754,0,10692,0,18587,10744,1,"East TN",2455501,77.9474331307542,0.159868421052632,30.7065645666607,4.64263708302298,15.9868421052632
2022-10-16,827361,77,595192,54,232169,23,644483,59,2920241,537,3564724,596,1,10693,3,18590,10748,4,"East TN",2455501,74.0785688949017,0.15943824865758,24.2720324691377,3.13581627537517,15.943824865758
2022-10-17,827805,444,595431,239,232374,205,644731,248,2921047,806,3565778,1054,2,10695,4,18594,10754,6,"East TN",2455501,78.5175815444587,0.166597653554175,42.9240305746159,18.0818496917737,16.6597653554175
2022-10-18,828170,365,595643,212,232527,153,644950,219,2922594,1547,3567544,1766,13,10708,6,18600,10758,4,"East TN",2455501,77.4994593771291,0.154003843689942,71.9201499001629,14.8645836430122,15.4003843689942
2022-10-19,828537,367,595870,227,232667,140,645180,230,2923606,1012,3568786,1242,1,10709,5,18605,10761,3,"East TN",2455501,77.5809091505155,0.154406030673252,50.5803092729345,14.9460334163985,15.4406030673252
2022-10-20,828882,345,596060,190,232822,155,645385,205,2924799,1193,3570184,1398,11,10720,3,18608,10764,3,"East TN",2455501,79.4135290517088,0.15094816687737,56.9333915970712,14.0500859091485,15.094816687737
2022-10-21,829286,404,596301,241,232985,163,645640,255,2926127,1328,3571767,1583,1,10721,3,18611,10765,1,"East TN",2455501,86.1738602427773,0.155010127487192,64.4674956353103,16.4528542240463,15.5010127487192
2022-10-22,829385,99,596367,66,233018,33,645714,74,2926761,634,3572475,708,0,10721,1,18612,10771,6,"East TN",2455501,85.5629869423796,0.154546543668384,28.8332197787743,4.03176378262522,15.4546543668384
2022-10-23,829502,117,596447,80,233055,37,645796,82,2927348,587,3573144,669,0,10721,2,18614,10771,0,"East TN",2455501,87.191982410107,0.155938242280285,27.2449491977401,4.76481174310253,15.5938242280285
2022-10-24,830026,524,596720,273,233306,251,646082,286,2928307,959,3574389,1245,1,10722,6,18620,10774,3,"East TN",2455501,90.4499733455617,0.156892346998026,50.7024839330141,21.3398406272284,15.6892346998026
2022-10-25,830571,545,597033,313,233538,232,646410,328,2929711,1404,3576121,1732,4,10726,6,18626,10777,3,"East TN",2455501,97.7804529503348,0.170222688585753,70.5355037525947,22.1950632477853,17.0222688585753
2022-10-26,831125,554,597327,294,233798,260,646715,305,2931023,1312,3577738,1617,14,10740,6,18632,10780,3,"East TN",2455501,105.39600676196,0.171470062555853,65.8521417828785,22.5615872280239,17.1470062555853
2022-10-27,831630,505,597578,251,234052,254,646973,258,2932293,1270,3579266,1528,3,10743,0,18632,10784,4,"East TN",2455501,111.91198863287,0.174851354327241,62.2276268671852,20.5660677800579,17.4851354327241
2022-10-28,832057,427,597813,235,234244,192,647227,254,2933473,1180,3580700,1434,0,10743,4,18636,10786,2,"East TN",2455501,112.848661026813,0.17765588268219,58.3994875180259,17.3895266179896,17.765588268219
2022-10-29,832158,101,597870,57,234288,44,647291,64,2934107,634,3581398,698,0,10743,2,18638,10788,2,"East TN",2455501,112.930110800199,0.176734282192088,28.4259709118424,4.11321355601158,17.6734282192088
2022-10-30,832190,32,597897,27,234293,5,647320,29,2934253,146,3581573,175,0,10743,1,18639,10789,1,"East TN",2455501,109.468495431279,0.180804365879701,7.1268551713072,1.30319637418189,18.0804365879701
2022-10-31,832913,723,598294,397,234619,326,647733,413,2936338,2085,3584071,2498,1,10744,7,18646,10792,3,"East TN",2455501,117.572747883222,0.170522619293534,101.730766959574,29.444093079172,17.0522619293534
2022-11-01,833430,517,598579,285,234851,232,648020,287,2937994,1656,3586014,1943,16,10760,5,18651,10794,2,"East TN",2455501,116.432451055813,0.16274133225513,79.1284548448565,21.0547664203761,16.274133225513
2022-11-02,833927,497,598852,273,235075,224,648303,283,2939641,1647,3587944,1930,7,10767,7,18658,10798,4,"East TN",2455501,114.111132514302,0.155594748187341,78.5990313178451,20.2402686865124,15.5594748187341
2022-11-03,834448,521,599147,295,235301,226,648605,302,2941509,1868,3590114,2170,9,10776,6,18664,10802,4,"East TN",2455501,114.762730701392,0.150442477876106,88.3730041242093,21.2176659671489,15.0442477876106
2022-11-04,834960,512,599442,295,235518,217,648913,308,2943307,1798,3592220,2106,4,10780,6,18670,10806,4,"East TN",2455501,118.224346070313,0.146354166666667,85.7666113758455,20.8511419869102,14.6354166666667
2022-11-05,835109,149,599546,104,235563,45,649022,109,2944096,789,3593118,898,0,10780,1,18671,10812,6,"East TN",2455501,120.179140631586,0.147696245733788,36.5709482504792,6.06800811728442,14.7696245733788
2022-11-06,835239,130,599621,75,235618,55,649097,75,2944849,753,3593946,828,0,10780,4,18675,10815,3,"East TN",2455501,124.170179527518,0.143619170775075,33.7202061819563,5.29423527011392,14.3619170775075
2022-11-07,835895,656,599923,302,235972,354,649404,307,2946118,1269,3595522,1576,1,10781,4,18679,10819,4,"East TN",2455501,121.441612119075,0.145926119989521,64.182421428458,26.7155256707287,14.5926119989521
2022-11-08,836420,525,600216,293,236204,232,649700,296,2947872,1754,3597572,2050,2,10783,3,18682,10820,1,"East TN",2455501,121.76741121262,0.145353867451116,83.4860177210272,21.3805655139216,14.5353867451116
2022-11-09,836948,528,600498,282,236450,246,649991,291,2950073,2201,3600064,2492,9,10792,4,18686,10822,2,"East TN",2455501,123.029882700109,0.139273927392739,101.486417639415,21.5027401740012,13.9273927392739
2022-11-10,837378,430,600711,213,236667,217,650209,218,2951314,1241,3601523,1459,1,10793,13,18699,10828,6,"East TN",2455501,119.323918011029,0.140590761679376,59.4176096853555,17.5117012780691,14.0590761679376
2022-11-11,837664,286,600888,177,236776,109,650398,189,2952548,1234,3602946,1423,1,10794,0,18699,10831,3,"East TN",2455501,110.12009361837,0.138448629498415,57.9515137644008,11.6473175942506,13.8448629498415
2022-11-12,837774,110,600966,78,236808,32,650481,83,2953337,789,3603818,872,0,10794,3,18702,10832,1,"East TN",2455501,108.531823037335,0.136355140186916,35.5121011964564,4.47973753625024,13.6355140186916
2022-11-13,837888,114,601046,80,236842,34,650578,97,2954096,759,3604674,856,0,10794,6,18708,10838,6,"East TN",2455501,107.880224850244,0.138049962714392,34.8605030093655,4.64263708302298,13.8049962714392
2022-11-14,838425,537,601285,239,237140,298,650826,248,2955217,1121,3606043,1369,7,10801,6,18714,10841,3,"East TN",2455501,103.033963333756,0.135158254918734,55.7523698829689,21.8692641542398,13.5158254918734
2022-11-15,838883,458,601559,274,237324,184,651108,282,2956708,1491,3607816,1773,0,10801,6,18720,10845,4,"East TN",2455501,100.305395925312,0.137446310035143,72.2052241070152,18.6519981054783,13.7446310035143
2022-11-16,839230,347,601764,205,237466,142,651323,215,2957976,1268,3609299,1483,8,10809,4,18724,10850,5,"East TN",2455501,92.9341914338459,0.144233892799134,60.3950069659919,14.1315356825348,14.4233892799134
2022-11-17,839619,389,601976,212,237643,177,651543,220,2959296,1320,3610839,1540,-12,10797,1,18725,10855,5,"East TN",2455501,91.2644710794253,0.143194504079004,62.7163255075034,15.8419809236486,14.3194504079004
2022-11-18,839940,321,602144,168,237796,153,651725,182,2960819,1523,3612544,1705,0,10797,1,18726,10858,3,"East TN",2455501,92.6898421136868,0.138257970410502,69.4359318118787,13.0726886285121,13.8257970410502
2022-11-19,840074,134,602236,92,237838,42,651825,100,2961703,884,3613528,984,0,10797,3,18729,10862,4,"East TN",2455501,93.6672393943232,0.138414006179197,40.073288506093,5.45713481688666,13.8414006179197
2022-11-20,840178,104,602313,77,237865,27,651906,81,2962583,880,3614489,961,1,10798,6,18735,10864,2,"East TN",2455501,93.2599905273914,0.135303107488538,39.1366161121498,4.23538821609114,13.5303107488538
2022-11-21,840625,447,602535,222,238090,225,652146,240,2963702,1119,3615848,1359,1,10799,4,18739,10866,2,"East TN",2455501,89.5947507250048,0.134625191228965,55.345121016037,18.2040243518532,13.4625191228965
2022-11-22,841053,428,602763,228,238290,200,652378,232,2965347,1645,3617725,1877,1,10800,8,18747,10868,2,"East TN",2455501,88.3730041242093,0.128166313452417,76.4406123231064,17.4302515046828,12.8166313452417
2022-11-23,841435,382,602957,194,238478,188,652582,204,2966844,1497,3619426,1701,3,10803,2,18749,10872,4,"East TN",2455501,89.7983751584707,0.124321121753728,69.273032265106,15.5569067167963,12.4321121753728
2022-11-24,841528,93,603014,57,238514,36,652648,66,2967639,795,3620287,861,0,10803,2,18751,10872,0,"East TN",2455501,77.7438086972883,0.116955969517358,35.0641274428314,3.78741446246611,11.6955969517358
2022-11-25,841661,133,603089,75,238572,58,652727,79,2968446,807,3621173,886,0,10803,3,18754,10873,1,"East TN",2455501,70.0875299989697,0.116120060261908,36.082249610161,5.41640993019347,11.6120060261908
2022-11-26,841799,138,603152,63,238647,75,652793,66,2969204,758,3621997,824,1,10804,1,18755,10874,1,"East TN",2455501,70.2504295457424,0.114299208879443,33.5573066351836,5.62003436365939,11.4299208879443
2022-11-27,842093,294,603253,101,238840,193,652901,108,2970233,1029,3623134,1137,0,10804,2,18757,10877,3,"East TN",2455501,77.9881580174474,0.115095430884905,46.3041961701502,11.9731166877961,11.5095430884905
2022-11-28,842570,477,603531,278,239039,199,653185,284,2972018,1785,3625203,2069,3,10807,3,18760,10879,2,"East TN",2455501,79.2099046182429,0.111063602351684,84.2597905681977,19.4257709526488,11.1063602351684
2022-11-29,843113,543,603858,327,239255,216,653519,334,2974446,2428,3627965,2762,4,10811,6,18766,10881,2,"East TN",2455501,83.893266587959,0.11142578125,112.482137046574,22.1136134743989,11.142578125
2022-11-30,843749,636,604169,311,239580,325,653840,321,2976515,2069,3630355,2390,6,10817,5,18771,10886,5,"East TN",2455501,94.2373878080278,0.11510659712691,97.3324791967098,25.901027936865,11.510659712691
2022-12-01,844292,543,604474,305,239818,238,654158,318,2978371,1856,3632529,2174,22,10839,9,18780,10886,0,"East TN",2455501,112.563586819961,0.12334585851985,88.535903670982,22.1136134743989,12.334585851985
2022-12-02,844794,502,604744,270,240050,232,654437,279,2980420,2049,3634857,2328,38,10877,3,18783,10887,1,"East TN",2455501,127.591070009745,0.124963460976323,94.8075362217323,20.4438931199784,12.4963460976323
2022-12-03,844956,162,604862,118,240094,44,654566,129,2981470,1050,3636036,1179,0,10877,3,18786,10888,1,"East TN",2455501,128.568467290382,0.126291046370824,48.0146414112639,6.59743164429581,12.6291046370824
2022-12-04,845101,145,604951,89,240150,56,654662,96,2982206,736,3636868,832,1,10878,3,18789,10888,0,"East TN",2455501,122.500459173097,0.128221930974225,33.8831057287291,5.90510857051168,12.8221930974225
2022-12-05,845654,553,605209,258,240445,295,654931,269,2983857,1651,3638788,1920,0,10878,5,18794,10889,1,"East TN",2455501,125.595550561779,0.128524107471476,78.1917824509133,22.5208623413308,12.8524107471476
2022-12-06,846138,484,605498,289,240640,195,655235,304,2985794,1937,3641029,2241,6,10884,2,18796,10890,1,"East TN",2455501,123.192782246882,0.131353337415799,91.2644710794253,19.7108451595011,13.1353337415799
2022-12-07,846744,606,605812,314,240932,292,655561,326,2987517,1723,3643078,2049,5,10889,4,18800,10890,0,"East TN",2455501,121.971035646086,0.13526683958186,83.445292834334,24.6792813360695,13.526683958186
2022-12-08,847297,553,606144,332,241153,221,655899,338,2989269,1752,3645168,2090,6,10895,2,18802,10890,0,"East TN",2455501,122.378284513018,0.137748239575916,85.1150131887546,22.5208623413308,13.7748239575916
2022-12-09,847734,437,606386,242,241348,195,656150,251,2990734,1465,3646884,1716,-1,10894,2,18804,10890,0,"East TN",2455501,119.731166877961,0.142429533549514,69.8839055655037,17.7967754849214,14.2429533549514
2022-12-10,847877,143,606477,91,241400,52,656243,93,2991431,697,3647674,790,0,10894,0,18804,10890,0,"East TN",2455501,118.95739403079,0.144096923870081,32.1726604876154,5.82365879712531,14.4096923870081
