"DATE","TOTAL_CASES","NEW_CASES","TOTAL_CONFIRMED","NEW_CONFIRMED","TOTAL_PROBABLE","NEW_PROBABLE","POS_TESTS","NEW_POS_TESTS","NEG_TESTS","NEW_NEG_TESTS","TOTAL_TESTS","NEW_TESTS","NEW_DEATHS","TOTAL_DEATHS","NEW_ACTIVE","TOTAL_ACTIVE","NEW_INACTIVE_RECOVERED","TOTAL_INACTIVE_RECOVERED","NEW_HOSPITALIZED","TOTAL_HOSPITALIZED","TOTAL_DEATHS_BY_DOD","Region","Population","New_cases_per_100k_per_week","PositivityRate_per_week","Tests_per_100k","New_cases_per_100k","Active_cases_per_100k","PositivityPercentage_per_week"
2021-12-07,81902,125,64897,63,17005,62,70778,72,474456,630,545234,702,2,973,14,1126,109,79803,1,2137,973,"Knox County",470313,NA,NA,149.262299787588,26.5780448339723,239.415027864422,NA
2021-12-06,81777,146,64834,103,16943,43,70706,113,473826,759,544532,872,8,971,34,1112,104,79694,2,2136,973,"Knox County",470313,NA,NA,185.408440761791,31.0431563660796,236.438286843017,NA
2021-12-05,81631,43,64731,28,16900,15,70593,33,473067,342,543660,375,2,963,-20,1078,61,79590,1,2134,971,"Knox County",470313,NA,NA,79.7341345019168,9.14284742288646,229.209058648177,NA
2021-12-04,81588,69,64703,49,16885,20,70560,55,472725,499,543285,554,0,961,17,1098,52,79529,3,2133,971,"Knox County",470313,NA,NA,117.793894704165,14.6710807483527,233.461545821612,NA
2021-12-03,81519,147,64654,103,16865,44,70505,108,472226,1009,542731,1117,3,961,60,1081,84,79477,2,2130,970,"Knox County",470313,NA,NA,237.501408636376,31.2557807247514,229.846931724192,NA
2021-12-02,81372,132,64551,83,16821,49,70397,84,471217,794,541614,878,0,958,32,1021,100,79393,4,2128,969,"Knox County",470313,NA,NA,186.684186913821,28.0664153446747,217.089470203885,NA
2021-12-01,81240,186,64468,140,16772,46,70313,147,470423,1009,540736,1156,4,958,92,989,90,79293,6,2124,967,"Knox County",470313,180.305456153668,0.108241952599929,245.793758624576,39.5481307129507,210.285490726389,10.8241952599929
2021-11-30,81054,117,64328,65,16726,52,70166,68,469414,693,539580,761,3,954,20,897,94,79203,5,2118,966,"Knox County",470313,178.604461284294,0.106423945387712,161.807136949223,24.877049964598,190.724049728585,10.6423945387712
2021-11-29,80937,165,64263,128,16674,37,70098,139,468721,967,538819,1106,2,951,76,877,87,79109,2,2113,964,"Knox County",470313,182.644324099057,0.106608373970069,235.162540690987,35.0830191808434,186.471562555149,10.6608373970069
2021-11-28,80772,33,64135,22,16637,11,69959,22,467754,270,537713,292,3,949,-20,801,50,79022,5,2111,963,"Knox County",470313,180.51808051234,0.106241473396999,62.0863127321592,7.01660383616868,170.312111296094,10.6241473396999
2021-11-27,80739,59,64113,30,16626,29,69937,32,467484,266,537421,298,0,946,-2,821,61,78972,1,2106,963,"Knox County",470313,178.391836925622,0.106990014265335,63.3620588841899,12.5448371616349,174.56459846953,10.6990014265335
2021-11-26,80680,20,64083,18,16597,2,69905,20,467218,298,537123,318,0,946,-45,823,65,78911,3,2105,962,"Knox County",470313,151.388543374306,0.106467040964858,67.6145460576254,4.25248717343556,174.989847186873,10.6467040964858
2021-11-25,80660,53,64065,26,16595,27,69885,29,466920,331,536805,360,0,946,-15,868,68,78846,3,2102,962,"Knox County",470313,134.591219039236,0.106501980890235,76.5447691218401,11.2690910096042,184.557943327103,10.6501980890235
2021-11-24,80607,105,64039,66,16568,39,69856,73,466589,742,536445,815,0,946,19,883,86,78778,2,2099,959,"Knox County",470313,117.368645986822,0.0969620253164557,173.288852317499,22.3255576605367,187.74730870718,9.69620253164557
2021-11-23,80502,99,63973,63,16529,36,69783,65,465847,674,535630,739,0,946,38,864,61,78692,1,2097,956,"Knox County",470313,113.54140753073,0.0967413441955193,157.129401058444,21.049811508506,183.707445892416,9.67413441955193
2021-11-22,80403,107,63910,82,16493,25,69718,82,465173,740,534891,822,0,946,38,826,69,78631,3,2096,956,"Knox County",470313,101.209194727766,0.0886388583973655,174.777222828202,22.7508063778803,175.627720262889,8.86388583973655
2021-11-21,80296,44,63828,32,16468,12,69636,37,464433,284,534069,321,0,946,-8,788,52,78562,2,2093,956,"Knox County",470313,103.548062673156,0.0920228695888919,68.2524191336408,9.35547178155824,167.547994633361,9.20228695888919
2021-11-20,80252,54,63796,37,16456,17,69599,44,464149,537,533748,581,0,946,14,796,40,78510,1,2091,955,"Knox County",470313,102.484940879797,0.0884732052578362,123.534752388303,11.481715368276,169.248989502735,8.84732052578362
2021-11-19,80198,112,63759,83,16439,29,69555,81,463612,825,533167,906,0,946,62,782,50,78470,0,2090,955,"Knox County",470313,122.046381877601,0.0904489436619718,192.637668956631,23.8139281712392,166.272248481331,9.04489436619718
2021-11-18,80086,80,63676,43,16410,37,69474,49,462787,937,532261,986,3,946,18,720,59,78420,1,2090,955,"Knox County",470313,127.787239561739,0.0833655705996132,209.647617650373,17.0099486937423,153.08953824368,8.33655705996132
2021-11-17,80006,105,63633,64,16373,41,69425,66,461850,834,531275,900,0,943,46,702,59,78361,1,2089,955,"Knox County",470313,127.787239561739,0.0806850618458611,191.3619228046,22.3255576605367,149.262299787588,8.06850618458611
2021-11-16,79901,73,63569,50,16332,23,69359,67,461016,777,530375,844,0,943,9,656,64,78302,1,2088,955,"Knox County",470313,122.259006236272,0.0794776119402985,179.454958718981,15.5215781830398,139.481579288686,7.94776119402985
2021-11-15,79828,84,63519,43,16309,41,69292,34,460239,460,529531,494,3,943,22,647,59,78238,0,2087,954,"Knox County",470313,117.368645986822,0.0751192368839428,105.036433183858,17.8604461284294,137.56796006064,7.51192368839428
2021-11-14,79744,72,63476,62,16268,10,69258,68,459779,624,529037,692,0,940,17,625,55,78179,1,2087,954,"Knox County",470313,123.322128029631,0.0756986859152323,147.13605620087,15.308953824368,132.890224169861,7.56986859152323
2021-11-13,79672,29,63414,12,16258,17,69190,12,459155,317,528345,329,0,940,-14,608,43,78124,2,2086,952,"Knox County",470313,118.006519062837,0.0731896719083673,69.953414003015,6.16610640148157,129.275610072441,7.31896719083673
2021-11-12,79643,66,63402,49,16241,17,69178,51,458838,687,528016,738,0,940,17,622,49,78081,4,2084,952,"Knox County",470313,108.225798563935,0.0696367650010034,156.916776699772,14.0332076723374,132.252351093846,6.96367650010034
2021-11-11,79577,68,63353,46,16224,22,69127,54,458151,962,527278,1016,0,940,-2,605,70,78032,0,2080,951,"Knox County",470313,105.674306259874,0.0702174346698584,216.026348410527,14.4584563896809,128.637736996426,7.02174346698584
2021-11-10,79509,75,63307,51,16202,24,69073,70,457189,855,526262,925,1,940,7,607,67,77962,2,2080,951,"Knox County",470313,99.2955754997204,0.0706629614926558,196.677531771395,15.9468269003834,129.062985713769,7.06629614926558
2021-11-09,79434,107,63256,77,16178,30,69003,134,456334,1174,525337,1308,1,939,34,600,72,77895,1,2078,951,"Knox County",470313,106.524803694561,0.0768811341330425,278.112661142686,22.7508063778803,127.574615203067,7.68811341330425
2021-11-08,79327,78,63179,58,16148,20,68869,70,455160,687,524029,757,6,938,-10,566,82,77823,1,2077,950,"Knox County",470313,105.24905754253,0.0796183868169991,160.956639514536,16.5846999763987,120.345387008226,7.96183868169991
2021-11-07,79249,31,63121,20,16128,11,68799,23,454473,390,523272,413,0,932,-20,576,51,77741,1,2076,948,"Knox County",470313,96.5314588369873,0.0754648195406489,87.8138601314444,6.59135511882512,122.471630594944,7.54648195406489
2021-11-06,79218,41,63101,27,16117,14,68776,30,454083,453,522859,483,0,932,-2,596,43,77690,2,2075,945,"Knox County",470313,99.0829511410486,0.0765957446808511,102.697565238469,8.7175987055429,126.72411776838,7.65957446808511
2021-11-05,79177,52,63074,32,16103,20,68746,36,453630,605,522376,641,0,932,-27,598,79,77647,2,2073,944,"Knox County",470313,96.1062101196437,0.0752300198448494,136.29221390861,11.0564666509325,127.149366485723,7.52300198448494
2021-11-04,79125,68,63042,45,16083,23,68710,49,453025,668,521735,717,0,932,-1,625,69,77568,1,2071,944,"Knox County",470313,96.1062101196437,0.0785659801678108,152.451665167665,14.4584563896809,132.890224169861,7.85659801678108
2021-11-03,79057,80,62997,60,16060,20,68661,66,452357,969,521018,1035,0,932,-1,626,81,77499,2,2070,943,"Knox County",470313,97.1693319130026,0.0762047067613,220.06621122529,17.0099486937423,133.102848528533,7.62047067613
2021-11-02,78977,41,62937,19,16040,22,68595,22,451388,301,519983,323,4,932,-52,627,89,77418,1,2068,943,"Knox County",470313,83.1361242406653,0.0677500572213321,68.6776678509843,8.7175987055429,133.315472887205,6.77500572213321
2021-11-01,78936,95,62918,71,16018,24,68573,82,451087,661,519660,743,1,928,-20,679,114,77329,3,2067,941,"Knox County",470313,86.7507383380855,0.0707233065442021,157.979898493131,20.1993140738189,144.371939538137,7.07233065442021
2021-10-31,78841,26,62847,19,15994,7,68491,19,450426,278,518917,297,0,927,-44,699,70,77215,1,2064,940,"Knox County",470313,85.6876165447266,0.0717150271290399,63.1494345255181,5.52823332546623,148.624426711573,7.17150271290399
2021-10-30,78815,55,62828,39,15987,16,68472,42,450148,522,518620,564,0,927,-24,743,79,77145,4,2063,940,"Knox County",470313,88.6643575661315,0.0731481481481481,119.920138290883,11.6943397269478,157.979898493131,7.31481481481481
2021-10-29,78760,73,62789,59,15971,14,68430,66,449626,846,518056,912,1,927,-37,767,109,77066,1,2059,940,"Knox County",470313,93.1294690982388,0.0753648442605097,193.913415108662,15.5215781830398,163.082883101254,7.53648442605097
2021-10-28,78687,54,62730,32,15957,22,68364,39,448780,561,517144,600,4,926,-53,804,103,76957,3,2058,939,"Knox County",470313,90.1527280768339,0.0751005811354493,127.574615203067,11.481715368276,170.94998437211,7.51005811354493
2021-10-27,78633,88,62698,56,15935,32,68325,65,448219,759,516544,824,1,922,-33,857,120,76854,3,2055,937,"Knox County",470313,91.8537229462082,0.0785831574008914,175.202471545545,18.7109435631165,182.219075381714,7.85831574008914
2021-10-26,78545,97,62642,57,15903,40,68260,55,447460,554,515720,609,0,921,-17,890,114,76734,5,2052,934,"Knox County",470313,103.760687031828,0.0808969004176742,129.488234431113,20.6245627911625,189.235679217883,8.08969004176742
2021-10-25,78448,71,62585,47,15863,24,68205,54,446906,491,515111,545,6,921,-72,907,137,76620,3,2047,933,"Knox County",470313,98.6577024237051,0.0781429556423811,115.880275476119,15.0963294656962,192.850293315303,7.81429556423811
2021-10-24,78377,38,62538,20,15839,18,68151,23,446415,337,514566,360,1,915,-71,979,108,76483,5,2044,932,"Knox County",470313,101.209194727766,0.0779338468509289,76.5447691218401,8.07972562952757,208.159247139671,7.79338468509289
2021-10-23,78339,59,62518,40,15821,19,68128,42,446078,471,514206,513,0,914,-16,1050,75,76375,1,2039,930,"Knox County",470313,102.059692162454,0.0788448315379326,109.076295998622,12.5448371616349,223.255576605367,7.88448315379326
2021-10-22,78280,91,62478,54,15802,37,68086,55,445607,551,513693,606,0,914,-68,1066,159,76300,2,2038,928,"Knox County",470313,105.886930618546,0.0820803549420754,128.850361355098,19.3488166391318,226.657566344116,8.20803549420754
2021-10-21,78189,124,62424,71,15765,53,68031,78,445056,712,513087,790,3,914,-22,1134,143,76141,2,2036,926,"Knox County",470313,120.77063572557,0.0875912408759124,167.973243350705,26.3654204753005,241.116022733796,8.75912408759124
2021-10-20,78065,150,62353,83,15712,67,67953,90,444344,959,512297,1049,3,911,-46,1156,193,75998,3,2034,925,"Knox County",470313,133.95334596322,0.0887745974955277,223.042952246695,31.8936538007667,245.793758624576,8.87745974955277
2021-10-19,77915,131,62270,85,15645,46,67863,92,443385,724,511248,816,4,908,-40,1202,167,75805,4,2031,924,"Knox County",470313,141.182574158061,0.0927548621500321,173.501476676171,27.8537909860029,255.574479123477,9.27548621500321
2021-10-18,77784,121,62185,90,15599,31,67771,106,442661,607,510432,713,9,904,-74,1242,186,75638,8,2027,922,"Knox County",470313,151.81379209165,0.100268207138436,151.601167732978,25.7275473992852,264.079453470348,10.0268207138436
2021-10-17,77663,62,62095,55,15568,7,67665,60,442054,303,509719,363,1,895,-66,1316,127,75452,4,2019,920,"Knox County",470313,156.916776699772,0.107835051546392,77.1826421978555,13.1827102376502,279.81365601206,10.7835051546392
2021-10-16,77601,55,62040,41,15561,14,67605,44,441751,372,509356,416,0,894,-83,1382,138,75325,1,2015,919,"Knox County",470313,156.066279265085,0.110456553755523,88.4517332074597,11.6943397269478,293.846863684397,11.0456553755523
2021-10-15,77546,125,61999,88,15547,37,67561,100,441379,794,508940,894,9,894,-68,1465,184,75187,5,2014,915,"Knox County",470313,163.295507459926,0.113072803015275,190.08617665257,26.5780448339723,311.494685454155,11.3072803015275
2021-10-14,77421,193,61911,134,15510,59,67461,144,440585,699,508046,843,0,885,9,1533,184,75003,7,2009,913,"Knox County",470313,177.966588208278,0.124852767962309,179.242334360309,41.0365012236532,325.953141843836,12.4852767962309
2021-10-13,77228,121,61777,87,15451,34,67317,99,439886,764,507203,863,7,885,-79,1524,193,74819,5,2002,909,"Knox County",470313,171.800481806797,0.131418092909535,183.494821533745,25.7275473992852,324.03952261579,13.1418092909535
2021-10-12,77107,136,61690,104,15417,32,67218,109,439122,821,506340,930,4,878,-82,1603,214,74626,3,1997,908,"Knox County",470313,172.863603600156,0.131819992035046,197.740653564754,28.9169127793618,340.83684695086,13.1819992035046
2021-10-11,76971,193,61586,136,15385,57,67109,149,438301,581,505410,730,3,874,-88,1685,278,74412,11,1994,902,"Knox County",470313,188.172557424524,0.139908712046041,155.215781830398,41.0365012236532,358.272044361946,13.9908712046041
2021-10-10,76778,54,61450,41,15328,13,66960,51,437720,489,504680,540,0,871,-89,1773,143,74134,4,1983,901,"Knox County",470313,186.471562555149,0.133435582822086,114.81715368276,11.481715368276,376.982987925063,13.3435582822086
2021-10-09,76724,66,61409,37,15315,29,66909,48,437231,490,504140,538,0,871,-66,1862,132,73991,7,1979,899,"Knox County",470313,188.810430500539,0.131135256650431,114.391904965417,14.0332076723374,395.906555846851,13.1135256650431
2021-10-08,76658,289,61372,113,15286,176,66861,123,436741,936,503602,1059,-1,871,76,1928,214,73859,5,1972,897,"Knox County",470313,223.680825322711,0.131382882064329,225.169195833413,61.4484396561439,409.939763519188,13.1382882064329
2021-10-07,76369,259,61259,170,15110,89,66738,176,435805,1106,502543,1282,6,872,-10,1852,263,73645,9,1967,894,"Knox County",470313,237.714032995048,0.127061595422417,272.58442781722,55.0697088959905,393.780312260133,12.7061595422417
2021-10-06,76110,139,61089,103,15021,36,66562,112,434699,835,501261,947,1,866,-120,1862,258,73382,4,1958,893,"Knox County",470313,241.54127145114,0.12744772651842,201.355267662174,29.5547858553772,395.906555846851,12.744772651842
2021-10-05,75971,210,60986,118,14985,92,66450,138,433864,915,500314,1053,3,865,-73,1982,280,73124,4,1954,888,"Knox County",470313,257.275473992852,0.129614571475037,223.893449681382,44.6511153210734,421.421478887464,12.9614571475037
2021-10-04,75761,317,60868,225,14893,92,66312,246,432949,829,499261,1075,3,862,-15,2055,329,72844,4,1950,885,"Knox County",470313,283.640894468152,0.137665537419156,228.571185572162,67.4019216989537,436.943057070504,13.7665537419156
2021-10-03,75444,102,60643,93,14801,9,66066,107,432120,678,498186,785,1,859,-66,2070,167,72515,6,1946,884,"Knox County",470313,293.846863684397,0.140970470396201,166.910121557346,21.6876845845214,440.132422450581,14.0970470396201
2021-10-02,75342,67,60550,43,14792,24,65959,50,431442,472,497401,522,5,858,-144,2136,206,72348,2,1940,883,"Knox County",470313,294.059488043069,0.141603450840399,110.989915226668,14.2458320310091,454.165630122918,14.1603450840399
2021-10-01,75275,225,60507,151,14768,74,65909,167,430970,965,496879,1132,0,853,-77,2280,302,72142,9,1938,881,"Knox County",470313,280.451529088075,0.146556798116539,240.690774016453,47.8404807011501,484.783537771654,14.6556798116539
2021-09-30,75050,240,60356,166,14694,74,65742,186,430005,1104,495747,1290,1,853,-111,2357,350,71840,8,1929,879,"Knox County",470313,276.411666273312,0.147854203409759,274.285422686594,51.0298460812268,501.155613389381,14.7854203409759
2021-09-29,74810,361,60190,170,14620,191,65556,192,428901,1111,494457,1303,6,852,-98,2468,453,71490,7,1921,877,"Knox County",470313,323.614273898446,0.151675977653631,277.049539349327,76.7573934805119,524.756917201949,15.1675977653631
2021-09-28,74449,348,60020,248,14429,100,65364,270,427790,778,493154,1048,2,846,-75,2566,421,71037,1,1914,874,"Knox County",470313,352.956435395152,0.170230607966457,222.830327888024,73.9932768177788,545.594104351783,17.0230607966457
2021-09-27,74101,239,59772,162,14329,77,65094,186,427012,760,492106,946,7,844,-303,2641,535,70616,12,1913,872,"Knox County",470313,336.371735418753,0.164816396242528,201.142643303502,50.817221722555,561.540931252166,16.4816396242528
2021-09-26,73862,124,59610,99,14252,25,64908,117,426252,703,491160,820,2,837,-143,2944,265,70081,1,1901,866,"Knox County",470313,341.049471309532,0.165415663503753,174.351974110858,26.3654204753005,625.966111929715,16.5415663503753
2021-09-25,73738,110,59511,90,14227,20,64791,102,425549,705,490340,807,0,835,-179,3087,289,69816,3,1900,862,"Knox County",470313,350.192318732419,0.166076776476994,171.587857448125,23.3886794538956,656.371395219779,16.6076776476994
2021-09-24,73628,244,59421,165,14207,79,64689,182,424844,939,489533,1121,13,835,-237,3266,468,69527,5,1897,857,"Knox County",470313,354.232181547182,0.168370824812543,238.351906071063,51.8803435159139,694.431155422027,16.8370824812543
2021-09-23,73384,355,59256,245,14128,110,64507,268,423905,1371,488412,1639,14,822,-220,3503,561,69059,8,1892,854,"Knox County",470313,378.683982794437,0.171395106715252,348.491323863044,75.4816473284812,744.823128427239,17.1395106715252
2021-09-22,73029,251,59011,187,14018,64,64239,202,422534,1261,486773,1463,3,808,-329,3723,577,68498,4,1884,851,"Knox County",470313,355.295303340541,0.169173890872004,311.069436736811,53.3687140266163,791.60048733503,16.9173890872004
2021-09-21,72778,397,58824,216,13954,181,64037,230,421273,996,485310,1226,10,805,-353,4052,740,67921,7,1880,843,"Knox County",470313,365.713896915458,0.160433807030666,260.6774637316,84.4118703926959,861.553901338045,16.0433807030666
2021-09-20,72381,432,58608,310,13773,122,63807,343,420277,1295,484084,1638,5,795,114,4405,313,67181,9,1873,839,"Knox County",470313,406.750398139112,0.165710351159054,348.278699504373,91.8537229462082,936.610299949183,16.5710351159054
2021-09-19,71949,120,58298,87,13651,33,63464,97,418982,432,482446,529,1,790,-176,4291,295,66868,7,1864,832,"Knox County",470313,405.899900704425,0.169060904665796,112.478285737371,25.5149230406134,912.3711230606,16.9060904665796
2021-09-18,71829,226,58211,183,13618,43,63367,197,418550,1075,481917,1272,0,789,-108,4467,334,66573,7,1857,824,"Knox County",470313,430.564326310351,0.170904590459046,270.458184230502,48.0531050598219,949.793010186833,17.0904590459046
2021-09-17,71603,547,58028,422,13575,125,63170,449,417475,1310,480645,1759,5,789,4,4575,538,66239,12,1850,812,"Knox County",470313,494.9895069879,0.187486878018056,374.006246903658,116.305524193463,972.756440923385,18.7486878018056
2021-09-16,71056,588,57606,456,13450,132,62721,487,416165,1518,478886,2005,7,784,10,4571,571,65701,16,1838,807,"Knox County",470313,544.530982558424,0.202689041649818,426.311839136915,125.023122899006,971.905943488698,20.2689041649818
2021-09-15,70468,338,57150,249,13318,89,62234,267,414647,808,476881,1075,6,777,-309,4561,641,65130,5,1822,805,"Knox County",470313,563.029301762869,0.21780303030303,228.571185572162,71.867033231061,969.77969990198,21.780303030303
2021-09-14,70130,555,56901,442,13229,113,61967,476,413839,1406,475806,1882,12,771,-160,4870,703,64489,8,1817,801,"Knox County",470313,596.62395043301,0.227952755905512,400.159043020287,118.006519062837,1035.48062673156,22.7952755905512
2021-09-13,69575,399,56459,299,13116,100,61491,333,412433,1134,473924,1467,20,759,-435,5030,814,63786,15,1809,798,"Knox County",470313,589.607346596841,0.230853939333267,311.919934171499,84.8371191100395,1069.50052411904,23.0853939333267
2021-09-12,69176,387,56160,358,13016,29,61158,376,411299,1460,472457,1836,0,739,79,5465,308,62972,5,1794,790,"Knox County",470313,646.378050362206,0.228842067988669,390.378322521385,82.2856268059781,1161.99212014127,22.8842067988669
2021-09-11,68789,866,55802,707,12987,159,60782,763,409839,2621,470621,3384,4,739,499,5386,363,62664,26,1789,782,"Knox County",470313,782.457639912144,0.235008949880668,719.520829745297,184.13269460976,1145.1947958062,23.5008949880668
2021-09-10,67923,1024,55095,746,12828,278,60019,800,407218,2513,467237,3313,1,735,467,4887,556,62301,24,1763,772,"Knox County",470313,883.879458998582,0.234059617698169,704.424500279601,217.727343279901,1039.09524082898,23.4059617698169
2021-09-09,66899,310,54349,167,12550,143,59219,173,404705,685,463924,858,1,734,-380,4420,689,61745,17,1739,765,"Knox County",470313,824.769887287827,0.230763662685487,182.431699740386,65.9135511882512,939.799665329259,23.0763662685487
2021-09-08,66589,290,54182,226,12407,64,59046,250,404020,837,463066,1087,5,733,-408,4800,693,61056,11,1722,761,"Knox County",470313,814.563918071582,0.229333911911478,231.122677876223,61.6610640148157,1020.59692162454,22.9333911911478
2021-09-07,66299,415,53956,299,12343,116,58796,311,403183,979,461979,1290,3,728,-210,5208,622,60363,13,1711,758,"Knox County",470313,784.796507857533,0.227125047223272,274.285422686594,88.2391088487879,1107.34765996262,22.7125047223272
2021-09-06,65884,991,53657,791,12227,200,58485,844,402204,3221,460689,4065,1,725,348,5418,642,59741,20,1698,757,"Knox County",470313,910.670128191226,0.222130992231415,864.318018000778,210.710739443732,1151.99877528369,22.2130992231415
2021-09-05,64893,969,52866,799,12027,170,57641,834,398983,2999,456624,3833,2,724,624,5070,343,59099,15,1678,754,"Knox County",470313,1034.4175049382,0.222938867077958,814.989166788926,206.033003552953,1078.00549846592,22.2938867077958
2021-09-04,63924,543,52067,389,11857,154,56807,408,395984,1502,452791,1910,2,722,225,4446,316,58756,10,1663,749,"Knox County",470313,965.739837087216,0.221325507459036,406.112525063096,115.455026758776,945.327898654726,22.1325507459036
2021-09-03,63381,334,51678,238,11703,96,56399,249,394482,909,450881,1158,5,720,-154,4221,483,58440,8,1653,745,"Knox County",470313,819.029029603689,0.216111541440744,246.219007341919,71.0165357963739,897.487417953576,21.6111541440744
2021-09-02,63047,323,51440,180,11607,143,56150,200,393573,681,449723,881,3,715,-158,4375,478,57957,5,1645,741,"Knox County",470313,821.793146266423,0.217660292463442,187.322059989837,68.6776678509843,930.231569189029,21.7660292463442
2021-09-01,62724,276,51260,211,11464,65,55950,226,392892,645,448842,871,3,712,-119,4533,392,57479,2,1640,738,"Knox County",470313,818.816405245018,0.219303255282696,185.195816403119,58.6843229934108,963.82621785917,21.9303255282696
2021-08-31,62448,596,51049,433,11399,163,55724,479,392247,1894,447971,2373,2,709,190,4652,404,57087,8,1638,736,"Knox County",470313,857.30141416461,0.214697501822278,504.55760312813,126.72411776838,989.128516541112,21.4697501822278
2021-08-30,61852,513,50616,403,11236,110,55245,430,390353,1630,445598,2060,9,707,96,4462,408,56683,11,1630,732,"Knox County",470313,755.6669707195,0.21595598349381,438.006178863863,109.076295998622,948.729888393474,21.595598349381
2021-08-29,61339,483,50213,407,11126,76,54815,439,388723,1485,443538,1924,1,698,257,4366,225,56275,5,1619,726,"Knox County",470313,652.331532405015,0.217500223673615,409.089266084501,102.697565238469,928.317949960983,21.7500223673615
2021-08-28,60856,398,49806,301,11050,97,54376,320,387238,1065,441614,1385,0,697,192,4109,206,56050,4,1614,720,"Knox County",470313,621.501000397608,0.219958693203154,294.484736760413,84.6244947513677,873.673489782336,21.9958693203154
2021-08-27,60458,472,49505,373,10953,99,54056,390,386173,1166,440229,1556,5,697,194,3917,273,55844,5,1610,717,"Knox County",470313,650.843161894313,0.224796380090498,330.843502093287,100.358697293079,832.849612917355,22.4796380090498
2021-08-26,59986,449,49132,347,10854,102,53666,368,385007,1426,438673,1794,5,692,154,3723,290,55571,0,1605,716,"Knox County",470313,677.633831086957,0.221683524199615,381.44809945717,95.4683370436284,791.60048733503,22.1683524199615
2021-08-25,59537,351,48785,224,10752,127,53298,238,383581,642,436879,880,2,687,90,3569,259,55281,4,1605,712,"Knox County",470313,693.58065798734,0.222519211493485,187.109435631165,74.6311498937941,758.856336099576,22.2519211493485
2021-08-24,59186,342,48561,222,10625,120,53060,237,382939,677,435999,914,4,685,77,3479,261,55022,5,1601,703,"Knox County",470313,639.574070884709,0.230381432512128,194.338663826005,72.7175306657481,739.720143819116,23.0381432512128
2021-08-23,58844,287,48339,206,10505,81,52823,227,382262,825,435085,1052,1,681,30,3402,256,54761,1,1596,703,"Knox County",470313,591.520965824887,0.233456075749605,223.680825322711,61.0231909388003,723.348068201389,23.3456075749605
2021-08-22,58557,240,48133,217,10424,23,52596,233,381437,889,434033,1122,2,680,69,3372,169,54505,0,1595,700,"Knox County",470313,539.853246667645,0.231299551878663,238.564530429735,51.0298460812268,716.969337441236,23.1299551878663
2021-08-21,58317,496,47916,373,10401,123,52363,411,380548,1905,432911,2316,0,678,381,3303,115,54336,8,1595,698,"Knox County",470313,560.690433817479,0.218393190782645,492.438014683838,105.461681901202,702.298256692883,21.8393190782645
2021-08-20,57821,424,47543,331,10278,93,51952,357,378643,1148,430595,1505,0,678,231,2922,193,54221,6,1587,695,"Knox County",470313,550.484464601234,0.216111864760513,319.999659801026,90.1527280768339,621.288376038936,21.6111864760513
2021-08-19,57397,368,47212,253,10185,115,51595,264,377495,952,429090,1216,1,678,203,2691,164,54028,6,1581,692,"Knox County",470313,533.26189154882,0.218434203220433,258.551220144882,78.2457639912144,572.172149185755,21.8434203220433
2021-08-18,57029,263,46959,191,10070,72,51331,200,376543,914,427874,1114,2,677,97,2488,164,53864,5,1575,692,"Knox County",470313,514.550947985703,0.208788829959952,236.863535560361,55.9202063306777,529.009404375384,20.8788829959952
2021-08-17,56766,263,46768,180,9998,83,51131,197,375629,1042,426760,1239,0,675,102,2391,161,53700,5,1570,692,"Knox County",470313,497.753623650633,0.197511501463823,263.441580394333,55.9202063306777,508.384841584222,19.7511501463823
2021-08-16,56503,185,46588,126,9915,59,50934,132,374587,422,425521,554,2,675,-25,2289,208,53539,5,1565,689,"Knox County",470313,476.065939066111,0.197882197220384,117.793894704165,39.335506354279,486.6971569997,19.7882197220384
2021-08-15,56318,204,46462,181,9856,23,50802,198,374165,953,424967,1151,3,673,80,2314,121,53331,6,1560,689,"Knox County",470313,468.411462153927,0.193402968664101,244.730636831217,43.3753691690427,492.012765966495,19.3402968664101
2021-08-14,56114,219,46281,147,9833,72,50604,154,373212,794,423816,948,0,670,96,2234,123,53210,4,1554,688,"Knox County",470313,409.514514801845,0.194383331176394,201.567892020846,46.5647345491194,475.002817272752,19.4383331176394
2021-08-13,55895,266,46134,205,9761,61,50450,220,372418,1470,422868,1690,1,670,124,2138,141,53087,5,1550,686,"Knox County",470313,375.919866131704,0.172522750252781,359.335166155305,56.558079406693,454.590878840262,17.2522750252781
2021-08-12,55629,222,45929,145,9700,77,50230,153,370948,643,421178,796,2,669,82,2014,138,52946,7,1545,683,"Knox County",470313,344.876709765624,0.167378537106247,169.248989502735,47.2026076251348,428.225458364961,16.7378537106247
2021-08-11,55407,316,45784,238,9623,78,50077,248,370305,989,420382,1237,1,667,183,1932,132,52808,10,1538,681,"Knox County",470313,356.145800775228,0.170978332239002,263.01633167699,67.1892973402819,410.790260953875,17.0978332239002
2021-08-10,55091,173,45546,109,9545,64,49829,121,369316,621,419145,742,1,666,56,1749,116,52676,2,1528,679,"Knox County",470313,337.009608494768,0.172239393087946,157.767274134459,36.7840140502176,371.88000331694,17.2239393087946
2021-08-09,54918,197,45437,159,9481,38,49708,167,368695,753,418403,920,1,665,75,1693,121,52560,4,1526,675,"Knox County",470313,339.56110079883,0.168492784607162,195.614409978036,41.8869986583403,359.97303923132,16.8492784607162
2021-08-08,54721,88,45278,66,9443,22,49541,75,367942,418,417483,493,1,664,22,1618,65,52439,4,1522,674,"Knox County",470313,314.896675192903,0.166715499560504,104.823808825187,18.7109435631165,344.026212330937,16.6715499560504
2021-08-07,54633,105,45212,75,9421,30,49466,80,367524,638,416990,718,0,663,44,1596,61,52374,2,1518,674,"Knox County",470313,290.657498304321,0.161309884778654,152.664289526337,22.3255576605367,339.348476440158,16.1309884778654
2021-08-06,54528,203,45137,147,9391,56,49386,163,366886,879,416272,1042,0,663,139,1552,64,52313,10,1516,674,"Knox County",470313,277.262163707999,0.169300605245461,221.554581735993,43.162744810371,329.9930046586,16.9300605245461
2021-08-05,54325,174,44990,131,9335,43,49223,147,366007,850,415230,997,2,663,102,1413,70,52249,4,1506,673,"Knox County",470313,267.056194491753,0.162790697674419,211.986485595763,36.9966384088894,300.438218803223,16.2790697674419
2021-08-04,54151,144,44859,101,9292,43,49076,105,365157,656,414233,761,1,661,70,1311,73,52179,4,1502,671,"Knox County",470313,230.484804800208,0.151242728714966,161.807136949223,30.6179076487361,278.750534218701,15.1242728714966
2021-08-03,54007,238,44758,177,9249,61,48971,183,364501,814,413472,997,0,660,161,1241,77,52106,5,1498,670,"Knox County",470313,244.305388113873,0.155195681511471,211.986485595763,50.6045973638832,263.866829111677,15.5195681511471
2021-08-02,53769,97,44581,75,9188,22,48788,82,363687,532,412475,614,2,660,-3,1080,98,52029,3,1493,668,"Knox County",470313,223.042952246695,0.148523657061544,130.551356224472,20.6245627911625,229.63430736552,14.8523657061544
2021-08-01,53672,107,44506,91,9166,16,48706,99,363155,526,411861,625,0,658,63,1083,44,51931,2,1490,668,"Knox County",470313,227.082815061459,0.14928745220716,132.890224169861,22.7508063778803,230.272180441536,14.928745220716
2021-07-31,53565,104,44415,64,9150,40,48607,68,362629,399,411236,467,1,658,46,1020,57,51887,6,1488,666,"Knox County",470313,226.870190702787,0.153916045793204,99.2955754997204,22.1129333018649,216.876845845214,15.3916045793204
2021-07-30,53461,118,44351,83,9110,35,48539,90,362230,339,410769,429,1,657,79,974,38,51830,0,1482,666,"Knox County",470313,208.797120215686,0.158282208588957,91.2158498701928,25.0896743232698,207.096125346312,15.8282208588957
2021-07-29,53343,117,44268,65,9075,52,48449,68,361891,483,410340,551,0,656,82,895,35,51792,1,1482,665,"Knox County",470313,196.677531771395,0.156390639063906,117.15602162815,24.877049964598,190.298801011241,15.6390639063906
2021-07-28,53226,131,44203,90,9023,41,48381,95,361408,536,409789,631,0,656,80,813,51,51757,4,1481,664,"Knox County",470313,193.913415108662,0.15878535002318,134.165970321892,27.8537909860029,172.863603600156,15.878535002318
2021-07-27,53095,117,44113,78,8982,39,48286,84,360872,499,409158,583,0,656,85,733,32,51706,4,1477,664,"Knox County",470313,168.185867709377,0.15025641025641,123.960001105647,24.877049964598,155.853654906413,15.025641025641
2021-07-26,52978,97,44035,73,8943,24,48202,79,360373,371,408575,450,1,656,61,648,35,51674,4,1473,664,"Knox County",470313,168.185867709377,0.156049250535332,95.6809614023002,20.6245627911625,137.780584419312,15.6049250535332
2021-07-25,52881,51,43962,43,8919,8,48123,44,360002,320,408125,364,3,655,22,587,26,51639,5,1469,664,"Knox County",470313,156.278903623757,0.151942446043165,77.3952665565272,10.8438422922607,124.810498540334,15.1942446043165
2021-07-24,52830,64,43919,42,8911,22,48079,44,359682,348,407761,392,0,652,39,565,25,51613,1,1464,663,"Knox County",470313,147.773929276886,0.148235294117647,83.348748599337,13.6079589549938,120.132762649555,14.8235294117647
2021-07-23,52766,56,43877,31,8889,25,48035,32,359334,321,407369,353,1,652,24,526,31,51588,3,1463,661,"Knox County",470313,134.591219039236,0.134175691937425,75.0563986111377,11.9069640856196,111.840412661355,13.4175691937425
2021-07-22,52710,94,43846,69,8864,25,48003,78,359013,474,407016,552,0,651,70,502,24,51557,3,1460,660,"Knox County",470313,129.700858789785,0.137142857142857,117.368645986822,19.9866897151471,106.737428053233,13.7142857142857
2021-07-21,52616,61,43777,47,8839,14,47925,46,358539,411,406464,457,1,651,33,432,27,51533,1,1457,660,"Knox County",470313,114.81715368276,0.129165344335132,97.1693319130026,12.9700858789785,91.8537229462082,12.9165344335132
2021-07-20,52555,78,43730,43,8825,35,47879,45,358128,299,406007,344,0,650,54,399,24,51506,3,1456,660,"Knox County",470313,106.524803694561,0.126373626373626,73.1427793830917,16.5846999763987,84.8371191100395,12.6373626373626
2021-07-19,52477,48,43687,36,8790,12,47834,42,357829,348,405663,390,0,650,28,345,20,51482,0,1453,660,"Knox County",470313,96.1062101196437,0.116058906030856,82.9234998819935,10.2059692162454,73.3554037417635,11.6058906030856
2021-07-18,52429,36,43651,30,8778,6,47792,31,357481,272,405273,303,0,650,27,317,9,51462,1,1453,660,"Knox County",470313,92.9168447395671,0.113937656753852,64.4251806775488,7.65447691218401,67.4019216989537,11.3937656753852
2021-07-17,52393,27,43621,20,8772,7,47761,21,357209,202,404970,223,0,650,12,290,15,51453,1,1452,659,"Knox County",470313,85.0497434687113,0.112509534706331,47.4152319838065,5.74085768413801,61.6610640148157,11.2509534706331
2021-07-16,52366,37,43601,21,8765,16,47740,22,357007,291,404747,313,0,650,25,278,12,51438,1,1451,659,"Knox County",470313,81.0098806539475,0.110379550735864,66.5514242642666,7.86710127085579,59.1095717107543,11.0379550735864
2021-07-15,52329,55,43580,42,8749,13,47718,44,356716,364,404434,408,-1,650,36,253,20,51426,1,1450,659,"Knox County",470313,72.7175306657481,0.102953240360952,86.7507383380855,11.6943397269478,53.7939627439599,10.2953240360952
2021-07-14,52274,21,43538,17,8736,4,47674,16,356352,269,404026,285,0,651,8,217,13,51406,2,1449,659,"Knox County",470313,64.212556318877,0.0975286849073257,60.5979422214568,4.46511153210734,46.1394858317759,9.75286849073257
2021-07-13,52253,42,43521,26,8732,16,47658,29,356083,355,403741,384,3,651,28,209,11,51393,3,1447,659,"Knox County",470313,56.558079406693,0.0888985255854293,81.6477537299628,8.93022306421468,44.4384909624016,8.88985255854293
2021-07-12,52211,27,43495,21,8716,6,47629,24,355728,270,403357,294,0,648,16,181,11,51382,1,1444,659,"Knox County",470313,52.0929678745856,0.0846153846153846,62.5115614495028,5.74085768413801,38.4850089195918,8.46153846153846
2021-07-11,52184,8,43474,3,8710,5,47605,4,355458,136,403063,140,0,648,1,165,7,51371,0,1443,658,"Knox County",470313,46.1394858317759,0.0781631656082071,29.7674102140489,1.70099486937423,35.0830191808434,7.81631656082071
2021-07-10,52176,20,43471,16,8705,4,47601,16,355322,191,402923,207,0,648,12,164,8,51364,2,1443,658,"Knox County",470313,44.6511153210734,0.0763170851797144,44.0132422450581,4.25248717343556,34.8703948221716,7.63170851797144
2021-07-09,52156,27,43455,21,8701,6,47585,21,355131,338,402716,359,0,648,12,152,15,51356,0,1441,658,"Knox County",470313,42.5248717343556,0.0741454020221473,76.3321447631684,5.74085768413801,32.3189025181103,7.41454020221473
2021-07-08,52129,19,43434,14,8695,5,47564,16,354793,317,402357,333,0,648,6,140,13,51341,0,1441,657,"Knox County",470313,34.8703948221716,0.0629370629370629,70.8039114377021,4.03986281476378,29.7674102140489,6.29370629370629
2021-07-07,52110,18,43420,5,8690,13,47548,5,354476,333,402024,338,1,648,8,134,9,51328,1,1441,655,"Knox County",470313,34.2325217461563,0.0559610705596107,71.867033231061,3.82723845609201,28.4916640620183,5.59610705596107
2021-07-06,52092,24,43415,9,8677,15,47543,14,354143,263,401686,277,0,647,14,126,10,51319,2,1440,655,"Knox County",470313,30.4052832900643,0.0513347022587269,58.8969473520825,5.10298460812268,26.790669192644,5.13347022587269
2021-07-05,52068,10,43406,7,8662,3,47529,6,353880,105,401409,111,0,647,0,112,10,51309,1,1438,655,"Knox County",470313,26.790669192644,0.0464589235127479,23.6013038125674,2.12624358671778,23.8139281712392,4.64589235127479
2021-07-04,52058,8,43399,7,8659,1,47523,7,353775,143,401298,150,0,647,0,112,8,51299,1,1437,655,"Knox County",470313,26.790669192644,0.047887323943662,31.8936538007667,1.70099486937423,23.8139281712392,4.7887323943662
2021-07-03,52050,9,43392,7,8658,2,47516,7,353632,185,401148,192,0,647,-2,112,11,51291,1,1436,655,"Knox County",470313,24.4518012472545,0.0431818181818182,40.8238768649814,1.913619228046,23.8139281712392,4.31818181818182
2021-07-02,52041,17,43385,13,8656,4,47509,17,353447,342,400956,359,-1,647,10,114,8,51280,0,1435,655,"Knox County",470313,22.3255576605367,0.0409090909090909,76.3321447631684,3.61461409742023,24.2391768885827,4.09090909090909
2021-07-01,52024,18,43372,15,8652,3,47492,17,353105,248,400597,265,-1,648,13,104,6,51272,1,1435,655,"Knox County",470313,22.1129333018649,0.0431442080378251,56.3454550480212,3.82723845609201,22.1129333018649,4.31442080378251
2021-06-30,52006,18,43357,12,8649,6,47475,11,352857,299,400332,310,0,649,9,91,9,51266,0,1434,655,"Knox County",470313,22.1129333018649,0.0474759615384615,65.9135511882512,3.82723845609201,19.3488166391318,4.74759615384615
2021-06-29,51988,21,43345,16,8643,5,47464,19,352558,438,400022,457,0,649,8,82,13,51257,1,1434,655,"Knox County",470313,21.4750602258496,0.0455531453362256,97.1693319130026,4.46511153210734,17.4351974110858,4.55531453362256
2021-06-28,51967,9,43329,2,8638,7,47445,2,352120,113,399565,115,0,649,-4,74,13,51244,0,1433,655,"Knox County",470313,21.2624358671778,0.0432900432900433,24.4518012472545,1.913619228046,15.7342025417116,4.32900432900433
2021-06-27,51958,5,43327,3,8631,2,47443,3,352007,151,399450,154,0,649,0,78,5,51231,0,1433,655,"Knox County",470313,20.6245627911625,0.041036717062635,32.7441512354538,1.06312179335889,16.5846999763987,4.1036717062635
2021-06-26,51953,3,43324,2,8629,1,47440,2,351856,206,399296,208,0,649,0,78,3,51226,0,1433,655,"Knox County",470313,19.3488166391318,0.0380085653104925,44.2258666037299,0.637873076015334,16.5846999763987,3.80085653104925
2021-06-25,51950,13,43322,9,8628,4,47438,11,351650,311,399088,322,0,649,4,78,9,51223,0,1433,655,"Knox County",470313,18.4983192044447,0.0354997269251775,68.4650434923126,2.76411666273312,16.5846999763987,3.54997269251775
2021-06-24,51937,14,43313,9,8624,5,47427,10,351339,364,398766,374,1,649,8,74,5,51214,1,1433,655,"Knox County",470313,17.6478217697576,0.0298969072164948,79.521510143245,2.97674102140489,15.7342025417116,2.98969072164948
2021-06-23,51923,13,43304,6,8619,7,47417,8,350975,282,398392,290,0,648,6,66,7,51209,0,1432,654,"Knox County",470313,16.5846999763987,0.0286458333333333,61.6610640148157,2.76411666273312,14.0332076723374,2.86458333333333
2021-06-22,51910,14,43298,5,8612,9,47409,5,350693,247,398102,252,2,648,10,60,2,51202,1,1432,653,"Knox County",470313,15.0963294656962,0.0239067055393586,53.5813383852881,2.97674102140489,12.7574615203067,2.39067055393586
2021-06-21,51896,9,43293,8,8603,1,47404,9,350446,289,397850,298,0,646,5,50,4,51200,1,1431,652,"Knox County",470313,15.0963294656962,0.0252897787144362,63.3620588841899,1.913619228046,10.6312179335889,2.52897787144363
2021-06-20,51887,3,43285,2,8602,1,47395,3,350157,161,397552,164,1,646,-2,45,4,51196,0,1430,652,"Knox County",470313,14.6710807483527,0.0251572327044025,34.8703948221716,0.637873076015334,9.56809614023002,2.51572327044025
2021-06-19,51884,3,43283,1,8601,2,47392,1,349996,191,397388,192,0,645,-3,47,6,51192,0,1430,652,"Knox County",470313,14.6710807483527,0.0248414376321353,40.8238768649814,0.637873076015334,9.99334485757357,2.48414376321353
2021-06-18,51881,6,43282,4,8599,2,47391,3,349805,283,397196,286,1,645,-5,50,10,51186,0,1430,652,"Knox County",470313,13.1827102376502,0.0210129310344828,60.8105665801286,1.27574615203067,10.6312179335889,2.10129310344828
2021-06-17,51875,12,43278,8,8597,4,47388,9,349522,515,396910,524,0,644,6,55,6,51176,0,1430,652,"Knox County",470313,12.7574615203067,0.0189431704885344,111.415163944012,2.55149230406134,11.6943397269478,1.89431704885344
2021-06-16,51863,7,43270,4,8593,3,47379,4,349007,362,396386,366,1,644,-6,49,12,51170,0,1430,651,"Knox County",470313,11.481715368276,0.0163304514889529,77.8205152738708,1.48837051070245,10.4185935749171,1.63304514889529
2021-06-15,51856,13,43266,9,8590,4,47375,14,348645,428,396020,442,0,643,-2,55,15,51158,0,1430,651,"Knox County",470313,11.2690910096042,0.0189260563380282,93.9799665329259,2.76411666273312,11.6943397269478,1.89260563380282
2021-06-14,51843,7,43257,2,8586,5,47361,3,348217,260,395578,263,1,643,-5,57,11,51143,0,1430,651,"Knox County",470313,10.8438422922607,0.0165400089405454,55.9202063306777,1.48837051070245,12.1195884442914,1.65400089405454
2021-06-13,51836,3,43255,3,8581,0,47358,4,347957,128,395315,132,0,642,-5,62,8,51132,1,1430,651,"Knox County",470313,10.8438422922607,0.0172335600907029,28.0664153446747,0.637873076015334,13.1827102376502,1.72335600907029
2021-06-12,51833,2,43252,1,8581,1,47354,1,347829,226,395183,227,0,642,-6,67,8,51124,0,1429,651,"Knox County",470313,10.6312179335889,0.0169642857142857,48.2657294184936,0.425248717343556,14.2458320310091,1.69642857142857
2021-06-11,51831,7,43251,3,8580,4,47353,2,347603,318,394956,320,0,642,-2,73,9,51116,0,1429,650,"Knox County",470313,10.8438422922607,0.0162708883025506,68.039794774969,1.48837051070245,15.5215781830398,1.62708883025506
2021-06-10,51824,7,43248,4,8576,3,47351,5,347285,358,394636,363,0,642,-1,75,8,51107,0,1429,649,"Knox County",470313,9.7807204989018,0.0156176053005206,77.1826421978555,1.48837051070245,15.9468269003834,1.56176053005206
2021-06-09,51817,2,43244,1,8573,1,47346,1,346927,367,394273,368,1,642,-17,76,18,51099,0,1429,649,"Knox County",470313,8.7175987055429,0.0141843971631206,78.2457639912144,0.425248717343556,16.1594512590551,1.41843971631206
2021-06-08,51815,5,43243,3,8572,2,47345,4,346560,266,393905,270,1,641,-17,93,21,51081,0,1429,648,"Knox County",470313,7.01660383616868,0.0102933607822954,57.4085768413801,1.06312179335889,19.7740653564754,1.02933607822954
2021-06-07,51810,15,43240,9,8570,6,47341,10,346294,316,393635,326,0,640,-8,110,23,51060,2,1429,647,"Knox County",470313,8.7175987055429,0.0134596211365902,69.3155409269997,3.18936538007667,23.3886794538956,1.34596211365902
2021-06-06,51795,4,43231,2,8564,2,47331,2,345978,178,393309,180,0,640,-5,118,9,51037,0,1427,647,"Knox County",470313,8.93022306421468,0.0121713729308666,38.2723845609201,0.850497434687113,25.0896743232698,1.21713729308666
2021-06-05,51791,5,43229,2,8562,3,47329,3,345800,258,393129,261,0,640,-9,123,14,51028,0,1427,647,"Knox County",470313,9.56809614023002,0.0129310344827586,55.4949576133341,1.06312179335889,26.1527961166287,1.29310344827586
2021-06-04,51786,7,43227,2,8559,5,47326,3,345542,325,392868,328,1,640,-9,132,15,51014,0,1427,647,"Knox County",470313,9.56809614023002,0.0133587786259542,69.7407896443432,1.48837051070245,28.0664153446747,1.33587786259542
2021-06-03,51779,7,43225,4,8554,3,47323,6,345217,458,392540,464,0,639,-12,141,19,50999,0,1427,647,"Knox County",470313,9.56809614023002,0.0131998179335457,98.6577024237051,1.48837051070245,29.9800345727207,1.31998179335457
2021-06-02,51772,20,43221,7,8551,13,47317,6,344759,282,392076,288,0,639,5,153,15,50980,1,1427,647,"Knox County",470313,13.395334596322,0.0160604629192253,61.2358152974721,4.25248717343556,32.5315268767821,1.60604629192253
2021-06-01,51752,12,43214,9,8538,3,47311,10,344477,291,391788,301,0,639,-10,148,22,50965,1,1426,647,"Knox County",470313,14.8837051070245,0.0186219739292365,63.9999319602052,2.55149230406134,31.4684050834232,1.86219739292365
2021-05-31,51740,17,43205,14,8535,3,47301,12,344186,354,391487,366,0,639,-1,158,18,50943,0,1425,647,"Knox County",470313,15.308953824368,0.0191956124314442,77.8205152738708,3.61461409742023,33.5946486701409,1.91956124314442
2021-05-30,51723,3,43191,1,8532,2,47289,1,343832,203,391121,204,0,639,-9,159,12,50925,0,1425,647,"Knox County",470313,15.0963294656962,0.0185352622061483,43.3753691690427,0.637873076015334,33.8072730288127,1.85352622061483
2021-05-29,51720,14,43190,8,8530,6,47288,6,343629,199,390917,205,0,639,-14,168,28,50913,1,1425,647,"Knox County",470313,17.0099486937423,0.0204081632653061,43.5879935277145,2.97674102140489,35.7208922568587,2.04081632653061
2021-05-28,51706,11,43182,6,8524,5,47282,10,343430,390,390712,400,0,639,-10,182,21,50885,1,1424,646,"Knox County",470313,17.8604461284294,0.0228904847396768,85.0497434687113,2.33886794538956,38.6976332782636,2.28904847396768
2021-05-27,51695,23,43176,8,8519,15,47272,9,343040,341,390312,350,0,639,-5,192,28,50864,1,1423,646,"Knox County",470313,21.2624358671778,0.0255439924314096,74.4185255351224,4.8903602494509,40.8238768649814,2.55439924314096
2021-05-26,51672,16,43168,8,8504,8,47263,11,342699,571,389962,582,0,639,-8,197,24,50836,0,1422,646,"Knox County",470313,20.4119384324907,0.0245016611295681,123.747376746975,3.40198973874845,41.8869986583403,2.45016611295681
2021-05-25,51656,18,43160,8,8496,10,47252,7,342128,311,389380,318,0,639,-10,205,28,50812,1,1422,646,"Knox County",470313,21.6876845845214,0.0230927835051546,67.6145460576254,3.82723845609201,43.5879935277145,2.30927835051546
2021-05-24,51638,25,43152,21,8486,4,47245,24,341817,425,389062,449,0,639,-11,215,36,50784,1,1421,646,"Knox County",470313,23.3886794538956,0.0271132376395534,95.4683370436284,5.31560896679445,45.7142371144323,2.71132376395534
2021-05-23,51613,16,43131,8,8482,8,47221,8,341392,225,388613,233,1,639,-5,226,20,50748,1,1420,646,"Knox County",470313,26.1527961166287,0.0295624753646039,49.5414755705243,3.40198973874845,48.0531050598219,2.95624753646039
2021-05-22,51597,8,43123,4,8474,4,47213,4,341167,269,388380,273,0,638,-6,231,14,50728,0,1419,645,"Knox County",470313,24.877049964598,0.0280230326295585,58.0464499173954,1.70099486937423,49.1162268531808,2.80230326295585
2021-05-21,51589,16,43119,12,8470,4,47209,14,340898,377,388107,391,0,638,-17,237,33,50714,1,1419,645,"Knox County",470313,25.9401717579569,0.0296610169491525,83.1361242406653,3.40198973874845,50.3919730052114,2.96610169491525
2021-05-20,51573,34,43107,26,8466,8,47195,27,340521,594,387716,621,0,638,6,254,28,50681,1,1418,644,"Knox County",470313,28.2790397033465,0.0331356818974538,132.039726735174,7.22922819484046,54.0065871026317,3.31356818974538
2021-05-19,51539,14,43081,6,8458,8,47168,6,339927,544,387095,550,0,638,-29,248,43,50653,1,1417,644,"Knox County",470313,27.8537909860029,0.0317460317460317,116.943397269478,2.97674102140489,52.730840950601,3.17460317460317
2021-05-18,51525,24,43075,14,8450,10,47162,14,339383,444,386545,458,1,638,-21,277,44,50610,0,1416,644,"Knox County",470313,29.1295371380336,0.0326050420168067,97.3819562716744,5.10298460812268,58.8969473520825,3.26050420168067
2021-05-17,51501,15,43061,8,8440,7,47148,8,338939,420,386087,428,0,637,-18,298,33,50566,0,1416,643,"Knox County",470313,27.0032935513158,0.0274204468517265,91.0032255115211,3.18936538007667,63.3620588841899,2.74204468517265
2021-05-16,51486,22,43053,13,8433,9,47140,12,338519,272,385659,284,1,637,-10,316,31,50533,1,1416,643,"Knox County",470313,28.2790397033465,0.0282861896838602,60.385317862785,4.67773589077912,67.1892973402819,2.82861896838602
2021-05-15,51464,23,43040,13,8424,10,47128,17,338247,336,385375,353,0,636,-8,326,31,50502,1,1415,643,"Knox County",470313,31.4684050834232,0.0317666126418152,75.0563986111377,4.8903602494509,69.3155409269997,3.17666126418152
2021-05-14,51441,36,43027,25,8414,11,47111,26,337911,498,385022,524,0,636,4,334,32,50471,4,1414,642,"Knox County",470313,35.7208922568587,0.0341827221876942,111.415163944012,7.65447691218401,71.0165357963739,3.41827221876942
2021-05-13,51405,31,43002,17,8403,14,47085,17,337413,376,384498,393,0,636,-17,330,48,50439,0,1410,642,"Knox County",470313,35.0830191808434,0.0334448160535117,83.5613729580088,6.59135511882512,70.1660383616868,3.34448160535117
2021-05-12,51374,34,42985,28,8389,6,47068,26,337037,506,384105,532,0,636,-15,347,49,50391,0,1410,642,"Knox County",470313,39.335506354279,0.0403768506056528,113.116158813386,7.22922819484046,73.780652459107,4.03768506056528
2021-05-11,51340,36,42957,30,8383,6,47042,31,336531,555,383573,586,0,636,-11,362,47,50342,4,1410,642,"Knox County",470313,41.8869986583403,0.0441935483870968,124.597874181662,7.65447691218401,76.9700178391837,4.41935483870968
2021-05-10,51304,21,42927,14,8377,7,47011,13,335976,277,382987,290,1,636,-26,373,46,50295,1,1406,642,"Knox County",470313,43.162744810371,0.0479405806887238,61.6610640148157,4.46511153210734,79.3088857845732,4.79405806887238
2021-05-09,51283,17,42913,14,8370,3,46998,17,335699,369,382697,386,0,635,-22,399,39,50249,1,1405,641,"Knox County",470313,42.0996230170121,0.047976501305483,82.0730024473064,3.61461409742023,84.8371191100395,4.7976501305483
2021-05-08,51266,20,42899,11,8367,9,46981,14,335330,307,382311,321,0,635,-18,421,38,50210,1,1404,641,"Knox County",470313,41.4617499409967,0.0474934036939314,68.2524191336408,4.25248717343556,89.5148550008186,4.74934036939314
2021-05-07,51246,43,42888,31,8358,12,46967,33,335023,576,381990,609,0,635,3,439,40,50172,0,1403,641,"Knox County",470313,42.9501204516992,0.0484440166827077,129.488234431113,9.14284742288646,93.3420934569106,4.84440166827077
2021-05-06,51203,40,42857,26,8346,14,46934,28,334447,340,381381,368,1,635,-8,436,47,50132,0,1403,641,"Knox County",470313,44.8637396797452,0.0523932729624838,78.2457639912144,8.50497434687113,92.7042203808953,5.23932729624838
2021-05-05,51163,51,42831,32,8332,19,46906,38,334107,585,381013,623,0,634,5,444,46,50085,4,1403,640,"Knox County",470313,48.4783537771654,0.0546654099905749,132.464975452518,10.8438422922607,94.4052152502695,5.46654099905749
2021-05-04,51112,50,42799,32,8313,18,46868,34,333522,536,380390,570,0,634,6,439,44,50039,0,1399,640,"Knox County",470313,51.4550947985703,0.0558888538048626,121.195884442914,10.6312179335889,93.3420934569106,5.58888538048626
2021-05-03,51062,24,42767,9,8295,15,46834,7,332986,309,379820,316,1,634,-37,433,60,49995,1,1399,640,"Knox County",470313,52.0929678745856,0.053554650798622,67.1892973402819,5.10298460812268,92.0663473048799,5.3554650798622
2021-05-02,51038,25,42758,18,8280,7,46827,20,332677,288,379504,308,0,633,-17,470,42,49935,2,1398,640,"Knox County",470313,53.7939627439599,0.0558587479935795,65.4883024709077,5.31560896679445,99.9334485757357,5.58587479935795
2021-05-01,51013,45,42740,35,8273,10,46807,38,332389,450,379196,488,0,633,7,487,38,49893,2,1396,640,"Knox County",470313,59.1095717107543,0.0603290676416819,103.760687031828,9.56809614023002,103.548062673156,6.03290676416819
2021-04-30,50968,58,42705,30,8263,28,46769,29,331939,567,378708,596,0,633,-10,480,68,49855,3,1394,640,"Knox County",470313,62.298937090831,0.0593453655552157,126.72411776838,12.3322128029631,102.059692162454,5.93453655552157
2021-04-29,50910,54,42675,34,8235,20,46740,35,331372,571,378112,606,0,633,-2,490,56,49787,2,1391,639,"Knox County",470313,65.2756781122359,0.0573139435414885,128.850361355098,11.481715368276,104.185935749171,5.73139435414885
2021-04-28,50856,47,42641,28,8215,19,46705,34,330801,543,377506,577,4,633,-38,492,81,49731,1,1389,639,"Knox County",470313,64.4251806775488,0.0569199653279399,122.684254953616,9.99334485757357,104.611184466515,5.69199653279399
2021-04-27,50809,39,42613,17,8196,22,46671,20,330258,392,376929,412,1,629,-33,530,71,49650,2,1388,637,"Knox County",470313,62.0863127321592,0.0554041780199818,87.6012357727726,8.29234998819935,112.690910096042,5.54041780199818
2021-04-26,50770,69,42596,36,8174,33,46651,40,329866,480,376517,520,1,628,2,563,66,49579,0,1386,636,"Knox County",470313,71.6544088723892,0.0615911035072712,110.564666509325,14.6710807483527,119.707513932211,6.15911035072712
2021-04-25,50701,38,42560,25,8141,13,46611,26,329386,341,375997,367,0,627,-4,561,42,49513,3,1386,635,"Knox County",470313,74.4185255351224,0.0622546270330903,78.0331396325426,8.07972562952757,119.282265214868,6.22546270330903
2021-04-24,50663,35,42535,22,8128,13,46585,28,329045,510,375630,538,0,627,-28,565,63,49471,3,1383,635,"Knox County",470313,72.2922819484046,0.0586283185840708,114.391904965417,7.44185255351224,120.132762649555,5.86283185840708
2021-04-23,50628,43,42513,31,8115,12,46557,36,328535,553,375092,589,0,627,-4,593,47,49408,2,1380,635,"Knox County",470313,69.1029165683279,0.0606816292601829,125.235747257677,9.14284742288646,126.086244692364,6.06816292601829
2021-04-22,50585,79,42482,62,8103,17,46521,65,327982,787,374503,852,1,627,15,597,63,49361,1,1378,635,"Knox County",470313,74.4185255351224,0.064591439688716,181.155953588355,16.7973243350705,126.936742127052,6.4591439688716
2021-04-21,50506,62,42420,34,8086,28,46456,35,327195,479,373651,514,1,626,-2,582,63,49298,1,1377,634,"Knox County",470313,77.607890915199,0.0659282700421941,109.288920357294,13.1827102376502,123.747376746975,6.59282700421941
2021-04-20,50444,38,42386,34,8058,4,46421,39,326716,474,373137,513,1,625,-32,584,69,49235,1,1376,633,"Knox County",470313,77.3952665565272,0.0690983817107629,109.076295998622,8.07972562952757,124.172625464318,6.90983817107629
2021-04-19,50406,65,42352,41,8054,24,46382,39,326242,336,372624,375,0,624,-3,616,68,49166,0,1375,632,"Knox County",470313,76.5447691218401,0.0715048025613661,79.7341345019168,13.8205833136656,130.976604941815,7.15048025613661
2021-04-18,50341,38,42311,27,8030,11,46343,32,325906,364,372249,396,0,624,-12,619,50,49098,1,1375,632,"Knox County",470313,76.5447691218401,0.0725443473656341,84.1992460340241,8.07972562952757,131.614478017831,7.25443473656341
2021-04-17,50303,37,42284,18,8019,19,46311,23,325542,335,371853,358,0,624,-23,631,60,49048,1,1374,631,"Knox County",470313,76.9700178391837,0.0747845426744509,76.1195204044966,7.86710127085579,134.165970321892,7.47845426744509
2021-04-16,50266,346,42266,330,8000,16,46288,369,325207,2088,371495,2457,1,624,279,654,66,48988,4,1373,631,"Knox County",470313,141.395198516732,0.110155535224154,522.418049256559,73.5680281004352,139.056330571343,11.0155535224154
2021-04-15,49920,86,41936,54,7984,32,45919,55,323119,577,369038,632,1,623,12,375,73,48922,0,1369,630,"Knox County",470313,142.883569027435,0.112869399428027,134.378594680564,18.2856948457729,79.7341345019168,11.2869399428027
2021-04-14,49834,85,41882,60,7952,25,45864,62,322542,684,368406,746,0,622,-1,363,86,48849,3,1369,629,"Knox County",470313,147.773929276886,0.113018075588826,158.617771569146,18.0730704871011,77.1826421978555,11.3018075588826
2021-04-13,49749,68,41822,38,7927,30,45802,43,321858,340,367660,383,-5,622,-8,364,81,48763,1,1366,629,"Knox County",470313,154.152660037039,0.116513933046568,81.435129371291,14.4584563896809,77.3952665565272,11.6513933046568
2021-04-12,49681,63,41784,43,7897,20,45759,50,321518,360,367277,410,1,627,-24,372,86,48682,0,1365,629,"Knox County",470313,153.727411319696,0.117800074321813,87.175987055429,13.395334596322,79.0962614259015,11.7800074321813
2021-04-11,49618,26,41741,14,7877,12,45709,14,321158,296,366867,310,2,626,-26,396,50,48596,0,1365,628,"Knox County",470313,151.175919015634,0.11631419939577,65.9135511882512,5.52823332546623,84.1992460340241,11.631419939577
2021-04-10,49592,50,41727,33,7865,17,45695,41,320862,571,366557,612,0,624,6,422,44,48546,1,1365,628,"Knox County",470313,153.940035678367,0.114234234234234,130.126107507128,10.6312179335889,89.7274793594904,11.4234234234234
2021-04-09,49542,82,41694,62,7848,20,45654,71,320291,620,365945,691,5,624,11,416,66,48502,2,1364,627,"Knox County",470313,97.8072049890179,0.0887949260042283,146.923431842199,17.4351974110858,88.4517332074597,8.87949260042283
2021-04-08,49460,49,41632,26,7828,23,45583,26,319671,466,365254,492,-6,619,-23,405,78,48436,0,1362,627,"Knox County",470313,89.9401037181622,0.0842480790340285,104.611184466515,10.4185935749171,86.1128652620702,8.42480790340285
2021-04-07,49411,77,41606,54,7805,23,45557,57,319205,768,364762,825,2,625,9,428,66,48358,1,1362,627,"Knox County",470313,88.2391088487879,0.0811173784582326,175.415095904217,16.3720756177269,91.0032255115211,8.11173784582326
2021-04-06,49334,75,41552,41,7782,34,45500,45,318437,422,363937,467,2,623,-3,419,76,48292,0,1361,627,"Knox County",470313,89.7274793594904,0.079852902547938,99.2955754997204,15.9468269003834,89.089606283475,7.9852902547938
2021-04-05,49259,44,41511,32,7748,12,45455,35,318015,266,363470,301,0,621,-60,422,104,48216,3,1361,627,"Knox County",470313,85.6876165447266,0.0781503515413737,63.9999319602052,9.35547178155824,89.7274793594904,7.81503515413737
2021-04-04,49215,49,41479,31,7736,18,45420,40,317749,341,363169,381,3,621,-27,482,73,48112,0,1358,626,"Knox County",470313,90.5779767941775,0.0835765455027859,81.0098806539475,10.4185935749171,102.484940879797,8.35765455027859
2021-04-03,49166,81,41448,64,7718,17,45380,71,317408,593,362788,664,0,618,6,509,75,48039,0,1358,625,"Knox County",470313,97.1693319130026,0.0902904998691442,141.182574158061,17.222573052414,108.225798563935,9.02904998691442
2021-04-02,49085,76,41384,45,7701,31,45309,45,316815,530,362124,575,0,618,5,503,71,47964,2,1358,622,"Knox County",470313,95.8935857609719,0.0860998650472335,122.259006236272,16.1594512590551,106.950052411904,8.60998650472335
2021-04-01,49009,75,41339,63,7670,12,45264,67,316285,580,361549,647,1,618,-20,498,94,47893,1,1356,621,"Knox County",470313,101.421819086438,0.0932642487046632,137.56796006064,15.9468269003834,105.886930618546,9.32642487046632
2021-03-31,48934,87,41276,66,7658,21,45197,72,315705,765,360902,837,3,617,-16,518,100,47799,2,1355,621,"Knox County",470313,103.548062673156,0.096849173553719,177.966588208278,18.4983192044447,110.139417791981,9.6849173553719
2021-03-30,48847,57,41210,33,7637,24,45125,38,314940,460,360065,498,1,614,-25,534,81,47699,2,1353,619,"Knox County",470313,99.7208242170639,0.094286446323341,105.886930618546,12.1195884442914,113.54140753073,9.4286446323341
2021-03-29,48790,43,41177,21,7613,22,45087,22,314480,400,359567,422,5,613,-58,559,96,47618,0,1351,618,"Knox County",470313,99.5081998583922,0.088220675944334,89.7274793594904,9.14284742288646,118.857016497524,8.8220675944334
2021-03-28,48747,80,41156,46,7591,34,45065,49,314080,484,359145,533,2,608,13,617,65,47522,5,1351,617,"Knox County",470313,106.099554977217,0.0871647509578544,113.328783172058,17.0099486937423,131.189229300487,8.71647509578544
2021-03-27,48667,42,41110,39,7557,3,45016,42,313596,442,358612,484,0,606,-16,604,58,47457,2,1346,616,"Knox County",470313,97.8072049890179,0.0838338338338338,102.910189597141,8.93022306421468,128.425112637754,8.38338338338338
2021-03-26,48625,79,41071,54,7554,25,44974,60,313154,417,358128,477,0,606,1,620,78,47399,2,1344,615,"Knox County",470313,98.4450780650333,0.0897896357106208,101.421819086438,16.7973243350705,131.827102376502,8.97896357106208
2021-03-25,48546,88,41017,64,7529,24,44914,67,312737,570,357651,637,0,606,7,619,81,47321,4,1342,613,"Knox County",470313,101.209194727766,0.0900205761316872,135.441716473923,18.7109435631165,131.614478017831,9.00205761316873
2021-03-24,48458,123,40953,91,7505,32,44847,95,312167,780,357014,875,1,606,38,612,84,47240,3,1338,612,"Knox County",470313,108.86367163995,0.0950076413652573,186.046313837806,26.1527961166287,130.126107507128,9.50076413652573
2021-03-23,48335,87,40862,57,7473,30,44752,63,311387,531,356139,594,1,605,17,574,69,47156,3,1335,611,"Knox County",470313,115.242402400104,0.0989557434112382,126.298869051036,18.4983192044447,122.046381877601,9.89557434112382
2021-03-22,48248,115,40805,78,7443,37,44689,81,310856,517,355545,598,2,604,32,557,81,47087,1,1332,610,"Knox County",470313,130.551356224472,0.108861362553597,127.149366485723,24.4518012472545,118.43176778018,10.8861362553597
2021-03-21,48133,50,40727,33,7406,17,44608,34,310339,330,354947,364,0,602,4,525,46,47006,1,1331,610,"Knox County",470313,124.172625464318,0.109704641350211,77.3952665565272,10.6312179335889,111.627788302684,10.9704641350211
2021-03-20,48083,59,40694,29,7389,30,44574,33,310009,315,354583,348,0,602,3,521,56,46960,4,1330,609,"Knox County",470313,127.787239561739,0.111225276136656,73.9932768177788,12.5448371616349,110.777290867996,11.1225276136656
2021-03-19,48024,146,40665,102,7359,44,44541,117,309694,956,354235,1073,3,602,51,518,92,46904,3,1326,609,"Knox County",470313,142.033071592748,0.109155713967476,228.145936854818,31.0431563660796,110.139417791981,10.9155713967476
2021-03-18,47878,68,40563,50,7315,18,44424,66,308738,627,353162,693,2,599,-16,467,82,46812,1,1323,608,"Knox County",470313,137.780584419312,0.107590759075908,147.348680559542,14.4584563896809,99.2955754997204,10.7590759075908
2021-03-17,47810,46,40513,36,7297,10,44358,41,308111,498,352469,539,1,597,-40,483,85,46730,3,1322,608,"Knox County",470313,121.408508801585,0.103349964362081,114.604529324088,9.7807204989018,102.697565238469,10.3349964362081
2021-03-16,47764,128,40477,84,7287,44,44317,100,307613,699,351930,799,0,596,48,523,80,46645,3,1319,606,"Knox County",470313,130.126107507128,0.106932487539647,169.886862578751,27.2159179099876,111.20253958534,10.6932487539647
2021-03-15,47636,44,40393,28,7243,16,44217,40,306914,290,351131,330,1,596,-65,475,108,46565,1,1316,605,"Knox County",470313,115.029778041432,0.103955619874578,70.1660383616868,9.35547178155824,100.996570369095,10.3955619874578
2021-03-14,47592,60,40365,38,7227,22,44177,46,306624,405,350801,451,0,595,-12,540,72,46457,0,1315,604,"Knox County",470313,117.15602162815,0.104653909756674,95.893585760972,12.7574615203067,114.81715368276,10.4653909756674
2021-03-13,47532,71,40327,34,7205,37,44131,41,306219,623,350350,664,1,595,-10,552,80,46385,1,1315,604,"Knox County",470313,119.707513932211,0.0991426687183996,141.182574158061,15.0963294656962,117.368645986822,9.91426687183997
2021-03-12,47461,63,40293,60,7168,3,44090,67,305596,692,349686,759,0,594,-52,562,115,46305,1,1314,602,"Knox County",470313,102.059692162454,0.0946871310507674,161.38188823188,13.395334596322,119.494889573539,9.46871310507674
2021-03-11,47398,83,40233,56,7165,27,44023,66,304904,627,348927,693,2,594,-22,614,103,46190,0,1313,600,"Knox County",470313,105.24905754253,0.0946871310507674,147.348680559542,17.6478217697576,130.551356224472,9.46871310507674
2021-03-10,47315,95,40177,72,7138,23,43957,82,304277,1001,348234,1083,2,592,26,636,67,46087,1,1313,599,"Knox County",470313,115.667651117447,0.0924879681941829,230.272180441536,20.1993140738189,135.229092115251,9.24879681941829
2021-03-09,47220,80,40105,50,7115,30,43875,55,303276,597,347151,652,0,590,-6,610,86,46020,2,1312,599,"Knox County",470313,105.461681901202,0.0857081174438687,138.631081853999,17.0099486937423,129.700858789785,8.57081174438687
2021-03-08,47140,85,40055,57,7085,28,43820,63,302679,412,346499,475,1,590,-30,616,114,45934,0,1310,595,"Knox County",470313,114.179280606745,0.0879212895122462,100.996570369095,18.0730704871011,130.976604941815,8.79212895122462
2021-03-07,47055,64,39998,40,7057,24,43757,42,302267,327,346024,369,0,589,-5,646,69,45820,0,1310,593,"Knox County",470313,115.029778041432,0.088604898828541,78.4583883498861,13.6079589549938,137.355335701969,8.8604898828541
2021-03-06,46991,125,39958,87,7033,38,43715,95,301940,848,345655,943,0,589,40,651,85,45751,1,1310,593,"Knox County",470313,126.511493409708,0.0944913550462405,200.504770227487,26.5780448339723,138.418457495328,9.44913550462405
2021-03-05,46866,70,39871,44,6995,26,43620,49,301092,521,344712,570,2,589,-19,611,87,45666,2,1309,593,"Knox County",470313,127.99986392041,0.0944618599791014,121.195884442914,14.8837051070245,129.913483148456,9.44618599791014
2021-03-04,46796,112,39827,85,6969,27,43571,100,300571,1094,344142,1194,5,587,-1,630,108,45579,1,1307,591,"Knox County",470313,134.165970321892,0.0919409761634506,253.873484254103,23.8139281712392,133.95334596322,9.19409761634506
2021-03-03,46684,74,39742,33,6942,41,43471,40,299477,497,342948,537,1,582,-49,631,122,45471,4,1306,589,"Knox County",470313,129.700858789785,0.0936708860759494,114.179280606745,15.7342025417116,134.165970321892,9.36708860759494
2021-03-02,46610,133,39709,91,6901,42,43431,99,298980,808,342411,907,-1,581,9,680,125,45349,2,1302,588,"Knox County",470313,140.969949799389,0.0976976976976977,192.850293315303,28.2790397033465,144.584563896809,9.76976976976977
2021-03-01,46477,59,39618,33,6859,26,43332,35,298172,165,341504,200,1,582,-58,671,116,45224,1,1300,585,"Knox County",470313,135.441716473923,0.0974576271186441,42.5248717343556,12.5448371616349,142.670944668763,9.74576271186441
2021-02-28,46418,77,39585,53,6833,24,43297,63,298007,563,341304,626,2,581,-19,729,94,45108,2,1299,585,"Knox County",470313,138.205833136656,0.0966445649989954,133.102848528533,16.3720756177269,155.003157471726,9.66445649989954
2021-02-27,46341,82,39532,47,6809,35,43234,58,297444,671,340678,729,1,579,-33,748,114,45014,3,1297,584,"Knox County",470313,129.062985713769,0.0932185597312618,155.003157471726,17.4351974110858,159.04302028649,9.32185597312618
2021-02-26,46259,107,39485,70,6774,37,43176,80,296773,506,339949,586,5,578,-17,781,119,44900,1,1294,583,"Knox County",470313,136.930086984625,0.0993931784892237,124.597874181662,22.7508063778803,166.059624122659,9.93931784892237
2021-02-25,46152,131,39415,92,6737,39,43096,97,296267,1029,339363,1126,2,573,-7,798,136,44781,5,1293,583,"Knox County",470313,140.969949799389,0.100191042241562,239.415027864422,27.8537909860029,169.674238220079,10.0191042241562
2021-02-24,46021,102,39323,72,6698,30,42999,80,295238,969,338237,1049,2,571,-30,805,130,44645,2,1288,582,"Knox County",470313,146.923431842199,0.0980279532835535,223.042952246695,21.6876845845214,171.162608730781,9.80279532835535
2021-02-23,45919,122,39251,68,6668,54,42919,75,294269,758,337188,833,5,569,-32,835,149,44515,6,1286,581,"Knox County",470313,144.584563896809,0.0947756845989512,177.116090773591,25.9401717579569,177.541339490935,9.47756845989512
2021-02-22,45797,62,39183,33,6614,29,42844,38,293511,307,336355,345,3,564,-110,867,169,44366,3,1280,579,"Knox County",470313,145.222436972824,0.0927465054778995,73.3554037417635,13.1827102376502,184.345318968432,9.27465054778995
2021-02-21,45735,82,39150,41,6585,41,42806,45,293204,499,336010,544,2,561,-31,977,111,44197,3,1277,577,"Knox County",470313,146.285558766183,0.090752110514198,115.667651117447,17.4351974110858,207.733998422327,9.0752110514198
2021-02-20,45653,137,39109,98,6544,39,42761,115,292705,1007,335466,1122,1,559,8,1008,128,44086,2,1274,574,"Knox County",470313,157.979898493131,0.0945584299732382,238.564530429735,29.1295371380336,214.325353541152,9.45584299732382
2021-02-19,45516,95,39011,43,6505,52,42646,48,291698,274,334344,322,1,558,-83,1000,177,43958,2,1272,573,"Knox County",470313,155.42840618907,0.0932409661112151,68.4650434923126,20.1993140738189,212.624358671778,9.32409661112151
2021-02-18,45421,155,38968,111,6453,44,42598,119,291424,988,334022,1107,4,557,-38,1083,189,43781,6,1270,571,"Knox County",470313,160.531390797193,0.0977076287110109,235.375165049658,32.9567755941256,230.272180441536,9.77076287110109
2021-02-17,45266,114,38857,68,6409,46,42479,76,290436,892,332915,968,1,553,-49,1121,162,43592,4,1264,565,"Knox County",470313,163.082883101254,0.0984544934172868,205.820379194281,24.2391768885827,238.351906071063,9.84544934172868
2021-02-16,45152,146,38789,90,6363,56,42403,101,289544,818,331947,919,2,552,-41,1170,185,43430,4,1260,562,"Knox County",470313,168.185867709377,0.101745823165008,195.401785619364,31.0431563660796,248.77049964598,10.1745823165008
2021-02-15,45006,76,38699,36,6307,40,42302,43,288726,312,331028,355,2,550,-140,1211,214,43245,1,1256,562,"Knox County",470313,171.162608730781,0.102492036724752,75.4816473284812,16.1594512590551,257.488098351523,10.2492036724752
2021-02-14,44930,165,38663,135,6267,30,42259,135,288414,706,330673,841,2,548,20,1351,143,43031,5,1255,562,"Knox County",470313,188.810430500539,0.113063542776003,178.817085642965,35.0830191808434,287.255508565572,11.3063542776003
2021-02-13,44765,135,38528,91,6237,44,42124,106,287708,871,329832,977,4,546,-9,1331,140,42888,7,1250,561,"Knox County",470313,188.385181783195,0.11441063946074,207.733998422327,28.7042884206901,283.003021392137,11.441063946074
2021-02-12,44630,179,38437,114,6193,65,42018,124,286837,996,328855,1120,3,542,13,1340,163,42748,3,1243,557,"Knox County",470313,206.245627911625,0.111977095594083,238.139281712392,38.0597602022483,284.916640620183,11.1977095594083
2021-02-11,44451,162,38323,112,6128,50,41894,118,285841,1133,327735,1251,5,539,-34,1327,191,42585,5,1240,556,"Knox County",470313,207.733998422327,0.109314259057689,265.993072698394,34.4451461048281,282.15252395745,10.9314259057689
2021-02-10,44289,148,38211,106,6078,42,41776,112,284708,1032,326484,1144,7,534,-47,1361,188,42394,6,1235,554,"Knox County",470313,214.963226617168,0.111851067050098,243.242266320514,31.4684050834232,289.38175215229,11.1851067050098
2021-02-09,44141,209,38105,154,6036,55,41664,165,283676,1023,325340,1188,0,527,12,1408,197,42206,6,1229,552,"Knox County",470313,228.35856121349,0.116783013379872,252.597738102072,44.4384909624016,299.375097009864,11.6783013379872
2021-02-08,43932,107,37951,72,5981,35,41499,76,282653,371,324152,447,4,527,-159,1396,262,42009,2,1223,547,"Knox County",470313,234.949916332315,0.119977037887486,95.0430883262848,22.7508063778803,296.823604705802,11.9977037887486
2021-02-07,43825,108,37879,75,5946,33,41423,83,282282,716,323705,799,1,523,-28,1555,135,41747,2,1221,544,"Knox County",470313,222.830327888024,0.113196650303205,169.886862578751,22.963430736552,330.630877734615,11.3196650303205
2021-02-06,43717,304,37804,176,5913,128,41340,197,281566,1396,322906,1593,2,522,136,1583,166,41612,6,1219,543,"Knox County",470313,258.763844503554,0.116016971625564,338.710603364143,64.6378050362206,336.584359777425,11.6016971625564
2021-02-05,43413,177,37628,131,5785,46,41143,143,280170,727,321313,870,8,520,-4,1447,173,41446,4,1213,539,"Knox County",470313,258.33859578621,0.12260010970927,184.983192044447,37.6345114849047,307.667446998063,12.260010970927
2021-02-04,43236,199,37497,148,5739,51,41000,161,279443,1582,320443,1743,2,512,0,1451,197,41273,7,1209,536,"Knox County",470313,266.205697057066,0.120375128468654,370.604257164909,42.3122473756839,308.51794443275,12.0375128468654
2021-02-03,43037,230,37349,165,5688,65,40839,172,277861,1634,318700,1806,5,510,-8,1451,233,41076,7,1202,528,"Knox County",470313,283.640894468152,0.118044044518115,383.999591761231,48.903602494509,308.51794443275,11.8044044518115
2021-02-02,42807,91,37184,70,5623,21,40667,77,276227,291,316894,368,7,505,-160,1459,244,40843,1,1195,528,"Knox County",470313,258.551220144882,0.119197482297404,78.2457639912144,19.3488166391318,310.218939302124,11.9197482297404
2021-02-01,42716,153,37114,82,5602,71,40590,97,275936,425,316526,522,4,498,-125,1619,274,40599,2,1194,526,"Knox County",470313,268.331940643784,0.120763537202961,110.989915226668,32.5315268767821,344.238836689609,12.0763537202961
2021-01-31,42563,174,37032,120,5531,54,40493,129,275511,939,316004,1068,7,494,12,1744,155,40325,4,1192,523,"Knox County",470313,282.365148316121,0.122459222082811,227.082815061459,36.9966384088894,370.816881523581,12.2459222082811
2021-01-30,42389,277,36912,233,5477,44,40364,250,274572,1518,314936,1768,7,487,92,1732,178,40170,9,1188,521,"Knox County",470313,276.624290631983,0.126335174953959,375.919866131704,58.8969473520825,368.26538921952,12.6335174953959
2021-01-29,42112,101,36679,52,5433,49,40114,62,273054,376,313168,438,4,480,-140,1640,237,39992,1,1179,515,"Knox County",470313,260.464839372928,0.12290937378452,93.1294690982388,21.4750602258496,348.703948221716,12.290937378452
2021-01-28,42011,157,36627,116,5384,41,40052,129,272678,657,312730,786,9,476,-75,1780,223,39755,5,1178,510,"Knox County",470313,251.534616308714,0.135583185316755,167.122745916018,33.3820243114692,378.471358435765,13.5583185316755
2021-01-27,41854,168,36511,123,5343,45,39923,125,272021,894,311944,1019,12,467,-73,1855,229,39532,2,1173,506,"Knox County",470313,238.351906071063,0.145585525213604,216.664221486542,35.7208922568587,394.418185336148,14.5585525213604
2021-01-26,41686,234,36388,173,5298,61,39798,193,271127,1041,310925,1234,3,455,-26,1928,257,39303,7,1171,502,"Knox County",470313,268.757189361128,0.144111192392099,262.378458600974,49.7540999291961,409.939763519188,14.4111192392099
2021-01-25,41452,158,36215,106,5237,52,39605,115,270086,415,309691,530,9,452,-198,1954,347,39046,1,1164,495,"Knox County",470313,269.820311154486,0.146573140435482,112.690910096042,33.5946486701409,415.467996844654,14.6573140435481
2021-01-24,41294,157,36109,104,5185,53,39490,111,269671,791,309161,902,4,443,-98,2152,251,38699,2,1163,491,"Knox County",470313,266.205697057066,0.147521341920024,191.787171521944,33.3820243114692,457.567619861667,14.7521341920024
2021-01-23,41137,309,36005,222,5132,87,39379,232,268880,1492,308259,1724,7,439,63,2250,239,38448,7,1161,486,"Knox County",470313,273.009676534563,0.145786220413086,366.564394350146,65.7009268295794,478.404807011501,14.5786220413086
2021-01-22,40828,178,35783,143,5045,35,39147,176,267388,1173,306535,1349,3,432,-150,2187,325,38209,7,1154,483,"Knox County",470313,289.38175215229,0.143292682926829,286.830259848229,37.8471358435765,465.009472415179,14.3292682926829
2021-01-21,40650,268,35640,195,5010,73,38971,203,266215,1081,305186,1284,11,429,-125,2337,382,37884,6,1147,475,"Knox County",470313,312.983055964857,0.143620989803531,273.009676534563,56.9833281240365,496.903126215946,14.3620989803531
2021-01-20,40382,192,35445,131,4937,61,38768,131,265134,736,303902,867,10,418,-154,2462,336,37502,8,1141,470,"Knox County",470313,318.08604057298,0.147148288973384,184.345318968432,40.8238768649814,523.481171049918,14.7148288973384
2021-01-19,40190,310,35314,195,4876,115,38637,219,264398,957,303035,1176,8,408,-85,2616,387,37166,14,1133,460,"Knox County",470313,334.245491832035,0.15155771195097,250.046245798011,65.9135511882512,556.225322285372,15.155771195097
2021-01-18,39880,129,35119,80,4761,49,38418,87,263441,472,301859,559,7,400,-364,2701,486,36779,4,1119,457,"Knox County",470313,328.079385430554,0.147436712886401,118.857016497524,27.4285422686594,574.298392772473,14.7436712886401
2021-01-17,39751,181,35039,138,4712,43,38331,151,262969,690,301300,841,3,393,-205,3065,383,36293,8,1115,448,"Knox County",470313,333.182370038676,0.153717948717949,178.817085642965,38.4850089195918,651.693659329,15.3717948717949
2021-01-16,39570,421,34901,340,4669,81,38180,389,262279,1757,300459,2146,1,390,9,3270,411,35910,7,1107,442,"Knox County",470313,356.996298209916,0.164923376307468,456.291873709636,89.5148550008186,695.281652856715,16.4923376307468
2021-01-15,39149,187,34561,149,4588,38,37791,153,260522,755,298313,908,0,389,-95,3261,282,35499,4,1100,434,"Knox County",470313,358.909917437962,0.171314741035857,193.062917673975,39.7607550716225,693.368033628669,17.1314741035857
2021-01-14,38962,338,34412,267,4550,71,37638,290,259767,1479,297405,1769,6,389,-91,3356,423,35217,7,1096,424,"Knox County",470313,373.793622544986,0.171788047423179,376.132490490376,71.867033231061,713.567347702487,17.1788047423179
2021-01-13,38624,249,34145,201,4479,48,37348,206,258288,946,295636,1152,12,383,-249,3447,486,34794,6,1089,417,"Knox County",470313,385.913210989277,0.174833352824231,244.943261189888,52.9434653092728,732.916164341619,17.4833352824231
2021-01-12,38375,332,33944,261,4431,71,37142,283,257342,1181,294484,1464,10,371,-176,3696,498,34308,6,1083,415,"Knox County",470313,390.590946880056,0.176377418259984,311.282061095483,70.5912870790304,785.859629650892,17.6377418259984
2021-01-11,38043,244,33683,197,4360,47,36859,228,256161,726,293020,954,4,361,-396,3872,636,33810,5,1077,410,"Knox County",470313,415.042748127311,0.184102230885857,202.843638172876,51.8803435159139,823.281516777125,18.4102230885857
2021-01-10,37799,328,33486,205,4313,123,36631,222,255435,1013,292066,1235,5,357,-6,4268,329,33174,17,1072,404,"Knox County",470313,446.298528852062,0.183942667220607,262.591082959646,69.7407896443432,907.480762811149,18.3942667220607
2021-01-09,37471,475,33281,393,4190,82,36409,426,254422,1384,290831,1810,5,352,101,4274,369,32845,12,1055,398,"Knox County",470313,457.780244220338,0.194575979337064,384.850089195918,100.996570369095,908.75650896318,19.4575979337064
2021-01-08,36996,459,32888,371,4108,88,35983,392,253038,1432,289021,1824,7,347,267,4173,185,32476,6,1043,396,"Knox County",470313,515.614069779062,0.200528996865204,387.826830217323,97.5945806303462,887.28144873733,20.0528996865204
2021-01-07,36537,389,32517,346,4020,43,35591,354,251606,1309,287197,1663,10,340,73,3906,306,32291,10,1037,388,"Knox County",470313,526.457912071323,0.208968521084934,353.594308471167,82.7108755233217,830.510744971965,20.8968521084934
2021-01-06,36148,497,32171,363,3977,134,35237,378,250297,1187,285534,1565,9,330,59,3833,429,31985,15,1027,385,"Knox County",470313,579.188753021924,0.217118402282454,332.757121321333,105.674306259874,814.989166788926,21.7118402282454
2021-01-05,35651,520,31808,328,3843,192,34859,345,249110,1193,283969,1538,14,321,32,3774,474,31556,14,1012,376,"Knox County",470313,619.162132452218,0.221456228161299,327.016263637195,110.564666509325,802.444329627291,22.1456228161299
2021-01-04,35131,322,31480,228,3651,94,34514,249,247917,654,282431,903,6,307,-222,3742,538,31082,6,998,370,"Knox County",470313,635.746832428617,0.224520781932055,191.999795880616,68.4650434923126,795.640350149794,22.4520781932055
2021-01-03,34809,285,31252,182,3557,103,34265,195,247263,608,281528,803,2,301,-15,3964,298,30544,10,992,362,"Knox County",470313,626.60398500573,0.231446665347318,170.737360013438,60.5979422214568,842.842957774929,23.1446665347318
2021-01-02,34524,422,31070,319,3454,103,34070,345,246655,1095,280725,1440,0,299,105,3979,317,30246,22,982,353,"Knox County",470313,615.334893996126,0.231922760887428,306.179076487361,89.7274793594904,846.032323155005,23.1922760887428
2021-01-01,34102,419,30751,349,3351,70,33725,374,245560,1297,279285,1671,2,299,2,3874,415,29929,7,960,349,"Knox County",470313,606.829919649255,0.233747260774288,355.295303340541,89.089606283475,823.706765494469,23.3747260774288
2020-12-31,33683,448,30402,311,3281,137,33351,322,244263,929,277614,1251,12,297,0,3872,436,29514,8,953,343,"Knox County",470313,619.37475681089,0.240758913967942,265.993072698394,95.2557126849566,823.281516777125,24.0758913967942
2020-12-30,33235,363,30091,248,3144,115,33029,271,243334,931,276363,1202,6,285,-146,3872,503,29078,9,945,340,"Knox County",470313,590.883092748871,0.238533151680291,255.574479123477,77.1826421978555,823.281516777125,23.8533151680291
2020-12-29,32872,590,29843,398,3029,192,32758,420,242403,1081,275161,1501,7,279,111,4018,472,28575,14,936,336,"Knox County",470313,605.766797855896,0.248090297571543,319.149162366339,125.448371616349,854.324673143205,24.8090297571543
2020-12-28,32282,252,29445,174,2837,78,32338,185,241322,565,273660,750,4,272,-331,3907,579,28103,4,922,328,"Knox County",470313,590.883092748871,0.245068461359944,159.468269003834,53.5813383852881,830.723369330637,24.5068461359944
2020-12-27,32030,230,29271,156,2759,74,32153,172,240757,489,272910,661,3,268,-74,4238,301,27524,8,918,323,"Knox County",470313,579.188753021924,0.246460594620104,140.544701082045,48.903602494509,901.102032050996,24.6460594620104
2020-12-26,31800,358,29115,288,2685,70,31981,328,240268,1064,272249,1392,0,265,59,4312,299,27223,10,910,316,"Knox County",470313,565.58079406693,0.245847176079734,295.973107271115,76.1195204044966,916.836234592707,24.5847176079734
2020-12-25,31442,353,28827,287,2615,66,31653,308,239204,1070,270857,1378,1,265,-101,4253,453,26924,5,900,310,"Knox County",470313,551.547586394592,0.246588813767671,292.99636624971,75.0563986111377,904.291397431073,24.6588813767671
2020-12-24,31089,351,28540,277,2549,74,31345,311,238134,1273,269479,1584,5,264,-111,4354,457,26471,8,895,303,"Knox County",470313,530.92302360343,0.235592820028342,336.796984136097,74.6311498937941,925.766457656922,23.5592820028342
2020-12-23,30738,472,28263,351,2475,121,31034,371,236861,1411,267895,1782,6,259,-14,4465,480,26014,9,887,296,"Knox County",470313,554.099078698654,0.231542882404951,378.896607153109,100.358697293079,949.367761469489,23.1542882404951
2020-12-22,30266,530,27912,392,2354,138,30663,432,235450,1470,266113,1902,7,253,-26,4479,549,25534,15,878,289,"Knox County",470313,541.341617178347,0.222986559424278,404.411530193722,112.690910096042,952.344502490894,22.2986559424278
2020-12-21,29736,442,27520,361,2216,81,30231,391,233980,1423,264211,1814,2,246,-137,4505,577,24985,5,863,283,"Knox County",470313,581.740245325985,0.22001331684581,385.700586630606,93.9799665329259,957.872735816361,22.001331684581
2020-12-20,29294,514,27159,431,2135,83,29840,478,232557,2245,262397,2723,2,244,235,4642,277,24408,7,858,280,"Knox County",470313,642.12556318877,0.208270377733598,578.976128663252,109.288920357294,987.002272954394,20.8270377733598
2020-12-19,28780,525,26728,441,2052,84,29362,489,230312,1445,259674,1934,6,242,252,4407,267,24131,13,851,274,"Knox County",470313,677.633831086957,0.211938705496684,411.215509671219,111.627788302684,937.035548666526,21.1938705496684
2020-12-18,28255,480,26287,420,1968,60,28873,430,228867,1358,257740,1788,4,236,98,4155,378,23864,11,838,267,"Knox County",470313,704.637124638273,0.214533895172618,380.172353305139,102.059692162454,883.454210281238,21.4533895172618
2020-12-17,27775,733,25867,635,1908,98,28443,663,227509,1898,255952,2561,11,232,288,4057,434,23486,11,827,261,"Knox County",470313,785.859629650892,0.224351902923331,544.530982558424,155.853654906413,862.617023131404,22.4351902923332
2020-12-16,27042,564,25232,452,1810,112,27780,472,225611,1729,253391,2201,8,221,99,3769,457,23052,11,816,257,"Knox County",470313,805.421070648696,0.224820746498693,467.986213436584,119.920138290883,801.381207833932,22.4820746498693
2020-12-15,26478,765,24780,675,1698,90,27308,716,223882,2415,251190,3131,2,213,324,3670,439,22595,15,805,253,"Knox County",470313,855.387794936564,0.225297176820208,665.726867001337,162.65763438391,780.331396325426,22.5297176820208
2020-12-14,25713,472,24105,411,1608,61,26592,461,221467,1624,248059,2085,6,211,-12,3346,478,22156,7,790,245,"Knox County",470313,861.766525696717,0.225841807221579,443.321787830657,100.358697293079,711.44110411577,22.5841807221579
2020-12-13,25241,628,23694,572,1547,56,26131,754,219843,2935,245974,3689,2,205,400,3358,226,21678,10,783,237,"Knox County",470313,886.0057025853,0.229167864742078,784.37125914019,133.528097245877,713.992596419831,22.9167864742078
2020-12-12,24613,464,23122,392,1491,72,25377,454,216908,2172,242285,2626,3,203,182,2958,279,21452,19,773,231,"Knox County",470313,873.035616706321,0.218461368287152,558.351565872089,98.6577024237051,628.94285295112,21.8461368287152
2020-12-11,24149,557,22730,523,1419,34,24923,429,214736,1407,239659,1836,6,200,281,2776,270,21173,10,754,227,"Knox County",470313,889.407692324048,0.217827789729163,390.378322521385,118.43176778018,590.245219672856,21.7827789729163
2020-12-10,23592,473,22207,415,1385,58,24494,538,213329,1910,237823,2448,8,194,325,2495,140,20903,9,744,225,"Knox County",470313,834.125359069386,0.212255772646536,520.504430028513,100.571321651751,530.497774886086,21.2255772646536
2020-12-09,23119,407,21792,337,1327,70,23956,359,211419,924,235375,1283,2,186,77,2170,328,20763,13,735,215,"Knox County",470313,800.743334757917,0.217042928997544,272.797052175891,86.5381139794137,461.394858317759,21.7042928997544
2020-12-08,22712,491,21455,446,1257,45,23597,538,210495,2077,234092,2615,9,184,126,2093,356,20435,9,722,212,"Knox County",470313,742.484260481849,0.213062356772404,556.0126979267,104.398560107843,445.022782700032,21.3062356772404
2020-12-07,22221,323,21009,271,1212,52,23059,317,208418,1135,231477,1452,3,175,-128,1967,448,20079,6,713,210,"Knox County",470313,710.803231039754,0.212489811273434,308.730568791422,68.6776678509843,418.232113507388,21.2489811273434
2020-12-06,21898,332,20738,291,1160,41,22742,187,207283,668,230025,855,6,172,103,2095,223,19631,6,707,207,"Knox County",470313,647.866420872908,0.215173465497522,181.79382666437,70.5912870790304,445.448031417375,21.5173465497522
2020-12-05,21566,289,20447,263,1119,26,22555,213,206615,714,229170,927,2,166,55,1992,232,19408,8,701,203,"Knox County",470313,610.657158105347,0.226086194814296,197.102780488738,61.4484396561439,423.547722474182,22.6086194814296
2020-12-04,21277,354,20184,322,1093,32,22342,297,205901,1091,228243,1388,5,164,17,1937,332,19176,11,693,201,"Knox County",470313,567.494413294976,0.223285922684172,295.122609836428,75.2690229698095,411.853382747234,22.3285922684172
2020-12-03,20923,441,19862,424,1061,17,22045,448,204810,1215,226855,1663,2,159,180,1920,259,18844,10,682,196,"Knox County",470313,560.690433817479,0.231660610821958,353.594308471167,93.7673421742542,408.238768649814,23.1660610821958
2020-12-02,20482,192,19438,170,1044,22,21597,185,203595,575,225192,760,2,157,-146,1740,336,18585,7,672,194,"Knox County",470313,514.976196703047,0.226190476190476,161.594512590551,40.8238768649814,369.966384088894,22.6190476190476
2020-12-01,20290,403,19268,380,1022,23,21412,409,203020,1832,224432,2241,5,155,87,1886,311,18249,7,665,189,"Knox County",470313,496.26525313993,0.221408572043937,476.491187783455,85.6876165447266,401.009540454974,22.1408572043937
2020-11-30,19887,385,18888,371,999,14,21003,436,201188,1815,222191,2251,1,150,24,1799,360,17938,3,658,186,"Knox County",470313,509.44796337758,0.215666831928607,478.617431370173,81.8603780886346,382.511221250529,21.5666831928607
2020-11-29,19502,226,18517,218,985,8,20567,261,199373,1465,219940,1726,0,149,41,1775,185,17578,5,655,183,"Knox County",470313,486.909781358372,0.205275648046732,366.989643067489,48.0531050598219,377.408236642406,20.5275648046732
2020-11-28,19276,271,18299,257,977,14,20306,299,197908,1967,218214,2266,0,149,73,1734,198,17393,8,650,177,"Knox County",470313,483.08254290228,0.189914599430663,481.806796750249,57.6212012000519,368.690637936863,18.9914599430663
2020-11-27,19005,235,18042,215,963,20,20007,249,195941,1247,215948,1496,3,149,-6,1661,238,17195,12,642,173,"Knox County",470313,457.780244220338,0.184390873175845,318.08604057298,49.9667242878679,353.169059753823,18.4390873175845
2020-11-26,18770,344,17827,341,943,3,19758,441,194694,1429,214452,1870,4,146,48,1667,292,16957,5,630,170,"Knox County",470313,437.155681429176,0.18080888183981,397.607550716225,73.1427793830917,354.444805905854,18.080888183981
2020-11-25,18426,219,17486,193,940,26,19317,123,193265,325,212582,448,0,142,-58,1619,277,16665,3,625,164,"Knox County",470313,442.896539113314,0.180354529191738,95.2557126849566,46.5647345491194,344.238836689609,18.0354529191738
2020-11-24,18207,153,17293,130,914,23,19194,116,192940,673,212134,789,2,142,-111,1677,262,16388,6,622,162,"Knox County",470313,389.740449445369,0.177484787018256,167.760618992033,32.5315268767821,356.571049492572,17.7484787018256
2020-11-23,18054,167,17163,147,891,20,19078,100,192267,392,211345,492,3,140,-97,1788,261,16126,7,616,160,"Knox County",470313,343.388339254922,0.174865192032574,104.611184466515,35.508267898187,380.172353305139,17.4865192032574
2020-11-22,17887,220,17016,212,871,8,18978,258,191875,1808,210853,2066,2,137,86,1885,132,15865,5,609,153,"Knox County",470313,342.112593102891,0.168240161238994,439.281925015894,46.7773589077912,400.796916096302,16.8240161238994
2020-11-21,17667,173,16804,169,863,4,18720,198,190067,1465,208787,1663,0,135,2,1799,171,15733,4,604,151,"Knox County",470313,321.275405953057,0.168291024478694,353.594308471167,36.7840140502176,382.511221250529,16.8291024478694
2020-11-20,17494,178,16635,169,859,9,18522,163,188602,791,207124,954,7,135,-17,1797,188,15562,5,600,149,"Knox County",470313,309.155817508765,0.168920550591645,202.843638172876,37.8471358435765,382.085972533185,16.8920550591645
2020-11-19,17316,166,16466,148,850,18,18359,128,187811,663,206170,791,2,128,-28,1814,192,15374,4,595,145,"Knox County",470313,271.308681665189,0.150770512286547,168.185867709377,35.2956435395152,385.700586630606,15.0770512286547
2020-11-18,17150,168,16318,163,832,5,18231,179,187148,875,205379,1054,0,126,-9,1842,177,15182,7,591,140,"Knox County",470313,260.464839372928,0.146241516199257,224.106074040054,35.7208922568587,391.654068673415,14.6241516199257
2020-11-17,16982,248,16155,240,827,8,18052,260,186273,1033,204325,1293,9,126,86,1851,153,15005,6,584,138,"Knox County",470313,280.664153446747,0.154697461806809,274.923295762609,52.730840950601,393.567687901461,15.4697461806809
2020-11-16,16734,272,15915,261,819,11,17792,286,185240,1409,203032,1695,2,117,79,1765,191,14852,6,578,137,"Knox County",470313,302.989711107284,0.154686843211433,360.398287948664,57.8338255587237,375.281993055688,15.4686843211433
2020-11-15,16462,274,15654,247,808,27,17506,295,183831,2278,201337,2573,2,115,162,1686,110,14661,3,572,135,"Knox County",470313,314.47142647556,0.150553726429213,547.082474862485,58.2590742760672,358.484668720618,15.0553726429213
2020-11-14,16188,306,15407,293,781,13,17211,321,181553,1699,198764,2020,0,113,188,1524,118,14551,7,569,131,"Knox County",470313,342.750466178906,0.157225433526012,429.501204516992,65.0630537535641,324.03952261579,15.7225433526012
2020-11-13,15882,219,15114,200,768,19,16890,190,179854,965,196744,1155,4,113,73,1336,142,14433,6,562,128,"Knox County",470313,351.468064884449,0.156790473490218,245.581134265904,46.5647345491194,284.066143185496,15.6790473490218
2020-11-12,15663,143,14914,130,749,13,16700,136,178889,955,195589,1091,1,109,-3,1263,145,14291,3,556,127,"Knox County",470313,346.577704634998,0.153202830622185,231.97317531091,30.4052832900643,268.544565002456,15.3202830622185
2020-11-11,15520,191,14784,177,736,14,16564,191,177934,1229,194498,1420,3,108,23,1266,165,14146,7,553,125,"Knox County",470313,351.468064884449,0.149284253578732,301.926589313925,40.6112525063096,269.182438078471,14.9284253578732
2020-11-10,15329,168,14607,163,722,5,16373,186,176705,1131,193078,1317,2,105,24,1243,142,13981,4,546,123,"Knox County",470313,334.458116190707,0.142400851743412,280.026280370732,35.7208922568587,264.29207782902,14.2400851743412
2020-11-09,15161,135,14444,121,717,14,16187,131,175574,490,191761,621,1,103,-16,1219,150,13839,2,542,121,"Knox County",470313,305.328579052673,0.142198685888006,132.039726735174,28.7042884206901,259.189093220898,14.2198685888006
2020-11-08,15026,215,14323,203,703,12,16056,252,175084,2625,191140,2877,1,102,94,1235,120,13689,3,540,119,"Knox County",470313,292.783741891039,0.133987239310542,611.720279898706,45.7142371144323,262.591082959646,13.3987239310542
2020-11-07,14811,169,14120,161,691,8,15804,187,172459,1918,188263,2105,1,101,59,1141,109,13569,5,537,114,"Knox County",470313,263.654204753005,0.120253164556962,447.574275004093,35.9335166155305,242.604393244499,12.0253164556962
2020-11-06,14642,155,13959,138,683,17,15617,160,170541,1236,186158,1396,0,100,24,1082,131,13460,5,532,114,"Knox County",470313,250.046245798011,0.114805578645978,296.823604705802,32.9567755941256,230.059556082864,11.4805578645978
2020-11-05,14487,158,13821,142,666,16,15457,151,169305,613,184762,764,1,100,33,1058,124,13329,6,527,111,"Knox County",470313,253.235611178088,0.119809523809524,162.445010025239,33.5946486701409,224.956571474741,11.9809523809524
2020-11-04,14329,145,13679,133,650,12,15306,148,168692,934,183998,1082,-1,99,20,1025,126,13205,5,521,110,"Knox County",470313,243.454890679186,0.119563078134226,230.059556082864,30.8305320074078,217.939967638573,11.9563078134226
2020-11-03,14184,196,13546,183,638,13,15158,195,167758,836,182916,1031,3,100,44,1005,149,13079,5,516,108,"Knox County",470313,249.408372721996,0.123936816524909,219.215713790603,41.6743742996685,213.687480465137,12.3936816524909
2020-11-02,13988,116,13363,110,625,6,14963,115,166922,807,181885,922,1,97,-36,961,151,12930,2,511,107,"Knox County",470313,245.368509907232,0.118699027218237,196.039658695379,24.6644256059263,204.332008683579,11.8699027218237
2020-11-01,13872,124,13253,116,619,8,14848,131,166115,1273,180963,1404,0,96,14,997,110,12779,3,509,105,"Knox County",470313,226.0196932681,0.124885110294118,298.524599575177,26.3654204753005,211.986485595763,12.4885110294118
2020-10-31,13748,5,13137,5,611,0,14717,7,164842,4,179559,11,0,96,-99,983,104,12669,0,506,103,"Knox County",470313,191.149298445929,0.137216338880484,2.33886794538956,1.06312179335889,209.009744574358,13.7216338880484
2020-10-30,13743,156,13132,146,611,10,14710,148,164838,853,179548,1001,1,96,27,1082,128,12565,4,506,102,"Knox County",470313,191.3619228046,0.144006436041834,212.83698303045,33.1693999527974,230.059556082864,14.4006436041834
2020-10-29,13587,152,12986,138,601,14,14562,136,163985,1569,178547,1705,0,95,49,1055,103,12437,4,502,102,"Knox County",470313,190.08617665257,0.122973728339855,362.524531535382,32.3189025181103,224.318698398726,12.2973728339855
2020-10-28,13435,103,12848,96,587,7,14426,102,162416,1055,176842,1157,3,95,-47,1006,147,12334,8,498,101,"Knox County",470313,181.155953588355,0.115336744571982,246.006382983247,21.9003089431931,213.900104823809,11.5336744571982
2020-10-27,13332,119,12752,113,580,6,14324,127,161361,799,175685,926,1,92,-6,1053,124,12187,3,490,100,"Knox County",470313,164.783877970628,0.107493685096829,196.890156130067,25.3022986819416,223.893449681382,10.7493685096829
2020-10-26,13213,81,12639,74,574,7,14197,73,160562,372,174759,445,2,91,-72,1059,151,12063,1,487,98,"Knox County",470313,157.342025417116,0.108888554669875,94.6178396089413,17.222573052414,225.169195833413,10.8888554669875
2020-10-25,13132,132,12565,121,567,11,14124,151,160190,1365,174314,1516,0,89,53,1131,79,11912,3,486,98,"Knox County",470313,159.04302028649,0.110042893063156,322.338527746416,28.0664153446747,240.478149657781,11.0042893063156
2020-10-24,13000,172,12444,167,556,5,13973,202,158825,1789,172798,1991,0,89,56,1078,116,11833,5,483,97,"Knox County",470313,194.551288184677,0.107424779773481,423.33509811551,36.5713896915458,229.209058648177,10.7424779773481
2020-10-23,12828,159,12277,148,551,11,13771,172,157036,1239,170807,1411,1,89,40,1022,118,11717,5,478,96,"Knox County",470313,195.189161260692,0.105234400611955,300.012970085879,33.8072730288127,217.302094562557,10.5234400611955
2020-10-22,12669,182,12129,168,540,14,13599,169,155797,1607,169396,1776,1,88,59,982,122,11599,5,473,96,"Knox County",470313,201.567892020846,0.108002602472349,377.620861001078,38.6976332782636,208.797120215686,10.8002602472349
2020-10-21,12487,72,11961,68,526,4,13430,74,154190,682,167620,756,0,87,-32,923,104,11477,1,468,96,"Knox County",470313,194.976536902021,0.109738124929146,160.744015155864,15.308953824368,196.252283054051,10.9738124929146
2020-10-20,12415,127,11893,121,522,6,13356,150,153508,739,166864,889,0,87,13,955,114,11373,7,467,95,"Knox County",470313,196.677531771395,0.112818761384335,189.023054859211,27.0032935513158,203.056262531548,11.2818761384335
2020-10-19,12288,112,11772,107,516,5,13206,117,152769,939,165975,1056,1,87,-9,942,120,11259,6,460,94,"Knox County",470313,203.26888689022,0.110164981373071,224.531322757398,23.8139281712392,200.292145868815,11.0164981373071
2020-10-18,12176,140,11665,135,511,5,13089,168,151830,1431,164919,1599,0,86,51,951,89,11139,7,454,94,"Knox County",470313,204.969881759594,0.11099388056552,339.986349516173,29.7674102140489,202.205765096861,11.099388056552
2020-10-17,12036,128,11530,125,506,3,12921,154,150399,1458,163320,1612,1,86,42,900,85,11050,3,447,93,"Knox County",470313,195.614409978036,0.110341795801736,342.750466178906,27.2159179099876,191.3619228046,11.0341795801736
2020-10-16,11908,72,11405,71,503,1,12767,61,148941,390,161708,451,1,85,-26,858,97,10965,3,444,92,"Knox County",470313,177.116090773591,0.109718638653397,95.893585760972,15.308953824368,182.431699740386,10.9718638653397
2020-10-15,11836,74,11334,62,502,12,12706,66,148551,941,161257,1007,1,84,-56,884,129,10868,3,441,90,"Knox County",470313,154.152660037039,0.10719131614654,214.112729182481,15.7342025417116,187.959933065852,10.719131614654
2020-10-14,11762,149,11272,143,490,6,12640,150,147610,1086,160250,1236,0,83,58,940,91,10739,5,438,88,"Knox County",470313,170.524735654766,0.11031847133758,262.803707318318,31.6810294420949,199.866897151471,11.031847133758
2020-10-13,11613,71,11129,68,484,3,12490,63,146524,581,159014,644,1,83,-36,882,106,10648,6,433,88,"Knox County",470313,158.617771569146,0.102432610124918,136.930086984625,15.0963294656962,187.534684348508,10.2432610124918
2020-10-12,11542,79,11061,66,481,13,12427,87,145943,806,158370,893,0,82,-42,918,121,10542,5,427,87,"Knox County",470313,151.601167732978,0.100644987906477,189.873552293898,16.7973243350705,195.189161260692,10.0644987906477
2020-10-11,11463,170,10995,163,468,7,12340,179,145137,1612,157477,1791,0,82,94,960,76,10421,8,422,85,"Knox County",470313,157.979898493131,0.0995546240503013,380.810226381155,36.1461409742023,204.119384324907,9.95546240503013
2020-10-10,11293,130,10832,122,461,8,12161,132,143525,1393,155686,1525,0,82,46,866,84,10345,3,414,85,"Knox County",470313,158.405147210475,0.0977872002120048,324.252146974462,27.6411666273312,184.13269460976,9.77872002120048
2020-10-09,11163,120,10710,118,453,2,12029,134,142132,1336,154161,1470,0,82,34,820,86,10261,3,411,85,"Knox County",470313,168.61111642672,0.0946766285314032,312.557807247514,25.5149230406134,174.351974110858,9.46766285314032
2020-10-08,11043,110,10592,102,451,8,11895,103,140796,943,152691,1046,1,82,32,786,77,10175,4,408,85,"Knox County",470313,176.265593338904,0.0985473561882626,222.40507917068,23.3886794538956,167.122745916018,9.85473561882626
2020-10-07,10933,104,10490,88,443,16,11792,95,139853,1650,151645,1745,0,81,11,754,93,10098,5,404,85,"Knox County",470313,166.697497198674,0.087008997147246,371.029505882253,22.1129333018649,160.318766438521,8.7008997147246
2020-10-06,10829,115,10402,102,427,13,11697,114,138203,1393,149900,1507,0,81,3,743,112,10005,4,399,84,"Knox County",470313,176.052968980232,0.0845945675052621,320.42490851837,24.4518012472545,157.979898493131,8.45945675052621
2020-10-05,10714,118,10300,109,414,9,11583,123,136810,1238,148393,1361,0,81,11,740,107,9893,5,395,84,"Knox County",470313,184.345318968432,0.0842508377213978,289.38175215229,25.0896743232698,157.342025417116,8.42508377213978
2020-10-04,10596,96,10191,89,405,7,11460,99,135572,1827,147032,1926,1,81,31,729,64,9786,2,390,82,"Knox County",470313,168.61111642672,0.0756143667296786,409.514514801845,20.4119384324907,155.003157471726,7.56143667296786
2020-10-03,10500,77,10102,76,398,1,11361,92,133745,1864,145106,1956,0,80,6,698,71,9722,2,388,82,"Knox County",470313,157.342025417116,0.0690218872037054,415.893245561998,16.3720756177269,148.411802352901,6.90218872037054
2020-10-02,10423,82,10026,79,397,3,11269,82,131881,602,143150,684,0,80,-17,692,99,9651,1,386,82,"Knox County",470313,149.262299787588,0.0692420537897311,145.435061331496,17.4351974110858,147.13605620087,6.92420537897311
2020-10-01,10341,71,9947,68,394,3,11187,73,131279,683,142466,756,0,80,2,709,69,9552,1,385,82,"Knox County",470313,140.969949799389,0.0682435832913941,160.744015155864,15.0963294656962,150.750670298291,6.82435832913941
2020-09-30,10270,75,9879,72,391,3,11114,70,130596,675,141710,745,1,80,-32,707,106,9483,2,384,82,"Knox County",470313,134.803843397907,0.0730833799664242,158.405147210475,15.9468269003834,150.325421580947,7.30833799664242
2020-09-29,10195,80,9807,75,388,5,11044,87,129921,1140,140965,1227,-1,79,-16,739,97,9377,2,382,82,"Knox County",470313,127.361990844395,0.0723281340265742,260.890088090272,17.0099486937423,157.129401058444,7.23281340265742
2020-09-28,10115,57,9732,51,383,6,10957,49,128781,431,139738,480,1,80,-70,755,126,9280,3,380,81,"Knox County",470313,114.391904965417,0.0710059171597633,102.059692162454,12.1195884442914,160.531390797193,7.10059171597633
2020-09-27,10058,72,9681,67,377,5,10908,79,128350,978,139258,1057,0,79,-18,825,90,9154,3,377,79,"Knox County",470313,109.288920357294,0.0770456191165822,224.74394711607,15.308953824368,175.415095904217,7.70456191165822
2020-09-26,9986,127,9614,122,372,5,10829,136,127372,2087,138201,2223,4,79,9,843,114,9064,5,374,79,"Knox County",470313,119.920138290883,0.0803123257110987,472.663949327363,27.0032935513158,179.242334360309,8.03123257110987
2020-09-25,9859,102,9492,100,367,2,10693,103,125285,1439,135978,1542,0,75,-3,834,105,8950,1,369,79,"Knox County",470313,124.172625464318,0.074346201743462,327.866761071882,21.6876845845214,177.328715132263,7.4346201743462
2020-09-24,9757,92,9392,89,365,3,10590,105,123846,1717,134436,1822,0,75,-52,837,144,8845,3,368,76,"Knox County",470313,128.637736996426,0.0691512752858399,387.40158149998,19.5614409978036,177.966588208278,6.91512752858399
2020-09-23,9665,53,9303,52,362,1,10485,49,122129,432,132614,481,2,75,-123,889,174,8701,2,365,76,"Knox County",470313,123.960001105647,0.0688405797101449,102.272316521125,11.2690910096042,189.023054859211,6.88405797101449
2020-09-22,9612,82,9251,75,361,7,10436,88,121697,1140,132133,1228,1,73,-53,1012,134,8527,3,363,76,"Knox County",470313,124.38524982299,0.0689459979621873,261.102712448944,17.4351974110858,215.175850975839,6.89459979621873
2020-09-21,9530,34,9176,30,354,4,10348,32,120557,379,130905,411,0,72,-103,1065,137,8393,2,360,76,"Knox County",470313,119.494889573539,0.0675490643541762,87.3886114141008,7.22922819484046,226.444941985444,6.75490643541762
2020-09-20,9496,97,9146,78,350,19,10316,88,120178,707,130494,795,0,72,-17,1168,114,8256,1,358,76,"Knox County",470313,124.810498540334,0.0706892495883322,169.036365144064,20.6245627911625,248.345250928637,7.06892495883322
2020-09-19,9399,132,9068,129,331,3,10228,136,119471,1466,129699,1602,1,72,31,1185,100,8142,5,357,74,"Knox County",470313,125.873620333693,0.0762593579494988,340.624222592189,28.0664153446747,251.959865026057,7.62593579494988
2020-09-18,9267,118,8939,114,328,4,10092,129,118005,1606,128097,1735,3,71,-16,1154,131,8042,3,352,74,"Knox County",470313,129.275610072441,0.0776566757493188,368.903262295535,25.0896743232698,245.368509907232,7.76566757493188
2020-09-17,9149,126,8825,119,324,7,9963,124,116399,1516,126362,1640,0,68,-15,1170,141,7911,6,349,74,"Knox County",470313,136.504838267282,0.0818550430816016,348.703948221716,26.790669192644,248.77049964598,8.18550430816016
2020-09-16,9023,99,8706,77,317,22,9839,117,114883,768,124722,885,1,68,-90,1185,188,7770,3,343,72,"Knox County",470313,146.285558766183,0.0860655737704918,188.172557424524,21.049811508506,251.959865026057,8.60655737704918
2020-09-15,8924,132,8629,126,295,6,9722,136,114115,1338,123837,1474,0,67,-65,1275,197,7582,3,340,71,"Knox County",470313,156.916776699772,0.089206274877078,313.408304682201,28.0664153446747,271.096057306517,8.9206274877078
2020-09-14,8792,127,8503,124,289,3,9586,136,112777,902,122363,1038,0,67,-68,1340,195,7385,5,337,71,"Knox County",470313,176.690842056248,0.0944486857890719,220.704084301306,27.0032935513158,284.916640620183,9.44486857890719
2020-09-13,8665,143,8379,136,286,7,9450,148,111875,1008,121325,1156,0,67,-8,1408,151,7190,0,332,71,"Knox County",470313,186.471562555149,0.0971668415529906,245.793758624576,30.4052832900643,299.375097009864,9.71668415529906
2020-09-12,8522,130,8243,123,279,7,9302,141,110867,1177,120169,1318,1,67,29,1416,100,7039,1,332,71,"Knox County",470313,186.046313837806,0.100692191217824,280.238904729404,27.6411666273312,301.076091879238,10.0692191217824
2020-09-11,8392,104,8120,95,272,9,9161,106,109690,773,118851,879,0,66,-17,1387,121,6939,5,331,69,"Knox County",470313,183.069572816401,0.108224076281287,186.896811272493,22.1129333018649,294.909985477756,10.8224076281287
2020-09-10,8288,192,8025,189,263,3,9055,192,108917,1501,117972,1693,0,66,89,1404,103,6818,5,326,67,"Knox County",470313,197.102780488738,0.115598720833827,359.97303923132,40.8238768649814,298.524599575177,11.5598720833827
2020-09-09,8096,91,7836,82,260,9,8863,93,107416,1710,116279,1803,0,66,-23,1315,114,6715,2,321,67,"Knox County",470313,195.401785619364,0.101698536481145,383.361718685216,19.3488166391318,279.601031653388,10.1698536481145
2020-09-08,8005,126,7754,124,251,2,8770,133,105706,702,114476,835,1,66,30,1338,95,6601,8,319,67,"Knox County",470313,194.126039467333,0.108805319880761,177.541339490935,26.790669192644,284.491391902839,10.8805319880761
2020-09-07,7879,95,7630,92,249,3,8637,98,105004,347,113641,445,1,65,11,1308,83,6506,0,311,67,"Knox County",470313,187.322059989837,0.112067905031369,94.6178396089413,20.1993140738189,278.112661142686,11.2067905031369
2020-09-06,7784,96,7538,92,246,4,8539,94,104657,476,113196,570,0,64,23,1297,73,6423,1,311,67,"Knox County",470313,177.328715132263,0.113615272438022,121.195884442914,20.4119384324907,275.773793197296,11.3615272438022
2020-09-05,7688,284,7446,282,242,2,8445,295,104181,1506,112626,1801,0,64,215,1274,69,6350,4,310,64,"Knox County",470313,210.072866367717,0.125965611761774,382.936469967872,60.385317862785,270.883432947845,12.5965611761774
2020-09-04,7404,93,7164,89,240,4,8150,97,102675,565,110825,662,1,64,16,1059,76,6281,0,306,64,"Knox County",470313,207.733998422327,0.12831348444103,140.757325440717,19.7740653564754,225.169195833413,12.831348444103
2020-09-03,7311,190,7075,184,236,6,8053,198,102110,1798,110163,1996,2,63,107,1043,81,6205,6,306,64,"Knox County",470313,207.308749704984,0.124260355029586,424.398219908869,40.3986281476379,221.767206094665,12.4260355029586
2020-09-02,7121,124,6891,120,230,4,7855,121,100312,1461,108167,1582,2,61,40,936,82,6124,5,300,63,"Knox County",470313,214.325353541152,0.131288810036751,336.371735418753,26.3654204753005,199.016399716784,13.1288810036751
2020-09-01,6997,153,6771,146,226,7,7734,158,98851,660,106585,818,2,59,64,896,87,6042,4,295,62,"Knox County",470313,220.06621122529,0.134747269494539,173.926725393515,32.5315268767821,190.511425369913,13.4747269494539
2020-08-31,6844,99,6625,93,219,6,7576,94,98191,431,105767,525,0,57,18,832,81,5955,3,291,59,"Knox County",470313,220.916708659978,0.132889112396279,111.627788302684,21.049811508506,176.903466414919,13.2889112396279
2020-08-30,6745,72,6532,71,213,1,7482,76,97760,423,105242,499,1,57,5,814,66,5874,1,288,59,"Knox County",470313,215.813724051855,0.131802613218318,106.099554977217,15.308953824368,173.076227958827,13.1802613218318
2020-08-29,6673,118,6461,113,212,5,7406,125,97337,1391,104743,1516,5,56,37,809,76,5808,3,287,57,"Knox County",470313,180.51808051234,0.114372203211371,322.338527746416,25.0896743232698,172.013106165469,11.4372203211371
2020-08-28,6555,89,6348,85,207,4,7281,91,95946,309,103227,400,0,51,-7,772,96,5732,3,284,57,"Knox County",470313,179.667583077653,0.117639040348964,85.0497434687113,18.9235679217883,164.146004894613,11.7639040348964
2020-08-27,6466,116,6263,112,203,4,7190,134,95637,1987,102827,2121,0,51,24,779,92,5636,2,281,57,"Knox County",470313,163.933380535941,0.107090202385739,450.976264742841,24.6644256059263,165.634375405315,10.7090202385739
2020-08-26,6350,77,6151,76,199,1,7056,86,93650,794,100706,880,0,51,-15,755,92,5544,3,279,56,"Knox County",470313,153.940035678367,0.113034472555112,187.109435631165,16.3720756177269,160.531390797193,11.3034472555112
2020-08-25,6273,87,6075,82,198,5,6970,96,92856,896,99826,992,2,51,-6,770,91,5452,3,276,55,"Knox County",470313,139.90682800603,0.101254868022501,210.923363802404,18.4983192044447,163.720756177269,10.1254868022501
2020-08-24,6186,32,5993,28,193,4,6874,29,91960,261,98834,290,0,49,-66,776,98,5361,1,273,55,"Knox County",470313,125.660995975021,0.0951030158256196,61.6610640148157,6.8039794774969,164.9965023293,9.51030158256196
2020-08-23,6154,76,5965,75,189,1,6845,74,91699,566,98544,640,0,49,13,842,63,5263,3,272,55,"Knox County",470313,126.511493409708,0.0928498318467612,136.079589549938,16.1594512590551,179.029710001637,9.28498318467612
2020-08-22,6078,137,5890,136,188,1,6771,154,91133,1892,97904,2046,0,49,70,829,67,5200,4,269,55,"Knox County",470313,130.551356224472,0.0901072058623965,435.029437842458,29.1295371380336,176.265593338904,9.01072058623965
2020-08-21,5941,30,5754,30,187,0,6617,41,89241,262,95858,303,1,49,-62,759,91,5133,1,265,55,"Knox County",470313,118.006519062837,0.0844334433443344,64.4251806775488,6.37873076015334,161.38188823188,8.44334433443344
2020-08-20,5911,119,5724,117,187,2,6576,130,88979,2068,95555,2198,3,48,24,821,92,5042,3,264,55,"Knox County",470313,118.644392138852,0.0830044904068581,467.348340360568,25.3022986819416,174.56459846953,8.30044904068581
2020-08-19,5792,46,5607,41,185,5,6446,48,86911,608,93357,656,2,45,-50,797,94,4950,4,261,55,"Knox County",470313,112.053037020027,0.080280701754386,139.481579288686,9.7807204989018,169.461613861407,8.0280701754386
2020-08-18,5746,134,5566,132,180,2,6398,152,86303,1164,92701,1316,0,43,3,847,131,4856,4,257,55,"Knox County",470313,122.046381877601,0.0843066183380319,279.81365601206,28.4916640620183,180.092831794996,8.43066183380319
2020-08-17,5612,50,5434,42,178,8,6246,50,85139,289,91385,339,1,43,-70,844,119,4725,0,253,54,"Knox County",470313,125.873620333693,0.0865564150440117,72.0796575897328,10.6312179335889,179.454958718981,8.65564150440117
2020-08-16,5562,83,5392,78,170,5,6196,82,84850,587,91046,669,0,42,11,914,72,4606,1,253,53,"Knox County",470313,127.361990844395,0.0872857712235951,142.24569595142,17.6478217697576,194.338663826005,8.72857712235951
2020-08-15,5479,119,5314,116,165,3,6114,132,84263,1223,90377,1355,1,42,42,903,76,4534,2,252,52,"Knox County",470313,123.534752388303,0.0928905792861322,288.106006000259,25.3022986819416,191.999795880616,9.28905792861323
2020-08-14,5360,91,5198,83,162,8,5982,96,83040,1024,89022,1120,0,41,5,861,86,4458,2,250,52,"Knox County",470313,136.504838267282,0.0901607212857703,238.139281712392,19.3488166391318,183.069572816401,9.01607212857703
2020-08-13,5269,127,5115,126,154,1,5886,229,82016,1778,87902,2007,1,41,13,856,113,4372,4,248,51,"Knox County",470313,138.205833136656,0.105735727686947,426.737087854259,27.0032935513158,182.006451023042,10.5735727686947
2020-08-12,5142,79,4989,72,153,7,5657,88,80238,892,85895,980,0,40,-40,843,119,4259,1,244,50,"Knox County",470313,145.222436972824,0.106473156948369,208.371871498343,16.7973243350705,179.242334360309,10.6473156948369
2020-08-11,5063,111,4917,108,146,3,5569,117,79346,1121,84915,1238,0,40,2,883,109,4140,5,243,50,"Knox County",470313,140.332076723374,0.103009859885833,263.228956035661,23.6013038125674,187.74730870718,10.3009859885833
2020-08-10,4952,37,4809,35,143,2,5452,35,78225,365,83677,400,1,40,-94,881,130,4031,0,238,48,"Knox County",470313,137.56796006064,0.100270305058566,85.0497434687113,7.86710127085579,187.322059989837,10.0270305058566
2020-08-09,4915,85,4774,81,141,4,5417,109,77860,826,83277,935,1,39,25,975,59,3901,4,238,48,"Knox County",470313,137.993208777984,0.10031113876789,198.803775358113,18.0730704871011,207.308749704984,10.031113876789
2020-08-08,4830,157,4693,156,137,1,5308,176,77034,2284,82342,2460,1,38,96,950,60,3842,4,234,47,"Knox County",470313,146.072934407512,0.0929978118161926,523.055922332574,33.3820243114692,201.993140738189,9.29978118161926
2020-08-07,4673,50,4537,46,136,4,5132,44,74750,403,79882,447,0,37,-35,854,85,3782,0,230,45,"Knox County",470313,137.355335701969,0.0942482579426007,95.0430883262848,10.6312179335889,181.581202305699,9.42482579426007
2020-08-06,4623,113,4491,105,132,8,5088,121,74347,1463,79435,1584,-1,37,41,889,73,3697,5,230,43,"Knox County",470313,134.378594680564,0.0857782197911487,336.796984136097,24.0265525299109,189.023054859211,8.57782197911487
2020-08-05,4510,99,4386,99,124,0,4967,100,72884,1107,77851,1207,1,38,-1,848,99,3624,3,225,42,"Knox County",470313,138.631081853999,0.0848748639825898,256.637600916836,21.049811508506,180.305456153668,8.48748639825898
2020-08-04,4411,112,4287,111,124,1,4867,106,71777,1082,76644,1188,1,37,-31,849,142,3525,9,222,41,"Knox County",470313,138.843706212671,0.0840530349105948,252.597738102072,23.8139281712392,180.51808051234,8.40530349105948
2020-08-03,4299,50,4176,50,123,0,4761,81,70695,593,75456,674,2,36,-59,880,107,3383,1,213,41,"Knox County",470313,141.607822875404,0.0867569158328429,143.308817744778,10.6312179335889,187.109435631165,8.67569158328429
2020-08-02,4249,97,4126,91,123,6,4680,95,70102,692,74782,787,3,34,28,939,66,3276,2,212,40,"Knox County",470313,144.159315179466,0.0866179465676291,167.335370274689,20.6245627911625,199.6542727928,8.66179465676291
2020-08-01,4152,118,4035,110,117,8,4585,118,69410,1417,73995,1535,1,31,29,911,88,3210,1,210,40,"Knox County",470313,135.866965191266,0.0895984909727836,326.37839056118,25.0896743232698,193.70079074999,8.95984909727836
2020-07-31,4034,117,3925,114,109,3,4467,116,67993,1060,72460,1176,2,30,9,882,106,3122,1,209,39,"Knox County",470313,150.112797222275,0.0904183535762483,250.046245798011,24.877049964598,187.534684348508,9.04183535762483
2020-07-30,3917,189,3811,186,106,3,4351,227,66933,2420,71284,2647,1,28,78,873,110,3016,7,208,36,"Knox County",470313,166.272248481331,0.0914912090297374,562.816677404197,40.1860037889661,185.621065120462,9.14912090297373
2020-07-29,3728,75,3625,71,103,4,4124,60,64513,438,68637,498,0,27,-40,795,115,2906,3,201,34,"Knox County",470313,161.169263873208,0.0944150499706055,105.886930618546,15.9468269003834,169.036365144064,9.44150499706055
2020-07-28,3653,154,3554,152,99,2,4064,186,64075,1211,68139,1397,1,27,46,835,107,2791,3,198,30,"Knox County",470313,170.099486937423,0.101331191186596,297.036229064474,32.7441512354538,177.541339490935,10.1331191186596
2020-07-27,3499,83,3402,76,97,7,3878,85,62864,677,66742,762,3,26,-36,789,116,2684,2,195,30,"Knox County",470313,177.116090773591,0.100772551692797,162.019761307895,17.6478217697576,167.760618992033,10.0772551692797
2020-07-26,3416,118,3326,113,90,5,3793,132,62187,1473,65980,1605,0,23,49,825,69,2568,2,193,29,"Knox County",470313,181.581202305699,0.0960498960498961,341.262095668204,25.0896743232698,175.415095904217,9.6049896049896
2020-07-25,3298,175,3213,172,85,3,3661,197,60714,1949,64375,2146,2,23,95,776,78,2499,3,191,28,"Knox County",470313,193.70079074999,0.0980353826605415,456.291873709636,37.2092627675612,164.9965023293,9.80353826605415
2020-07-24,3123,106,3041,99,82,7,3464,113,58765,916,62229,1029,0,21,-15,681,121,2421,4,188,25,"Knox County",470313,191.3619228046,0.0991669972233241,218.79046507326,22.5381820192085,144.797188255481,9.91669972233241
2020-07-23,3017,205,2942,197,75,8,3351,254,57849,2389,61200,2643,0,21,89,696,116,2300,4,184,25,"Knox County",470313,194.763912543349,0.101884920634921,561.96617996951,43.5879935277145,147.986553635558,10.1884920634921
2020-07-22,2812,69,2745,61,67,8,3097,63,55460,437,58557,500,3,21,-68,607,134,2184,3,180,24,"Knox County",470313,193.488166391318,0.102162269390994,106.312179335889,14.6710807483527,129.062985713769,10.2162269390994
2020-07-21,2743,232,2684,228,59,4,3034,280,55023,1691,58057,1971,0,18,120,675,112,2050,12,177,24,"Knox County",470313,210.072866367717,0.10548048048048,419.082610942075,49.3288512118525,143.52144210345,10.548048048048
2020-07-20,2511,74,2456,70,55,4,2754,57,53332,364,56086,421,0,18,-59,555,133,1938,4,165,23,"Knox County",470313,208.159247139671,0.106253029568589,89.5148550008186,15.7342025417116,118.006519062837,10.6253029568589
2020-07-19,2437,84,2386,74,51,10,2697,74,52968,577,55665,651,0,18,-16,614,100,1805,0,161,22,"Knox County",470313,200.93001894483,0.110885589146459,138.418457495328,17.8604461284294,130.551356224472,11.0885589146459
2020-07-18,2353,112,2312,109,41,3,2623,146,52391,2258,55014,2404,1,18,36,630,75,1705,8,161,20,"Knox County",470313,187.534684348508,0.102609418858509,511.148958246955,23.8139281712392,133.95334596322,10.2609418858509
2020-07-17,2241,74,2203,74,38,0,2477,80,50133,347,52610,427,0,17,3,594,71,1630,6,153,19,"Knox County",470313,180.730704871011,0.105800155262282,90.7906011528493,15.7342025417116,126.298869051036,10.5800155262282
2020-07-16,2167,187,2129,185,38,2,2397,228,49786,2035,52183,2263,2,17,97,591,88,1559,3,147,17,"Knox County",470313,176.903466414919,0.107444714599977,481.168923674234,39.7607550716225,125.660995975021,10.7444714599977
2020-07-15,1980,78,1944,78,36,0,2169,80,47751,511,49920,591,3,15,-14,494,89,1471,4,144,17,"Knox County",470313,178.817085642965,0.10827222731439,125.660995975021,16.5846999763987,105.036433183858,10.827222731439
2020-07-14,1902,95,1866,95,36,0,2089,127,47240,777,49329,904,2,12,12,508,81,1382,1,140,16,"Knox County",470313,149.687548504932,0.103380759691946,192.212420239287,20.1993140738189,108.013174205263,10.3380759691946
2020-07-13,1807,94,1771,92,36,2,1962,59,46463,655,48425,714,1,10,20,496,73,1301,2,139,15,"Knox County",470313,153.940035678367,0.099823987930601,151.81379209165,19.9866897151471,105.461681901202,9.9823987930601
2020-07-12,1713,69,1679,67,34,2,1903,87,45808,916,47711,1003,0,9,27,476,42,1228,4,137,12,"Knox County",470313,150.750670298291,0.097158680471948,213.262231747793,14.6710807483527,101.209194727766,9.7158680471948
2020-07-11,1644,28,1612,27,32,1,1816,36,44892,883,46708,919,0,9,-16,449,44,1186,2,133,11,"Knox County",470313,132.890224169861,0.10218443043542,195.401785619364,5.95348204280979,95.4683370436284,10.218443043542
2020-07-10,1616,78,1585,74,31,4,1780,68,44009,418,45789,486,0,9,29,465,49,1142,6,131,10,"Knox County",470313,133.740721604548,0.0995639534883721,103.335438314484,16.5846999763987,98.8703267823768,9.95639534883721
2020-07-09,1538,70,1511,66,27,4,1712,88,43591,1652,45303,1740,0,9,23,436,47,1093,8,125,10,"Knox County",470313,108.86367163995,0.0857322636463741,369.966384088894,14.8837051070245,92.7042203808953,8.57322636463741
2020-07-08,1468,70,1445,65,23,5,1624,63,41939,594,43563,657,1,9,15,413,54,1046,5,117,10,"Knox County",470313,107.162676770576,0.0822045773003269,139.694203647358,14.8837051070245,87.8138601314444,8.2204577300327
2020-07-07,1398,79,1380,79,18,0,1561,104,41345,1305,42906,1409,0,8,38,398,41,992,7,112,10,"Knox County",470313,103.760687031828,0.0728926096997691,299.587721368535,16.7973243350705,84.6244947513677,7.28926096997691
2020-07-06,1319,35,1301,35,18,0,1457,34,40040,658,41497,692,1,8,-19,360,53,951,6,105,9,"Knox County",470313,91.2158498701928,0.0695047784535187,147.13605620087,7.44185255351224,76.5447691218401,6.95047784535187
2020-07-05,1284,77,1266,77,18,0,1423,109,39382,1081,40805,1190,2,7,34,379,41,898,6,99,9,"Knox County",470313,92.9168447395671,0.0707740025377132,253.022986819416,16.3720756177269,80.5846319366039,7.07740025377132
2020-07-04,1207,41,1189,40,18,1,1314,50,38301,1141,39615,1191,0,5,4,345,37,857,1,93,8,"Knox County",470313,95.6809614023002,0.070061099796334,253.235611178088,8.7175987055429,73.3554037417635,7.0061099796334
2020-07-03,1166,62,1149,61,17,1,1264,49,37160,910,38424,959,0,5,27,341,35,820,4,92,6,"Knox County",470313,92.2789716635517,0.0634090329165603,203.906759966235,13.1827102376502,72.5049063070764,6.34090329165603
2020-07-02,1104,68,1088,68,16,0,1215,102,36250,1228,37465,1330,0,5,33,314,35,785,2,88,6,"Knox County",470313,91.8537229462082,0.0687937533656435,282.790397033465,14.4584563896809,66.7640486229383,6.87937533656435
2020-07-01,1036,49,1020,49,16,0,1113,34,35022,737,36135,771,0,5,25,281,24,750,4,86,6,"Knox County",470313,87.3886114141008,0.0639087775125961,163.933380535941,10.4185935749171,59.7474447867697,6.39087775125961
2020-06-30,987,40,971,39,16,1,1079,73,34285,1514,35364,1587,0,5,18,256,22,726,3,82,5,"Knox County",470313,79.0962614259015,0.058419689119171,337.434857212112,8.50497434687113,54.4318358199752,5.8419689119171
2020-06-29,947,51,932,51,15,0,1006,79,32771,1333,33777,1412,0,5,20,238,31,704,3,79,5,"Knox County",470313,82.4982511646499,0.0587677725118483,300.225594444551,10.8438422922607,50.6045973638832,5.87677725118483
2020-06-28,896,10,881,10,15,0,927,30,31438,684,32365,714,0,5,-5,218,15,673,1,76,5,"Knox County",470313,68.2524191336408,0.0523606228026118,151.81379209165,2.12624358671778,46.3521101904476,5.23606228026117
2020-06-27,886,29,871,29,15,0,897,16,30754,111,31651,127,0,5,18,223,11,658,3,75,5,"Knox County",470313,65.7009268295794,0.0555072463768116,27.0032935513158,6.16610640148157,47.4152319838065,5.55072463768116
2020-06-26,857,37,842,37,15,0,881,14,30643,319,31524,333,0,5,17,205,20,647,8,72,5,"Knox County",470313,60.385317862785,0.0554670066942939,70.8039114377021,7.86710127085579,43.5879935277145,5.54670066942939
2020-06-25,820,32,805,32,15,0,867,52,30324,702,31191,754,0,5,13,188,19,627,1,64,5,"Knox County",470313,52.730840950601,0.0522990522990523,160.318766438521,6.8039794774969,39.9733794302943,5.22990522990523
2020-06-24,788,35,773,34,15,1,815,32,29622,272,30437,304,0,5,22,175,13,608,1,63,5,"Knox County",470313,49.7540999291961,0.0565857388644619,64.6378050362206,7.44185255351224,37.2092627675612,5.65857388644619
2020-06-23,753,27,739,24,14,3,783,25,29350,216,30133,241,0,5,18,153,9,595,4,62,5,"Knox County",470313,46.989983266463,0.0638352638352638,51.2424704398985,5.74085768413801,32.5315268767821,6.38352638352638
2020-06-22,726,36,715,36,11,0,758,31,29134,572,29892,603,0,5,20,135,16,586,0,58,5,"Knox County",470313,43.8006178863863,0.0650195058517555,128.212488279082,7.65447691218401,28.7042884206901,6.50195058517555
2020-06-21,690,31,679,31,11,0,727,37,28562,815,29289,852,0,5,16,115,15,570,1,58,5,"Knox County",470313,48.2657294184936,0.0644057249533292,181.155953588355,6.59135511882512,24.4518012472545,6.44057249533292
2020-06-20,659,17,648,17,11,0,690,9,27747,437,28437,446,0,5,11,99,6,555,2,57,5,"Knox County",470313,45.7142371144323,0.0566091140673648,94.8304639676131,3.61461409742023,21.049811508506,5.66091140673648
2020-06-19,642,30,631,28,11,2,681,10,27310,334,27991,344,0,5,8,88,22,549,1,55,5,"Knox County",470313,44.2258666037299,0.0553047404063205,73.1427793830917,6.37873076015334,18.7109435631165,5.53047404063205
2020-06-18,612,15,603,15,9,0,671,18,26976,804,27647,822,0,5,2,80,13,527,0,54,5,"Knox County",470313,40.6112525063096,0.0448504983388704,174.777222828202,3.18936538007667,17.0099486937423,4.48504983388704
2020-06-17,597,17,588,17,9,0,653,13,26172,282,26825,295,0,5,-3,78,20,514,0,54,5,"Knox County",470313,36.7840140502176,0.0396891479322787,62.7241858081746,3.61461409742023,16.5846999763987,3.96891479322787
2020-06-16,580,9,571,8,9,1,640,9,25890,178,26530,187,0,5,-2,81,11,494,0,54,5,"Knox County",470313,32.9567755941256,0.0357847280924204,39.7607550716225,1.913619228046,17.222573052414,3.57847280924204
2020-06-15,571,8,563,8,8,0,631,9,25712,218,26343,227,0,5,-5,83,13,483,0,54,5,"Knox County",470313,27.0032935513158,0.0330917113142137,48.2657294184936,1.70099486937423,17.6478217697576,3.30917113142137
2020-06-14,563,8,555,8,8,0,622,9,25494,624,26116,633,0,5,4,88,4,470,0,54,5,"Knox County",470313,22.1129333018649,0.0260663507109005,134.591219039236,1.70099486937423,18.7109435631165,2.60663507109005
2020-06-13,555,10,547,8,8,2,613,9,24870,213,25483,222,0,5,0,84,10,466,3,54,5,"Knox County",470313,20.6245627911625,0.0282051282051282,47.2026076251348,2.12624358671778,17.8604461284294,2.82051282051282
2020-06-12,545,19,539,19,6,0,604,19,24657,750,25261,769,0,5,1,84,18,456,0,51,5,"Knox County",470313,18.2856948457729,0.0272583201267829,163.508131818597,4.03986281476378,17.8604461284294,2.72583201267829
2020-06-11,526,7,520,7,6,0,585,10,23907,379,24492,389,0,5,1,83,6,438,2,51,5,"Knox County",470313,16.5846999763987,0.0286554004408523,82.7108755233217,1.48837051070245,17.6478217697576,2.86554004408523
2020-06-10,519,12,513,12,6,0,575,12,23528,706,24103,718,0,5,-6,82,18,432,0,49,5,"Knox County",470313,15.5215781830398,0.024483306836248,152.664289526337,2.55149230406134,17.4351974110858,2.4483306836248
2020-06-09,507,16,501,16,6,0,563,19,22822,508,23385,527,0,5,5,88,11,414,1,49,5,"Knox County",470313,17.0099486937423,0.0249641319942611,112.053037020027,3.40198973874845,18.7109435631165,2.49641319942611
2020-06-08,491,8,485,8,6,0,544,8,22314,336,22858,344,0,5,4,83,4,403,1,48,5,"Knox County",470313,17.0099486937423,0.0238756246529706,73.1427793830917,1.70099486937423,17.6478217697576,2.38756246529706
2020-06-07,483,7,477,7,6,0,536,8,21978,850,22514,858,0,5,0,79,7,399,1,47,5,"Knox County",470313,16.7973243350705,0.0222106088319833,182.431699740386,1.48837051070245,16.7973243350705,2.22106088319833
2020-06-06,476,11,470,11,6,0,528,12,21128,478,21656,490,0,5,5,79,6,392,0,46,5,"Knox County",470313,17.0099486937423,0.0214896214896215,104.185935749171,2.33886794538956,16.7973243350705,2.14896214896215
2020-06-05,465,18,459,18,6,0,516,17,20650,518,21166,535,0,5,7,74,11,386,1,46,5,"Knox County",470313,16.7973243350705,0.0222740222740223,113.754031889401,3.82723845609201,15.7342025417116,2.22740222740223
2020-06-04,447,4,441,4,6,0,499,4,20132,338,20631,342,0,5,-1,67,5,375,0,45,5,"Knox County",470313,16.1594512590551,0.0209753539590981,72.7175306657481,0.850497434687113,14.2458320310091,2.09753539590981
2020-06-03,443,4,437,4,6,0,495,4,19794,399,20289,403,0,5,-3,68,7,370,0,45,5,"Knox County",470313,14.4584563896809,0.0205773078022292,85.6876165447266,0.850497434687113,14.4584563896809,2.05773078022292
2020-06-02,439,26,433,25,6,1,491,24,19395,939,19886,963,0,5,21,71,5,363,2,45,5,"Knox County",470313,16.5846999763987,0.0195679796696315,204.757257400922,5.52823332546623,15.0963294656962,1.95679796696315
2020-06-01,413,17,408,17,5,0,467,20,18456,972,18923,992,0,5,4,50,13,358,0,43,5,"Knox County",470313,18.4983192044447,0.019419594152302,210.923363802404,3.61461409742023,10.6312179335889,1.9419594152302
2020-05-31,396,7,391,7,5,0,447,7,17484,317,17931,324,0,5,3,46,4,345,0,43,5,"Knox County",470313,18.4983192044447,0.0217337614225735,68.8902922096561,1.48837051070245,9.7807204989018,2.17337614225735
2020-05-30,389,6,384,6,5,0,440,6,17167,294,17607,300,0,5,-1,43,7,341,2,43,5,"Knox County",470313,17.4351974110858,0.0212490282456595,63.7873076015334,1.27574615203067,9.14284742288646,2.12490282456595
2020-05-29,383,8,378,8,5,0,434,7,16873,205,17307,212,0,5,0,44,8,334,0,41,5,"Knox County",470313,15.308953824368,0.0203619909502262,45.076364038417,1.70099486937423,9.35547178155824,2.03619909502262
2020-05-28,375,11,370,11,5,0,427,11,16668,336,17095,347,0,5,7,44,4,326,0,41,5,"Knox County",470313,16.7973243350705,0.022310081897769,73.780652459107,2.33886794538956,9.35547178155824,2.2310081897769
2020-05-27,364,5,359,5,5,0,416,6,16332,420,16748,426,0,5,0,37,5,322,1,41,5,"Knox County",470313,17.0099486937423,0.0227272727272727,90.5779767941775,1.06312179335889,7.86710127085579,2.27272727272727
2020-05-26,359,9,354,9,5,0,410,10,15912,1142,16322,1152,0,5,7,37,2,317,0,40,5,"Knox County",470313,13.395334596322,0.0178523847588596,244.943261189888,1.913619228046,7.86710127085579,1.78523847588596
2020-05-25,350,9,345,9,5,0,400,11,14770,381,15170,392,0,5,5,30,4,315,1,40,5,"Knox County",470313,11.6943397269478,0.018395179194418,83.348748599337,1.913619228046,6.37873076015334,1.8395179194418
2020-05-24,341,2,336,2,5,0,389,3,14389,273,14778,276,0,5,1,25,1,311,0,39,5,"Knox County",470313,10.6312179335889,0.0173913043478261,58.6843229934108,0.425248717343556,5.31560896679445,1.73913043478261
2020-05-23,339,7,334,7,5,0,386,10,14116,360,14502,370,0,5,4,24,3,310,2,39,5,"Knox County",470313,10.8438422922607,0.0182677165354331,78.6710127085579,1.48837051070245,5.10298460812268,1.82677165354331
2020-05-22,332,1,327,1,5,0,376,1,13756,253,14132,254,0,5,-14,20,15,307,0,37,5,"Knox County",470313,9.35547178155824,0.0161641280696301,54.0065871026317,0.212624358671778,4.25248717343556,1.61641280696301
2020-05-21,331,0,326,0,5,0,375,0,13503,250,13878,250,0,5,-1,34,1,292,0,37,5,"Knox County",470313,7.01660383616868,0.0131410256410256,53.1560896679445,0,7.22922819484046,1.31410256410256
2020-05-20,331,7,326,7,5,0,375,7,13253,360,13628,367,0,5,4,35,3,291,0,37,5,"Knox County",470313,7.44185255351224,0.0137210062071219,78.0331396325426,1.48837051070245,7.44185255351224,1.37210062071219
2020-05-19,324,7,319,7,5,0,368,7,12893,369,13261,376,0,5,4,31,3,288,2,37,5,"Knox County",470313,7.01660383616868,0.0170678336980306,79.9467588605886,1.48837051070245,6.59135511882512,1.70678336980306
2020-05-18,317,3,312,3,5,0,361,4,12524,478,12885,482,0,5,0,27,3,285,0,35,5,"Knox County",470313,5.74085768413801,0.0134736842105263,102.484940879797,0.637873076015334,5.74085768413801,1.34736842105263
2020-05-17,314,3,309,3,5,0,357,5,12046,216,12403,221,0,5,1,27,2,282,1,35,5,"Knox County",470313,5.95348204280979,0.0146551724137931,46.989983266463,0.637873076015334,5.74085768413801,1.46551724137931
2020-05-16,311,0,306,0,5,0,352,0,11830,349,12182,349,0,5,-4,26,4,280,0,34,5,"Knox County",470313,4.46511153210734,0.0104393214441061,74.2059011764506,0,5.52823332546623,1.04393214441061
2020-05-15,311,1,306,1,5,0,352,4,11481,541,11833,545,0,5,-4,30,5,276,0,34,5,"Knox County",470313,4.46511153210734,0.0104247104247104,115.880275476119,0.212624358671778,6.37873076015334,1.04247104247104
2020-05-14,310,3,305,3,5,0,348,7,10940,458,11288,465,0,5,0,34,3,271,0,34,5,"Knox County",470313,5.10298460812268,0.0121212121212121,98.8703267823768,0.637873076015334,7.22922819484046,1.21212121212121
2020-05-13,307,7,302,7,5,0,341,5,10482,341,10823,346,0,5,1,34,6,268,0,34,5,"Knox County",470313,5.10298460812268,0.0114942528735632,73.5680281004352,1.48837051070245,7.22922819484046,1.14942528735632
2020-05-12,300,6,295,6,5,0,336,8,10141,401,10477,409,0,5,3,33,3,262,0,34,5,"Knox County",470313,4.8903602494509,0.0117145899893504,86.9633626967573,1.27574615203067,7.01660383616868,1.17145899893504
2020-05-11,294,16,289,16,5,0,328,12,9740,254,10068,266,0,5,9,30,7,259,1,34,5,"Knox County",470313,7.65447691218401,0.015763168012303,56.558079406693,3.40198973874845,6.37873076015334,1.5763168012303
2020-05-10,278,5,273,5,5,0,316,5,9486,221,9802,226,0,5,1,21,4,252,1,33,5,"Knox County",470313,8.07972562952757,0.0157329240214889,48.0531050598219,1.06312179335889,4.46511153210734,1.57329240214889
2020-05-09,273,2,268,2,5,0,311,4,9265,352,9576,356,0,5,-1,20,3,248,0,32,5,"Knox County",470313,8.50497434687113,0.0172215843857635,75.694271687153,0.425248717343556,4.25248717343556,1.72215843857635
2020-05-08,271,3,266,3,5,0,307,4,8913,265,9220,269,0,5,-2,21,5,245,0,32,5,"Knox County",470313,8.93022306421468,0.0192554557124519,57.1959524827083,0.637873076015334,4.46511153210734,1.92554557124519
2020-05-07,268,3,263,3,5,0,303,3,8648,220,8951,223,0,5,-2,23,5,240,0,32,5,"Knox County",470313,8.93022306421468,0.0195704057279236,47.4152319838065,0.637873076015334,4.8903602494509,1.95704057279236
2020-05-06,265,1,260,1,5,0,300,1,8428,185,8728,186,0,5,-7,25,8,235,0,32,5,"Knox County",470313,7.65447691218401,0.0191214470284238,39.5481307129507,0.212624358671778,5.31560896679445,1.91214470284238
2020-05-05,264,4,259,4,5,0,299,5,8243,305,8542,310,0,5,-1,32,5,227,0,32,5,"Knox County",470313,7.22922819484046,0.0185185185185185,65.9135511882512,0.850497434687113,6.8039794774969,1.85185185185185
2020-05-04,260,4,255,4,5,0,294,7,7938,259,8232,266,0,5,-3,33,7,222,0,32,5,"Knox County",470313,4.67773589077912,0.0157952069716776,56.558079406693,0.850497434687113,7.01660383616868,1.57952069716776
2020-05-03,256,7,251,5,5,2,287,6,7679,290,7966,296,0,5,6,36,1,215,2,32,5,"Knox County",470313,5.10298460812268,0.0157397691500525,62.9368101668463,1.48837051070245,7.65447691218401,1.57397691500525
2020-05-02,249,3,246,3,3,0,281,5,7389,308,7670,313,0,5,1,30,2,214,1,30,5,"Knox County",470313,5.31560896679445,0.0166398282340311,66.5514242642666,0.637873076015334,6.37873076015334,1.66398282340311
2020-05-01,246,9,243,8,3,1,276,7,7081,354,7357,361,0,5,4,29,5,212,0,29,5,"Knox County",470313,6.59135511882512,0.0173913043478261,76.7573934805119,1.913619228046,6.16610640148157,1.73913043478261
2020-04-30,237,4,235,4,2,0,269,3,6727,119,6996,122,0,5,-1,25,5,207,0,29,5,"Knox County",470313,6.8039794774969,0.0183387270765912,25.9401717579569,0.850497434687113,5.31560896679445,1.83387270765912
2020-04-29,233,8,231,8,2,0,266,10,6608,671,6874,681,0,5,5,26,3,202,0,29,5,"Knox County",470313,8.29234998819935,0.0183056619838229,144.797188255481,1.70099486937423,5.52823332546623,1.83056619838229
2020-04-28,225,8,223,8,2,0,256,10,5937,391,6193,401,1,5,4,21,3,199,0,29,5,"Knox County",470313,9.14284742288646,0.019672131147541,85.262367827383,1.70099486937423,4.46511153210734,1.9672131147541
2020-04-27,217,2,215,2,2,0,246,4,5546,161,5792,165,0,4,1,17,1,196,0,29,5,"Knox County",470313,8.7175987055429,0.0192389910218042,35.0830191808434,0.425248717343556,3.61461409742023,1.92389910218042
2020-04-26,215,1,213,1,2,0,242,1,5385,172,5627,173,0,4,-2,16,3,195,0,29,4,"Knox County",470313,7.44185255351224,0.0180505415162455,36.7840140502176,0.212624358671778,3.40198973874845,1.80505415162455
2020-04-25,214,0,212,0,2,0,241,0,5213,53,5454,53,0,4,-6,18,6,192,0,29,4,"Knox County",470313,6.8039794774969,0.0178936605316973,11.2690910096042,0,3.82723845609201,1.78936605316973
2020-04-24,214,8,212,8,2,0,241,10,5160,836,5401,846,0,4,5,24,3,186,1,29,4,"Knox County",470313,6.59135511882512,0.0155673904137649,179.880207436324,1.70099486937423,5.10298460812268,1.55673904137648
2020-04-23,206,1,204,1,2,0,231,2,4324,137,4555,139,0,4,0,19,1,183,0,28,4,"Knox County",470313,5.95348204280979,0.0150528885272579,29.5547858553772,0.212624358671778,4.03986281476378,1.50528885272579
2020-04-22,205,5,203,3,2,2,229,2,4187,189,4416,191,0,4,1,19,4,182,0,28,4,"Knox County",470313,5.31560896679445,0.0147357723577236,40.6112525063096,1.06312179335889,4.03986281476378,1.47357723577236
2020-04-21,200,4,200,4,0,0,227,5,3998,475,4225,480,0,4,-2,18,6,178,1,28,4,"Knox County",470313,4.46511153210734,0.0117244748412311,102.059692162454,0.850497434687113,3.82723845609201,1.17244748412311
2020-04-20,196,3,196,3,0,0,222,2,3523,175,3745,177,0,4,-1,20,4,172,1,27,4,"Knox County",470313,4.67773589077912,0.0106847984458475,37.6345114849047,0.637873076015334,4.25248717343556,1.06847984458475
2020-04-19,193,0,193,0,0,0,220,0,3348,72,3568,72,0,4,-4,21,4,168,0,26,4,"Knox County",470313,4.46511153210734,0.0107252298263534,15.308953824368,0,4.46511153210734,1.07252298263534
2020-04-18,193,0,193,0,0,0,220,1,3276,135,3496,136,0,4,-5,25,5,164,0,26,4,"Knox County",470313,4.46511153210734,0.0107790298873101,28.9169127793618,0,5.31560896679445,1.07790298873101
2020-04-17,193,2,193,2,0,0,219,3,3141,104,3360,107,0,4,-2,30,4,159,1,26,4,"Knox County",470313,3.18936538007667,0.0115207373271889,22.7508063778803,0.425248717343556,6.37873076015334,1.15207373271889
2020-04-16,191,7,191,7,0,0,216,9,3037,213,3253,222,0,4,2,32,5,155,2,25,4,"Knox County",470313,4.46511153210734,0.015884476534296,47.2026076251348,1.48837051070245,6.8039794774969,1.5884476534296
2020-04-15,184,9,184,9,0,0,207,10,2824,84,3031,94,0,4,3,30,6,150,1,23,4,"Knox County",470313,5.31560896679445,0.0232919254658385,19.9866897151471,1.913619228046,6.37873076015334,2.32919254658385
2020-04-14,175,4,175,4,0,0,197,4,2740,102,2937,106,0,4,1,27,3,144,1,22,4,"Knox County",470313,5.31560896679445,0.0317286652078775,22.5381820192085,0.850497434687113,5.74085768413801,3.17286652078775
2020-04-13,171,4,171,4,0,0,193,9,2638,242,2831,251,0,4,-2,26,6,141,1,21,4,"Knox County",470313,5.52823332546623,0.0364372469635627,53.3687140266163,0.850497434687113,5.52823332546623,3.64372469635628
2020-04-12,167,5,167,5,0,0,184,6,2396,166,2580,172,0,4,1,28,4,135,0,20,4,"Knox County",470313,6.59135511882512,0.0386029411764706,36.5713896915458,1.06312179335889,5.95348204280979,3.86029411764706
2020-04-11,162,5,162,5,0,0,178,8,2230,313,2408,321,1,4,-4,27,8,131,1,20,4,"Knox County",470313,7.65447691218401,0.0384917517674784,68.2524191336408,1.06312179335889,5.74085768413801,3.84917517674784
2020-04-10,157,4,157,4,0,0,170,5,1917,123,2087,128,0,3,0,31,4,123,0,19,4,"Knox County",470313,8.07972562952757,0.0394126738794436,27.2159179099876,0.850497434687113,6.59135511882512,3.94126738794436
2020-04-09,153,1,153,1,0,0,165,1,1794,81,1959,82,0,3,-2,31,3,119,0,19,4,"Knox County",470313,6.8039794774969,0.037261698440208,17.4351974110858,0.212624358671778,6.59135511882512,3.7261698440208
2020-04-08,152,8,152,8,0,0,164,12,1713,111,1877,123,0,3,-3,33,11,116,1,19,4,"Knox County",470313,6.59135511882512,0.0380388841927303,26.1527961166287,1.70099486937423,7.01660383616868,3.80388841927303
2020-04-07,144,20,144,20,0,0,152,25,1602,366,1754,391,0,3,11,36,9,105,2,18,3,"Knox County",470313,9.99334485757357,0.0449591280653951,83.1361242406653,4.25248717343556,7.65447691218401,4.49591280653951
2020-04-06,124,8,124,8,0,0,127,14,1236,54,1363,68,2,3,-2,25,8,96,1,16,3,"Knox County",470313,10.8438422922607,0.0552529182879377,14.4584563896809,1.70099486937423,5.31560896679445,5.52529182879377
2020-04-05,116,4,116,4,0,0,113,10,1182,75,1295,85,0,1,-2,27,6,88,0,15,3,"Knox County",470313,10.6312179335889,0.0626043405676127,18.0730704871011,0.850497434687113,5.74085768413801,6.26043405676127
2020-04-04,112,15,112,15,0,0,103,6,1107,127,1210,133,0,1,4,29,11,82,1,15,2,"Knox County",470313,12.7574615203067,0.0722772277227723,28.2790397033465,3.18936538007667,6.16610640148157,7.22772277227723
2020-04-03,97,4,97,4,0,0,97,3,980,51,1077,54,0,1,-8,25,12,71,1,14,1,"Knox County",470313,12.7574615203067,0.0758547008547008,11.481715368276,0.850497434687113,5.31560896679445,7.58547008547009
2020-04-02,93,7,93,7,0,0,94,7,929,106,1023,113,0,1,NA,33,8,59,0,13,1,"Knox County",470313,14.0332076723374,0.0796277145811789,24.0265525299109,1.48837051070245,7.01660383616868,7.96277145811789
2020-04-01,86,15,86,15,0,0,87,15,823,140,910,155,NA,NA,NA,NA,7,51,1,13,1,"Knox County",470313,15.5215781830398,0.0800800800800801,32.9567755941256,3.18936538007667,NA,8.00800800800801
2020-03-31,71,8,71,8,0,0,72,11,683,58,755,69,NA,NA,NA,NA,12,44,1,12,1,"Knox County",470313,12.9700858789785,0.0974889217134417,14.6710807483527,1.70099486937423,NA,9.74889217134417
2020-03-30,63,13,63,13,0,0,61,15,625,130,686,145,NA,NA,NA,NA,9,32,2,11,1,"Knox County",470313,14.0332076723374,0.0888594164456233,30.8305320074078,2.76411666273312,NA,8.88594164456233
2020-03-29,50,8,50,8,0,0,46,8,495,55,541,63,NA,NA,NA,NA,6,23,1,9,1,"Knox County",470313,14.8837051070245,0.0887978142076503,13.395334596322,1.70099486937423,NA,8.87978142076503
2020-03-28,42,7,42,7,0,0,38,6,440,62,478,68,NA,NA,NA,NA,1,17,1,8,0,"Knox County",470313,13.1827102376502,0.0974512743628186,14.4584563896809,1.48837051070245,NA,9.74512743628186
2020-03-27,35,2,35,2,0,0,32,2,378,54,410,56,NA,NA,NA,NA,5,16,1,7,0,"Knox County",470313,12.7574615203067,0.0956651718983558,11.9069640856196,0.425248717343556,NA,9.56651718983558
2020-03-26,33,7,33,7,0,0,30,7,324,82,354,89,NA,NA,NA,NA,3,11,2,6,0,"Knox County",470313,12.7574615203067,0.0992248062015504,18.9235679217883,1.48837051070245,NA,9.92248062015504
2020-03-25,26,6,26,6,0,0,23,7,242,68,265,75,NA,NA,NA,NA,3,8,1,4,0,"Knox County",470313,10.8438422922607,0.0991150442477876,15.9468269003834,1.27574615203067,NA,9.91150442477876
2020-03-24,20,7,20,7,0,0,16,7,174,43,190,50,NA,NA,NA,NA,2,5,0,3,0,"Knox County",470313,10.6312179335889,0.0952380952380952,10.6312179335889,1.48837051070245,NA,9.52380952380952
2020-03-23,13,4,13,4,0,0,9,4,131,22,140,26,NA,NA,NA,NA,3,3,2,3,0,"Knox County",470313,8.7175987055429,0.0960187353629977,5.52823332546623,0.850497434687113,NA,9.60187353629976
2020-03-22,9,2,9,2,0,0,5,0,109,9,114,9,NA,NA,NA,NA,0,0,1,1,0,"Knox County",470313,7.44185255351224,0.0884718498659517,1.913619228046,0.425248717343556,NA,8.84718498659517
2020-03-21,7,1,7,1,0,0,5,2,100,17,105,19,NA,NA,NA,NA,0,0,0,0,0,"Knox County",470313,6.16610640148157,0.0895061728395062,4.03986281476378,0.212624358671778,NA,8.95061728395062
2020-03-20,6,5,6,5,0,0,3,2,83,38,86,40,NA,NA,NA,NA,0,0,0,0,0,"Knox County",470313,6.8039794774969,0.0941558441558442,8.50497434687113,1.06312179335889,NA,9.41558441558442
2020-03-19,1,0,1,0,0,0,1,0,45,11,46,11,NA,NA,NA,NA,0,0,0,0,0,"Knox County",470313,5.31560896679445,0.0956521739130435,2.33886794538956,0,NA,9.56521739130435
2020-03-18,1,0,1,0,0,0,1,0,34,15,35,15,NA,NA,NA,NA,0,0,0,0,0,"Knox County",470313,4.03986281476378,0.0882352941176471,3.18936538007667,0,NA,8.82352941176471
2020-03-17,1,0,1,0,0,0,1,0,19,5,20,5,NA,NA,NA,NA,0,0,0,0,0,"Knox County",470313,2.55149230406134,0.064,1.06312179335889,0,NA,6.4
2020-03-16,1,1,1,1,0,0,1,1,14,3,15,4,NA,NA,NA,NA,0,0,0,0,0,"Knox County",470313,1.913619228046,0.0485436893203883,0.850497434687113,0.212624358671778,NA,4.85436893203883
2020-03-15,0,0,0,0,0,0,0,0,11,1,11,1,NA,NA,NA,NA,0,0,0,0,0,"Knox County",470313,1.48837051070245,0.0526315789473684,0.212624358671778,0,NA,5.26315789473684
2020-03-14,0,0,0,0,0,0,0,0,10,8,10,8,NA,NA,NA,NA,0,0,0,0,0,"Knox County",470313,1.27574615203067,0.0357142857142857,1.70099486937423,0,NA,3.57142857142857
2020-03-13,0,0,0,0,0,0,0,0,2,0,2,0,NA,NA,NA,NA,0,0,0,0,0,"Knox County",470313,0.212624358671778,0.0227272727272727,0,0,NA,2.27272727272727
2020-03-12,0,0,0,0,0,0,0,0,2,2,2,2,NA,NA,NA,NA,0,0,0,0,0,"Knox County",470313,0.212624358671778,0.0285714285714286,0.425248717343556,0,NA,2.85714285714286
2020-03-12,0,0,0,0,0,0,0,0,0,0,0,0,NA,NA,NA,NA,0,0,0,0,0,"Anderson",76978,NA,NA,0,0,NA,NA
2020-03-13,0,0,0,0,0,0,0,0,1,1,1,1,NA,NA,NA,NA,0,0,0,0,0,"Anderson",76978,NA,NA,1.29907246226194,0,NA,NA
2020-03-14,0,0,0,0,0,0,0,0,1,0,1,0,NA,NA,NA,NA,0,0,0,0,0,"Anderson",76978,NA,NA,0,0,NA,NA
2020-03-15,0,0,0,0,0,0,0,0,1,0,1,0,NA,NA,NA,NA,0,0,0,0,0,"Anderson",76978,NA,NA,0,0,NA,NA
2020-03-16,0,0,0,0,0,0,0,0,2,1,2,1,NA,NA,NA,NA,0,0,0,0,0,"Anderson",76978,NA,NA,1.29907246226194,0,NA,NA
2020-03-17,0,0,0,0,0,0,0,0,4,2,4,2,NA,NA,NA,NA,0,0,0,0,0,"Anderson",76978,NA,NA,2.59814492452389,0,NA,NA
2020-03-18,0,0,0,0,0,0,0,0,4,0,4,0,NA,NA,NA,NA,0,0,0,0,0,"Anderson",76978,0,0,0,0,NA,0
2020-03-19,1,1,1,1,0,0,2,2,5,1,7,3,NA,NA,NA,NA,0,0,0,0,0,"Anderson",76978,1.29907246226194,0.285714285714286,3.89721738678583,1.29907246226194,NA,28.5714285714286
2020-03-20,1,0,1,0,0,0,2,0,7,2,9,2,NA,NA,NA,NA,0,0,0,0,0,"Anderson",76978,1.29907246226194,0.25,2.59814492452389,0,NA,25
2020-03-21,1,0,1,0,0,0,2,0,7,0,9,0,NA,NA,NA,NA,0,0,0,0,0,"Anderson",76978,1.29907246226194,0.25,0,0,NA,25
2020-03-22,1,0,1,0,0,0,2,0,10,3,12,3,NA,NA,NA,NA,0,0,0,0,0,"Anderson",76978,1.29907246226194,0.181818181818182,3.89721738678583,0,NA,18.1818181818182
2020-03-23,1,0,1,0,0,0,2,0,15,5,17,5,NA,NA,NA,NA,0,0,0,0,0,"Anderson",76978,1.29907246226194,0.133333333333333,6.49536231130973,0,NA,13.3333333333333
2020-03-24,1,0,1,0,0,0,2,0,20,5,22,5,NA,NA,NA,NA,0,0,0,0,0,"Anderson",76978,1.29907246226194,0.111111111111111,6.49536231130973,0,NA,11.1111111111111
2020-03-25,2,1,2,1,0,0,4,2,29,9,33,11,NA,NA,NA,NA,1,1,0,0,0,"Anderson",76978,2.59814492452389,0.137931034482759,14.2897970848814,1.29907246226194,NA,13.7931034482759
2020-03-26,3,1,3,1,0,0,5,1,44,15,49,16,NA,NA,NA,NA,0,1,1,1,0,"Anderson",76978,2.59814492452389,0.0714285714285714,20.7851593961911,1.29907246226194,NA,7.14285714285714
2020-03-27,4,1,4,1,0,0,6,1,53,9,59,10,NA,NA,NA,NA,3,4,0,1,0,"Anderson",76978,3.89721738678583,0.08,12.9907246226195,1.29907246226194,NA,8
2020-03-28,7,3,7,3,0,0,9,3,72,19,81,22,NA,NA,NA,NA,0,4,1,2,0,"Anderson",76978,7.79443477357167,0.0972222222222222,28.5795941697628,3.89721738678583,NA,9.72222222222222
2020-03-29,7,0,7,0,0,0,9,0,83,11,92,11,NA,NA,NA,NA,0,4,0,2,0,"Anderson",76978,7.79443477357167,0.0875,14.2897970848814,0,NA,8.75
2020-03-30,8,1,8,1,0,0,10,1,127,44,137,45,NA,NA,NA,NA,1,5,0,2,0,"Anderson",76978,9.09350723583361,0.0666666666666667,58.4582608017875,1.29907246226194,NA,6.66666666666667
2020-03-31,9,1,9,1,0,0,11,1,142,15,153,16,NA,NA,NA,NA,1,6,0,2,0,"Anderson",76978,10.3925796980956,0.0687022900763359,20.7851593961911,1.29907246226194,NA,6.87022900763359
2020-04-01,9,0,9,0,0,0,11,0,163,21,174,21,NA,NA,NA,NA,0,6,0,2,0,"Anderson",76978,9.09350723583361,0.049645390070922,27.2805217075008,0,NA,4.9645390070922
2020-04-02,9,0,9,0,0,0,11,0,179,16,190,16,0,0,NA,3,0,6,0,2,0,"Anderson",76978,7.79443477357167,0.0425531914893617,20.7851593961911,0,3.89721738678583,4.25531914893617
2020-04-03,9,0,9,0,0,0,11,0,192,13,203,13,0,0,-2,1,2,8,0,2,0,"Anderson",76978,6.49536231130972,0.0347222222222222,16.8879420094053,0,1.29907246226194,3.47222222222222
2020-04-04,9,0,9,0,0,0,11,0,219,27,230,27,0,0,0,1,0,8,0,2,0,"Anderson",76978,2.59814492452389,0.0134228187919463,35.0749564810725,0,1.29907246226194,1.34228187919463
2020-04-05,9,0,9,0,0,0,11,0,248,29,259,29,0,0,0,1,0,8,0,2,0,"Anderson",76978,2.59814492452389,0.0119760479041916,37.6731014055964,0,1.29907246226194,1.19760479041916
2020-04-06,9,0,9,0,0,0,11,0,262,14,273,14,0,0,-1,0,1,9,0,2,0,"Anderson",76978,1.29907246226194,0.00735294117647059,18.1870144716672,0,0,0.735294117647059
2020-04-07,10,1,10,1,0,0,12,1,304,42,316,43,0,0,1,1,0,9,0,2,0,"Anderson",76978,1.29907246226194,0.00613496932515337,55.8601158772636,1.29907246226194,1.29907246226194,0.613496932515337
2020-04-08,10,0,10,0,0,0,12,0,322,18,334,18,1,1,-1,0,0,9,0,2,1,"Anderson",76978,1.29907246226194,0.00625,23.383304320715,0,0,0.625
2020-04-09,10,0,10,0,0,0,12,0,350,28,362,28,0,1,0,0,0,9,0,2,1,"Anderson",76978,1.29907246226194,0.00581395348837209,36.3740289433345,0,0,0.581395348837209
2020-04-10,10,0,10,0,0,0,12,0,366,16,378,16,0,1,0,0,0,9,0,2,1,"Anderson",76978,1.29907246226194,0.00571428571428571,20.7851593961911,0,0,0.571428571428571
2020-04-11,10,0,10,0,0,0,12,0,439,73,451,73,0,1,0,0,0,9,0,2,1,"Anderson",76978,1.29907246226194,0.00452488687782805,94.832289745122,0,0,0.452488687782805
2020-04-12,12,2,12,2,0,0,14,2,477,38,491,40,0,1,2,2,0,9,0,2,1,"Anderson",76978,3.89721738678583,0.0129310344827586,51.9628984904778,2.59814492452389,2.59814492452389,1.29310344827586
2020-04-13,13,1,13,1,0,0,15,1,514,37,529,38,0,1,0,2,1,10,0,2,1,"Anderson",76978,5.19628984904778,0.015625,49.3647535659539,1.29907246226194,2.59814492452389,1.5625
2020-04-14,13,0,13,0,0,0,15,0,526,12,541,12,0,1,0,2,0,10,0,2,1,"Anderson",76978,3.89721738678583,0.0133333333333333,15.5888695471433,0,2.59814492452389,1.33333333333333
2020-04-15,13,0,13,0,0,0,15,0,544,18,559,18,0,1,-2,0,2,12,0,2,1,"Anderson",76978,3.89721738678583,0.0133333333333333,23.383304320715,0,0,1.33333333333333
2020-04-16,13,0,13,0,0,0,15,0,566,22,581,22,0,1,0,0,0,12,0,2,1,"Anderson",76978,3.89721738678583,0.0136986301369863,28.5795941697628,0,0,1.36986301369863
2020-04-17,13,0,13,0,0,0,15,0,586,20,601,20,0,1,0,0,0,12,0,2,1,"Anderson",76978,3.89721738678583,0.0134529147982063,25.9814492452389,0,0,1.34529147982063
2020-04-18,13,0,13,0,0,0,15,0,616,30,631,30,0,1,0,0,0,12,0,2,1,"Anderson",76978,3.89721738678583,0.0166666666666667,38.9721738678584,0,0,1.66666666666667
2020-04-19,14,1,14,1,0,0,16,1,628,12,644,13,0,1,0,0,1,13,0,2,1,"Anderson",76978,2.59814492452389,0.0130718954248366,16.8879420094053,1.29907246226194,0,1.30718954248366
2020-04-20,19,5,18,4,1,1,19,3,648,20,667,23,0,1,5,5,0,13,0,2,1,"Anderson",76978,7.79443477357167,0.0289855072463768,29.8786666320247,6.49536231130973,6.49536231130973,2.89855072463768
2020-04-21,20,1,19,1,1,0,22,3,1071,423,1093,426,0,1,1,6,0,13,0,2,1,"Anderson",76978,9.09350723583361,0.0126811594202899,553.404868923589,1.29907246226194,7.79443477357167,1.26811594202899
2020-04-22,21,1,20,1,1,0,24,2,1141,70,1165,72,0,1,0,6,1,14,0,2,1,"Anderson",76978,10.3925796980956,0.0148514851485149,93.53321728286,1.29907246226194,7.79443477357167,1.48514851485149
2020-04-23,21,0,20,0,1,0,24,0,1191,50,1215,50,0,1,-1,5,1,15,0,2,1,"Anderson",76978,10.3925796980956,0.0141955835962145,64.9536231130973,0,6.49536231130973,1.41955835962145
2020-04-24,22,1,21,1,1,0,25,1,1299,108,1324,109,0,1,1,6,0,15,0,2,1,"Anderson",76978,11.6916521603575,0.0138312586445367,141.598898386552,1.29907246226194,7.79443477357167,1.38312586445367
2020-04-25,22,0,21,0,1,0,25,0,1336,37,1361,37,0,1,0,6,0,15,0,2,1,"Anderson",76978,11.6916521603575,0.0136986301369863,48.065681103692,0,7.79443477357167,1.36986301369863
2020-04-26,22,0,21,0,1,0,25,0,1372,36,1397,36,0,1,0,6,0,15,0,2,1,"Anderson",76978,10.3925796980956,0.0119521912350598,46.76660864143,0,7.79443477357167,1.19521912350598
2020-04-27,22,0,21,0,1,0,25,0,1411,39,1436,39,0,1,-1,5,1,16,0,2,1,"Anderson",76978,3.89721738678583,0.00780234070221066,50.6638260282159,0,6.49536231130973,0.780234070221066
2020-04-28,22,0,21,0,1,0,25,0,1690,279,1715,279,0,1,0,5,0,16,0,2,1,"Anderson",76978,2.59814492452389,0.00482315112540193,362.441216971083,0,6.49536231130973,0.482315112540193
2020-04-29,26,4,25,4,1,0,28,3,2070,380,2098,383,0,1,4,9,0,16,0,2,1,"Anderson",76978,6.49536231130972,0.00428724544480171,497.544753046325,5.19628984904778,11.6916521603575,0.428724544480171
2020-04-30,26,0,25,0,1,0,29,1,2102,32,2131,33,0,1,-1,8,1,17,0,2,1,"Anderson",76978,6.49536231130972,0.00545851528384279,42.8693912546442,0,10.3925796980956,0.545851528384279
2020-05-01,26,0,25,0,1,0,29,0,2154,52,2183,52,0,1,-2,6,2,19,0,2,1,"Anderson",76978,5.19628984904778,0.00465657741559953,67.5517680376211,0,7.79443477357167,0.465657741559953
2020-05-02,26,0,25,0,1,0,29,0,2221,67,2250,67,0,1,0,6,0,19,0,2,1,"Anderson",76978,5.19628984904778,0.00449943757030371,87.0378549715503,0,7.79443477357167,0.449943757030371
2020-05-03,27,1,26,1,1,0,30,1,2314,93,2344,94,0,1,1,7,0,19,0,2,1,"Anderson",76978,6.49536231130972,0.00527983104540655,122.112811452623,1.29907246226194,9.09350723583361,0.527983104540655
2020-05-04,27,0,26,0,1,0,30,0,2406,92,2436,92,0,1,-1,6,1,20,0,2,1,"Anderson",76978,6.49536231130972,0.005,119.514666528099,0,7.79443477357167,0.5
2020-05-05,28,1,27,1,1,0,30,0,2475,69,2505,69,0,1,-1,5,2,22,0,2,1,"Anderson",76978,7.79443477357167,0.00632911392405063,89.6359998960742,1.29907246226194,6.49536231130973,0.632911392405063
2020-05-06,30,2,29,2,1,0,31,1,2525,50,2556,51,0,1,2,7,0,22,0,2,1,"Anderson",76978,5.19628984904778,0.00655021834061135,66.2526955753592,2.59814492452389,9.09350723583361,0.655021834061135
2020-05-07,30,0,29,0,1,0,33,2,2597,72,2630,74,0,1,-1,6,1,23,0,2,1,"Anderson",76978,5.19628984904778,0.00801603206412826,96.1313622073839,0,7.79443477357167,0.801603206412826
2020-05-08,30,0,29,0,1,0,33,0,2652,55,2685,55,0,1,0,6,0,23,0,2,1,"Anderson",76978,5.19628984904778,0.00796812749003984,71.448985424407,0,7.79443477357167,0.796812749003984
2020-05-09,30,0,29,0,1,0,33,0,2734,82,2767,82,0,1,0,6,0,23,0,2,1,"Anderson",76978,5.19628984904778,0.00773694390715667,106.523941905479,0,7.79443477357167,0.773694390715667
2020-05-10,30,0,29,0,1,0,33,0,2827,93,2860,93,0,1,-3,3,3,26,0,2,1,"Anderson",76978,3.89721738678583,0.00581395348837209,120.813738990361,0,3.89721738678583,0.581395348837209
2020-05-11,32,2,31,2,1,0,33,0,2909,82,2942,82,0,1,2,5,0,26,0,2,1,"Anderson",76978,6.49536231130972,0.00592885375494071,106.523941905479,2.59814492452389,6.49536231130973,0.592885375494071
2020-05-12,33,1,32,1,1,0,35,2,3042,133,3077,135,0,1,1,6,0,26,0,2,1,"Anderson",76978,6.49536231130972,0.00874125874125874,175.374782405363,1.29907246226194,7.79443477357167,0.874125874125874
2020-05-13,35,2,34,2,1,0,38,3,3220,178,3258,181,0,1,1,7,1,27,1,3,1,"Anderson",76978,6.49536231130972,0.00997150997150997,235.132115669412,2.59814492452389,9.09350723583361,0.997150997150997
2020-05-14,35,0,34,0,1,0,39,1,3346,126,3385,127,0,1,-1,6,1,28,0,3,1,"Anderson",76978,6.49536231130972,0.00794701986754967,164.982202707267,0,7.79443477357167,0.794701986754967
2020-05-15,36,1,35,1,1,0,39,0,3417,71,3456,71,0,1,1,7,0,28,0,3,1,"Anderson",76978,7.79443477357167,0.00778210116731518,92.2341448205981,1.29907246226194,9.09350723583361,0.778210116731518
2020-05-16,36,0,35,0,1,0,41,2,3657,240,3698,242,0,1,-1,6,1,29,0,3,1,"Anderson",76978,7.79443477357167,0.00859291084854995,314.375535867391,0,7.79443477357167,0.859291084854995
2020-05-17,36,0,35,0,1,0,41,0,3727,70,3768,70,0,1,0,6,0,29,0,3,1,"Anderson",76978,7.79443477357167,0.00881057268722467,90.9350723583361,0,7.79443477357167,0.881057268722467
2020-05-18,37,1,36,1,1,0,42,1,3804,77,3846,78,0,1,-2,4,3,32,0,3,1,"Anderson",76978,6.49536231130972,0.00995575221238938,101.327652056432,1.29907246226194,5.19628984904778,0.995575221238938
2020-05-19,37,0,36,0,1,0,42,0,3856,52,3898,52,0,1,0,4,0,32,0,3,1,"Anderson",76978,5.19628984904778,0.00852618757612668,67.5517680376211,0,5.19628984904778,0.852618757612667
2020-05-20,37,0,36,0,1,0,43,1,3921,65,3964,66,0,1,0,4,0,32,0,3,1,"Anderson",76978,2.59814492452389,0.00708215297450425,85.7387825092884,0,5.19628984904778,0.708215297450425
2020-05-21,37,0,36,0,1,0,44,1,4001,80,4045,81,0,1,-1,3,1,33,0,3,1,"Anderson",76978,2.59814492452389,0.00757575757575758,105.224869443218,0,3.89721738678583,0.757575757575758
2020-05-22,38,1,37,1,1,0,45,1,4029,28,4074,29,0,1,-1,2,2,35,1,4,1,"Anderson",76978,2.59814492452389,0.00970873786407767,37.6731014055964,1.29907246226194,2.59814492452389,0.970873786407767
2020-05-23,38,0,37,0,1,0,46,1,4192,163,4238,164,0,1,0,2,0,35,0,4,1,"Anderson",76978,2.59814492452389,0.00925925925925926,213.047883810959,0,2.59814492452389,0.925925925925926
2020-05-24,38,0,37,0,1,0,46,0,4247,55,4293,55,0,1,0,2,0,35,0,4,1,"Anderson",76978,2.59814492452389,0.00952380952380952,71.448985424407,0,2.59814492452389,0.952380952380952
2020-05-25,38,0,37,0,1,0,47,1,4281,34,4328,35,0,1,0,2,0,35,0,4,1,"Anderson",76978,1.29907246226194,0.0103734439834025,45.4675361791681,0,2.59814492452389,1.03734439834025
2020-05-26,38,0,37,0,1,0,47,0,4412,131,4459,131,0,1,-1,1,1,36,0,4,1,"Anderson",76978,1.29907246226194,0.0089126559714795,170.178492556315,0,1.29907246226194,0.89126559714795
2020-05-27,38,0,37,0,1,0,47,0,4515,103,4562,103,0,1,0,1,0,36,0,4,1,"Anderson",76978,1.29907246226194,0.00668896321070234,133.80446361298,0,1.29907246226194,0.668896321070234
2020-05-28,38,0,37,0,1,0,47,0,4563,48,4610,48,0,1,0,1,0,36,0,4,1,"Anderson",76978,1.29907246226194,0.00530973451327434,62.3554781885734,0,1.29907246226194,0.530973451327434
2020-05-29,39,1,38,1,1,0,47,0,4613,50,4660,50,0,1,0,1,1,37,0,4,1,"Anderson",76978,1.29907246226194,0.00341296928327645,64.9536231130973,1.29907246226194,1.29907246226194,0.341296928327645
2020-05-30,39,0,38,0,1,0,48,1,4665,52,4713,53,0,1,0,1,0,37,0,4,1,"Anderson",76978,1.29907246226194,0.00421052631578947,68.8508404998831,0,1.29907246226194,0.421052631578947
2020-05-31,40,1,39,1,1,0,49,1,4731,66,4780,67,0,1,1,2,0,37,0,4,1,"Anderson",76978,2.59814492452389,0.00616016427104723,87.0378549715503,1.29907246226194,2.59814492452389,0.616016427104723
2020-06-01,40,0,39,0,1,0,49,0,4855,124,4904,124,0,1,0,2,0,37,0,4,1,"Anderson",76978,2.59814492452389,0.00347222222222222,161.084985320481,0,2.59814492452389,0.347222222222222
2020-06-02,40,0,39,0,1,0,49,0,4982,127,5031,127,0,1,0,2,0,37,0,4,1,"Anderson",76978,2.59814492452389,0.0034965034965035,164.982202707267,0,2.59814492452389,0.34965034965035
2020-06-03,41,1,40,1,1,0,50,1,5042,60,5092,61,0,1,1,3,0,37,0,4,2,"Anderson",76978,3.89721738678583,0.00566037735849057,79.2434201979787,1.29907246226194,3.89721738678583,0.566037735849057
2020-06-04,41,0,40,0,1,0,50,0,5090,48,5140,48,1,2,-2,1,1,38,0,4,2,"Anderson",76978,3.89721738678583,0.00566037735849057,62.3554781885734,0,1.29907246226194,0.566037735849057
2020-06-05,42,1,41,1,1,0,53,3,5147,57,5200,60,0,2,1,2,0,38,0,4,2,"Anderson",76978,3.89721738678583,0.0111111111111111,77.9443477357167,1.29907246226194,2.59814492452389,1.11111111111111
2020-06-06,43,1,42,1,1,0,54,1,5200,53,5254,54,0,2,1,3,0,38,0,4,2,"Anderson",76978,5.19628984904778,0.011090573012939,70.149912962145,1.29907246226194,3.89721738678583,1.1090573012939
2020-06-07,45,2,43,1,2,1,57,3,5295,95,5352,98,0,2,2,5,0,38,0,4,2,"Anderson",76978,6.49536231130972,0.013986013986014,127.309101301671,2.59814492452389,6.49536231130973,1.3986013986014
2020-06-08,46,1,44,1,2,0,57,0,5336,41,5393,41,0,2,1,6,0,38,0,4,2,"Anderson",76978,7.79443477357167,0.016359918200409,53.2619709527397,1.29907246226194,7.79443477357167,1.6359918200409
2020-06-09,47,1,45,1,2,0,60,3,5517,181,5577,184,0,2,1,7,0,38,0,4,2,"Anderson",76978,9.09350723583361,0.0201465201465201,239.029333056198,1.29907246226194,9.09350723583361,2.01465201465201
2020-06-10,52,5,50,5,2,0,63,3,5725,208,5788,211,0,2,2,9,3,41,0,4,2,"Anderson",76978,14.2897970848814,0.0186781609195402,274.10428953727,6.49536231130973,11.6916521603575,1.86781609195402
2020-06-11,55,3,53,3,2,0,66,3,5870,145,5936,148,0,2,2,11,1,42,1,5,2,"Anderson",76978,18.1870144716672,0.0201005025125628,192.262724414768,3.89721738678583,14.2897970848814,2.01005025125628
2020-06-12,57,2,55,2,2,0,70,4,5952,82,6022,86,0,2,2,13,0,42,0,5,2,"Anderson",76978,19.4860869339292,0.0206812652068127,111.720231754527,2.59814492452389,16.8879420094053,2.06812652068127
2020-06-13,58,1,55,0,3,1,70,0,5995,43,6065,43,0,2,0,13,1,43,0,5,2,"Anderson",76978,19.4860869339292,0.0197287299630086,55.8601158772636,1.29907246226194,16.8879420094053,1.97287299630086
2020-06-14,60,2,57,2,3,0,70,0,6170,175,6240,175,0,2,1,14,1,44,1,6,2,"Anderson",76978,19.4860869339292,0.0146396396396396,227.33768089584,2.59814492452389,18.1870144716672,1.46396396396396
2020-06-15,60,0,57,0,3,0,71,1,6228,58,6299,59,0,2,0,14,0,44,0,6,2,"Anderson",76978,18.1870144716672,0.0154525386313466,76.6452752734548,0,18.1870144716672,1.54525386313466
2020-06-16,64,4,61,4,3,0,75,4,6289,61,6364,65,0,2,3,17,1,45,0,6,2,"Anderson",76978,22.0842318584531,0.0190597204574333,84.4397100470264,5.19628984904778,22.0842318584531,1.90597204574333
2020-06-17,66,2,63,2,3,0,79,4,6326,37,6405,41,0,2,0,17,2,47,0,6,2,"Anderson",76978,18.1870144716672,0.0259319286871961,53.2619709527397,2.59814492452389,22.0842318584531,2.59319286871961
2020-06-18,70,4,67,4,3,0,84,5,6456,130,6540,135,0,2,2,19,2,49,0,6,2,"Anderson",76978,19.4860869339292,0.0298013245033113,175.374782405363,5.19628984904778,24.682376782977,2.98013245033113
2020-06-19,72,2,69,2,3,0,86,2,6521,65,6607,67,0,2,0,19,2,51,0,6,2,"Anderson",76978,19.4860869339292,0.0273504273504274,87.0378549715503,2.59814492452389,24.682376782977,2.73504273504274
2020-06-20,73,1,70,1,3,0,87,1,6559,38,6646,39,0,2,-1,18,2,53,0,6,2,"Anderson",76978,19.4860869339292,0.0292598967297762,50.6638260282159,1.29907246226194,23.383304320715,2.92598967297762
2020-06-21,74,1,71,1,3,0,88,1,6619,60,6707,61,0,2,-1,17,2,55,0,6,2,"Anderson",76978,18.1870144716672,0.0385438972162741,79.2434201979787,1.29907246226194,22.0842318584531,3.85438972162741
2020-06-22,76,2,73,2,3,0,90,2,6711,92,6801,94,0,2,0,17,2,57,1,7,2,"Anderson",76978,20.7851593961911,0.0378486055776892,122.112811452623,2.59814492452389,22.0842318584531,3.78486055776892
2020-06-23,76,0,73,0,3,0,90,0,6800,89,6890,89,0,2,-1,16,1,58,0,7,2,"Anderson",76978,15.5888695471433,0.0285171102661597,115.617449141313,0,20.7851593961911,2.85171102661597
2020-06-24,77,1,74,1,3,0,91,1,6831,31,6922,32,0,2,-2,14,3,61,0,7,2,"Anderson",76978,14.2897970848814,0.02321083172147,41.5703187923822,1.29907246226194,18.1870144716672,2.321083172147
2020-06-25,81,4,78,4,3,0,92,1,6944,113,7036,114,0,2,0,14,4,65,0,7,2,"Anderson",76978,14.2897970848814,0.0161290322580645,148.094260697862,5.19628984904778,18.1870144716672,1.61290322580645
2020-06-26,86,5,83,5,3,0,98,6,6972,28,7070,34,0,2,3,17,2,67,0,7,2,"Anderson",76978,18.1870144716672,0.0259179265658747,44.1684637169061,6.49536231130973,22.0842318584531,2.59179265658747
2020-06-27,87,1,83,0,4,1,98,0,6984,12,7082,12,0,2,-4,13,5,72,0,7,2,"Anderson",76978,18.1870144716672,0.0252293577981651,15.5888695471433,1.29907246226194,16.8879420094053,2.52293577981651
2020-06-28,91,4,87,4,4,0,106,8,7093,109,7199,117,0,2,3,16,1,73,0,7,2,"Anderson",76978,22.0842318584531,0.0365853658536585,151.991478084648,5.19628984904778,20.7851593961911,3.65853658536585
2020-06-29,97,6,92,5,5,1,114,8,7315,222,7429,230,0,2,3,19,3,76,1,8,2,"Anderson",76978,27.2805217075008,0.0382165605095541,298.786666320247,7.79443477357167,24.682376782977,3.82165605095541
2020-06-30,102,5,96,4,6,1,120,6,7479,164,7599,170,0,2,2,21,3,79,0,8,2,"Anderson",76978,33.7758840188106,0.0423131170662905,220.842318584531,6.49536231130973,27.2805217075008,4.23131170662905
2020-07-01,104,2,98,2,6,0,124,4,7600,121,7724,125,0,2,-2,19,4,83,0,8,2,"Anderson",76978,35.0749564810725,0.0411471321695761,162.384057782743,2.59814492452389,24.682376782977,4.11471321695761
2020-07-02,110,6,104,6,6,0,130,6,7839,239,7969,245,0,2,4,23,2,85,0,8,2,"Anderson",76978,37.6731014055964,0.0407288317256163,318.272753254177,7.79443477357167,29.8786666320247,4.07288317256163
2020-07-03,120,10,113,9,7,1,142,12,7964,125,8106,137,0,2,7,30,3,88,0,8,2,"Anderson",76978,44.1684637169061,0.0424710424710425,177.972927329886,12.9907246226195,38.9721738678584,4.24710424710425
2020-07-04,131,11,124,11,7,0,156,14,8148,184,8304,198,0,2,8,38,3,91,2,10,2,"Anderson",76978,57.1591883395256,0.0474631751227496,257.216347527865,14.2897970848814,49.3647535659539,4.74631751227496
2020-07-05,140,9,133,9,7,0,169,13,8304,156,8473,169,0,2,8,46,1,92,1,11,2,"Anderson",76978,63.6545506508353,0.0494505494505494,219.543246122269,11.6916521603575,59.7573332640495,4.94505494505495
2020-07-06,141,1,134,1,7,0,170,1,8331,27,8501,28,0,2,-4,42,5,97,0,11,2,"Anderson",76978,57.1591883395256,0.0522388059701493,36.3740289433345,1.29907246226194,54.5610434150017,5.22388059701492
2020-07-07,157,16,150,16,7,0,190,20,8564,233,8754,253,0,2,12,54,4,101,0,11,2,"Anderson",76978,71.448985424407,0.0606060606060606,328.665332952272,20.7851593961911,70.149912962145,6.06060606060606
2020-07-08,173,16,165,15,8,1,206,16,8704,140,8910,156,0,2,10,64,6,107,0,11,2,"Anderson",76978,89.6359998960742,0.0691399662731872,202.655304112863,20.7851593961911,83.1406375847645,6.91399662731872
2020-07-09,187,14,179,14,8,0,220,14,8972,268,9192,282,0,2,11,75,3,110,0,11,2,"Anderson",76978,100.02857959417,0.0735895339329518,366.338434357868,18.1870144716672,97.4304346696459,7.35895339329518
2020-07-10,193,6,185,6,8,0,227,7,9002,30,9229,37,0,2,1,76,5,115,1,12,2,"Anderson",76978,94.832289745122,0.0756901157613535,48.065681103692,7.79443477357167,98.7295071319078,7.56901157613535
2020-07-11,201,8,193,8,8,0,235,8,9171,169,9406,177,0,2,1,77,7,122,1,13,2,"Anderson",76978,90.9350723583361,0.0716878402903811,229.935825820364,10.3925796980956,100.02857959417,7.16878402903811
2020-07-12,212,11,204,11,8,0,248,13,9354,183,9602,196,0,2,6,83,5,127,0,13,2,"Anderson",76978,93.53321728286,0.0699734278122232,254.618202603341,14.2897970848814,107.823014367741,6.99734278122232
2020-07-13,218,6,209,5,9,1,255,7,9393,39,9648,46,0,2,-6,77,12,139,2,15,2,"Anderson",76978,100.02857959417,0.0741063644289451,59.7573332640495,7.79443477357167,100.02857959417,7.41063644289451
2020-07-14,229,11,219,10,10,1,266,11,9533,140,9799,151,0,2,0,77,11,150,0,15,2,"Anderson",76978,93.53321728286,0.0727272727272727,196.159941801554,14.2897970848814,100.02857959417,7.27272727272727
2020-07-15,245,16,234,15,11,1,285,19,9635,102,9920,121,0,2,0,77,16,166,0,15,2,"Anderson",76978,93.53321728286,0.0782178217821782,157.187767933695,20.7851593961911,100.02857959417,7.82178217821782
2020-07-16,263,18,252,18,11,0,308,23,9924,289,10232,312,0,2,4,81,14,180,1,16,2,"Anderson",76978,98.7295071319078,0.0846153846153846,405.310608225727,23.383304320715,105.224869443218,8.46153846153846
2020-07-17,270,7,259,7,11,0,317,9,9995,71,10312,80,0,2,-8,73,15,195,1,17,3,"Anderson",76978,100.02857959417,0.0831024930747922,103.925796980956,9.09350723583361,94.832289745122,8.31024930747922
2020-07-18,277,7,266,7,11,0,328,11,10209,214,10537,225,0,2,-4,69,11,206,0,17,3,"Anderson",76978,98.7295071319078,0.0822281167108753,292.291304008938,9.09350723583361,89.6359998960742,8.22281167108753
2020-07-19,285,8,274,8,11,0,337,9,10290,81,10627,90,0,2,-5,64,13,219,2,19,3,"Anderson",76978,94.832289745122,0.0868292682926829,116.916521603575,10.3925796980956,83.1406375847645,8.68292682926829
2020-07-20,313,28,302,28,11,0,367,30,10459,169,10826,199,1,3,9,73,18,237,0,19,3,"Anderson",76978,123.411883914885,0.0950764006791171,258.515419990127,36.3740289433345,94.832289745122,9.50764006791171
2020-07-21,336,23,324,22,12,1,391,24,10751,292,11142,316,0,3,12,85,11,248,1,20,3,"Anderson",76978,139.000753462028,0.0930752047654505,410.506898074775,29.8786666320247,110.421159292265,9.30752047654505
2020-07-22,365,29,353,29,12,0,424,33,10886,135,11310,168,0,3,13,98,16,264,0,20,3,"Anderson",76978,155.888695471433,0.1,218.244173660007,37.6731014055964,127.309101301671,10
2020-07-23,388,23,376,23,12,0,455,31,11313,427,11768,458,0,3,9,107,14,278,2,22,3,"Anderson",76978,162.384057782743,0.095703125,594.975187715971,29.8786666320247,139.000753462028,9.5703125
2020-07-24,394,6,382,6,12,0,463,8,11425,112,11888,120,0,3,-16,91,22,300,0,22,4,"Anderson",76978,161.084985320481,0.0926395939086294,155.888695471433,7.79443477357167,118.215594065837,9.26395939086294
2020-07-25,426,32,413,31,13,1,499,36,11682,257,12181,293,1,4,26,117,5,305,1,23,4,"Anderson",76978,193.56179687703,0.104014598540146,380.62823144275,41.5703187923822,151.991478084648,10.4014598540146
2020-07-26,465,39,451,38,14,1,541,42,12085,403,12626,445,0,4,31,148,8,313,2,25,4,"Anderson",76978,233.83304320715,0.102051025512756,578.087245706565,50.6638260282159,192.262724414768,10.2051025512756
2020-07-27,483,18,468,17,15,1,562,21,12265,180,12827,201,0,4,-19,129,37,350,1,26,4,"Anderson",76978,220.842318584531,0.0974512743628186,261.113564914651,23.383304320715,167.580347631791,9.74512743628186
2020-07-28,523,40,508,40,15,0,608,46,12645,380,13253,426,0,4,24,153,16,366,1,27,5,"Anderson",76978,242.926550442984,0.10279488394126,553.404868923589,51.9628984904778,198.758086726078,10.279488394126
2020-07-29,527,4,512,4,15,0,612,4,12681,36,13293,40,1,5,-15,138,18,384,0,27,5,"Anderson",76978,210.449738886435,0.0948058497226425,51.9628984904778,5.19628984904778,179.271999792148,9.48058497226425
2020-07-30,564,37,549,37,15,0,665,53,13166,485,13831,538,0,5,20,158,17,401,0,27,5,"Anderson",76978,228.636753358102,0.101793504604944,698.900984696926,48.065681103692,205.253449037387,10.1793504604944
2020-07-31,576,12,561,12,15,0,679,14,13348,182,14027,196,0,5,-8,150,20,421,0,27,5,"Anderson",76978,236.431188131674,0.100981767180926,254.618202603341,15.5888695471433,194.860869339292,10.0981767180926
2020-08-01,599,23,584,23,15,0,704,25,13757,409,14461,434,0,5,17,167,6,427,1,28,5,"Anderson",76978,224.739535971316,0.0899122807017544,563.797448621684,29.8786666320247,216.945101197745,8.99122807017544
2020-08-02,606,7,591,7,15,0,711,7,13885,128,14596,135,0,5,2,169,5,432,1,29,6,"Anderson",76978,183.169217178934,0.0862944162436548,175.374782405363,9.09350723583361,219.543246122269,8.62944162436548
2020-08-03,631,25,615,24,16,1,742,31,14112,227,14854,258,0,5,14,183,11,443,0,29,6,"Anderson",76978,192.262724414768,0.0888011840157869,335.160695263582,32.4768115565486,237.730260593936,8.88011840157869
2020-08-04,638,7,622,7,16,0,750,8,14355,243,15105,251,2,7,-19,164,24,467,0,29,6,"Anderson",76978,149.393333160124,0.0766738660907127,326.067188027748,9.09350723583361,213.047883810959,7.66738660907127
2020-08-05,653,15,637,15,16,0,769,19,14564,209,15333,228,-1,6,-1,163,17,484,0,29,6,"Anderson",76978,163.683130245005,0.0769607843137255,296.188521395723,19.4860869339292,211.748811348697,7.69607843137255
2020-08-06,675,22,659,22,16,0,799,30,14885,321,15684,351,0,6,3,166,19,503,1,30,6,"Anderson",76978,144.197043311076,0.0723151645979493,455.974434253943,28.5795941697628,215.646028735483,7.23151645979493
2020-08-07,679,4,663,4,16,0,803,4,14966,81,15769,85,0,6,-21,145,25,528,0,30,6,"Anderson",76978,133.80446361298,0.0711825487944891,110.421159292265,5.19628984904778,188.365507027982,7.11825487944891
2020-08-08,690,11,674,11,16,0,819,16,15286,320,16105,336,0,6,1,146,10,538,0,30,6,"Anderson",76978,118.215594065837,0.0699513381995134,436.488347320014,14.2897970848814,189.664579490244,6.99513381995134
2020-08-09,697,7,681,7,16,0,828,9,15423,137,16251,146,0,6,-9,137,16,554,0,30,6,"Anderson",76978,118.215594065837,0.0706948640483384,189.664579490244,9.09350723583361,177.972927329886,7.06948640483384
2020-08-10,702,5,686,5,16,0,834,6,15562,139,16396,145,0,6,-11,126,16,570,0,30,6,"Anderson",76978,92.2341448205981,0.059662775616083,188.365507027982,6.49536231130973,163.683130245005,5.9662775616083
2020-08-11,723,21,707,21,16,0,856,22,15765,203,16621,225,0,6,9,135,12,582,1,31,6,"Anderson",76978,110.421159292265,0.0699208443271768,292.291304008938,27.2805217075008,175.374782405363,6.99208443271768
2020-08-12,731,8,715,8,16,0,864,8,16005,240,16869,248,0,6,-8,127,16,598,0,31,6,"Anderson",76978,101.327652056432,0.0618489583333333,322.169970640962,10.3925796980956,164.982202707267,6.18489583333333
2020-08-13,749,18,733,18,16,0,888,24,16233,228,17121,252,1,7,3,130,14,612,2,33,6,"Anderson",76978,96.1313622073839,0.0619345859429367,327.36626049001,23.383304320715,168.879420094053,6.19345859429367
2020-08-14,766,17,749,16,17,1,910,22,16562,329,17472,351,0,7,-9,121,26,638,0,33,6,"Anderson",76978,113.019304216789,0.0628302994715208,455.974434253943,22.0842318584531,157.187767933695,6.28302994715208
2020-08-15,776,10,759,10,17,0,922,12,16785,223,17707,235,-1,6,5,126,6,644,0,33,6,"Anderson",76978,111.720231754527,0.0642946317103621,305.282028631557,12.9907246226195,163.683130245005,6.4294631710362
2020-08-16,788,12,771,12,17,0,936,14,16927,142,17863,156,0,6,7,133,5,649,0,33,7,"Anderson",76978,118.215594065837,0.0669975186104218,202.655304112863,15.5888695471433,172.776637480839,6.69975186104218
2020-08-17,792,4,775,4,17,0,939,3,16970,43,17909,46,0,6,-13,120,17,666,0,33,7,"Anderson",76978,116.916521603575,0.069398545935228,59.7573332640495,5.19628984904778,155.888695471433,6.9398545935228
2020-08-18,806,14,789,14,17,0,956,17,17134,164,18090,181,0,6,5,125,9,675,0,33,7,"Anderson",76978,107.823014367741,0.068073519400953,235.132115669412,18.1870144716672,162.384057782743,6.8073519400953
2020-08-19,820,14,803,14,17,0,970,14,17308,174,18278,188,0,6,0,125,14,689,0,33,7,"Anderson",76978,115.617449141313,0.0752306600425834,244.225622905246,18.1870144716672,162.384057782743,7.52306600425834
2020-08-20,835,15,818,15,17,0,986,16,17750,442,18736,458,0,6,5,130,10,699,0,33,8,"Anderson",76978,111.720231754527,0.0606811145510836,594.975187715971,19.4860869339292,168.879420094053,6.06811145510836
2020-08-21,838,3,821,3,17,0,989,3,17786,36,18775,39,1,7,-7,123,9,708,0,33,8,"Anderson",76978,93.53321728286,0.0606293169608596,50.6638260282159,3.89721738678583,159.785912858219,6.06293169608596
2020-08-22,856,18,839,18,17,0,1008,19,18330,544,19338,563,1,8,10,133,7,715,1,34,8,"Anderson",76978,103.925796980956,0.052728387492336,731.377796253475,23.383304320715,172.776637480839,5.2728387492336
2020-08-23,857,1,840,1,17,0,1009,1,18414,84,19423,85,0,8,-5,128,6,721,0,34,8,"Anderson",76978,89.6359998960742,0.0467948717948718,110.421159292265,1.29907246226194,166.281275169529,4.67948717948718
2020-08-24,858,1,840,0,18,1,1009,0,18453,39,19462,39,0,8,-19,109,20,741,0,34,8,"Anderson",76978,85.7387825092884,0.0450740502253702,50.6638260282159,1.29907246226194,141.598898386552,4.50740502253703
2020-08-25,866,8,848,8,18,0,1017,8,18605,152,19622,160,0,8,-2,107,10,751,1,35,8,"Anderson",76978,77.9443477357167,0.0398172323759791,207.851593961911,10.3925796980956,139.000753462028,3.98172323759791
2020-08-26,872,6,854,6,18,0,1023,6,18785,180,19808,186,0,8,-14,93,20,771,0,35,8,"Anderson",76978,67.5517680376211,0.034640522875817,241.627477980722,7.79443477357167,120.813738990361,3.4640522875817
2020-08-27,875,3,857,3,18,0,1026,3,19196,411,20222,414,0,8,-16,77,19,790,0,35,8,"Anderson",76978,51.9628984904778,0.0269179004037685,537.815999376445,3.89721738678583,100.02857959417,2.69179004037685
2020-08-28,875,0,857,0,18,0,1026,0,19234,38,20260,38,0,8,-20,57,20,810,0,35,8,"Anderson",76978,48.065681103692,0.0249158249158249,49.3647535659539,0,74.0471303489309,2.49158249158249
2020-08-29,884,9,865,8,19,1,1034,8,19496,262,20530,270,0,8,3,60,6,816,0,35,8,"Anderson",76978,36.3740289433345,0.0218120805369128,350.749564810725,11.6916521603575,77.9443477357167,2.18120805369128
2020-08-30,900,16,881,16,19,0,1050,16,19579,83,20629,99,0,8,8,68,8,824,0,35,8,"Anderson",76978,55.8601158772636,0.0339966832504146,128.608173763933,20.7851593961911,88.3369274338123,3.39966832504146
2020-08-31,902,2,883,2,19,0,1052,2,19637,58,20689,60,0,8,-15,53,17,841,0,35,8,"Anderson",76978,57.1591883395256,0.0350448247758761,77.9443477357167,2.59814492452389,68.8508404998831,3.50448247758761
2020-09-01,909,7,889,6,20,1,1058,6,19748,111,20806,117,0,8,0,53,7,848,0,35,8,"Anderson",76978,55.8601158772636,0.0346283783783784,151.991478084648,9.09350723583361,68.8508404998831,3.46283783783784
2020-09-02,917,8,895,6,22,2,1068,10,20064,316,21132,326,0,8,5,58,3,851,0,35,8,"Anderson",76978,58.4582608017875,0.033987915407855,423.497622697394,10.3925796980956,75.3462028111928,3.3987915407855
2020-09-03,933,16,909,14,24,2,1084,16,20388,324,21472,340,0,8,10,68,6,857,0,35,9,"Anderson",76978,75.3462028111928,0.0464,441.684637169061,20.7851593961911,88.3369274338123,4.64
2020-09-04,942,9,917,8,25,1,1094,10,20577,189,21671,199,0,8,6,74,3,860,0,35,9,"Anderson",76978,87.0378549715503,0.0481927710843374,258.515419990127,11.6916521603575,96.1313622073839,4.81927710843374
2020-09-05,961,19,936,19,25,0,1115,21,20846,269,21961,290,0,8,16,90,3,863,1,36,10,"Anderson",76978,100.02857959417,0.0566037735849057,376.731014055964,24.682376782977,116.916521603575,5.66037735849057
2020-09-06,963,2,938,2,25,0,1117,2,20902,56,22019,58,0,8,-1,89,3,866,0,36,10,"Anderson",76978,81.8415651225025,0.0482014388489209,75.3462028111928,2.59814492452389,115.617449141313,4.82014388489209
2020-09-07,966,3,941,3,25,0,1122,5,20990,88,22112,93,0,8,-8,81,11,877,0,36,10,"Anderson",76978,83.1406375847645,0.0491918482080112,120.813738990361,3.89721738678583,105.224869443218,4.91918482080112
2020-09-08,975,9,944,3,31,6,1126,4,21165,175,22291,179,1,9,4,85,4,881,0,36,10,"Anderson",76978,85.7387825092884,0.0457912457912458,232.533970744888,11.6916521603575,110.421159292265,4.57912457912458
2020-09-09,984,9,953,9,31,0,1135,9,21406,241,22541,250,0,9,-3,82,12,893,1,37,11,"Anderson",76978,87.0378549715503,0.0475514549325763,324.768115565486,11.6916521603575,106.523941905479,4.75514549325763
2020-09-10,1013,29,981,28,32,1,1165,30,21775,369,22940,399,1,10,25,107,3,896,0,37,11,"Anderson",76978,103.925796980956,0.0551771117166213,518.329912442516,37.6731014055964,139.000753462028,5.51771117166213
2020-09-11,1014,1,982,1,32,0,1167,2,21908,133,23075,135,0,10,-13,94,14,910,0,37,11,"Anderson",76978,93.53321728286,0.051994301994302,175.374782405363,1.29907246226194,122.112811452623,5.1994301994302
2020-09-12,1017,3,985,3,32,0,1172,5,22050,142,23222,147,0,10,-5,89,8,918,0,37,11,"Anderson",76978,72.7480578866689,0.0452022204599524,190.963651952506,3.89721738678583,115.617449141313,4.52022204599524
2020-09-13,1038,21,1005,20,33,1,1193,21,22294,244,23487,265,0,10,16,105,5,923,1,38,11,"Anderson",76978,97.4304346696459,0.0517711171662125,344.254202499415,27.2805217075008,136.402608537504,5.17711171662125
2020-09-14,1044,6,1010,5,34,1,1199,6,22400,106,23599,112,0,10,-7,98,13,936,1,39,11,"Anderson",76978,101.327652056432,0.0517821116341627,145.496115773338,7.79443477357167,127.309101301671,5.17821116341627
2020-09-15,1060,16,1026,16,34,0,1216,17,22640,240,23856,257,1,11,5,103,10,946,1,40,12,"Anderson",76978,110.421159292265,0.0575079872204473,333.86162280132,20.7851593961911,133.80446361298,5.75079872204473
2020-09-16,1068,8,1034,8,34,0,1228,12,22776,136,24004,148,0,11,-5,98,13,959,0,40,12,"Anderson",76978,109.122086830003,0.063568010936432,192.262724414768,10.3925796980956,127.309101301671,6.3568010936432
2020-09-17,1090,22,1054,20,36,2,1248,20,23197,421,24445,441,0,11,15,113,7,966,1,41,12,"Anderson",76978,100.02857959417,0.0551495016611296,572.890955857518,28.5795941697628,146.7951882356,5.51495016611296
2020-09-18,1109,19,1073,19,36,0,1266,18,23421,224,24687,242,0,11,6,119,13,979,0,41,12,"Anderson",76978,123.411883914885,0.0614143920595533,314.375535867391,24.682376782977,154.589623009171,6.14143920595533
2020-09-19,1124,15,1088,15,36,0,1287,21,23703,282,24990,303,0,11,9,128,6,985,1,42,12,"Anderson",76978,139.000753462028,0.0650452488687783,393.618956065369,19.4860869339292,166.281275169529,6.50452488687783
2020-09-20,1131,7,1095,7,36,0,1297,10,23855,152,25152,162,0,11,0,128,7,992,0,42,13,"Anderson",76978,120.813738990361,0.0624624624624625,210.449738886435,9.09350723583361,166.281275169529,6.24624624624625
2020-09-21,1133,2,1097,2,36,0,1299,2,23888,33,25187,35,0,11,-6,122,8,1000,0,42,13,"Anderson",76978,115.617449141313,0.0629722921914358,45.4675361791681,2.59814492452389,158.486840395957,6.29722921914358
2020-09-22,1147,14,1111,14,36,0,1316,17,24136,248,25452,265,0,11,0,122,14,1014,1,43,13,"Anderson",76978,113.019304216789,0.06265664160401,344.254202499415,18.1870144716672,158.486840395957,6.265664160401
2020-09-23,1147,0,1111,0,36,0,1316,0,24177,41,25493,41,0,11,-12,110,12,1026,0,43,13,"Anderson",76978,102.626724518694,0.0591000671591672,53.2619709527397,0,142.897970848814,5.91000671591672
2020-09-24,1160,13,1124,13,36,0,1331,15,24501,324,25832,339,1,12,0,110,12,1038,0,43,13,"Anderson",76978,90.9350723583361,0.0598413842826244,440.385564706799,16.8879420094053,142.897970848814,5.98413842826244
2020-09-25,1174,14,1137,13,37,1,1344,13,24737,236,26081,249,1,13,-2,108,15,1053,0,43,13,"Anderson",76978,84.4397100470264,0.0559540889526542,323.469043103224,18.1870144716672,140.29982592429,5.59540889526542
2020-09-26,1188,14,1151,14,37,0,1361,17,25037,300,26398,317,0,13,8,116,6,1059,0,43,13,"Anderson",76978,83.1406375847645,0.0525568181818182,411.805970537037,18.1870144716672,150.692405622386,5.25568181818182
2020-09-27,1207,19,1168,17,39,2,1377,16,25244,207,26621,223,0,13,12,128,7,1066,0,43,13,"Anderson",76978,98.7295071319078,0.0544588155207624,289.693159084414,24.682376782977,166.281275169529,5.44588155207624
2020-09-28,1210,3,1170,2,40,1,1379,2,25281,37,26660,39,0,13,-9,119,12,1078,0,43,13,"Anderson",76978,100.02857959417,0.0543109300746775,50.6638260282159,3.89721738678583,154.589623009171,5.43109300746775
2020-09-29,1221,11,1180,10,41,1,1389,10,25575,294,26964,304,0,13,-7,112,18,1096,0,43,13,"Anderson",76978,96.1313622073839,0.0482804232804233,394.918028527631,14.2897970848814,145.496115773338,4.82804232804233
2020-09-30,1233,12,1190,10,43,2,1399,10,25641,66,27040,76,0,13,3,115,9,1105,0,43,13,"Anderson",76978,111.720231754527,0.0536522301228184,98.7295071319078,15.5888695471433,149.393333160124,5.36522301228184
2020-10-01,1249,16,1204,14,45,2,1414,15,25921,280,27335,295,0,13,4,119,12,1117,0,43,13,"Anderson",76978,115.617449141313,0.0552228875582169,383.226376367274,20.7851593961911,154.589623009171,5.52228875582169
2020-10-02,1256,7,1210,6,46,1,1421,7,26003,82,27424,89,0,13,1,120,6,1123,0,43,13,"Anderson",76978,106.523941905479,0.0573343261355175,115.617449141313,9.09350723583361,155.888695471433,5.73343261355175
2020-10-03,1272,16,1226,16,46,0,1445,24,26267,264,27712,288,0,13,3,123,13,1136,0,43,13,"Anderson",76978,109.122086830003,0.0639269406392694,374.13286913144,20.7851593961911,159.785912858219,6.39269406392694
2020-10-04,1288,16,1240,14,48,2,1461,16,26604,337,28065,353,0,13,8,131,8,1144,0,43,13,"Anderson",76978,105.224869443218,0.0581717451523546,458.572579178467,20.7851593961911,170.178492556315,5.81717451523546
2020-10-05,1314,26,1265,25,49,1,1488,27,26815,211,28303,238,0,13,11,142,15,1159,1,44,13,"Anderson",76978,135.103536075242,0.0663420572124163,309.179246018343,33.7758840188106,184.468289641196,6.63420572124163
2020-10-06,1342,28,1292,27,50,1,1520,32,27152,337,28672,369,0,13,15,157,13,1172,1,45,13,"Anderson",76978,157.187767933695,0.0766978922716628,479.357738574658,36.3740289433345,203.954376575125,7.66978922716628
2020-10-07,1348,6,1298,6,50,0,1528,8,27387,235,28915,243,0,13,-3,154,9,1181,0,45,13,"Anderson",76978,149.393333160124,0.0688,315.674608329653,7.79443477357167,200.05715918834,6.88
2020-10-08,1358,10,1306,8,52,2,1537,9,27626,239,29163,248,0,13,-3,151,13,1194,1,46,13,"Anderson",76978,141.598898386552,0.0672866520787746,322.169970640962,12.9907246226195,196.159941801554,6.72866520787746
2020-10-09,1373,15,1319,13,54,2,1553,16,27799,173,29352,189,0,13,-2,149,17,1211,0,46,13,"Anderson",76978,151.991478084648,0.0684647302904564,245.524695367508,19.4860869339292,193.56179687703,6.84647302904564
2020-10-10,1389,16,1335,16,54,0,1573,20,28011,212,29584,232,0,13,3,152,13,1224,1,47,14,"Anderson",76978,151.991478084648,0.0683760683760684,301.384811244771,20.7851593961911,197.459014263816,6.83760683760684
2020-10-11,1417,28,1363,28,54,0,1604,31,28300,289,29904,320,0,13,18,170,10,1234,0,47,14,"Anderson",76978,167.580347631791,0.0777596519847743,415.703187923822,36.3740289433345,220.842318584531,7.77596519847743
2020-10-12,1433,16,1378,15,55,1,1620,16,28379,79,29999,95,0,13,-11,159,27,1261,0,47,14,"Anderson",76978,154.589623009171,0.0778301886792453,123.411883914885,20.7851593961911,206.552521499649,7.78301886792453
2020-10-13,1453,20,1396,18,57,2,1638,18,28500,121,30138,139,0,13,7,166,13,1274,0,47,14,"Anderson",76978,144.197043311076,0.0804911323328786,180.57107225441,25.9814492452389,215.646028735483,8.04911323328786
2020-10-14,1475,22,1418,22,57,0,1662,24,28800,300,30462,324,0,13,12,178,10,1284,0,47,14,"Anderson",76978,164.982202707267,0.0866192630898513,420.89947777287,28.5795941697628,231.234898282626,8.66192630898513
2020-10-15,1497,22,1434,16,63,6,1676,14,28951,151,30627,165,0,13,2,180,20,1304,1,48,14,"Anderson",76978,180.57107225441,0.0949453551912568,214.346956273221,28.5795941697628,233.83304320715,9.49453551912568
2020-10-16,1504,7,1437,3,67,4,1680,4,29050,99,30730,103,0,13,-11,169,18,1322,0,48,15,"Anderson",76978,170.178492556315,0.0921625544267054,133.80446361298,9.09350723583361,219.543246122269,9.21625544267054
2020-10-17,1532,28,1464,27,68,1,1710,30,29298,248,31008,278,0,13,14,183,14,1336,2,50,15,"Anderson",76978,185.767362103458,0.0962078651685393,361.142144508821,36.3740289433345,237.730260593936,9.62078651685393
2020-10-18,1552,20,1484,20,68,0,1733,23,29537,239,31270,262,0,13,5,188,15,1351,0,50,15,"Anderson",76978,175.374782405363,0.0944363103953148,340.35698511263,25.9814492452389,244.225622905246,9.44363103953148
2020-10-19,1556,4,1488,4,68,0,1738,5,29614,77,31352,82,0,13,-16,172,20,1371,1,51,15,"Anderson",76978,159.785912858219,0.0872135994087214,106.523941905479,5.19628984904778,223.440463509055,8.72135994087214
2020-10-20,1583,27,1515,27,68,0,1773,35,29813,199,31586,234,0,13,6,178,21,1392,0,51,15,"Anderson",76978,168.879420094053,0.093232044198895,303.982956169295,35.0749564810725,231.234898282626,9.3232044198895
2020-10-21,1600,17,1532,17,68,0,1792,19,30029,216,31821,235,0,13,8,186,9,1401,1,52,15,"Anderson",76978,162.384057782743,0.0956585724797645,305.282028631557,22.0842318584531,241.627477980722,9.56585724797645
2020-10-22,1621,21,1553,21,68,0,1817,25,30361,332,32178,357,1,14,-4,182,24,1425,0,52,15,"Anderson",76978,161.084985320481,0.0909090909090909,463.768869027514,27.2805217075008,236.431188131674,9.09090909090909
2020-10-23,1636,15,1567,14,69,1,1833,16,30636,275,32469,291,0,14,-7,175,22,1447,0,52,15,"Anderson",76978,171.477565018577,0.0879815986198965,378.030086518226,19.4860869339292,227.33768089584,8.79815986198965
2020-10-24,1667,31,1597,30,70,1,1866,33,31012,376,32878,409,0,14,19,194,12,1459,2,54,17,"Anderson",76978,175.374782405363,0.0834224598930481,531.320637065136,40.2712463301203,252.020057678817,8.34224598930481
2020-10-25,1684,17,1613,16,71,1,1885,19,31208,196,33093,215,0,14,0,194,17,1476,4,58,17,"Anderson",76978,171.477565018577,0.0833790455293472,279.300579386318,22.0842318584531,252.020057678817,8.33790455293472
2020-10-26,1700,16,1628,15,72,1,1903,18,31342,134,33245,152,-1,13,-11,183,28,1504,1,59,17,"Anderson",76978,187.06643456572,0.0871632329635499,197.459014263816,20.7851593961911,237.730260593936,8.71632329635499
2020-10-27,1729,29,1652,24,77,5,1927,24,31497,155,33424,179,1,14,10,193,18,1522,2,61,17,"Anderson",76978,189.664579490244,0.0837867247007617,232.533970744888,37.6731014055964,250.720985216555,8.37867247007617
2020-10-28,1785,56,1706,54,79,2,1986,59,31931,434,33917,493,0,14,33,226,23,1545,0,61,17,"Anderson",76978,240.32840551846,0.0925572519083969,640.442723895139,72.7480578866689,293.5903764712,9.25572519083969
2020-10-29,1814,29,1727,21,87,8,2005,19,32137,206,34142,225,0,14,6,232,23,1568,2,63,17,"Anderson",76978,250.720985216555,0.0957230142566191,292.291304008938,37.6731014055964,301.384811244771,9.57230142566191
2020-10-30,1851,37,1761,34,90,3,2043,38,32288,151,34331,189,2,16,20,252,15,1583,1,64,17,"Anderson",76978,279.300579386318,0.112781954887218,245.524695367508,48.065681103692,327.36626049001,11.2781954887218
2020-10-31,1851,0,1761,0,90,0,2043,0,32289,1,34332,1,0,16,-10,242,10,1593,0,64,19,"Anderson",76978,239.029333056198,0.121733149931224,1.29907246226194,0,314.375535867391,12.1733149931224
2020-11-01,1856,5,1766,5,90,0,2051,8,32533,244,34584,252,0,16,-10,232,15,1608,0,64,19,"Anderson",76978,223.440463509055,0.111334674714956,327.36626049001,6.49536231130973,301.384811244771,11.1334674714956
2020-11-02,1889,33,1797,31,92,2,2086,35,32800,267,34886,302,0,16,8,240,25,1633,0,64,20,"Anderson",76978,245.524695367508,0.111517367458867,392.319883603107,42.8693912546442,311.777390942867,11.1517367458867
2020-11-03,1915,26,1822,25,93,1,2111,25,32980,180,35091,205,0,16,6,246,20,1653,0,64,21,"Anderson",76978,241.627477980722,0.110377924415117,266.309854763699,33.7758840188106,319.571825716438,11.0377924415117
2020-11-04,1933,18,1837,15,96,3,2129,18,33059,79,35188,97,2,18,1,247,15,1668,1,65,21,"Anderson",76978,192.262724414768,0.112509834775767,126.010028839409,23.383304320715,320.8708981787,11.2509834775767
2020-11-05,1957,24,1855,18,102,6,2149,20,33158,99,35307,119,0,18,1,248,23,1691,0,65,22,"Anderson",76978,185.767362103458,0.123605150214592,154.589623009171,31.1777390942867,322.169970640962,12.3605150214592
2020-11-06,2006,49,1901,46,105,3,2198,49,33525,367,35723,416,0,18,24,272,25,1716,2,67,23,"Anderson",76978,201.356231650601,0.111350574712644,540.414144300969,63.6545506508353,353.347709735249,11.1350574712644
2020-11-07,2086,80,1978,77,108,3,2275,77,33972,447,36247,524,0,18,50,322,30,1746,0,67,23,"Anderson",76978,305.282028631557,0.121148825065274,680.713970225259,103.925796980956,418.301332848346,12.1148825065274
2020-11-08,2140,54,2029,51,111,3,2337,62,34582,610,36919,672,0,18,39,361,15,1761,1,68,23,"Anderson",76978,368.936579282392,0.122483940042827,872.976694640027,70.149912962145,468.965158876562,12.2483940042827
2020-11-09,2148,8,2036,7,112,1,2346,9,34656,74,37002,83,0,18,-46,315,54,1815,0,68,23,"Anderson",76978,336.459767725844,0.122873345935728,107.823014367741,10.3925796980956,409.207825612513,12.2873345935728
2020-11-10,2167,19,2054,18,113,1,2368,22,34827,171,37195,193,0,18,-16,299,35,1850,1,69,23,"Anderson",76978,327.36626049001,0.122148288973384,250.720985216555,24.682376782977,388.422666216322,12.2148288973384
2020-11-11,2206,39,2090,36,116,3,2410,42,35100,273,37510,315,1,19,13,312,25,1875,1,70,23,"Anderson",76978,354.646782197511,0.121016365202412,409.207825612513,50.6638260282159,405.310608225727,12.1016365202412
2020-11-12,2213,7,2096,6,117,1,2418,8,35298,198,37716,206,0,19,-13,299,20,1895,0,70,24,"Anderson",76978,332.562550339058,0.111664591116646,267.608927225961,9.09350723583361,388.422666216322,11.1664591116646
2020-11-13,2269,56,2149,53,120,3,2477,59,35560,262,38037,321,2,21,31,330,23,1918,2,72,24,"Anderson",76978,341.656057574892,0.12057044079516,417.002260386084,72.7480578866689,428.693912546442,12.057044079516
2020-11-14,2310,41,2189,40,121,1,2522,45,35956,396,38478,441,1,22,20,350,20,1938,1,73,25,"Anderson",76978,290.992231546676,0.110712684894666,572.890955857518,53.2619709527397,454.675361791681,11.0712684894666
2020-11-15,2408,98,2287,98,121,0,2630,108,36538,582,39168,690,1,23,79,429,18,1956,1,74,25,"Anderson",76978,348.151419886201,0.130280124499778,896.359998960742,127.309101301671,557.302086310374,13.0280124499778
2020-11-16,2457,49,2316,29,141,20,2659,29,36815,277,39474,306,0,23,-6,423,55,2011,1,75,25,"Anderson",76978,401.413390838941,0.126618122977346,397.516173452155,63.6545506508353,549.507651536803,12.6618122977346
2020-11-17,2473,16,2331,15,142,1,2675,16,37021,206,39696,222,2,25,-37,386,51,2062,1,76,26,"Anderson",76978,397.516173452155,0.122750899640144,288.394086622152,20.7851593961911,501.441970433111,12.2750899640144
2020-11-18,2503,30,2357,26,146,4,2701,26,37315,294,40016,320,0,25,-5,381,35,2097,0,76,27,"Anderson",76978,385.824521291798,0.116121308858739,415.703187923822,38.9721738678584,494.946608121801,11.6121308858739
2020-11-19,2561,58,2411,54,150,4,2763,62,37731,416,40494,478,0,25,19,400,39,2136,1,77,27,"Anderson",76978,452.077216867157,0.124190064794816,620.95663696121,75.3462028111928,519.628984904778,12.4190064794816
2020-11-20,2591,30,2438,27,153,3,2794,31,37845,114,40639,145,0,25,-10,390,40,2176,0,77,28,"Anderson",76978,418.301332848346,0.121829362029208,188.365507027982,38.9721738678584,506.638260282159,12.1829362029208
2020-11-21,2648,57,2487,49,161,8,2842,48,38189,344,41031,392,0,25,33,423,24,2200,1,78,28,"Anderson",76978,439.086492244537,0.125342734038386,509.236405206682,74.0471303489309,549.507651536803,12.5342734038386
2020-11-22,2704,56,2536,49,168,7,2899,57,38672,483,41571,540,0,25,42,465,14,2214,1,79,31,"Anderson",76978,384.525448829536,0.111943404078236,701.49912962145,72.7480578866689,604.068694951804,11.1943404078236
2020-11-23,2711,7,2542,6,169,1,2905,6,38694,22,41599,28,0,25,-64,401,71,2285,0,79,32,"Anderson",76978,329.964405414534,0.115764705882353,36.3740289433345,9.09350723583361,520.92805736704,11.5764705882353
2020-11-24,2724,13,2554,12,170,1,2917,12,38851,157,41768,169,2,27,-35,366,46,2331,0,79,32,"Anderson",76978,326.067188027748,0.116795366795367,219.543246122269,16.8879420094053,475.460521187872,11.6795366795367
2020-11-25,2752,28,2575,21,177,7,2938,21,38888,37,41826,58,1,28,-11,355,38,2369,0,79,32,"Anderson",76978,323.469043103224,0.130939226519337,75.3462028111928,36.3740289433345,461.170724102991,13.0939226519337
2020-11-26,2797,45,2617,42,180,3,2983,45,39238,350,42221,395,0,28,-30,325,75,2444,1,80,33,"Anderson",76978,306.581101093819,0.127388535031847,513.133622593468,58.4582608017875,422.198550235132,12.7388535031847
2020-11-27,2896,99,2707,90,189,9,3078,95,39664,426,42742,521,0,28,56,381,43,2487,3,83,35,"Anderson",76978,396.217100989893,0.135045173561579,676.816752838473,128.608173763933,494.946608121801,13.5045173561579
2020-11-28,2927,31,2732,25,195,6,3108,30,39807,143,42915,173,1,29,5,386,25,2512,2,85,35,"Anderson",76978,362.441216971083,0.141188959660297,224.739535971316,40.2712463301203,501.441970433111,14.1188959660297
2020-11-29,3018,91,2821,89,197,2,3204,96,40244,437,43448,533,0,29,65,451,26,2538,1,86,35,"Anderson",76978,407.908753150251,0.162493340436867,692.405622385617,118.215594065837,585.881680480137,16.2493340436867
2020-11-30,3088,70,2887,66,201,4,3277,73,40496,252,43773,325,0,29,1,452,69,2607,0,86,37,"Anderson",76978,489.750318272753,0.171113155473781,422.198550235132,90.9350723583361,587.180752942399,17.1113155473781
2020-12-01,3164,76,2953,66,211,10,3349,72,40927,431,44276,503,1,30,14,466,61,2668,6,92,38,"Anderson",76978,571.591883395256,0.172248803827751,653.433448517758,98.7295071319078,605.367767414066,17.2248803827751
2020-12-02,3179,15,2967,14,212,1,3365,16,41035,108,44400,124,0,30,-40,426,55,2723,0,92,38,"Anderson",76978,554.70394138585,0.165889665889666,161.084985320481,19.4860869339292,553.404868923589,16.5889665889666
2020-12-03,3220,41,2996,29,224,12,3398,33,41259,224,44657,257,1,31,-14,412,54,2777,1,93,39,"Anderson",76978,549.507651536803,0.170361247947455,333.86162280132,53.2619709527397,535.217854451921,17.0361247947455
2020-12-04,3287,67,3056,60,231,7,3461,63,41417,158,44878,221,1,32,-25,387,91,2868,0,93,39,"Anderson",76978,507.93733274442,0.179307116104869,287.09501415989,87.0378549715503,502.741042895373,17.9307116104869
2020-12-05,3318,31,3075,19,243,12,3479,18,41484,67,44963,85,0,32,1,388,30,2898,0,93,39,"Anderson",76978,507.93733274442,0.18115234375,110.421159292265,40.2712463301203,504.040115357635,18.115234375
2020-12-06,3354,36,3104,29,250,7,3507,28,41692,208,45199,236,0,32,12,400,24,2922,2,95,40,"Anderson",76978,436.488347320014,0.173043974871502,306.581101093819,46.76660864143,519.628984904778,17.3043974871502
2020-12-07,3494,140,3228,124,266,16,3643,136,42285,593,45928,729,2,34,28,428,110,3032,4,99,41,"Anderson",76978,527.42341967835,0.169837587006961,947.023824988958,181.870144716672,556.003013848112,16.9837587006961
2020-12-08,3565,71,3277,49,288,22,3695,52,42583,298,46278,350,1,35,-8,420,78,3110,2,101,43,"Anderson",76978,520.92805736704,0.172827172827173,454.675361791681,92.2341448205981,545.610434150017,17.2827172827173
2020-12-09,3670,105,3368,91,302,14,3799,104,42844,261,46643,365,0,35,46,466,59,3169,3,104,44,"Anderson",76978,637.844578970615,0.193490860454748,474.16144872561,136.402608537504,605.367767414066,19.3490860454748
2020-12-10,3764,94,3446,78,318,16,3886,87,43376,532,47262,619,3,38,81,547,10,3179,3,107,45,"Anderson",76978,706.695419470498,0.187332053742802,804.125854140144,122.112811452623,710.592636857284,18.7332053742802
2020-12-11,3837,73,3499,53,338,20,3937,51,43542,166,47479,217,1,39,30,577,42,3221,2,109,45,"Anderson",76978,714.48985424407,0.183006535947712,281.898724310842,94.832289745122,749.564810725142,18.3006535947712
2020-12-12,3925,88,3560,61,365,27,4002,65,44055,513,48057,578,0,39,55,632,33,3254,2,111,45,"Anderson",76978,788.536984593001,0.169036845507434,750.863883187404,114.318376679051,821.013796149549,16.9036845507434
2020-12-13,4157,232,3743,183,414,49,4206,204,44927,872,49133,1076,1,40,188,820,43,3297,0,111,47,"Anderson",76978,1043.15518719634,0.177681748856126,1397.80196939385,301.384811244771,1065.23941905479,17.7681748856126
2020-12-14,4272,115,3829,86,443,29,4305,99,45218,291,49523,390,0,40,-37,783,152,3449,1,112,48,"Anderson",76978,1010.67837563979,0.184144645340751,506.638260282159,149.393333160124,1017.1737379511,18.4144645340751
2020-12-15,4407,135,3914,85,493,50,4401,96,45745,527,50146,623,1,41,42,825,92,3541,6,118,51,"Anderson",76978,1093.81901322456,0.182523267838676,809.322143989192,175.374782405363,1071.7347813661,18.2523267838676
2020-12-16,4476,69,3944,30,532,39,4437,36,46068,323,50505,359,2,43,-17,808,84,3625,4,122,52,"Anderson",76978,1047.05240458313,0.165199378560331,466.367013952038,89.6359998960742,1049.65054950765,16.5199378560331
2020-12-17,4677,201,4118,174,559,27,4631,194,46596,528,51227,722,2,45,114,922,85,3710,2,124,54,"Anderson",76978,1186.05315804516,0.187894073139975,937.930317753124,261.113564914651,1197.74481020551,18.7894073139975
2020-12-18,4775,98,4194,76,581,22,4718,87,46962,366,51680,453,1,46,23,945,74,3784,2,126,54,"Anderson",76978,1218.5299696017,0.185908117114973,588.479825404661,127.309101301671,1227.62347683754,18.5908117114973
2020-12-19,4880,105,4275,81,605,24,4805,87,47220,258,52025,345,0,46,74,1019,31,3815,1,127,55,"Anderson",76978,1240.61420146016,0.202368951612903,448.179999480371,136.402608537504,1323.75483904492,20.2368951612903
2020-12-20,5020,140,4397,122,623,18,4942,137,47684,464,52626,601,2,48,84,1103,54,3869,3,130,56,"Anderson",76978,1121.09953493206,0.2107071285428,780.742549819429,181.870144716672,1432.87692587493,21.07071285428
2020-12-21,5068,48,4415,18,653,30,4965,23,47904,220,52869,243,3,51,-83,1020,128,3997,2,132,59,"Anderson",76978,1034.06167996051,0.197250448296473,315.674608329653,62.3554781885734,1325.05391150718,19.7250448296473
2020-12-22,5138,70,4459,44,679,26,5012,47,48010,106,53022,153,1,52,-31,989,100,4097,2,134,64,"Anderson",76978,949.621969913482,0.212447844228095,198.758086726078,90.9350723583361,1284.78266517706,21.2447844228095
2020-12-23,5212,74,4501,42,711,32,5055,43,48326,316,53381,359,2,54,-8,981,80,4177,2,136,66,"Anderson",76978,956.117332224792,0.214881780250348,466.367013952038,96.1313622073839,1274.39008547897,21.4881780250348
2020-12-24,5270,58,4525,24,745,34,5082,27,48478,152,53560,179,1,55,-47,934,104,4281,1,137,71,"Anderson",76978,770.349970121333,0.193313330475782,232.533970744888,75.3462028111928,1213.33367975266,19.3313330475782
2020-12-25,5364,94,4603,78,761,16,5175,93,48887,409,54062,502,0,55,-16,918,110,4391,1,138,72,"Anderson",76978,765.153680272286,0.191855583543241,652.134376055496,122.112811452623,1192.54852035647,19.1855583543241
2020-12-26,5420,56,4632,29,788,27,5203,28,49006,119,54209,147,0,55,6,924,50,4441,3,141,74,"Anderson",76978,701.49912962145,0.182234432234432,190.963651952506,72.7480578866689,1200.34295513004,18.2234432234432
2020-12-27,5480,60,4669,37,811,23,5239,36,49142,136,54381,172,1,56,29,953,30,4471,6,147,75,"Anderson",76978,597.573332640495,0.169230769230769,223.440463509055,77.9443477357167,1238.01605653563,16.9230769230769
2020-12-28,5527,47,4690,21,837,26,5259,20,49211,69,54470,89,2,58,-85,868,130,4601,4,151,82,"Anderson",76978,596.274260178233,0.183635227982511,115.617449141313,61.0564057263114,1127.59489724337,18.3635227982511
2020-12-29,5623,96,4742,52,881,44,5307,48,49306,95,54613,143,2,60,-34,834,128,4729,5,156,85,"Anderson",76978,630.050144197043,0.185417976115651,185.767362103458,124.710956377147,1083.42643352646,18.5417976115651
2020-12-30,5658,35,4760,18,898,17,5324,17,49434,128,54758,145,6,66,-89,745,118,4847,1,157,88,"Anderson",76978,579.386318168827,0.195352214960058,188.365507027982,45.4675361791681,967.808984385149,19.5352214960058
2020-12-31,5821,163,4860,100,961,63,5426,102,49738,304,55164,406,6,72,63,808,94,4941,1,158,93,"Anderson",76978,715.788926706332,0.214463840399002,527.42341967835,211.748811348697,1049.65054950765,21.4463840399002
2021-01-01,5886,65,4902,42,984,23,5481,55,50014,276,55495,331,0,72,-25,783,90,5031,2,160,94,"Anderson",76978,678.115825300735,0.213538032100488,429.992985008704,84.4397100470264,1017.1737379511,21.3538032100488
2021-01-02,5979,93,4943,41,1036,52,5522,41,50299,285,55821,326,0,72,48,831,45,5076,2,162,96,"Anderson",76978,726.181506404427,0.197890818858561,423.497622697394,120.813738990361,1079.52921613968,19.7890818858561
2021-01-03,6004,25,4955,12,1049,13,5538,16,50351,52,55889,68,0,72,-9,822,34,5110,1,163,98,"Anderson",76978,680.713970225259,0.198275862068966,88.3369274338123,32.4768115565486,1067.83756397932,19.8275862068966
2021-01-04,6041,37,4979,24,1062,13,5569,31,50458,107,56027,138,1,73,-57,765,93,5203,0,163,103,"Anderson",76978,667.72324560264,0.199100834938985,179.271999792148,48.065681103692,993.790433630388,19.9100834938985
2021-01-05,6113,72,5010,31,1103,41,5600,31,50576,118,56176,149,2,75,-48,717,118,5321,2,165,106,"Anderson",76978,636.545506508353,0.187460012795905,193.56179687703,93.53321728286,931.434955441815,18.7460012795905
2021-01-06,6187,74,5050,40,1137,34,5643,43,50737,161,56380,204,5,80,-12,705,81,5402,2,167,108,"Anderson",76978,687.209332536569,0.196670776818742,265.010782301437,96.1313622073839,915.846085894671,19.6670776818742
2021-01-07,6292,105,5130,80,1162,25,5735,92,50958,221,56693,313,1,81,65,770,39,5441,1,168,111,"Anderson",76978,611.863129725376,0.202092871157619,406.609680687989,136.402608537504,1000.2857959417,20.2092871157619
2021-01-08,6374,82,5180,50,1194,32,5787,52,51157,199,56944,251,5,86,61,831,16,5457,2,170,114,"Anderson",76978,633.947361583829,0.211180124223602,326.067188027748,106.523941905479,1079.52921613968,21.1180124223602
2021-01-09,6484,110,5249,69,1235,41,5862,75,51588,431,57450,506,2,88,43,874,65,5522,0,170,116,"Anderson",76978,656.031593442282,0.208717004297115,657.330665904544,142.897970848814,1135.38933201694,20.8717004297115
2021-01-10,6544,60,5274,25,1270,35,5887,25,51682,94,57569,119,2,90,28,902,30,5552,3,173,117,"Anderson",76978,701.49912962145,0.207738095238095,154.589623009171,77.9443477357167,1171.76336096027,20.7738095238095
2021-01-11,6577,33,5284,10,1293,23,5900,13,51753,71,57653,84,1,91,-93,809,125,5677,1,174,119,"Anderson",76978,696.302839772403,0.203567035670357,109.122086830003,42.8693912546442,1050.94962196991,20.3567035670357
2021-01-12,6630,53,5318,34,1312,19,5938,38,51925,172,57863,210,2,93,-100,709,151,5828,1,175,119,"Anderson",76978,671.620462989426,0.200355660936574,272.805217075008,68.8508404998831,921.042375743719,20.0355660936574
2021-01-13,6656,26,5335,17,1321,9,5957,19,52015,90,57972,109,3,96,-44,665,67,5895,0,175,120,"Anderson",76978,609.264984800852,0.197236180904523,141.598898386552,33.7758840188106,863.883187404193,19.7236180904523
2021-01-14,6753,97,5397,62,1356,35,6031,74,52422,407,58453,481,5,101,8,673,84,5979,2,177,122,"Anderson",76978,598.872405102757,0.168181818181818,624.853854347995,126.010028839409,874.275767102289,16.8181818181818
2021-01-15,6787,34,5417,20,1370,14,6055,24,52577,155,58632,179,0,101,-16,657,50,6029,1,178,125,"Anderson",76978,536.516926914183,0.158767772511848,232.533970744888,44.1684637169061,853.490607706098,15.8767772511848
2021-01-16,6851,64,5447,30,1404,34,6088,33,52821,244,58909,277,1,102,2,659,61,6090,1,179,128,"Anderson",76978,476.759593650134,0.154900616860864,359.843072046559,83.1406375847645,856.088752630622,15.4900616860864
2021-01-17,6888,37,5467,20,1421,17,6111,23,52925,104,59036,127,0,102,-6,653,43,6133,0,179,130,"Anderson",76978,446.880927018109,0.152692569870484,164.982202707267,48.065681103692,848.29431785705,15.2692569870484
2021-01-18,6907,19,5475,8,1432,11,6121,10,53021,96,59142,106,1,103,-68,585,86,6219,0,179,131,"Anderson",76978,428.693912546442,0.148421759570181,137.701680999766,24.682376782977,759.957390423238,14.8421759570181
2021-01-19,6949,42,5492,17,1457,25,6141,20,53133,112,59274,132,1,104,-78,507,119,6338,0,179,133,"Anderson",76978,414.40411546156,0.143869596031184,171.477565018577,54.5610434150017,658.629738366806,14.3869596031184
2021-01-20,6977,28,5508,16,1469,12,6160,19,53285,152,59445,171,3,107,-29,478,54,6392,0,179,135,"Anderson",76978,417.002260386084,0.137813985064494,222.141391046793,36.3740289433345,620.95663696121,13.7813985064494
2021-01-21,7033,56,5548,40,1485,16,6199,39,53526,241,59725,280,5,112,-42,436,93,6485,2,181,136,"Anderson",76978,363.740289433345,0.132075471698113,363.740289433345,72.7480578866689,566.395593546208,13.2075471698113
2021-01-22,7071,38,5566,18,1505,20,6221,22,53671,145,59892,167,2,114,-16,420,52,6537,0,181,139,"Anderson",76978,368.936579282392,0.131746031746032,216.945101197745,49.3647535659539,545.610434150017,13.1746031746032
2021-01-23,7109,38,5580,14,1529,24,6234,13,53931,260,60165,273,0,114,8,428,30,6567,1,182,139,"Anderson",76978,335.160695263582,0.116242038216561,354.646782197511,49.3647535659539,556.003013848112,11.6242038216561
2021-01-24,7122,13,5592,12,1530,1,6248,14,53998,67,60246,81,0,114,-21,407,34,6601,0,182,141,"Anderson",76978,303.982956169295,0.113223140495868,105.224869443218,16.8879420094053,528.722492140612,11.3223140495868
2021-01-25,7139,17,5603,11,1536,6,6259,11,54058,60,60317,71,2,116,-47,360,62,6663,1,183,143,"Anderson",76978,301.384811244771,0.117446808510638,92.2341448205981,22.0842318584531,467.6660864143,11.7446808510638
2021-01-26,7166,27,5624,21,1542,6,6284,25,54222,164,60506,189,0,116,-36,324,63,6726,1,184,146,"Anderson",76978,281.898724310842,0.116071428571429,245.524695367508,35.0749564810725,420.89947777287,11.6071428571429
2021-01-27,7183,17,5632,8,1551,9,6293,9,54308,86,60601,95,4,120,-18,306,31,6757,0,184,148,"Anderson",76978,267.608927225961,0.115051903114187,123.411883914885,22.0842318584531,397.516173452155,11.5051903114187
2021-01-28,7270,87,5672,40,1598,47,6340,47,54534,226,60874,273,4,124,24,330,59,6816,0,184,149,"Anderson",76978,307.880173556081,0.122715404699739,354.646782197511,113.019304216789,428.693912546442,12.2715404699739
2021-01-29,7283,13,5676,4,1607,9,6345,5,54579,45,60924,50,1,125,-34,296,46,6862,1,185,149,"Anderson",76978,275.403361999532,0.12015503875969,64.9536231130973,16.8879420094053,384.525448829536,12.015503875969
2021-01-30,7323,40,5711,35,1612,5,6381,36,54838,259,61219,295,2,127,1,297,37,6899,2,187,150,"Anderson",76978,278.001506924056,0.139468690702087,383.226376367274,51.9628984904778,385.824521291798,13.9468690702087
2021-01-31,7339,16,5718,7,1621,9,6392,11,55007,169,61399,180,1,128,-4,293,19,6918,0,187,152,"Anderson",76978,281.898724310842,0.12489158716392,233.83304320715,20.7851593961911,380.62823144275,12.489158716392
2021-02-01,7359,20,5730,12,1629,8,6405,13,55060,53,61465,66,1,129,-26,267,45,6963,1,188,153,"Anderson",76978,285.795941697628,0.127177700348432,85.7387825092884,25.9814492452389,346.852347423939,12.7177700348432
2021-02-02,7366,7,5736,6,1630,1,6411,6,55129,69,61540,75,5,134,-45,222,47,7010,0,188,154,"Anderson",76978,259.814492452389,0.122823984526112,97.4304346696459,9.09350723583361,288.394086622152,12.2823984526112
2021-02-03,7388,22,5742,6,1646,16,6421,10,55321,192,61742,202,4,138,1,223,17,7027,0,188,155,"Anderson",76978,266.309854763699,0.112182296231376,262.412637376913,28.5795941697628,289.693159084414,11.2182296231376
2021-02-04,7418,30,5756,14,1662,16,6438,17,55645,324,62083,341,2,140,-5,218,33,7060,0,188,155,"Anderson",76978,192.262724414768,0.0810587262200165,442.983709631323,38.9721738678584,283.197796773104,8.10587262200166
2021-02-05,7436,18,5767,11,1669,7,6455,17,55802,157,62257,174,2,142,-13,205,29,7089,0,188,156,"Anderson",76978,198.758086726078,0.0825206301575394,226.038608433578,23.383304320715,266.309854763699,8.25206301575394
2021-02-06,7462,26,5783,16,1679,10,6475,20,56024,222,62499,242,1,143,8,213,17,7106,1,189,156,"Anderson",76978,180.57107225441,0.0734375,314.375535867391,33.7758840188106,276.702434461794,7.34375
2021-02-07,7475,13,5790,7,1685,6,6483,8,56131,107,62614,115,0,143,-10,203,23,7129,0,189,156,"Anderson",76978,176.673854867625,0.0748971193415638,149.393333160124,16.8879420094053,263.711709839175,7.48971193415638
2021-02-08,7500,25,5796,6,1704,19,6488,5,56153,22,62641,27,2,145,-13,190,36,7165,0,189,156,"Anderson",76978,183.169217178934,0.070578231292517,35.0749564810725,32.4768115565486,246.82376782977,7.0578231292517
2021-02-09,7524,24,5806,10,1718,14,6499,11,56322,169,62821,180,2,147,-24,166,46,7211,2,191,156,"Anderson",76978,205.253449037387,0.068696330991413,233.83304320715,31.1777390942867,215.646028735483,6.8696330991413
2021-02-10,7549,25,5821,15,1728,10,6518,19,56517,195,63035,214,1,148,8,174,16,7227,1,192,156,"Anderson",76978,209.150666424173,0.0750193348801237,278.001506924056,32.4768115565486,226.038608433578,7.50193348801237
2021-02-11,7562,13,5829,8,1733,5,6530,12,56697,180,63227,192,-1,147,-16,158,30,7257,0,192,157,"Anderson",76978,187.06643456572,0.0804195804195804,249.421912754293,16.8879420094053,205.253449037387,8.04195804195804
2021-02-12,7589,27,5844,15,1745,12,6545,15,56891,194,63436,209,0,147,13,171,14,7271,0,192,157,"Anderson",76978,198.758086726078,0.0763358778625954,271.506144612746,35.0749564810725,222.141391046793,7.63358778625954
2021-02-13,7615,26,5854,10,1761,16,6555,10,57080,189,63635,199,0,147,11,182,15,7286,0,192,157,"Anderson",76978,198.758086726078,0.0704225352112676,258.515419990127,33.7758840188106,236.431188131674,7.04225352112676
2021-02-14,7629,14,5864,10,1765,4,6566,11,57141,61,63707,72,2,149,1,183,11,7297,0,192,157,"Anderson",76978,200.05715918834,0.0759377859103385,93.53321728286,18.1870144716672,237.730260593936,7.59377859103385
2021-02-15,7645,16,5872,8,1773,8,6575,9,57214,73,63789,82,0,149,-6,177,22,7319,1,193,158,"Anderson",76978,188.365507027982,0.0757839721254355,106.523941905479,20.7851593961911,229.935825820364,7.57839721254355
2021-02-16,7674,29,5886,14,1788,15,6592,17,57298,84,63890,101,0,149,11,188,18,7337,0,193,158,"Anderson",76978,194.860869339292,0.0869971936389149,131.206318688456,37.6731014055964,244.225622905246,8.69971936389149
2021-02-17,7693,19,5898,12,1795,7,6604,12,57406,108,64010,120,0,149,-8,180,27,7364,0,193,160,"Anderson",76978,187.06643456572,0.0882051282051282,155.888695471433,24.682376782977,233.83304320715,8.82051282051282
2021-02-18,7717,24,5920,22,1797,2,6630,26,57562,156,64192,182,0,149,9,189,15,7379,0,193,160,"Anderson",76978,201.356231650601,0.103626943005181,236.431188131674,31.1777390942867,245.524695367508,10.3626943005181
2021-02-19,7730,13,5931,11,1799,2,6645,15,57608,46,64253,61,0,149,0,189,13,7392,0,193,161,"Anderson",76978,183.169217178934,0.122399020807834,79.2434201979787,16.8879420094053,245.524695367508,12.2399020807834
2021-02-20,7749,19,5938,7,1811,12,6654,9,57730,122,64384,131,1,150,3,192,15,7407,0,193,162,"Anderson",76978,174.075709943101,0.132176234979973,170.178492556315,24.682376782977,249.421912754293,13.2176234979973
2021-02-21,7761,12,5945,7,1816,5,6661,7,57794,64,64455,71,2,152,-1,191,11,7418,1,194,162,"Anderson",76978,171.477565018577,0.127005347593583,92.2341448205981,15.5888695471433,248.122840292031,12.7005347593583
2021-02-22,7766,5,5947,2,1819,3,6667,6,57831,37,64498,43,1,153,-17,174,21,7439,0,194,163,"Anderson",76978,157.187767933695,0.129760225669958,55.8601158772636,6.49536231130973,226.038608433578,12.9760225669958
2021-02-23,7790,24,5956,9,1834,15,6675,8,57974,143,64649,151,2,155,-2,172,24,7463,0,194,165,"Anderson",76978,150.692405622386,0.10935441370224,196.159941801554,31.1777390942867,223.440463509055,10.935441370224
2021-02-24,7822,32,5975,19,1847,13,6698,23,58148,174,64846,197,0,155,15,187,17,7480,0,194,165,"Anderson",76978,167.580347631791,0.11244019138756,255.917275065603,41.5703187923822,242.926550442984,11.244019138756
2021-02-25,7839,17,5983,8,1856,9,6709,11,58275,127,64984,138,1,156,-3,184,19,7499,0,194,165,"Anderson",76978,158.486840395957,0.0997474747474748,179.271999792148,22.0842318584531,239.029333056198,9.97474747474748
2021-02-26,7851,12,5991,8,1860,4,6718,9,58374,99,65092,108,0,156,-17,167,29,7528,0,194,165,"Anderson",76978,157.187767933695,0.0870083432657926,140.29982592429,15.5888695471433,216.945101197745,8.70083432657926
2021-02-27,7860,9,5998,7,1862,2,6724,6,58466,92,65190,98,0,156,-6,161,15,7543,0,194,165,"Anderson",76978,144.197043311076,0.086848635235732,127.309101301671,11.6916521603575,209.150666424173,8.6848635235732
2021-02-28,7874,14,6008,10,1866,4,6735,11,58537,71,65272,82,0,156,0,161,14,7557,0,194,165,"Anderson",76978,146.7951882356,0.0905752753977968,106.523941905479,18.1870144716672,209.150666424173,9.05752753977968
2021-03-01,7882,8,6013,5,1869,3,6742,7,58572,35,65314,42,0,156,-11,150,19,7576,0,194,165,"Anderson",76978,150.692405622386,0.0919117647058824,54.5610434150017,10.3925796980956,194.860869339292,9.19117647058824
2021-03-02,7905,23,6024,11,1881,12,6752,10,58688,116,65440,126,1,157,-2,148,24,7600,1,195,165,"Anderson",76978,149.393333160124,0.0973451327433628,163.683130245005,29.8786666320247,192.262724414768,9.73451327433628
2021-03-03,7938,33,6045,21,1893,12,6777,25,58804,116,65581,141,1,158,13,161,19,7619,0,195,166,"Anderson",76978,150.692405622386,0.107482993197279,183.169217178934,42.8693912546442,209.150666424173,10.7482993197279
2021-03-04,7963,25,6058,13,1905,12,6794,17,58967,163,65761,180,0,158,13,174,12,7631,0,195,166,"Anderson",76978,161.084985320481,0.109395109395109,233.83304320715,32.4768115565486,226.038608433578,10.9395109395109
2021-03-05,7995,32,6075,17,1920,15,6816,22,59101,134,65917,156,0,158,17,191,15,7646,2,197,166,"Anderson",76978,187.06643456572,0.118787878787879,202.655304112863,41.5703187923822,248.122840292031,11.8787878787879
2021-03-06,8005,10,6080,5,1925,5,6824,8,59190,89,66014,97,0,158,-1,190,11,7657,0,197,166,"Anderson",76978,188.365507027982,0.121359223300971,126.010028839409,12.9907246226195,246.82376782977,12.1359223300971
2021-03-07,8011,6,6083,3,1928,3,6827,3,59229,39,66056,42,0,158,-10,180,16,7673,0,197,166,"Anderson",76978,177.972927329886,0.11734693877551,54.5610434150017,7.79443477357167,233.83304320715,11.734693877551
2021-03-08,8027,16,6090,7,1937,9,6836,9,59306,77,66142,86,1,159,-4,176,19,7692,0,197,166,"Anderson",76978,188.365507027982,0.113526570048309,111.720231754527,20.7851593961911,228.636753358102,11.3526570048309
2021-03-09,8048,21,6098,8,1950,13,6844,8,59371,65,66215,73,0,159,3,179,18,7710,3,200,167,"Anderson",76978,185.767362103458,0.118709677419355,94.832289745122,27.2805217075008,232.533970744888,11.8709677419355
2021-03-10,8070,22,6111,13,1959,9,6860,16,59528,157,66388,173,0,159,11,190,11,7721,1,201,167,"Anderson",76978,171.477565018577,0.102850061957869,224.739535971316,28.5795941697628,246.82376782977,10.2850061957869
2021-03-11,8093,23,6121,10,1972,13,6870,10,59625,97,66495,107,0,159,1,191,22,7743,1,202,168,"Anderson",76978,168.879420094053,0.103542234332425,139.000753462028,29.8786666320247,248.122840292031,10.3542234332425
2021-03-12,8113,20,6138,17,1975,3,6890,20,59731,106,66621,126,0,159,8,199,12,7755,0,202,168,"Anderson",76978,153.29055054691,0.105113636363636,163.683130245005,25.9814492452389,258.515419990127,10.5113636363636
2021-03-13,8124,11,6142,4,1982,7,6894,4,59807,76,66701,80,0,159,2,201,9,7764,1,203,168,"Anderson",76978,154.589623009171,0.101892285298399,103.925796980956,14.2897970848814,261.113564914651,10.1892285298399
2021-03-14,8130,6,6146,4,1984,2,6900,6,59843,36,66743,42,0,159,-13,188,19,7783,1,204,168,"Anderson",76978,154.589623009171,0.106259097525473,54.5610434150017,7.79443477357167,244.225622905246,10.6259097525473
2021-03-15,8148,18,6152,6,1996,12,6906,6,59876,33,66782,39,0,159,-9,179,27,7810,1,205,168,"Anderson",76978,157.187767933695,0.109375,50.6638260282159,23.383304320715,232.533970744888,10.9375
2021-03-16,8181,33,6165,13,2016,20,6921,15,59969,93,66890,108,0,159,-1,178,34,7844,2,207,168,"Anderson",76978,172.776637480839,0.114074074074074,140.29982592429,42.8693912546442,231.234898282626,11.4074074074074
2021-03-17,8198,17,6176,11,2022,6,6934,13,60056,87,66990,100,0,159,-5,173,22,7866,0,207,169,"Anderson",76978,166.281275169529,0.122923588039867,129.907246226195,22.0842318584531,224.739535971316,12.2923588039867
2021-03-18,8214,16,6188,12,2026,4,6949,15,60137,81,67086,96,1,160,-1,172,16,7882,0,207,169,"Anderson",76978,157.187767933695,0.133671742808799,124.710956377147,20.7851593961911,223.440463509055,13.3671742808799
2021-03-19,8238,24,6202,14,2036,10,6962,13,60256,119,67218,132,0,160,13,185,11,7893,1,208,169,"Anderson",76978,162.384057782743,0.120603015075377,171.477565018577,31.1777390942867,240.32840551846,12.0603015075377
2021-03-20,8250,12,6208,6,2042,6,6970,8,60295,39,67265,47,0,160,3,188,9,7902,1,209,169,"Anderson",76978,163.683130245005,0.134751773049645,61.0564057263114,15.5888695471433,244.225622905246,13.4751773049645
2021-03-21,8260,10,6214,6,2046,4,6977,7,60357,62,67334,69,-1,159,-5,183,16,7918,0,209,169,"Anderson",76978,168.879420094053,0.130287648054146,89.6359998960742,12.9907246226195,237.730260593936,13.0287648054146
2021-03-22,8266,6,6215,1,2051,5,6978,1,60423,66,67401,67,0,159,-9,174,15,7933,1,210,169,"Anderson",76978,153.29055054691,0.116316639741519,87.0378549715503,7.79443477357167,226.038608433578,11.6316639741519
2021-03-23,8272,6,6216,1,2056,5,6979,1,60466,43,67445,44,0,159,-15,159,21,7954,0,210,170,"Anderson",76978,118.215594065837,0.104504504504505,57.1591883395256,7.79443477357167,206.552521499649,10.4504504504505
2021-03-24,8280,8,6223,7,2057,1,6986,7,60587,121,67573,128,1,160,-11,148,18,7972,0,210,170,"Anderson",76978,106.523941905479,0.0891938250428816,166.281275169529,10.3925796980956,192.262724414768,8.91938250428817
2021-03-25,8290,10,6228,5,2062,5,6992,6,60688,101,67680,107,0,160,-10,138,20,7992,0,210,170,"Anderson",76978,98.7295071319078,0.0723905723905724,139.000753462028,12.9907246226195,179.271999792148,7.23905723905724
2021-03-26,8307,17,6240,12,2067,5,7003,11,60754,66,67757,77,0,160,3,141,14,8006,0,210,171,"Anderson",76978,89.6359998960742,0.0760667903525046,100.02857959417,22.0842318584531,183.169217178934,7.60667903525046
2021-03-27,8311,4,6244,4,2067,0,7009,6,60818,64,67827,70,1,161,-12,129,15,8021,2,212,171,"Anderson",76978,79.2434201979786,0.0693950177935943,90.9350723583361,5.19628984904778,167.580347631791,6.93950177935943
2021-03-28,8314,3,6244,0,2070,3,7009,0,60847,29,67856,29,1,162,-12,117,14,8035,0,212,172,"Anderson",76978,70.149912962145,0.0613026819923372,37.6731014055964,3.89721738678583,151.991478084648,6.13026819923372
2021-03-29,8329,15,6248,4,2081,11,7013,4,60933,86,67946,90,1,163,-16,101,30,8065,0,212,173,"Anderson",76978,81.8415651225025,0.0642201834862385,116.916521603575,19.4860869339292,131.206318688456,6.42201834862385
2021-03-30,8334,5,6251,3,2083,2,7016,3,60991,58,68007,61,1,164,-12,89,16,8081,0,212,173,"Anderson",76978,80.5424926602406,0.0658362989323843,79.2434201979787,6.49536231130973,115.617449141313,6.58362989323843
2021-03-31,8357,23,6265,14,2092,9,7032,16,61155,164,68187,180,1,165,10,99,12,8093,1,213,173,"Anderson",76978,100.02857959417,0.0749185667752443,233.83304320715,29.8786666320247,128.608173763933,7.49185667752443
2021-04-01,8366,9,6269,4,2097,5,7036,4,61212,57,68248,61,0,165,-8,91,17,8110,0,213,173,"Anderson",76978,98.7295071319078,0.0774647887323944,79.2434201979787,11.6916521603575,118.215594065837,7.74647887323944
2021-04-02,8375,9,6276,7,2099,2,7043,7,61282,70,68325,77,0,165,-1,90,10,8120,0,213,173,"Anderson",76978,88.3369274338123,0.0704225352112676,100.02857959417,11.6916521603575,116.916521603575,7.04225352112676
2021-04-03,8381,6,6281,5,2100,1,7049,6,61332,50,68381,56,0,165,-8,82,14,8134,0,213,173,"Anderson",76978,90.9350723583361,0.0722021660649819,72.7480578866689,7.79443477357167,106.523941905479,7.22021660649819
2021-04-04,8383,2,6283,2,2100,0,7051,2,61370,38,68421,40,0,165,-5,77,7,8141,0,213,173,"Anderson",76978,89.6359998960742,0.0743362831858407,51.9628984904778,2.59814492452389,100.02857959417,7.43362831858407
2021-04-05,8397,14,6286,3,2111,11,7053,2,61428,58,68481,60,0,165,4,81,10,8151,2,215,173,"Anderson",76978,88.3369274338123,0.0747663551401869,77.9443477357167,18.1870144716672,105.224869443218,7.47663551401869
2021-04-06,8402,5,6290,4,2112,1,7059,6,61470,42,68529,48,0,165,3,84,2,8153,0,215,173,"Anderson",76978,88.3369274338123,0.0823754789272031,62.3554781885734,6.49536231130973,109.122086830003,8.23754789272031
2021-04-07,8422,20,6303,13,2119,7,7073,14,61629,159,68702,173,0,165,10,94,10,8163,2,217,173,"Anderson",76978,84.4397100470264,0.0796116504854369,224.739535971316,25.9814492452389,122.112811452623,7.96116504854369
2021-04-08,8425,3,6305,2,2120,1,7076,3,61720,91,68796,94,5,170,-17,77,15,8178,1,218,173,"Anderson",76978,76.6452752734548,0.072992700729927,122.112811452623,3.89721738678583,100.02857959417,7.2992700729927
2021-04-09,8433,8,6311,6,2122,2,7085,9,61807,87,68892,96,-4,166,8,85,4,8182,0,218,173,"Anderson",76978,75.3462028111928,0.0740740740740741,124.710956377147,10.3925796980956,110.421159292265,7.40740740740741
2021-04-10,8438,5,6316,5,2122,0,7090,5,61878,71,68968,76,0,166,-6,79,11,8193,0,218,173,"Anderson",76978,74.0471303489309,0.0698466780238501,98.7295071319078,6.49536231130973,102.626724518694,6.98466780238501
2021-04-11,8445,7,6321,5,2124,2,7095,5,61922,44,69017,49,-1,165,0,79,8,8201,0,218,173,"Anderson",76978,80.5424926602406,0.0738255033557047,63.6545506508353,9.09350723583361,102.626724518694,7.38255033557047
2021-04-12,8448,3,6324,3,2124,0,7098,3,61991,69,69089,72,0,165,-7,72,10,8211,0,218,173,"Anderson",76978,66.2526955753592,0.0740131578947368,93.53321728286,3.89721738678583,93.53321728286,7.40131578947368
2021-04-13,8458,10,6329,5,2129,5,7104,6,62052,61,69156,67,5,170,-8,64,13,8224,0,218,173,"Anderson",76978,72.7480578866689,0.0717703349282297,87.0378549715503,12.9907246226195,83.1406375847645,7.17703349282297
2021-04-14,8472,14,6338,9,2134,5,7115,11,62190,138,69305,149,0,170,7,71,7,8231,0,218,173,"Anderson",76978,64.9536231130973,0.0696517412935323,193.56179687703,18.1870144716672,92.2341448205981,6.96517412935323
2021-04-15,8481,9,6343,5,2138,4,7120,5,62271,81,69391,86,0,170,6,77,3,8234,0,218,173,"Anderson",76978,72.7480578866689,0.0739495798319328,111.720231754527,11.6916521603575,100.02857959417,7.39495798319328
2021-04-16,8494,13,6354,11,2140,2,7133,13,62424,153,69557,166,0,170,6,83,7,8241,0,218,173,"Anderson",76978,79.2434201979786,0.0721804511278196,215.646028735483,16.8879420094053,107.823014367741,7.21804511278196
2021-04-17,8499,5,6357,3,2142,2,7137,4,62489,65,69626,69,0,170,0,83,5,8246,0,218,173,"Anderson",76978,79.2434201979786,0.0714285714285714,89.6359998960742,6.49536231130973,107.823014367741,7.14285714285714
2021-04-18,8506,7,6363,6,2143,1,7143,6,62534,45,69677,51,0,170,0,83,7,8253,0,218,173,"Anderson",76978,79.2434201979786,0.0727272727272727,66.2526955753592,9.09350723583361,107.823014367741,7.27272727272727
2021-04-19,8512,6,6366,3,2146,3,7146,3,62557,23,69703,26,0,170,-6,77,12,8265,0,218,174,"Anderson",76978,83.1406375847645,0.0781758957654723,33.7758840188106,7.79443477357167,100.02857959417,7.81758957654723
2021-04-20,8518,6,6369,3,2149,3,7149,3,62656,99,69805,102,0,170,-1,76,7,8272,0,218,174,"Anderson",76978,77.9443477357167,0.0693374422187981,132.505391150718,7.79443477357167,98.7295071319078,6.93374422187981
2021-04-21,8530,12,6375,6,2155,6,7155,6,62811,155,69966,161,1,171,-2,74,13,8285,0,218,174,"Anderson",76978,75.3462028111928,0.0605143721633888,209.150666424173,15.5888695471433,96.1313622073839,6.05143721633888
2021-04-22,8548,18,6381,6,2167,12,7162,7,62955,144,70117,151,0,171,12,86,6,8291,0,218,174,"Anderson",76978,87.0378549715503,0.0578512396694215,196.159941801554,23.383304320715,111.720231754527,5.78512396694215
2021-04-23,8558,10,6386,5,2172,5,7168,6,63121,166,70289,172,0,171,8,94,2,8293,0,218,174,"Anderson",76978,83.1406375847645,0.0478142076502732,223.440463509055,12.9907246226195,122.112811452623,4.78142076502732
2021-04-24,8570,12,6392,6,2178,6,7175,7,63188,67,70363,74,0,171,8,102,4,8297,1,219,174,"Anderson",76978,92.2341448205981,0.0515603799185889,96.1313622073839,15.5888695471433,132.505391150718,5.15603799185889
2021-04-25,8574,4,6394,2,2180,2,7177,2,63228,40,70405,42,0,171,0,102,4,8301,0,219,174,"Anderson",76978,88.3369274338123,0.0467032967032967,54.5610434150017,5.19628984904778,132.505391150718,4.67032967032967
2021-04-26,8583,9,6398,4,2185,5,7181,4,63303,75,70484,79,0,171,2,104,7,8308,0,219,175,"Anderson",76978,92.2341448205981,0.0448143405889885,102.626724518694,11.6916521603575,135.103536075242,4.48143405889885
2021-04-27,8593,10,6404,6,2189,4,7187,6,63371,68,70558,74,0,171,-3,101,13,8321,0,219,175,"Anderson",76978,97.4304346696459,0.050464807436919,96.1313622073839,12.9907246226195,131.206318688456,5.0464807436919
2021-04-28,8610,17,6416,12,2194,5,7200,13,63509,138,70709,151,0,171,1,102,16,8337,1,220,175,"Anderson",76978,103.925796980956,0.0605652759084791,196.159941801554,22.0842318584531,132.505391150718,6.05652759084791
2021-04-29,8616,6,6418,2,2198,4,7203,3,63658,149,70861,152,0,171,-1,101,7,8344,0,220,175,"Anderson",76978,88.3369274338123,0.0551075268817204,197.459014263816,7.79443477357167,131.206318688456,5.51075268817204
2021-04-30,8623,7,6421,3,2202,4,7207,4,63780,122,70987,126,0,171,-2,99,9,8353,0,220,175,"Anderson",76978,84.4397100470264,0.0558739255014327,163.683130245005,9.09350723583361,128.608173763933,5.58739255014327
2021-05-01,8628,5,6424,3,2204,2,7210,3,63843,63,71053,66,0,171,-1,98,6,8359,1,221,175,"Anderson",76978,75.3462028111928,0.0507246376811594,85.7387825092884,6.49536231130973,127.309101301671,5.07246376811594
2021-05-02,8631,3,6425,1,2206,2,7211,1,63894,51,71105,52,0,171,-7,91,10,8369,0,221,175,"Anderson",76978,74.0471303489309,0.0485714285714286,67.5517680376211,3.89721738678583,118.215594065837,4.85714285714286
2021-05-03,8641,10,6430,5,2211,5,7216,5,64000,106,71216,111,0,171,-3,88,13,8382,0,221,175,"Anderson",76978,75.3462028111928,0.0478142076502732,144.197043311076,12.9907246226195,114.318376679051,4.78142076502732
2021-05-04,8643,2,6430,0,2213,2,7217,1,64076,76,71293,77,0,171,-11,77,13,8395,0,221,175,"Anderson",76978,64.9536231130973,0.0408163265306122,100.02857959417,2.59814492452389,100.02857959417,4.08163265306122
2021-05-05,8651,8,6434,4,2217,4,7220,3,64193,117,71413,120,0,171,-3,74,11,8406,0,221,175,"Anderson",76978,53.2619709527397,0.0284090909090909,155.888695471433,10.3925796980956,96.1313622073839,2.84090909090909
2021-05-06,8656,5,6437,3,2219,2,7226,6,64245,52,71471,58,0,171,-4,70,9,8415,1,222,175,"Anderson",76978,51.9628984904778,0.0377049180327869,75.3462028111928,6.49536231130973,90.9350723583361,3.77049180327869
2021-05-07,8661,5,6439,2,2222,3,7229,3,64366,121,71595,124,0,171,-4,66,9,8424,0,222,175,"Anderson",76978,49.3647535659539,0.0361842105263158,161.084985320481,6.49536231130973,85.7387825092884,3.61842105263158
2021-05-08,8667,6,6442,3,2225,3,7231,2,64435,69,71666,71,0,171,-6,60,12,8436,1,223,175,"Anderson",76978,50.6638260282159,0.034257748776509,92.2341448205981,7.79443477357167,77.9443477357167,3.4257748776509
2021-05-09,8668,1,6442,0,2226,1,7232,1,64463,28,71695,29,0,171,-4,56,5,8441,0,223,175,"Anderson",76978,48.065681103692,0.0355932203389831,37.6731014055964,1.29907246226194,72.7480578866689,3.55932203389831
2021-05-10,8673,5,6442,0,2231,5,7232,0,64551,88,71783,88,0,171,-5,51,10,8451,0,223,175,"Anderson",76978,41.5703187923822,0.0282186948853616,114.318376679051,6.49536231130973,66.2526955753592,2.82186948853616
2021-05-11,8680,7,6443,1,2237,6,7234,2,64593,42,71827,44,0,171,2,53,5,8456,0,223,175,"Anderson",76978,48.065681103692,0.0318352059925094,57.1591883395256,9.09350723583361,68.8508404998831,3.18352059925094
2021-05-12,8693,13,6450,7,2243,6,7240,6,64697,104,71937,110,0,171,8,61,5,8461,2,225,175,"Anderson",76978,54.5610434150017,0.0381679389312977,142.897970848814,16.8879420094053,79.2434201979787,3.81679389312977
2021-05-13,8697,4,6452,2,2245,2,7242,2,64800,103,72042,105,0,171,-3,58,7,8468,2,227,175,"Anderson",76978,53.2619709527397,0.0280210157618214,136.402608537504,5.19628984904778,75.3462028111928,2.80210157618214
2021-05-14,8705,8,6455,3,2250,5,7247,5,64887,87,72134,92,0,171,2,60,6,8474,0,227,175,"Anderson",76978,57.1591883395256,0.0333951762523191,119.514666528099,10.3925796980956,77.9443477357167,3.33951762523191
2021-05-15,8710,5,6457,2,2253,3,7249,2,64952,65,72201,67,0,171,1,61,4,8478,0,227,175,"Anderson",76978,55.8601158772636,0.0336448598130841,87.0378549715503,6.49536231130973,79.2434201979787,3.36448598130841
2021-05-16,8712,2,6458,1,2254,1,7250,1,64988,36,72238,37,0,171,-5,56,7,8485,0,227,175,"Anderson",76978,57.1591883395256,0.0331491712707182,48.065681103692,2.59814492452389,72.7480578866689,3.31491712707182
2021-05-17,8718,6,6463,5,2255,1,7255,5,65047,59,72302,64,1,172,0,56,5,8490,0,227,175,"Anderson",76978,58.4582608017875,0.0443159922928709,83.1406375847645,7.79443477357167,72.7480578866689,4.43159922928709
2021-05-18,8722,4,6463,0,2259,4,7255,0,65138,91,72393,91,0,172,0,56,4,8494,1,228,175,"Anderson",76978,54.5610434150017,0.0371024734982332,118.215594065837,5.19628984904778,72.7480578866689,3.71024734982332
2021-05-19,8729,7,6468,5,2261,2,7261,6,65257,119,72518,125,0,172,4,60,3,8497,0,228,175,"Anderson",76978,46.76660864143,0.036144578313253,162.384057782743,9.09350723583361,77.9443477357167,3.6144578313253
2021-05-20,8731,2,6470,2,2261,0,7263,2,65376,119,72639,121,0,172,-1,59,3,8500,0,228,175,"Anderson",76978,44.1684637169061,0.0351758793969849,157.187767933695,2.59814492452389,76.6452752734548,3.51758793969849
2021-05-21,8733,2,6470,0,2263,2,7263,0,65446,70,72709,70,0,172,-7,52,9,8509,0,228,175,"Anderson",76978,36.3740289433345,0.0278260869565217,90.9350723583361,2.59814492452389,67.5517680376211,2.78260869565217
2021-05-22,8738,5,6472,2,2266,3,7265,2,65486,40,72751,42,0,172,-3,49,8,8517,0,228,175,"Anderson",76978,36.3740289433345,0.0290909090909091,54.5610434150017,6.49536231130973,63.6545506508353,2.90909090909091
2021-05-23,8738,0,6472,0,2266,0,7265,0,65515,29,72780,29,0,172,-3,46,3,8520,0,228,175,"Anderson",76978,33.7758840188106,0.0276752767527675,37.6731014055964,0,59.7573332640495,2.76752767527675
2021-05-24,8746,8,6476,4,2270,4,7268,3,65574,59,72842,62,0,172,2,48,6,8526,0,228,175,"Anderson",76978,36.3740289433345,0.0240740740740741,80.5424926602406,10.3925796980956,62.3554781885734,2.40740740740741
2021-05-25,8748,2,6476,0,2272,2,7269,1,65619,45,72888,46,0,172,-10,38,12,8538,0,228,175,"Anderson",76978,33.7758840188106,0.0282828282828283,59.7573332640495,2.59814492452389,49.3647535659539,2.82828282828283
2021-05-26,8755,7,6481,5,2274,2,7275,6,65719,100,72994,106,0,172,0,38,7,8545,0,228,175,"Anderson",76978,33.7758840188106,0.0294117647058824,137.701680999766,9.09350723583361,49.3647535659539,2.94117647058824
2021-05-27,8757,2,6482,1,2275,1,7276,1,65769,50,73045,51,0,172,-1,37,3,8548,1,229,175,"Anderson",76978,33.7758840188106,0.0320197044334975,66.2526955753592,2.59814492452389,48.065681103692,3.20197044334975
2021-05-28,8762,5,6486,4,2276,1,7281,5,65852,83,73133,88,0,172,0,37,5,8553,0,229,175,"Anderson",76978,37.6731014055964,0.0424528301886792,114.318376679051,6.49536231130973,48.065681103692,4.24528301886792
2021-05-29,8763,1,6486,0,2277,1,7281,0,65889,37,73170,37,0,172,-5,32,6,8559,0,229,175,"Anderson",76978,32.4768115565486,0.0381861575178998,48.065681103692,1.29907246226194,41.5703187923822,3.81861575178998
2021-05-30,8766,3,6487,1,2279,2,7282,1,65939,50,73221,51,0,172,0,32,3,8562,0,229,175,"Anderson",76978,36.3740289433345,0.0385487528344671,66.2526955753592,3.89721738678583,41.5703187923822,3.85487528344671
2021-05-31,8770,4,6490,3,2280,1,7285,3,65990,51,73275,54,0,172,1,33,3,8565,0,229,175,"Anderson",76978,31.1777390942867,0.0392609699769053,70.149912962145,5.19628984904778,42.8693912546442,3.92609699769053
2021-06-01,8773,3,6492,2,2281,1,7286,1,66038,48,73324,49,0,172,1,34,2,8567,1,230,175,"Anderson",76978,32.4768115565486,0.0389908256880734,63.6545506508353,3.89721738678583,44.1684637169061,3.89908256880734
2021-06-02,8777,4,6493,1,2284,3,7288,2,66079,41,73367,43,0,172,-2,32,6,8573,0,230,175,"Anderson",76978,28.5795941697628,0.0348525469168901,55.8601158772636,5.19628984904778,41.5703187923822,3.48525469168901
2021-06-03,8778,1,6493,0,2285,1,7291,3,66169,90,73460,93,1,173,-3,29,3,8576,0,230,175,"Anderson",76978,27.2805217075008,0.036144578313253,120.813738990361,1.29907246226194,37.6731014055964,3.6144578313253
2021-06-04,8779,1,6494,1,2285,0,7293,2,66222,53,73515,55,-1,172,-2,27,4,8580,0,230,175,"Anderson",76978,22.0842318584531,0.031413612565445,71.448985424407,1.29907246226194,35.0749564810725,3.1413612565445
2021-06-05,8780,1,6495,1,2285,0,7294,1,66279,57,73573,58,0,172,-3,24,4,8584,0,230,175,"Anderson",76978,22.0842318584531,0.032258064516129,75.3462028111928,1.29907246226194,31.1777390942867,3.2258064516129
2021-06-06,8780,0,6495,0,2285,0,7294,0,66304,25,73598,25,0,172,-4,20,4,8588,0,230,175,"Anderson",76978,18.1870144716672,0.0318302387267905,32.4768115565486,0,25.9814492452389,3.18302387267904
2021-06-07,8781,1,6495,0,2286,1,7294,0,66368,64,73662,64,0,172,-1,19,2,8590,0,230,175,"Anderson",76978,14.2897970848814,0.0232558139534884,83.1406375847645,1.29907246226194,24.682376782977,2.32558139534884
2021-06-08,8782,1,6495,0,2287,1,7294,0,66405,37,73699,37,0,172,-1,18,2,8592,1,231,176,"Anderson",76978,11.6916521603575,0.0213333333333333,48.065681103692,1.29907246226194,23.383304320715,2.13333333333333
2021-06-09,8782,0,6495,0,2287,0,7294,0,66487,82,73781,82,0,172,-4,14,4,8596,0,231,176,"Anderson",76978,6.49536231130972,0.0144927536231884,106.523941905479,0,18.1870144716672,1.44927536231884
2021-06-10,8786,4,6496,1,2290,3,7295,1,66544,57,73839,58,0,172,4,18,0,8596,0,231,176,"Anderson",76978,10.3925796980956,0.0105540897097625,75.3462028111928,5.19628984904778,23.383304320715,1.05540897097625
2021-06-11,8787,1,6496,0,2291,1,7296,1,66599,55,73895,56,1,173,-3,15,3,8599,0,231,176,"Anderson",76978,10.3925796980956,0.00789473684210526,72.7480578866689,1.29907246226194,19.4860869339292,0.789473684210526
2021-06-12,8788,1,6496,0,2292,1,7297,1,66654,55,73951,56,2,175,-4,11,3,8602,0,231,176,"Anderson",76978,10.3925796980956,0.00793650793650794,72.7480578866689,1.29907246226194,14.2897970848814,0.793650793650794
2021-06-13,8789,1,6496,0,2293,1,7298,1,66692,38,73990,39,0,175,-3,8,4,8606,0,231,176,"Anderson",76978,11.6916521603575,0.0102040816326531,50.6638260282159,1.29907246226194,10.3925796980956,1.02040816326531
2021-06-14,8791,2,6498,2,2293,0,7300,2,66778,86,74078,88,0,175,1,9,1,8607,0,231,176,"Anderson",76978,12.9907246226194,0.0144230769230769,114.318376679051,2.59814492452389,11.6916521603575,1.44230769230769
2021-06-15,8791,0,6498,0,2293,0,7301,1,66809,31,74110,32,0,175,-1,8,1,8608,0,231,176,"Anderson",76978,11.6916521603575,0.0170316301703163,41.5703187923822,0,10.3925796980956,1.70316301703163
2021-06-16,8792,1,6499,1,2293,0,7302,1,66853,44,74155,45,0,175,0,8,1,8609,0,231,176,"Anderson",76978,12.9907246226194,0.0213903743315508,58.4582608017875,1.29907246226194,10.3925796980956,2.13903743315508
2021-06-17,8792,0,6499,0,2293,0,7302,0,66939,86,74241,86,0,175,-1,7,1,8610,0,231,176,"Anderson",76978,7.79443477357167,0.0174129353233831,111.720231754527,0,9.09350723583361,1.74129353233831
2021-06-18,8794,2,6500,1,2294,1,7306,4,66989,50,74295,54,0,175,1,8,1,8611,0,231,176,"Anderson",76978,9.09350723583361,0.025,70.149912962145,2.59814492452389,10.3925796980956,2.5
2021-06-19,8794,0,6500,0,2294,0,7306,0,67037,48,74343,48,0,175,-1,7,1,8612,0,231,176,"Anderson",76978,7.79443477357167,0.0229591836734694,62.3554781885734,0,9.09350723583361,2.29591836734694
2021-06-20,8794,0,6500,0,2294,0,7307,1,67060,23,74367,24,0,175,-2,5,2,8614,0,231,176,"Anderson",76978,6.49536231130972,0.0238726790450928,31.1777390942867,0,6.49536231130973,2.38726790450928
2021-06-21,8795,1,6500,0,2295,1,7307,0,67100,40,74407,40,0,175,0,5,1,8615,0,231,176,"Anderson",76978,5.19628984904778,0.0212765957446809,51.9628984904778,1.29907246226194,6.49536231130973,2.12765957446809
2021-06-22,8799,4,6501,1,2298,3,7307,0,67142,42,74449,42,0,175,2,7,2,8617,1,232,176,"Anderson",76978,10.3925796980956,0.0176991150442478,54.5610434150017,5.19628984904778,9.09350723583361,1.76991150442478
2021-06-23,8800,1,6502,1,2298,0,7308,1,67190,48,74498,49,0,175,1,8,0,8617,0,232,176,"Anderson",76978,10.3925796980956,0.0174927113702624,63.6545506508353,1.29907246226194,10.3925796980956,1.74927113702624
2021-06-24,8800,0,6502,0,2298,0,7309,1,67235,45,74544,46,0,175,-3,5,3,8620,0,232,176,"Anderson",76978,10.3925796980956,0.0231023102310231,59.7573332640495,0,6.49536231130973,2.31023102310231
2021-06-25,8801,1,6503,1,2298,0,7310,1,67271,36,74581,37,0,175,1,6,0,8620,0,232,176,"Anderson",76978,9.09350723583361,0.013986013986014,48.065681103692,1.29907246226194,7.79443477357167,1.3986013986014
2021-06-26,8802,1,6504,1,2298,0,7311,1,67304,33,74615,34,0,175,0,6,1,8621,0,232,176,"Anderson",76978,10.3925796980956,0.0183823529411765,44.1684637169061,1.29907246226194,7.79443477357167,1.83823529411765
2021-06-27,8802,0,6504,0,2298,0,7311,0,67336,32,74647,32,0,175,0,6,0,8621,0,232,176,"Anderson",76978,10.3925796980956,0.0142857142857143,41.5703187923822,0,7.79443477357167,1.42857142857143
2021-06-28,8803,1,6504,0,2299,1,7312,1,67352,16,74664,17,0,175,1,7,0,8621,0,232,176,"Anderson",76978,10.3925796980956,0.0194552529182879,22.0842318584531,1.29907246226194,9.09350723583361,1.94552529182879
2021-06-29,8806,3,6507,3,2299,0,7315,3,67411,59,74726,62,0,175,2,9,1,8622,0,232,176,"Anderson",76978,9.09350723583361,0.0288808664259928,80.5424926602406,3.89721738678583,11.6916521603575,2.88808664259928
2021-06-30,8806,0,6507,0,2299,0,7315,0,67457,46,74772,46,0,175,-1,8,1,8623,0,232,176,"Anderson",76978,7.79443477357167,0.0255474452554745,59.7573332640495,0,10.3925796980956,2.55474452554745
2021-07-01,8807,1,6508,1,2299,0,7316,1,67494,37,74810,38,0,175,1,9,0,8623,0,232,176,"Anderson",76978,9.09350723583361,0.0263157894736842,49.3647535659539,1.29907246226194,11.6916521603575,2.63157894736842
2021-07-02,8807,0,6508,0,2299,0,7316,0,67537,43,74853,43,0,175,0,9,0,8623,0,232,176,"Anderson",76978,7.79443477357167,0.0220588235294118,55.8601158772636,0,11.6916521603575,2.20588235294118
2021-07-03,8807,0,6508,0,2299,0,7316,0,67558,21,74874,21,0,175,-1,8,1,8624,0,232,176,"Anderson",76978,6.49536231130972,0.0193050193050193,27.2805217075008,0,10.3925796980956,1.93050193050193
2021-07-04,8808,1,6508,0,2300,1,7317,1,67583,25,74900,26,0,175,0,8,1,8625,0,232,176,"Anderson",76978,7.79443477357167,0.0237154150197628,33.7758840188106,1.29907246226194,10.3925796980956,2.37154150197628
2021-07-05,8808,0,6508,0,2300,0,7318,1,67598,15,74916,16,0,175,-1,7,1,8626,0,232,176,"Anderson",76978,6.49536231130972,0.0238095238095238,20.7851593961911,0,9.09350723583361,2.38095238095238
2021-07-06,8809,1,6508,0,2301,1,7318,0,67628,30,74946,30,1,176,-3,4,3,8629,0,232,176,"Anderson",76978,3.89721738678583,0.0136363636363636,38.9721738678584,1.29907246226194,5.19628984904778,1.36363636363636
2021-07-07,8810,1,6508,0,2302,1,7318,0,67674,46,74992,46,0,176,-2,2,3,8632,0,232,176,"Anderson",76978,5.19628984904778,0.0136363636363636,59.7573332640495,1.29907246226194,2.59814492452389,1.36363636363636
2021-07-08,8811,1,6509,1,2302,0,7319,1,67715,41,75034,42,0,176,-1,1,2,8634,0,232,176,"Anderson",76978,5.19628984904778,0.0133928571428571,54.5610434150017,1.29907246226194,1.29907246226194,1.33928571428571
2021-07-09,8813,2,6510,1,2303,1,7320,1,67759,44,75079,45,0,176,1,2,1,8635,0,232,176,"Anderson",76978,7.79443477357167,0.0176991150442478,58.4582608017875,2.59814492452389,2.59814492452389,1.76991150442478
2021-07-10,8815,2,6511,1,2304,1,7321,1,67781,22,75102,23,0,176,2,4,0,8635,1,233,176,"Anderson",76978,10.3925796980956,0.0219298245614035,29.8786666320247,2.59814492452389,5.19628984904778,2.19298245614035
2021-07-11,8815,0,6511,0,2304,0,7321,0,67796,15,75117,15,0,176,0,4,0,8635,0,233,176,"Anderson",76978,9.09350723583361,0.0184331797235023,19.4860869339292,0,5.19628984904778,1.84331797235023
2021-07-12,8823,8,6515,4,2308,4,7325,4,67832,36,75157,40,0,176,7,11,1,8636,1,234,176,"Anderson",76978,19.4860869339292,0.029045643153527,51.9628984904778,10.3925796980956,14.2897970848814,2.9045643153527
2021-07-13,8824,1,6515,0,2309,1,7325,0,67853,21,75178,21,0,176,0,11,1,8637,0,234,177,"Anderson",76978,19.4860869339292,0.0301724137931034,27.2805217075008,1.29907246226194,14.2897970848814,3.01724137931034
2021-07-14,8829,5,6520,5,2309,0,7330,5,67907,54,75237,59,0,176,5,16,0,8637,1,235,177,"Anderson",76978,24.682376782977,0.0489795918367347,76.6452752734548,6.49536231130973,20.7851593961911,4.89795918367347
2021-07-15,8832,3,6523,3,2309,0,7332,2,67940,33,75272,35,0,176,3,19,0,8637,0,235,177,"Anderson",76978,27.2805217075008,0.0546218487394958,45.4675361791681,3.89721738678583,24.682376782977,5.46218487394958
2021-07-16,8842,10,6525,2,2317,8,7333,1,67968,28,75301,29,0,176,10,29,0,8637,0,235,177,"Anderson",76978,37.6731014055964,0.0585585585585586,37.6731014055964,12.9907246226195,37.6731014055964,5.85585585585586
2021-07-17,8847,5,6526,1,2321,4,7334,1,68004,36,75338,37,0,176,4,33,1,8638,0,235,177,"Anderson",76978,41.5703187923822,0.0550847457627119,48.065681103692,6.49536231130973,42.8693912546442,5.50847457627119
2021-07-18,8850,3,6528,2,2322,1,7336,2,68024,20,75360,22,0,176,-1,32,4,8642,0,235,177,"Anderson",76978,45.4675361791681,0.0617283950617284,28.5795941697628,3.89721738678583,41.5703187923822,6.17283950617284
2021-07-19,8855,5,6532,4,2323,1,7340,4,68058,34,75398,38,1,177,2,34,2,8644,0,235,177,"Anderson",76978,41.5703187923822,0.0622406639004149,49.3647535659539,6.49536231130973,44.1684637169061,6.22406639004149
2021-07-20,8870,15,6543,11,2327,4,7351,11,68093,35,75444,46,0,177,10,44,5,8649,1,236,177,"Anderson",76978,59.7573332640495,0.0977443609022556,59.7573332640495,19.4860869339292,57.1591883395256,9.77443609022556
2021-07-21,8877,7,6547,4,2330,3,7356,5,68178,85,75534,90,0,177,6,50,1,8650,0,236,178,"Anderson",76978,62.3554781885734,0.0875420875420875,116.916521603575,9.09350723583361,64.9536231130973,8.75420875420875
2021-07-22,8887,10,6552,5,2335,5,7360,4,68234,56,75594,60,0,177,9,59,1,8651,0,236,178,"Anderson",76978,71.448985424407,0.0869565217391304,77.9443477357167,12.9907246226195,76.6452752734548,8.69565217391304
2021-07-23,8897,10,6556,4,2341,6,7365,5,68305,71,75670,76,0,177,10,69,0,8651,0,236,178,"Anderson",76978,71.448985424407,0.0867208672086721,98.7295071319078,12.9907246226195,89.6359998960742,8.67208672086721
2021-07-24,8905,8,6560,4,2345,4,7369,4,68359,54,75728,58,0,177,7,76,1,8652,0,236,179,"Anderson",76978,75.3462028111928,0.0897435897435897,75.3462028111928,10.3925796980956,98.7295071319078,8.97435897435897
2021-07-25,8910,5,6563,3,2347,2,7370,1,68381,22,75751,23,0,177,2,78,3,8655,0,236,179,"Anderson",76978,77.9443477357167,0.0869565217391304,29.8786666320247,6.49536231130973,101.327652056432,8.69565217391304
2021-07-26,8933,23,6572,9,2361,14,7378,8,68431,50,75809,58,2,179,13,91,8,8663,0,236,179,"Anderson",76978,101.327652056432,0.0924574209245742,75.3462028111928,29.8786666320247,118.215594065837,9.24574209245742
2021-07-27,8948,15,6577,5,2371,10,7383,5,68484,53,75867,58,0,179,12,103,3,8666,0,236,179,"Anderson",76978,101.327652056432,0.0756501182033097,75.3462028111928,19.4860869339292,133.80446361298,7.56501182033097
2021-07-28,8968,20,6585,8,2383,12,7395,12,68567,83,75962,95,0,179,14,117,6,8672,0,236,179,"Anderson",76978,118.215594065837,0.0911214953271028,123.411883914885,25.9814492452389,151.991478084648,9.11214953271028
2021-07-29,8980,12,6595,10,2385,2,7407,12,68616,49,76023,61,0,179,8,125,4,8676,0,236,179,"Anderson",76978,120.813738990361,0.10955710955711,79.2434201979787,15.5888695471433,162.384057782743,10.955710955711
2021-07-30,9011,31,6616,21,2395,10,7430,23,68665,49,76095,72,0,179,19,144,12,8688,1,237,179,"Anderson",76978,148.094260697862,0.152941176470588,93.53321728286,40.2712463301203,187.06643456572,15.2941176470588
2021-07-31,9024,13,6622,6,2402,7,7436,6,68707,42,76143,48,0,179,8,152,5,8693,0,237,179,"Anderson",76978,154.589623009171,0.16144578313253,62.3554781885734,16.8879420094053,197.459014263816,16.144578313253
2021-08-01,9043,19,6633,11,2410,8,7451,15,68746,39,76197,54,0,179,14,166,5,8698,0,237,179,"Anderson",76978,172.776637480839,0.181614349775785,70.149912962145,24.682376782977,215.646028735483,18.1614349775785
2021-08-02,9054,11,6638,5,2416,6,7456,5,68825,79,76281,84,0,179,3,169,8,8706,0,237,179,"Anderson",76978,157.187767933695,0.165254237288136,109.122086830003,14.2897970848814,219.543246122269,16.5254237288136
2021-08-03,9077,23,6649,11,2428,12,7469,13,68897,72,76366,85,0,179,13,182,10,8716,1,238,179,"Anderson",76978,167.580347631791,0.172344689378758,110.421159292265,29.8786666320247,236.431188131674,17.2344689378758
2021-08-04,9103,26,6671,22,2432,4,7490,21,68999,102,76489,123,0,179,24,206,2,8718,0,238,179,"Anderson",76978,175.374782405363,0.180265654648956,159.785912858219,33.7758840188106,267.608927225961,18.0265654648956
2021-08-05,9133,30,6687,16,2446,14,7506,16,69097,98,76603,114,0,179,13,219,17,8735,1,239,179,"Anderson",76978,198.758086726078,0.170689655172414,148.094260697862,38.9721738678584,284.496869235366,17.0689655172414
2021-08-06,9158,25,6703,16,2455,9,7524,18,69240,143,76764,161,0,179,17,236,8,8743,1,240,179,"Anderson",76978,190.963651952506,0.14050822122571,209.150666424173,32.4768115565486,306.581101093819,14.050822122571
2021-08-07,9171,13,6709,6,2462,7,7531,7,69315,75,76846,82,0,179,5,241,8,8751,0,240,179,"Anderson",76978,190.963651952506,0.135135135135135,106.523941905479,16.8879420094053,313.076463405129,13.5135135135135
2021-08-08,9185,14,6717,8,2468,6,7541,10,69367,52,76908,62,0,179,6,247,8,8759,0,240,179,"Anderson",76978,184.468289641196,0.126582278481013,80.5424926602406,18.1870144716672,320.8708981787,12.6582278481013
2021-08-09,9221,36,6737,20,2484,16,7560,19,69466,99,77026,118,0,179,16,263,20,8779,0,240,179,"Anderson",76978,216.945101197745,0.139597315436242,153.29055054691,46.76660864143,341.656057574892,13.9597315436242
2021-08-10,9260,39,6757,20,2503,19,7580,20,69566,100,77146,120,0,179,20,283,19,8798,2,242,179,"Anderson",76978,237.730260593936,0.142307692307692,155.888695471433,50.6638260282159,367.63750682013,14.2307692307692
2021-08-11,9314,54,6781,24,2533,30,7609,29,69698,132,77307,161,0,179,30,313,24,8822,1,243,179,"Anderson",76978,274.10428953727,0.145476772616137,209.150666424173,70.149912962145,406.609680687989,14.5476772616137
2021-08-12,9362,48,6817,36,2545,12,7646,37,69866,168,77512,205,0,179,27,340,21,8843,0,243,181,"Anderson",76978,297.487593857985,0.154015401540154,266.309854763699,62.3554781885734,441.684637169061,15.4015401540154
2021-08-13,9426,64,6852,35,2574,29,7684,38,69980,114,77664,152,2,181,46,386,16,8859,1,244,181,"Anderson",76978,348.151419886201,0.177777777777778,197.459014263816,83.1406375847645,501.441970433111,17.7777777777778
2021-08-14,9476,50,6887,35,2589,15,7716,32,70166,186,77882,218,0,181,29,415,21,8880,0,244,181,"Anderson",76978,396.217100989893,0.178571428571429,283.197796773104,64.9536231130973,539.115071838707,17.8571428571429
2021-08-15,9499,23,6900,13,2599,10,7731,15,70255,89,77986,104,0,181,16,431,7,8887,0,244,181,"Anderson",76978,407.908753150251,0.176252319109462,135.103536075242,29.8786666320247,559.900231234898,17.6252319109462
2021-08-16,9537,38,6924,24,2613,14,7755,24,70344,89,78099,113,0,181,11,442,27,8914,0,244,182,"Anderson",76978,410.506898074775,0.181733457595527,146.7951882356,49.3647535659539,574.19002831978,18.1733457595527
2021-08-17,9580,43,6945,21,2635,22,7779,24,70452,108,78231,132,1,182,14,456,28,8942,0,244,182,"Anderson",76978,415.703187923822,0.183410138248848,171.477565018577,55.8601158772636,592.377042791447,18.3410138248848
2021-08-18,9632,52,6972,27,2660,25,7810,31,70564,112,78374,143,0,182,16,472,36,8978,0,244,182,"Anderson",76978,413.105042999299,0.188378631677601,185.767362103458,67.5517680376211,613.162202187638,18.8378631677601
2021-08-19,9706,74,7005,33,2701,41,7845,35,70716,152,78561,187,0,182,47,519,27,9005,0,244,182,"Anderson",76978,446.880927018109,0.189704480457579,242.926550442984,96.1313622073839,674.218607913949,18.9704480457579
2021-08-20,9766,60,7047,42,2719,18,7889,44,70910,194,78799,238,0,182,27,546,33,9038,2,246,182,"Anderson",76978,441.684637169061,0.180616740088106,309.179246018343,77.9443477357167,709.293564395022,18.0616740088106
2021-08-21,9847,81,7080,33,2767,48,7923,34,71184,274,79107,308,0,182,60,606,21,9059,1,247,182,"Anderson",76978,481.955883499182,0.168979591836735,400.114318376679,105.224869443218,787.237912130739,16.8979591836735
2021-08-22,9870,23,7102,22,2768,1,7951,28,71340,156,79291,184,0,182,-2,604,25,9084,0,247,182,"Anderson",76978,481.955883499182,0.168582375478927,239.029333056198,29.8786666320247,784.639767206215,16.8582375478927
2021-08-23,9918,48,7116,14,2802,34,7968,17,71475,135,79443,152,0,182,-4,600,52,9136,2,249,183,"Anderson",76978,494.946608121801,0.158482142857143,197.459014263816,62.3554781885734,779.443477357167,15.8482142857143
2021-08-24,9962,44,7143,27,2819,17,7992,24,71561,86,79553,110,1,183,-23,577,66,9202,0,249,184,"Anderson",76978,496.245680584063,0.161119515885023,142.897970848814,57.1591883395256,749.564810725142,16.1119515885023
2021-08-25,10033,71,7169,26,2864,45,8014,22,71605,44,79619,66,0,183,14,591,57,9259,1,250,184,"Anderson",76978,520.92805736704,0.163855421686747,85.7387825092884,92.2341448205981,767.751825196809,16.3855421686747
2021-08-26,10101,68,7205,36,2896,32,8058,44,71777,172,79835,216,1,184,15,606,52,9311,2,252,185,"Anderson",76978,513.133622593468,0.167189952904239,280.59965184858,88.3369274338123,787.237912130739,16.7189952904239
2021-08-27,10176,75,7260,55,2916,20,8119,61,71954,177,80073,238,0,184,30,636,45,9356,0,252,185,"Anderson",76978,532.619709527397,0.180533751962323,309.179246018343,97.4304346696459,826.210085998597,18.0533751962323
2021-08-28,10235,59,7292,32,2943,27,8159,40,72158,204,80317,244,0,184,32,668,27,9383,0,252,185,"Anderson",76978,504.040115357635,0.19504132231405,316.973680791915,76.6452752734548,867.780404790979,19.504132231405
2021-08-29,10299,64,7341,49,2958,15,8213,54,72369,211,80582,265,0,184,39,707,25,9408,1,253,186,"Anderson",76978,557.302086310374,0.20294345468629,344.254202499415,83.1406375847645,918.444230819195,20.294345468629
2021-08-30,10370,71,7387,46,2983,25,8261,48,72595,226,80856,274,0,184,3,710,68,9476,3,256,186,"Anderson",76978,587.180752942399,0.207360226468507,355.945854659773,92.2341448205981,922.341448205981,20.7360226468507
2021-08-31,10504,134,7469,82,3035,52,8348,87,72852,257,81200,344,0,184,48,758,86,9562,0,256,186,"Anderson",76978,704.097274545974,0.216150576806314,446.880927018109,174.075709943101,984.696926394554,21.6150576806314
2021-09-01,10535,31,7491,22,3044,9,8372,24,72943,91,81315,115,0,184,-17,741,48,9610,0,256,187,"Anderson",76978,652.134376055496,0.211084905660377,149.393333160124,40.2712463301203,962.612694536101,21.1084905660377
2021-09-02,10594,59,7517,26,3077,33,8401,29,73043,100,81444,129,1,185,-10,731,68,9678,0,256,187,"Anderson",76978,640.442723895139,0.213175885643257,167.580347631791,76.6452752734548,949.621969913482,21.3175885643257
2021-09-03,10623,29,7535,18,3088,11,8419,18,73116,73,81535,91,0,185,-37,694,66,9744,0,256,187,"Anderson",76978,580.685390631089,0.205198358413133,118.215594065837,37.6731014055964,901.55628880979,20.5198358413133
2021-09-04,10730,107,7605,70,3125,37,8495,76,73437,321,81932,397,0,185,78,772,29,9773,1,257,187,"Anderson",76978,643.040868819663,0.208049535603715,515.731767517992,139.000753462028,1002.88394086622,20.8049535603715
2021-09-05,10842,112,7679,74,3163,38,8571,76,73741,304,82312,380,0,185,76,848,36,9809,1,258,188,"Anderson",76978,705.396347008236,0.206936416184971,493.647535659539,145.496115773338,1101.61344799813,20.6936416184971
2021-09-06,10957,115,7756,77,3201,38,8658,87,74148,407,82806,494,0,185,-1,847,116,9925,3,261,189,"Anderson",76978,762.555535347762,0.203589743589744,641.741796357401,149.393333160124,1100.31437553587,20.3589743589744
2021-09-07,10994,37,7776,20,3218,17,8676,18,74247,99,82923,117,0,185,-74,773,111,10036,0,261,189,"Anderson",76978,636.545506508353,0.190365641323273,151.991478084648,48.065681103692,1004.18301332848,19.0365641323273
2021-09-08,11035,41,7807,31,3228,10,8708,32,74354,107,83062,139,0,185,-60,713,101,10137,2,263,192,"Anderson",76978,649.536231130973,0.192329708070979,180.57107225441,53.2619709527397,926.238665592767,19.2329708070979
2021-09-09,11093,58,7828,21,3265,37,8726,18,74560,206,83286,224,0,185,-39,674,97,10234,1,264,194,"Anderson",76978,648.237158668711,0.176438653637351,290.992231546676,75.3462028111928,875.574839564551,17.6438653637351
2021-09-10,11245,152,7901,73,3344,79,8807,81,74853,293,83660,374,1,186,64,738,87,10321,2,266,195,"Anderson",76978,808.02307152693,0.182588235294118,485.853100885967,197.459014263816,958.715477149315,18.2588235294118
2021-09-11,11357,112,7964,63,3393,49,8876,69,75199,346,84075,415,0,186,79,817,33,10354,1,267,195,"Anderson",76978,814.51843383824,0.177788147456836,539.115071838707,145.496115773338,1061.34220166801,17.7788147456836
2021-09-12,11395,38,7996,32,3399,6,8911,35,75342,143,84253,178,0,186,5,822,33,10387,4,271,195,"Anderson",76978,718.387071630856,0.175167439464194,231.234898282626,49.3647535659539,1067.83756397932,17.5167439464194
2021-09-13,11483,88,8030,34,3453,54,8945,34,75472,130,84417,164,4,190,-48,774,132,10519,3,274,195,"Anderson",76978,683.312115149783,0.178150217256363,213.047883810959,114.318376679051,1005.48208579075,17.8150217256363
2021-09-14,11543,60,8060,30,3483,30,8980,35,75631,159,84611,194,1,191,-48,726,107,10626,1,275,195,"Anderson",76978,713.190781781808,0.180094786729858,252.020057678817,77.9443477357167,943.126607602172,18.0094786729858
2021-09-15,11583,40,8076,16,3507,24,8994,14,75692,61,84686,75,0,191,-41,685,81,10707,1,276,196,"Anderson",76978,711.891709319546,0.176108374384236,97.4304346696459,51.9628984904778,889.864636649432,17.6108374384236
2021-09-16,11670,87,8130,54,3540,33,9050,56,75914,222,84964,278,0,191,27,712,60,10767,1,277,196,"Anderson",76978,749.564810725142,0.193087008343266,361.142144508821,113.019304216789,924.939593130505,19.3087008343266
2021-09-17,11743,73,8172,42,3571,31,9087,37,76077,163,85164,200,0,191,15,727,58,10825,1,278,200,"Anderson",76978,646.938086206449,0.186170212765957,259.814492452389,94.832289745122,944.425680064434,18.6170212765957
2021-09-18,11795,52,8202,30,3593,22,9120,33,76231,154,85351,187,0,191,7,734,45,10870,1,279,201,"Anderson",76978,568.993738470732,0.191222570532915,242.926550442984,67.5517680376211,953.519187300268,19.1222570532915
2021-09-19,11818,23,8211,9,3607,14,9130,10,76299,68,85429,78,0,191,-15,719,38,10908,0,279,201,"Anderson",76978,549.507651536803,0.186224489795918,101.327652056432,29.8786666320247,934.033100366338,18.6224489795918
2021-09-20,11881,63,8246,35,3635,28,9166,36,76485,186,85651,222,0,191,26,745,37,10945,3,282,201,"Anderson",76978,517.030839980254,0.179092382495948,288.394086622152,81.8415651225025,967.808984385149,17.9092382495948
2021-09-21,11935,54,8272,26,3663,28,9190,24,76603,118,85793,142,0,191,-56,689,110,11055,1,283,202,"Anderson",76978,509.236405206682,0.177664974619289,184.468289641196,70.149912962145,895.06092649848,17.7664974619289
2021-09-22,11986,51,8306,34,3680,17,9230,40,76875,272,86105,312,0,191,-39,650,90,11145,0,283,203,"Anderson",76978,523.526202291564,0.16631430584919,405.310608225727,66.2526955753592,844.397100470264,16.631430584919
2021-09-23,12061,75,8354,48,3707,27,9281,51,77083,208,86364,259,2,193,-12,638,85,11230,1,284,203,"Anderson",76978,507.93733274442,0.165,336.459767725844,97.4304346696459,828.808230923121,16.5
2021-09-24,12102,41,8376,22,3726,19,9306,25,77223,140,86529,165,2,195,-17,621,56,11286,1,285,205,"Anderson",76978,466.367013952038,0.16043956043956,214.346956273221,53.2619709527397,806.723999064668,16.043956043956
2021-09-25,12112,10,8380,4,3732,6,9312,6,77318,95,86630,101,0,195,-33,588,43,11329,0,285,205,"Anderson",76978,411.805970537037,0.150117279124316,131.206318688456,12.9907246226195,763.854607810024,15.0117279124316
2021-09-26,12130,18,8395,15,3735,3,9330,18,77455,137,86785,155,1,196,-11,577,28,11357,0,285,205,"Anderson",76978,405.310608225727,0.147492625368732,201.356231650601,23.383304320715,749.564810725142,14.7492625368732
2021-09-27,12180,50,8416,21,3764,29,9352,22,77541,86,86893,108,1,197,-46,531,95,11452,1,286,206,"Anderson",76978,388.422666216322,0.14975845410628,140.29982592429,64.9536231130973,689.807477461093,14.975845410628
2021-09-28,12229,49,8440,24,3789,25,9379,27,77636,95,87015,122,0,197,-27,504,76,11528,1,287,206,"Anderson",76978,381.927303905012,0.154664484451718,158.486840395957,63.6545506508353,654.73252098002,15.4664484451718
2021-09-29,12265,36,8456,16,3809,20,9396,17,77827,191,87223,208,2,199,-35,469,69,11597,0,287,208,"Anderson",76978,362.441216971083,0.148479427549195,270.207072150485,46.76660864143,609.264984800852,14.8479427549195
2021-09-30,12327,62,8494,38,3833,24,9436,40,77999,172,87435,212,0,199,2,471,60,11657,1,288,209,"Anderson",76978,345.553274961677,0.144724556489262,275.403361999532,80.5424926602406,611.863129725376,14.4724556489262
2021-10-01,12378,51,8521,27,3857,24,9465,29,78150,151,87615,180,0,199,-12,459,63,11720,1,289,210,"Anderson",76978,358.543999584297,0.146408839779006,233.83304320715,66.2526955753592,596.274260178233,14.6408839779006
2021-10-02,12395,17,8528,7,3867,10,9471,6,78230,80,87701,86,1,200,-10,449,26,11746,0,289,210,"Anderson",76978,367.63750682013,0.148459383753501,111.720231754527,22.0842318584531,583.283535555613,14.8459383753501
2021-10-03,12408,13,8537,9,3871,4,9480,9,78328,98,87808,107,4,204,-10,439,19,11765,0,289,210,"Anderson",76978,361.142144508821,0.146627565982405,139.000753462028,16.8879420094053,570.292810932994,14.6627565982405
2021-10-04,12452,44,8560,23,3892,21,9506,26,78448,120,87954,146,1,205,-23,416,66,11831,0,289,212,"Anderson",76978,353.347709735249,0.145146088595664,189.664579490244,57.1591883395256,540.414144300969,14.5146088595664
2021-10-05,12505,53,8589,29,3916,24,9536,30,78576,128,88112,158,2,207,-15,401,66,11897,0,289,213,"Anderson",76978,358.543999584297,0.143117593436645,205.253449037387,68.8508404998831,520.92805736704,14.3117593436645
2021-10-06,12535,30,8612,23,3923,7,9562,26,78741,165,88303,191,1,208,-6,395,35,11932,0,289,214,"Anderson",76978,350.749564810725,0.153703703703704,248.122840292031,38.9721738678584,513.133622593468,15.3703703703704
2021-10-07,12567,32,8634,22,3933,10,9587,25,78881,140,88468,165,0,208,-9,386,41,11973,0,289,216,"Anderson",76978,311.777390942867,0.146176185866409,214.346956273221,41.5703187923822,501.441970433111,14.6176185866409
2021-10-08,12584,17,8639,5,3945,12,9597,10,79011,130,88608,140,1,209,-14,372,30,12003,1,290,216,"Anderson",76978,267.608927225961,0.132930513595166,181.870144716672,22.0842318584531,483.254955961443,13.2930513595166
2021-10-09,12599,15,8642,3,3957,12,9604,7,79073,62,88677,69,0,209,-11,361,26,12029,0,290,217,"Anderson",76978,265.010782301437,0.136270491803279,89.6359998960742,19.4860869339292,468.965158876562,13.6270491803279
2021-10-10,12609,10,8650,8,3959,2,9613,9,79160,87,88773,96,0,209,-16,345,26,12055,0,290,217,"Anderson",76978,261.113564914651,0.137823834196891,124.710956377147,12.9907246226195,448.179999480371,13.7823834196891
2021-10-11,12650,41,8664,14,3986,27,9626,13,79261,101,88887,114,0,209,-11,334,52,12107,1,291,217,"Anderson",76978,257.216347527865,0.128617363344051,148.094260697862,53.2619709527397,433.89020239549,12.8617363344051
2021-10-12,12685,35,8688,24,3997,11,9648,22,79360,99,89008,121,2,211,-9,325,42,12149,3,294,217,"Anderson",76978,233.83304320715,0.125,157.187767933695,45.4675361791681,422.198550235132,12.5
2021-10-13,12711,26,8702,14,4009,12,9666,18,79472,112,89138,130,0,211,-16,309,42,12191,1,295,219,"Anderson",76978,228.636753358102,0.124550898203593,168.879420094053,33.7758840188106,401.413390838941,12.4550898203593
2021-10-14,12730,19,8712,10,4018,9,9680,14,79575,103,89255,117,1,212,-23,286,41,12232,0,295,219,"Anderson",76978,211.748811348697,0.118170266836086,151.991478084648,24.682376782977,371.534724206916,11.8170266836086
2021-10-15,12753,23,8724,12,4029,11,9693,13,79697,122,89390,135,0,212,-14,272,37,12269,1,296,219,"Anderson",76978,219.543246122269,0.122762148337596,175.374782405363,29.8786666320247,353.347709735249,12.2762148337596
2021-10-16,12761,8,8729,5,4032,3,9700,7,79752,55,89452,62,0,212,-14,258,22,12291,1,297,219,"Anderson",76978,210.449738886435,0.123870967741935,80.5424926602406,10.3925796980956,335.160695263582,12.3870967741935
2021-10-17,12763,2,8730,1,4033,1,9701,1,79803,51,89504,52,0,212,-9,249,11,12302,0,297,219,"Anderson",76978,200.05715918834,0.120383036935705,67.5517680376211,2.59814492452389,323.469043103224,12.0383036935705
2021-10-18,12787,24,8740,10,4047,14,9712,11,79871,68,89583,79,1,213,-28,221,51,12353,1,298,219,"Anderson",76978,177.972927329886,0.123563218390805,102.626724518694,31.1777390942867,287.09501415989,12.3563218390805
2021-10-19,12816,29,8753,13,4063,16,9723,11,79982,111,89705,122,2,215,-17,204,44,12397,0,298,219,"Anderson",76978,170.178492556315,0.107604017216643,158.486840395957,37.6731014055964,265.010782301437,10.7604017216643
2021-10-20,12850,34,8778,25,4072,9,9752,29,80093,111,89845,140,0,215,11,215,23,12420,1,299,219,"Anderson",76978,180.57107225441,0.121640735502122,181.870144716672,44.1684637169061,279.300579386318,12.1640735502122
2021-10-21,12882,32,8796,18,4086,14,9770,18,80186,93,89956,111,0,215,10,225,22,12442,1,300,220,"Anderson",76978,197.459014263816,0.128388017118402,144.197043311076,41.5703187923822,292.291304008938,12.8388017118402
2021-10-22,12891,9,8802,6,4089,3,9778,8,80262,76,90040,84,0,215,-24,201,33,12475,1,301,220,"Anderson",76978,179.271999792148,0.130769230769231,109.122086830003,11.6916521603575,261.113564914651,13.0769230769231
2021-10-23,12908,17,8806,4,4102,13,9782,4,80315,53,90097,57,0,215,3,204,14,12489,1,302,220,"Anderson",76978,190.963651952506,0.127131782945736,74.0471303489309,22.0842318584531,265.010782301437,12.7131782945736
2021-10-24,12914,6,8811,5,4103,1,9789,7,80367,52,90156,59,0,215,-11,193,17,12506,0,302,220,"Anderson",76978,196.159941801554,0.134969325153374,76.6452752734548,7.79443477357167,250.720985216555,13.4969325153374
2021-10-25,12938,24,8824,13,4114,11,9803,14,80438,71,90241,85,1,216,-9,184,32,12538,2,304,220,"Anderson",76978,196.159941801554,0.138297872340426,110.421159292265,31.1777390942867,239.029333056198,13.8297872340426
2021-10-26,12950,12,8830,6,4120,6,9809,6,80502,64,90311,70,0,216,-8,176,20,12558,0,304,221,"Anderson",76978,174.075709943101,0.141914191419142,90.9350723583361,15.5888695471433,228.636753358102,14.1914191419142
2021-10-27,12968,18,8840,10,4128,8,9822,13,80623,121,90445,134,1,217,-5,171,22,12580,2,306,222,"Anderson",76978,153.29055054691,0.116666666666667,174.075709943101,23.383304320715,222.141391046793,11.6666666666667
2021-10-28,12990,22,8854,14,4136,8,9839,17,80705,82,90544,99,1,218,6,177,15,12595,0,306,223,"Anderson",76978,140.29982592429,0.11734693877551,128.608173763933,28.5795941697628,229.935825820364,11.734693877551
2021-10-29,13011,21,8865,11,4146,10,9851,12,80819,114,90670,126,0,218,7,184,14,12609,1,307,223,"Anderson",76978,155.888695471433,0.115873015873016,163.683130245005,27.2805217075008,239.029333056198,11.5873015873016
2021-10-30,13023,12,8869,4,4154,8,9856,5,80906,87,90762,92,0,218,0,184,12,12621,1,308,223,"Anderson",76978,149.393333160124,0.111278195488722,119.514666528099,15.5888695471433,239.029333056198,11.1278195488722
2021-10-31,13026,3,8871,2,4155,1,9859,3,80945,39,90804,42,0,218,-8,176,11,12632,0,308,223,"Anderson",76978,145.496115773338,0.108024691358025,54.5610434150017,3.89721738678583,228.636753358102,10.8024691358025
2021-11-01,13053,27,8875,4,4178,23,9863,4,81033,88,90896,92,1,219,-14,162,40,12672,1,309,224,"Anderson",76978,149.393333160124,0.0916030534351145,119.514666528099,35.0749564810725,210.449738886435,9.16030534351145
2021-11-02,13073,20,8880,5,4193,15,9868,5,81109,76,90977,81,2,221,-6,156,24,12696,1,310,224,"Anderson",76978,159.785912858219,0.0885885885885886,105.224869443218,25.9814492452389,202.655304112863,8.85885885885886
2021-11-03,13102,29,8897,17,4205,12,9885,17,81309,200,91194,217,1,222,10,166,18,12714,0,310,224,"Anderson",76978,174.075709943101,0.0841121495327103,281.898724310842,37.6731014055964,215.646028735483,8.41121495327103
2021-11-04,13124,22,8912,15,4212,7,9901,16,81442,133,91343,149,0,222,5,171,17,12731,0,310,224,"Anderson",76978,174.075709943101,0.0775969962453066,193.56179687703,28.5795941697628,222.141391046793,7.75969962453066
2021-11-05,13134,10,8915,3,4219,7,9902,1,81564,122,91466,123,0,222,3,174,7,12738,0,310,224,"Anderson",76978,159.785912858219,0.064070351758794,159.785912858219,12.9907246226195,226.038608433578,6.4070351758794
2021-11-06,13143,9,8919,4,4224,5,9907,5,81651,87,91558,92,0,222,-3,171,12,12750,3,313,225,"Anderson",76978,155.888695471433,0.064070351758794,119.514666528099,11.6916521603575,222.141391046793,6.4070351758794
2021-11-07,13149,6,8924,5,4225,1,9913,6,81699,48,91612,54,0,222,-3,168,9,12759,0,313,225,"Anderson",76978,159.785912858219,0.0668316831683168,70.149912962145,7.79443477357167,218.244173660007,6.68316831683168
2021-11-08,13174,25,8935,11,4239,14,9926,13,81787,88,91713,101,1,223,-1,167,25,12784,0,313,225,"Anderson",76978,157.187767933695,0.0771113831089351,131.206318688456,32.4768115565486,216.945101197745,7.71113831089351
2021-11-09,13197,23,8942,7,4255,16,9932,6,81945,158,91877,164,1,224,6,173,16,12800,0,313,226,"Anderson",76978,161.084985320481,0.0711111111111111,213.047883810959,29.8786666320247,224.739535971316,7.11111111111111
2021-11-10,13216,19,8954,12,4262,7,9945,13,82061,116,92006,129,0,224,5,178,14,12814,1,314,228,"Anderson",76978,148.094260697862,0.0738916256157636,167.580347631791,24.682376782977,231.234898282626,7.38916256157635
2021-11-11,13238,22,8971,17,4267,5,9962,17,82251,190,92213,207,0,224,1,179,21,12835,0,314,229,"Anderson",76978,148.094260697862,0.0701149425287356,268.907999688223,28.5795941697628,232.533970744888,7.01149425287356
2021-11-12,13251,13,8979,8,4272,5,9970,8,82384,133,92354,141,0,224,0,179,13,12848,0,314,229,"Anderson",76978,151.991478084648,0.0765765765765766,183.169217178934,16.8879420094053,232.533970744888,7.65765765765766
2021-11-13,13258,7,8983,4,4275,3,9974,4,82435,51,92409,55,3,227,-14,165,18,12866,1,315,230,"Anderson",76978,149.393333160124,0.0787309048178613,71.448985424407,9.09350723583361,214.346956273221,7.87309048178613
2021-11-14,13260,2,8985,2,4275,0,9977,3,82514,79,92491,82,0,227,-5,160,7,12873,0,315,230,"Anderson",76978,144.197043311076,0.0728100113765643,106.523941905479,2.59814492452389,207.851593961911,7.28100113765643
2021-11-15,13292,32,8998,13,4294,19,9991,14,82599,85,92590,99,0,227,6,166,26,12899,0,315,230,"Anderson",76978,153.29055054691,0.0741163055872292,128.608173763933,41.5703187923822,215.646028735483,7.41163055872292
2021-11-16,13317,25,9011,13,4306,12,10004,13,82725,126,92729,139,1,228,-2,164,26,12925,0,315,231,"Anderson",76978,155.888695471433,0.0845070422535211,180.57107225441,32.4768115565486,213.047883810959,8.45070422535211
2021-11-17,13334,17,9020,9,4314,8,10013,9,82839,114,92852,123,0,228,-1,163,18,12943,2,317,233,"Anderson",76978,153.29055054691,0.0803782505910166,159.785912858219,22.0842318584531,211.748811348697,8.03782505910165
2021-11-18,13357,23,9034,14,4323,9,10031,18,82974,135,93005,153,4,232,4,167,15,12958,0,317,234,"Anderson",76978,154.589623009171,0.0871212121212121,198.758086726078,29.8786666320247,216.945101197745,8.71212121212121
2021-11-19,13371,14,9039,5,4332,9,10038,7,83083,109,93121,116,1,233,2,169,11,12969,0,317,234,"Anderson",76978,155.888695471433,0.0886571056062582,150.692405622386,18.1870144716672,219.543246122269,8.86571056062582
2021-11-20,13380,9,9044,5,4336,4,10043,5,83176,93,93219,98,0,233,-9,160,18,12987,0,317,235,"Anderson",76978,158.486840395957,0.0851851851851852,127.309101301671,11.6916521603575,207.851593961911,8.51851851851852
2021-11-21,13392,12,9050,6,4342,6,10049,6,83216,40,93265,46,0,233,4,164,8,12995,0,317,235,"Anderson",76978,171.477565018577,0.0930232558139535,59.7573332640495,15.5888695471433,213.047883810959,9.30232558139535
2021-11-22,13420,28,9067,17,4353,11,10067,18,83338,122,93405,140,1,234,5,169,22,13017,0,317,235,"Anderson",76978,166.281275169529,0.0932515337423313,181.870144716672,36.3740289433345,219.543246122269,9.32515337423313
2021-11-23,13437,17,9072,5,4365,12,10072,5,83435,97,93507,102,0,234,-4,165,21,13038,0,317,235,"Anderson",76978,155.888695471433,0.0874035989717224,132.505391150718,22.0842318584531,214.346956273221,8.74035989717224
2021-11-24,13462,25,9086,14,4376,11,10084,12,83545,110,93629,122,1,235,7,172,17,13055,0,317,235,"Anderson",76978,166.281275169529,0.0913770913770914,158.486840395957,32.4768115565486,223.440463509055,9.13770913770914
2021-11-25,13467,5,9088,2,4379,3,10085,1,83590,45,93675,46,0,235,-12,160,17,13072,1,318,235,"Anderson",76978,142.897970848814,0.0805970149253731,59.7573332640495,6.49536231130973,207.851593961911,8.05970149253731
2021-11-26,13474,7,9094,6,4380,1,10094,9,83633,43,93727,52,0,235,-7,153,14,13086,0,318,236,"Anderson",76978,133.80446361298,0.0924092409240924,67.5517680376211,9.09350723583361,198.758086726078,9.24092409240924
2021-11-27,13479,5,9096,2,4383,3,10096,2,83669,36,93765,38,0,235,-7,146,12,13098,0,318,236,"Anderson",76978,128.608173763933,0.0970695970695971,49.3647535659539,6.49536231130973,189.664579490244,9.70695970695971
2021-11-28,13489,10,9097,1,4392,9,10097,1,83707,38,93804,39,0,235,-11,135,21,13119,0,318,236,"Anderson",76978,126.010028839409,0.0890538033395176,50.6638260282159,12.9907246226195,175.374782405363,8.90538033395176
2021-11-29,13516,27,9112,15,4404,12,10113,16,83786,79,93899,95,0,235,14,149,13,13132,0,318,236,"Anderson",76978,124.710956377147,0.0931174089068826,123.411883914885,35.0749564810725,193.56179687703,9.31174089068826
2021-11-30,13543,27,9125,13,4418,14,10125,12,83888,102,94013,114,0,235,15,164,12,13144,1,319,236,"Anderson",76978,137.701680999766,0.104743083003953,148.094260697862,35.0749564810725,213.047883810959,10.4743083003953
2021-12-01,13574,31,9143,18,4431,13,10143,18,83995,107,94138,125,0,235,16,180,15,13159,0,319,236,"Anderson",76978,145.496115773338,0.115913555992141,162.384057782743,40.2712463301203,233.83304320715,11.5913555992141
2021-12-02,13616,42,9167,24,4449,18,10169,26,84133,138,94302,164,0,235,26,206,16,13175,0,319,238,"Anderson",76978,193.56179687703,0.133971291866029,213.047883810959,54.5610434150017,267.608927225961,13.3971291866029
2021-12-03,13647,31,9184,17,4463,14,10188,19,84320,187,94508,206,1,236,17,223,13,13188,0,319,238,"Anderson",76978,224.739535971316,0.120358514724712,267.608927225961,40.2712463301203,289.693159084414,12.0358514724712
2021-12-04,13667,20,9197,13,4470,7,10202,14,84389,69,94591,83,0,236,14,237,6,13194,0,319,238,"Anderson",76978,244.225622905246,0.128329297820823,107.823014367741,25.9814492452389,307.880173556081,12.8329297820823
2021-12-05,13680,13,9199,2,4481,11,10204,2,84431,42,94635,44,0,236,4,241,9,13203,0,319,238,"Anderson",76978,248.122840292031,0.128760529482551,57.1591883395256,16.8879420094053,313.076463405129,12.8760529482551
2021-12-06,13715,35,9219,20,4496,15,10227,23,84533,102,94760,125,2,238,9,250,24,13227,0,319,238,"Anderson",76978,258.515419990127,0.132404181184669,162.384057782743,45.4675361791681,324.768115565486,13.2404181184669
2021-12-07,13746,31,9235,16,4511,15,10244,17,84628,95,94872,112,0,238,9,259,22,13249,0,319,238,"Anderson",76978,263.711709839175,0.138533178114086,145.496115773338,40.2712463301203,336.459767725844,13.8533178114086
2020-03-12,1,1,1,1,0,0,1,1,11,11,12,12,NA,NA,NA,NA,0,0,0,0,0,"East TN",2455501,NA,NA,0.488698640318208,0.040724886693184,NA,NA
2020-03-13,1,0,1,0,0,0,1,0,23,12,24,12,NA,NA,NA,NA,0,0,0,0,0,"East TN",2455501,NA,NA,0.488698640318208,0,NA,NA
2020-03-14,3,2,3,2,0,0,3,2,51,28,54,30,NA,NA,NA,NA,0,0,0,0,0,"East TN",2455501,NA,NA,1.22174660079552,0.081449773386368,NA,NA
2020-03-15,3,0,3,0,0,0,3,0,54,3,57,3,NA,NA,NA,NA,0,0,0,0,0,"East TN",2455501,NA,NA,0.122174660079552,0,NA,NA
2020-03-16,5,2,5,2,0,0,5,2,90,36,95,38,NA,NA,NA,NA,0,0,0,0,0,"East TN",2455501,NA,NA,1.54754569434099,0.081449773386368,NA,NA
2020-03-17,6,1,6,1,0,0,5,0,131,41,136,41,NA,NA,NA,NA,0,0,0,0,0,"East TN",2455501,NA,NA,1.66972035442054,0.040724886693184,NA,NA
2020-03-18,8,2,8,2,0,0,7,2,172,41,179,43,NA,NA,NA,NA,0,0,0,0,0,"East TN",2455501,0.325799093545472,0.0391061452513966,1.75117012780691,0.081449773386368,NA,3.91061452513966
2020-03-19,11,3,11,3,0,0,11,4,239,67,250,71,NA,NA,NA,NA,0,0,0,0,0,"East TN",2455501,0.40724886693184,0.0420168067226891,2.89146695521606,0.122174660079552,NA,4.20168067226891
2020-03-20,29,18,29,18,0,0,27,16,383,144,410,160,NA,NA,NA,NA,3,3,2,2,0,"East TN",2455501,1.14029682740915,0.0673575129533679,6.51598187090944,0.733047960477312,NA,6.73575129533679
2020-03-21,38,9,38,9,0,0,38,11,611,228,649,239,NA,NA,NA,NA,3,6,1,3,1,"East TN",2455501,1.42537103426144,0.0588235294117647,9.73324791967098,0.366523980238656,NA,5.88235294117647
2020-03-22,48,10,47,9,1,1,43,5,714,103,757,108,NA,NA,NA,NA,2,8,4,7,2,"East TN",2455501,1.83261990119328,0.0571428571428571,4.39828776286387,0.40724886693184,NA,5.71428571428571
2020-03-23,64,16,63,16,1,0,56,13,847,133,903,146,NA,NA,NA,NA,7,15,4,11,2,"East TN",2455501,2.40276831489786,0.0631188118811881,5.94583345720486,0.651598187090944,NA,6.31188118811881
2020-03-24,83,19,82,19,1,0,70,14,988,141,1058,155,NA,NA,NA,NA,7,22,5,16,2,"East TN",2455501,3.13581627537517,0.0704989154013015,6.31235743744352,0.773772847170496,NA,7.04989154013015
2020-03-25,116,33,115,33,1,0,99,29,1289,301,1388,330,NA,NA,NA,NA,15,37,12,28,3,"East TN",2455501,4.39828776286387,0.076095947063689,13.4392126087507,1.34392126087507,NA,7.6095947063689
2020-03-26,144,28,143,28,1,0,130,31,1775,486,1905,517,NA,NA,NA,NA,15,52,5,33,4,"East TN",2455501,5.41640993019347,0.0719033232628399,21.0547664203761,1.14029682740915,NA,7.19033232628399
2020-03-27,166,22,165,22,1,0,147,17,2172,397,2319,414,NA,NA,NA,NA,17,69,6,39,4,"East TN",2455501,5.57930947696621,0.0628601361969618,16.8601030909782,0.895947507250048,NA,6.28601361969618
2020-03-28,197,31,196,31,1,0,180,33,2609,437,2789,470,NA,NA,NA,NA,12,81,8,47,4,"East TN",2455501,6.47525698421626,0.0663551401869159,19.1406967457965,1.2624714874887,NA,6.63551401869159
2020-03-29,213,16,212,16,1,0,196,16,2796,187,2992,203,NA,NA,NA,NA,27,108,3,50,7,"East TN",2455501,6.71960630437536,0.0684563758389262,8.26715199871635,0.651598187090944,NA,6.84563758389262
2020-03-30,246,33,245,33,1,0,226,30,3346,550,3572,580,NA,NA,NA,NA,33,141,8,58,9,"East TN",2455501,7.41192937815949,0.0636942675159236,23.6204342820467,1.34392126087507,NA,6.36942675159236
2020-03-31,295,49,294,49,1,0,278,52,3646,300,3924,352,NA,NA,NA,NA,39,180,12,70,10,"East TN",2455501,8.63367597895501,0.0725750174459177,14.3351601160008,1.99551944796602,NA,7.25750174459177
2020-04-01,346,51,345,51,1,0,336,58,4244,598,4580,656,NA,NA,NA,NA,36,216,9,79,12,"East TN",2455501,9.36672393943232,0.0742481203007519,26.7155256707287,2.07696922135238,NA,7.42481203007519
2020-04-02,391,45,390,45,1,0,383,47,4840,596,5223,643,2,7,NA,134,34,250,5,84,14,"East TN",2455501,10.0590470132164,0.0762507534659433,26.1861021437173,1.83261990119328,5.45713481688666,7.62507534659433
2020-04-03,412,21,411,21,1,0,401,18,5125,285,5526,303,1,8,-13,121,33,283,2,86,17,"East TN",2455501,10.0183221265233,0.0792017461802308,12.3396406680348,0.855222620556864,4.92771128987526,7.92017461802307
2020-04-04,447,35,446,35,1,0,431,30,5717,592,6148,622,3,11,0,121,32,315,5,91,19,"East TN",2455501,10.181221673296,0.0747246204227449,25.3308795231604,1.42537103426144,4.92771128987526,7.47246204227449
2020-04-05,473,26,472,26,1,0,464,33,6094,377,6558,410,-1,10,1,122,26,341,2,93,20,"East TN",2455501,10.5884705402278,0.0751542344363432,16.6972035442054,1.05884705402278,4.96843617656845,7.51542344363432
2020-04-06,514,41,513,41,1,0,514,50,6627,533,7141,583,8,18,0,122,33,374,5,98,20,"East TN",2455501,10.9142696337733,0.080694872513309,23.7426089421263,1.66972035442054,4.96843617656845,8.06948725133091
2020-04-07,570,56,569,56,1,0,592,78,7756,1129,8348,1207,0,18,19,141,37,411,7,105,21,"East TN",2455501,11.1993438406256,0.0709764918625678,49.1549382386731,2.2805936548183,5.74220902373894,7.09764918625678
2020-04-08,607,37,606,37,1,0,632,40,8163,407,8795,447,1,19,4,145,32,443,8,113,25,"East TN",2455501,10.629195426921,0.0702253855278766,18.2040243518532,1.50682080764781,5.90510857051168,7.02253855278766
2020-04-09,633,26,632,26,1,0,662,30,8614,451,9276,481,3,22,3,148,20,463,2,115,25,"East TN",2455501,9.85542257975053,0.0688378978534419,19.5886704994215,1.05884705402278,6.02728323059123,6.88378978534419
2020-04-10,655,22,654,22,1,0,682,20,8942,328,9624,348,0,22,-7,141,29,492,4,119,25,"East TN",2455501,9.89614746644371,0.0685700341630063,14.172260569228,0.895947507250048,5.74220902373894,6.85700341630063
2020-04-11,679,24,678,24,1,0,728,46,10023,1081,10751,1127,2,24,-5,136,27,519,5,124,27,"East TN",2455501,9.44817371281869,0.0645231370845101,45.8969473032184,0.977397280636416,5.53858459027302,6.45231370845101
2020-04-12,709,30,708,30,1,0,761,33,11473,1450,12234,1483,0,24,18,154,12,531,1,125,28,"East TN",2455501,9.61107325959142,0.0523255813953488,60.3950069659919,1.22174660079552,6.27163255075034,5.23255813953488
2020-04-13,738,29,737,29,1,0,803,42,12436,963,13239,1005,0,24,-2,152,31,562,7,132,32,"East TN",2455501,9.12237461927321,0.0473925877336832,40.9285111266499,1.18102171410234,6.19018277736397,4.73925877336832
2020-04-14,749,11,748,11,1,0,823,20,12721,285,13544,305,4,28,-17,135,24,586,1,133,33,"East TN",2455501,7.28975471807994,0.0444572748267898,12.4210904414211,0.447973753625024,5.49785970357984,4.44572748267898
2020-04-15,773,24,772,24,1,0,850,27,13133,412,13983,439,2,30,-6,129,28,614,4,137,34,"East TN",2455501,6.76033119106854,0.0420200462606014,17.8782252583078,0.977397280636416,5.25351038342074,4.20200462606014
2020-04-16,801,28,800,28,1,0,886,36,13810,677,14696,713,1,31,1,130,26,640,6,143,34,"East TN",2455501,6.84178096445491,0.0413284132841328,29.0368442122402,1.14029682740915,5.29423527011392,4.13284132841328
2020-04-17,823,22,821,21,2,1,916,30,14139,329,15055,359,0,31,-1,129,23,663,3,146,35,"East TN",2455501,6.84178096445491,0.0430859878475419,14.6202343228531,0.895947507250048,5.25351038342074,4.30859878475419
2020-04-18,835,12,833,12,2,0,935,19,14920,781,15855,800,0,31,-11,118,23,686,0,146,35,"East TN",2455501,6.3530823241367,0.0405564263322884,32.5799093545472,0.488698640318208,4.80553662979571,4.05564263322884
2020-04-19,914,79,912,79,2,0,1016,81,15607,687,16623,768,1,32,66,184,12,698,1,147,35,"East TN",2455501,8.34860177210272,0.0580997949419002,31.2767129803653,3.21726604876154,7.49337915154586,5.80997949419002
2020-04-20,939,25,931,19,8,6,1033,17,16570,963,17603,980,0,32,10,194,15,713,2,149,35,"East TN",2455501,8.18570222532998,0.0527039413382218,39.9103889593203,1.0181221673296,7.9006280184777,5.27039413382218
2020-04-21,1045,106,1037,106,8,0,1154,121,19276,2706,20430,2827,0,32,83,277,23,736,6,155,36,"East TN",2455501,12.0545664611825,0.0480685448736567,115.129254681631,4.3168379894775,11.280793614012,4.80685448736567
2020-04-22,1247,202,1237,200,10,2,1354,200,21828,2552,23182,2752,2,34,177,454,23,759,2,157,36,"East TN",2455501,19.3035962925692,0.054788563974345,112.074888179642,8.22642711202317,18.4890985587055,5.4788563974345
2020-04-23,1492,245,1480,243,12,2,1601,247,22935,1107,24536,1354,0,34,236,690,9,768,3,160,36,"East TN",2455501,28.1408967049901,0.0726626016260163,55.1414965825711,9.97759723983008,28.100171818297,7.26626016260163
2020-04-24,1540,48,1527,47,13,1,1655,54,25624,2689,27279,2743,0,34,22,712,26,794,4,164,36,"East TN",2455501,29.1997437590129,0.0604548429319372,111.708364199404,1.95479456127283,28.996119325547,6.04548429319372
2020-04-25,1563,23,1546,19,17,4,1674,19,26399,775,28073,794,0,34,10,722,13,807,3,167,37,"East TN",2455501,29.6477175126379,0.0604845310198068,32.3355600343881,0.936672393943232,29.4033681924788,6.04845310198068
2020-04-26,1583,20,1565,19,18,1,1700,26,27517,1118,29217,1144,0,34,-1,721,21,828,0,167,38,"East TN",2455501,27.2449491977401,0.0543115769414007,46.5892703770025,0.81449773386368,29.3626433057857,5.43115769414007
2020-04-27,1652,69,1633,68,19,1,1772,72,28432,915,30204,987,0,34,50,771,19,847,8,175,39,"East TN",2455501,29.0368442122402,0.058646139195302,40.1954631661726,2.8100171818297,31.3988876404449,5.8646139195302
2020-04-28,1689,37,1667,34,22,3,1812,40,30606,2174,32418,2214,2,36,19,790,16,863,1,176,40,"East TN",2455501,26.2268270304105,0.0548882215548882,90.1648991387094,1.50682080764781,32.1726604876154,5.48882215548882
2020-04-29,1752,63,1729,62,23,1,1878,66,33355,2749,35233,2815,1,37,39,829,23,886,6,182,41,"East TN",2455501,20.5660677800579,0.0434818687245872,114.640556041313,2.56566786167059,33.7609310686495,4.34818687245872
2020-04-30,1774,22,1750,21,24,1,1900,22,33904,549,35804,571,0,37,-1,828,23,909,1,183,41,"East TN",2455501,11.4844180474779,0.0265353212637558,23.2539103018081,0.895947507250048,33.7202061819563,2.65353212637558
2020-05-01,1814,40,1786,36,28,4,1929,29,35566,1662,37495,1691,0,37,-16,812,56,965,0,183,41,"East TN",2455501,11.1586189539324,0.0268206734534064,68.8657833981741,1.62899546772736,33.0686079948654,2.68206734534064
2020-05-02,1835,21,1807,21,28,0,1966,37,37443,1877,39409,1914,0,37,-107,705,128,1093,2,185,41,"East TN",2455501,11.077169180546,0.0257586450247001,77.9474331307542,0.855222620556864,28.7110451186947,2.57586450247001
2020-05-03,1873,38,1840,33,33,5,2003,37,39563,2120,41566,2157,0,37,-20,685,58,1151,3,188,43,"East TN",2455501,11.8102171410234,0.0245363997084784,87.8435805971979,1.54754569434099,27.896547384831,2.45363997084784
2020-05-04,1920,47,1884,44,36,3,2060,57,41509,1946,43569,2003,0,37,-312,373,359,1510,1,189,43,"East TN",2455501,10.9142696337733,0.0215488215488215,81.5719480464475,1.91406967457965,15.1903827365576,2.15488215488215
2020-05-05,1948,28,1911,27,37,1,2092,32,44419,2910,46511,2942,2,39,-45,328,71,1581,1,190,43,"East TN",2455501,10.5477456535347,0.0198680195841907,119.812616651347,1.14029682740915,13.3577628353644,1.98680195841907
2020-05-06,1985,37,1948,37,37,0,2135,43,45463,1044,47598,1087,1,40,7,335,29,1610,0,190,43,"East TN",2455501,9.48889859951187,0.0207844723008492,44.267951835491,1.50682080764781,13.6428370422166,2.07844723008492
2020-05-07,2028,43,1989,41,39,2,2183,48,46854,1391,49037,1439,0,40,19,354,24,1634,4,194,47,"East TN",2455501,10.3441212200687,0.0213859291166024,58.6031119514918,1.75117012780691,14.4166098893871,2.13859291166024
2020-05-08,2047,19,2008,19,39,0,2219,36,48524,1670,50743,1706,1,41,-15,339,33,1667,0,194,48,"East TN",2455501,9.48889859951187,0.0218900966183575,69.4766566985719,0.773772847170496,13.8057365889894,2.18900966183575
2020-05-09,2063,16,2022,14,41,2,2237,18,51343,2819,53580,2837,0,41,-33,306,49,1716,1,195,49,"East TN",2455501,9.28527416604595,0.0191235622045022,115.536503548563,0.651598187090944,12.4618153281143,1.91235622045022
2020-05-10,2079,16,2037,15,42,1,2256,19,53907,2564,56163,2583,1,42,-27,279,42,1758,3,198,49,"East TN",2455501,8.3893266587959,0.0173323285606631,105.192382328494,0.651598187090944,11.3622433873983,1.73323285606631
2020-05-11,2140,61,2097,60,43,1,2307,51,55478,1571,57785,1622,3,45,13,292,45,1803,4,202,51,"East TN",2455501,8.95947507250048,0.0173747889701744,66.0557662163444,2.48421808828422,11.8916669144097,1.73747889701745
2020-05-12,2193,53,2150,53,43,0,2373,66,59033,3555,61406,3621,3,48,30,322,20,1823,3,205,51,"East TN",2455501,9.97759723983008,0.0188653910708291,147.464814716019,2.15841899473875,13.1134135152052,1.88653910708291
2020-05-13,2247,54,2201,51,46,3,2425,52,60658,1625,63083,1677,0,48,18,340,36,1859,7,212,53,"East TN",2455501,10.6699203136142,0.0187278010978366,68.2956349844696,2.19914388143194,13.8464614756826,1.87278010978366
2020-05-14,2278,31,2232,31,46,0,2470,45,62366,1708,64836,1753,1,49,-1,339,31,1890,2,214,54,"East TN",2455501,10.181221673296,0.0181657066902969,71.3907263731516,1.2624714874887,13.8057365889894,1.81657066902969
2020-05-15,2306,28,2260,28,46,0,2507,37,64686,2320,67193,2357,1,50,-21,318,48,1938,4,218,54,"East TN",2455501,10.5477456535347,0.0175075987841945,95.9885579358347,1.14029682740915,12.9505139684325,1.75075987841945
2020-05-16,2316,10,2270,10,46,0,2525,18,67456,2770,69981,2788,1,51,-28,290,37,1975,1,219,54,"East TN",2455501,10.3033963333756,0.0175599048838485,113.540984100597,0.40724886693184,11.8102171410234,1.75599048838485
2020-05-17,2396,80,2350,80,46,0,2604,79,69683,2227,72287,2306,0,51,59,349,21,1996,4,223,56,"East TN",2455501,12.9097890817393,0.0215827338129496,93.9115887144823,3.25799093545472,14.2129854559212,2.15827338129496
2020-05-18,2445,49,2398,48,47,1,2665,61,71561,1878,74226,1939,0,51,8,357,41,2037,3,226,56,"East TN",2455501,12.4210904414211,0.0217748312146463,78.9655552980838,1.99551944796602,14.5387845494667,2.17748312146463
2020-05-19,2486,41,2438,40,48,1,2705,40,72685,1124,75390,1164,1,52,-6,351,46,2083,3,229,56,"East TN",2455501,11.9323918011029,0.0237414187643021,47.4037681108662,1.66972035442054,14.2944352293076,2.37414187643021
2020-05-20,2528,42,2480,42,48,0,2750,45,74425,1740,77175,1785,0,52,13,364,29,2112,3,232,56,"East TN",2455501,11.4436931607847,0.0230627306273063,72.6939227473334,1.71044524111373,14.823858756319,2.30627306273063
2020-05-21,2769,241,2720,240,49,1,2988,238,75887,1462,78875,1700,0,52,211,575,30,2142,4,236,57,"East TN",2455501,19.9959193663533,0.0368972149013463,69.2323073784128,9.81469769305734,23.4168098485808,3.68972149013463
2020-05-22,2860,91,2808,88,52,3,3066,78,77412,1525,80478,1603,0,52,40,615,51,2193,6,242,57,"East TN",2455501,22.5615872280239,0.0420775310500565,65.2819933691739,3.70596468907974,25.0458053163082,4.20775310500565
2020-05-23,2926,66,2870,62,56,4,3157,91,79627,2215,82784,2306,2,54,36,651,28,2221,6,248,58,"East TN",2455501,24.8421808828422,0.0493634304459892,93.9115887144823,2.68784252175014,26.5119012372628,4.93634304459892
2020-05-24,2978,52,2922,52,56,0,3227,70,81747,2120,84974,2190,0,54,26,677,26,2247,0,248,59,"East TN",2455501,23.7018840554331,0.0491053834633877,89.187501858073,2.11769410804557,27.5707482912856,4.91053834633877
2020-05-25,3062,84,3005,83,57,1,3321,94,84397,2650,87718,2744,1,55,42,719,41,2288,2,250,59,"East TN",2455501,25.1272550896945,0.0486214052772013,111.749089086097,3.42089048222746,29.2811935323993,4.86214052772013
2020-05-26,3123,61,3057,52,66,9,3377,56,86783,2386,90160,2442,1,56,15,734,45,2333,3,253,59,"East TN",2455501,25.9417528235582,0.0454976303317536,99.4501733047553,2.48421808828422,29.8920668327971,4.54976303317536
2020-05-27,3199,76,3130,73,69,3,3444,67,88650,1867,92094,1934,0,56,40,774,36,2369,8,261,59,"East TN",2455501,27.3263989711265,0.0465178631275555,78.7619308646179,3.09509138868198,31.5210623005244,4.65178631275555
2020-05-28,3273,74,3204,74,69,0,3511,67,90049,1399,93560,1466,0,56,14,788,60,2429,1,262,59,"East TN",2455501,20.5253428933647,0.0356145726932244,59.7026838922077,3.01364161529562,32.091210714229,3.56145726932244
2020-05-29,3348,75,3278,74,70,1,3594,83,91327,1278,94921,1361,0,56,10,798,65,2494,4,266,59,"East TN",2455501,19.8737447062738,0.0365575019040366,55.4265707894234,3.0543665019888,32.4984595811608,3.65575019040366
2020-05-30,3421,73,3350,72,71,1,3675,81,93572,2245,97247,2326,0,56,-1,797,74,2568,4,270,60,"East TN",2455501,20.1588189131261,0.0358155292816152,94.726086448346,2.97291672860243,32.4577346944676,3.58155292816152
2020-05-31,3533,112,3460,110,73,2,3769,94,96355,2783,100124,2877,0,56,71,868,41,2609,1,271,61,"East TN",2455501,22.6023121147171,0.0357755775577558,117.16549901629,4.56118730963661,35.3492016496837,3.57755775577558
2020-06-01,3629,96,3553,93,76,3,3903,134,100187,3832,104090,3966,0,56,-169,699,265,2874,5,276,61,"East TN",2455501,23.0910107550353,0.0355484974346445,161.514900625168,3.90958912254566,28.4666957985356,3.55484974346445
2020-06-02,3736,107,3658,105,78,2,4018,115,104246,4059,108264,4174,1,57,16,715,90,2964,3,279,65,"East TN",2455501,24.9643555429218,0.0354065399911622,169.98567705735,4.35756287617069,29.1182939856266,3.54065399911622
2020-06-03,3786,50,3708,50,78,0,4068,50,106176,1930,110244,1980,0,57,-65,650,115,3079,4,283,66,"East TN",2455501,23.905508488899,0.0343801652892562,80.6352756525043,2.0362443346592,26.4711763505696,3.43801652892562
2020-06-04,3837,51,3757,49,80,2,4129,61,107724,1548,111853,1609,6,63,-37,613,82,3161,5,288,67,"East TN",2455501,22.9688360949558,0.0337834144208167,65.526342689333,2.07696922135238,24.9643555429218,3.37834144208167
2020-06-05,3936,99,3852,95,84,4,4211,82,109880,2156,114091,2238,1,64,-43,570,141,3302,4,292,68,"East TN",2455501,23.9462333755922,0.0321857068335942,91.1422964193458,4.03176378262522,23.2131854151149,3.21857068335942
2020-06-06,3989,53,3902,50,87,3,4286,75,112985,3105,117271,3180,1,65,-14,556,66,3368,4,296,68,"East TN",2455501,23.1317356417285,0.0305133839392729,129.505139684325,2.15841899473875,22.6430370014103,3.05133839392729
2020-06-07,4047,58,3958,56,89,2,4367,81,116949,3964,121316,4045,0,65,-8,548,66,3434,6,302,69,"East TN",2455501,20.9325917602966,0.0282181955454889,164.732166673929,2.36204342820467,22.3172379078648,2.82181955454889
2020-06-08,4207,160,4114,156,93,4,4524,157,119900,2951,124424,3108,0,65,75,623,85,3519,6,308,69,"East TN",2455501,23.5389845086604,0.0305399822956624,126.572947842416,6.51598187090944,25.3716044098536,3.05399822956624
2020-06-09,4315,108,4221,107,94,1,4642,118,122227,2327,126869,2445,1,66,-35,588,142,3661,7,315,70,"East TN",2455501,23.5797093953535,0.0335393711367912,99.5723479648349,4.39828776286387,23.9462333755922,3.35393711367912
2020-06-10,4392,77,4295,74,97,3,4716,74,125065,2838,129781,2912,0,66,-63,525,140,3801,6,321,70,"East TN",2455501,24.6792813360695,0.0331678353892614,118.590870050552,3.13581627537517,21.3805655139216,3.31678353892614
2020-06-11,4656,264,4557,262,99,2,4996,280,127356,2291,132352,2571,1,67,149,674,114,3915,8,329,70,"East TN",2455501,33.3536822017177,0.0422947460851749,104.703683688176,10.7513700870006,27.448573631206,4.22947460851749
2020-06-12,4827,171,4727,170,100,1,5168,172,129984,2628,135152,2800,2,69,24,698,145,4060,3,332,71,"East TN",2455501,36.2858740436269,0.0454394378234652,114.029682740915,6.96395562453446,28.4259709118424,4.54394378234652
2020-06-13,4975,148,4871,144,104,4,5336,168,132175,2191,137511,2359,0,69,50,748,98,4158,4,336,72,"East TN",2455501,40.1547382794794,0.0518774703557312,96.0700077092211,6.02728323059123,30.4622152465016,5.18774703557312
2020-06-14,5091,116,4986,115,105,1,5471,135,136045,3870,141516,4005,0,69,30,778,86,4244,4,340,73,"East TN",2455501,42.5167817076841,0.0546534653465347,163.103171206202,4.72408685640934,31.6839618472971,5.46534653465347
2020-06-15,5274,183,5158,172,116,11,5650,179,139219,3174,144869,3353,0,69,58,836,125,4369,9,349,78,"East TN",2455501,43.4534541016273,0.0550745903643923,136.550545082246,7.45265426485267,34.0460052755018,5.50745903643923
2020-06-16,5428,154,5310,152,118,2,5808,158,141019,1800,146827,1958,3,72,64,900,87,4456,4,353,81,"East TN",2455501,45.3267988895138,0.0584226876440525,79.7393281452543,6.27163255075034,36.6523980238656,5.84226876440525
2020-06-17,5561,133,5440,130,121,3,5930,122,142459,1440,148389,1562,3,75,-6,894,136,4592,6,359,83,"East TN",2455501,47.6073925443321,0.0652407566638005,63.6122730147534,5.41640993019347,36.4080487037065,6.52407566638005
2020-06-18,5739,178,5617,177,122,1,6136,206,146050,3591,152186,3797,1,76,42,936,135,4727,10,369,83,"East TN",2455501,44.1050522887183,0.0574770595946355,154.63239477402,7.24902983138675,38.1184939448202,5.74770595946355
2020-06-19,5874,135,5748,131,126,4,6254,118,147514,1464,153768,1582,4,80,22,958,109,4836,12,381,84,"East TN",2455501,42.6389563677636,0.0583369144821659,64.4267707486171,5.49785970357984,39.0144414520703,5.83369144821659
2020-06-20,5940,66,5813,65,127,1,6349,95,149689,2175,156038,2270,0,80,-44,914,110,4946,6,387,84,"East TN",2455501,39.2995156589226,0.0546769579532574,92.4454927935277,2.68784252175014,37.2225464375702,5.46769579532574
2020-06-21,6028,88,5900,87,128,1,6468,119,153039,3350,159507,3469,1,81,0,914,87,5033,3,390,87,"East TN",2455501,38.1592188315134,0.0554165971874826,141.274631938655,3.58379002900019,37.2225464375702,5.54165971874826
2020-06-22,6224,196,6089,189,135,7,6666,198,156450,3411,163116,3609,1,82,43,957,152,5185,7,397,88,"East TN",2455501,38.6886423585248,0.0556803858168466,146.976116075701,7.98207779186406,38.9737165653771,5.56803858168466
2020-06-23,6414,190,6273,184,141,6,6850,184,158255,1805,165105,1989,4,86,57,1014,129,5314,15,412,88,"East TN",2455501,40.1547382794794,0.0570084254294781,81.001799632743,7.73772847170496,41.2950351068886,5.70084254294781
2020-06-24,6592,178,6449,176,143,2,7033,183,159886,1631,166919,1814,2,88,37,1051,139,5453,9,421,88,"East TN",2455501,41.9873581806727,0.0595250944414463,73.8749444614358,7.24902983138675,42.8018559145364,5.95250944414463
2020-06-25,6761,169,6609,160,152,9,7217,184,163060,3174,170277,3358,0,88,22,1073,147,5600,8,429,88,"East TN",2455501,41.620834200434,0.0597534685755348,136.754169515712,6.8825058511481,43.6978034217864,5.97534685755348
2020-06-26,6975,214,6813,204,162,10,7389,172,164649,1589,172038,1761,1,89,67,1140,146,5746,16,445,88,"East TN",2455501,44.8381002491956,0.0621237000547345,71.716525466697,8.71512575234138,46.4263708302298,6.21237000547345
2020-06-27,7049,74,6882,69,167,5,7435,46,164858,209,172293,255,-1,88,-52,1088,127,5873,5,450,90,"East TN",2455501,45.1638993427411,0.066810212242387,10.3848461067619,3.01364161529562,44.3086767221842,6.6810212242387
2020-06-28,7176,127,7007,125,169,2,7606,171,167947,3089,175553,3260,0,88,30,1118,97,5970,5,455,91,"East TN",2455501,46.7521699237752,0.0709211018322323,132.76313061978,5.17206061003437,45.5304233229797,7.09211018322323
2020-06-29,7519,343,7348,341,171,2,7946,340,173215,5268,181161,5608,1,89,147,1265,195,6165,22,477,92,"East TN",2455501,52.7387282676733,0.0709337766694375,228.385164575376,13.9686361357621,51.5169816668778,7.09337766694375
2020-06-30,7789,270,7614,266,175,4,8394,448,179502,6287,187896,6735,0,89,100,1365,170,6335,22,499,93,"East TN",2455501,55.996719203128,0.0677460401035496,274.282111878594,10.9957194071597,55.5894703361962,6.77460401035496
2020-07-01,8064,275,7886,272,178,3,8728,334,182706,3204,191434,3538,0,89,66,1431,209,6544,17,516,96,"East TN",2455501,59.9470332123668,0.0691413420354885,144.084649120485,11.1993438406256,58.2773128579463,6.91413420354885
2020-07-02,8544,480,8361,475,183,5,9334,606,189089,6383,198423,6989,2,91,314,1745,164,6708,24,540,99,"East TN",2455501,72.6124729739471,0.0752149506146522,284.626233098663,19.5479456127283,71.0649272796061,7.52149506146522
2020-07-03,8770,226,8581,220,189,6,9562,228,192445,3356,202007,3584,5,96,24,1769,197,6905,14,554,100,"East TN",2455501,73.1011716142653,0.0725082585338183,145.957993908371,9.20382439265958,72.0423245602425,7.25082585338183
2020-07-04,8990,220,8799,218,191,2,9842,280,197209,4764,207051,5044,2,98,77,1846,141,7046,14,568,106,"East TN",2455501,79.0470050714701,0.0692502445480177,205.41632848042,8.95947507250048,75.1781408356177,6.92502445480177
2020-07-05,9310,320,9118,319,192,1,10210,368,201057,3848,211267,4216,2,100,163,2009,155,7201,11,579,109,"East TN",2455501,86.9069082032546,0.0729125833006664,171.696122298464,13.0319637418189,81.8162973666066,7.29125833006664
2020-07-06,9544,234,9341,223,203,11,10420,210,202688,1631,213108,1841,4,104,-51,1958,281,7482,26,605,109,"East TN",2455501,82.4678955536976,0.0774407612608383,74.9745164021517,9.52962348620506,79.7393281452543,7.74407612608383
2020-07-07,9992,448,9780,439,212,9,10986,566,208966,6278,219952,6844,0,104,159,2117,289,7771,31,636,110,"East TN",2455501,89.7169253850844,0.080858497629149,278.721124528151,18.2447492385464,86.2145851294705,8.0858497629149
2020-07-08,10373,381,10151,371,222,10,11420,434,213138,4172,224558,4606,1,105,61,2178,319,8090,20,656,110,"East TN",2455501,94.0337633745619,0.0812703779736747,187.578828108805,15.5161818301031,88.6988032177547,8.12703779736747
2020-07-09,10822,449,10586,435,236,14,11892,472,219088,5950,230980,6422,1,106,149,2327,299,8389,24,680,113,"East TN",2455501,92.7712918870731,0.078569892803391,261.535222343628,18.2854741252396,94.7668113350392,7.8569892803391
2020-07-10,11289,467,11041,455,248,12,12345,453,222372,3284,234717,3737,0,106,141,2468,326,8715,27,707,115,"East TN",2455501,102.58598958013,0.0850810149801284,152.188901572429,19.0185220857169,100.509020358778,8.50810149801284
2020-07-11,11595,306,11340,299,255,7,12767,422,226850,4478,239617,4900,5,111,44,2512,257,8972,22,729,120,"East TN",2455501,106.088329835744,0.0898176011791439,199.551944796602,12.4618153281143,102.300915373278,8.98176011791439
2020-07-12,12065,470,11802,462,263,8,13400,633,232780,5930,246180,6563,1,112,222,2734,247,9219,24,753,125,"East TN",2455501,112.197062839722,0.091369976799473,267.277431367367,19.1406967457965,111.341840219165,9.1369976799473
2020-07-13,12419,354,12143,341,276,13,13743,343,236214,3434,249957,3777,3,115,-119,2615,470,9689,18,771,129,"East TN",2455501,117.084049242904,0.0901788379603246,153.817897040156,14.4166098893871,106.495578702676,9.01788379603246
2020-07-14,12934,515,12653,510,281,5,14327,584,240702,4488,255029,5072,4,119,77,2692,434,10123,34,805,133,"East TN",2455501,119.812616651347,0.0952475981412321,206.556625307829,20.9733166469898,109.631394978051,9.52475981412321
2020-07-15,13314,380,13027,374,287,6,14710,383,243799,3097,258509,3480,6,125,-105,2587,479,10602,24,829,140,"East TN",2455501,119.771891764654,0.0969043621690083,141.72260569228,15.4754569434099,105.355281875267,9.69043621690083
2020-07-16,14141,827,13839,812,302,15,15807,1097,253633,9834,269440,10931,6,131,349,2936,472,11074,43,872,142,"East TN",2455501,135.165898934678,0.101794071762871,445.163736443194,33.6794812952632,119.568267331188,10.1794071762871
2020-07-17,14609,468,14293,454,316,14,16318,511,257952,4319,274270,4830,3,134,95,3031,370,11444,24,896,147,"East TN",2455501,135.206623821371,0.100447500821682,196.701202728079,19.0592469724101,123.437131567041,10.0447500821682
2020-07-18,15118,509,14787,494,331,15,16986,668,266043,8091,283029,8759,6,140,185,3216,318,11762,27,923,150,"East TN",2455501,143.473775820087,0.0971851101078043,356.709282545599,20.7289673268307,130.97123560528,9.71851101078043
2020-07-19,15599,481,15249,462,350,19,17546,560,270897,4854,288443,5414,0,140,76,3292,405,12167,25,948,154,"East TN",2455501,143.921749573712,0.0980999929015924,220.484536556898,19.5886704994215,134.066326993962,9.80999929015924
2020-07-20,16035,436,15670,421,365,15,17957,411,273354,2457,291311,2868,2,142,-270,3022,704,12871,29,977,158,"East TN",2455501,147.261190282553,0.10190066257194,116.798975036052,17.7560505982282,123.070607586802,10.190066257194
2020-07-21,17036,1001,16654,984,382,17,19169,1212,281731,8377,300900,9589,1,143,381,3403,619,13490,61,1038,161,"East TN",2455501,167.053485215441,0.105556887794031,390.510938500941,40.7656115798772,138.586789416905,10.5556887794031
2020-07-22,17620,584,17222,568,398,16,19823,654,285031,3300,304854,3954,4,147,-80,3323,660,14150,29,1067,166,"East TN",2455501,175.36136210085,0.110324738375229,161.02620198485,23.7833338288195,135.32879848145,11.0324738375229
2020-07-23,18415,795,17995,773,420,22,20822,999,295235,10204,316057,11203,4,151,242,3565,549,14699,50,1117,172,"East TN",2455501,174.058165726668,0.107578780273291,456.24090562374,32.3762849210813,145.184221061201,10.7578780273291
2020-07-24,19018,603,18585,590,433,13,21506,684,301044,5809,322550,6493,2,153,6,3571,595,15294,34,1151,178,"East TN",2455501,179.556025430248,0.107456503728252,264.426689298844,24.55710667599,145.42857038136,10.7456503728252
2020-07-25,19996,978,19551,966,445,12,22708,1202,310659,9615,333367,10817,10,163,550,4121,418,15712,28,1179,186,"East TN",2455501,198.655997289352,0.1136715801184,440.521099360171,39.8289391859339,167.827258062611,11.36715801184
2020-07-26,20771,775,20311,760,460,15,23605,897,318182,7523,341787,8420,1,164,391,4512,383,16095,21,1200,193,"East TN",2455501,210.629113977148,0.113583533293341,342.903545956609,31.5617871872176,183.750688759646,11.3583533293341
2020-07-27,21417,646,20935,624,482,22,24311,706,322648,4466,346959,5172,6,170,-78,4434,718,16813,38,1238,197,"East TN",2455501,219.181340182716,0.114182001150086,210.629113977148,26.3082768037969,180.574147597578,11.4182001150086
2020-07-28,22232,815,21727,792,505,23,25283,972,330869,8221,356152,9193,7,177,170,4604,638,17451,50,1288,202,"East TN",2455501,211.606511257784,0.110656627814378,374.38388337044,33.190782654945,187.497378335419,11.0656627814378
2020-07-29,22575,343,22059,332,516,11,25599,316,332441,1572,358040,1888,5,182,-337,4267,675,18126,24,1312,211,"East TN",2455501,201.791813564727,0.108600007520776,76.8885860767314,13.9686361357621,173.773091519816,10.8600007520776
2020-07-30,23763,1188,23232,1173,531,15,26980,1381,344975,12534,371955,13915,5,187,674,4941,509,18635,42,1354,217,"East TN",2455501,217.796694035148,0.110164943289563,566.686798335655,48.3811653915026,201.221665151022,11.0164943289563
2020-07-31,24385,622,23838,606,547,16,27634,654,348943,3968,376577,4622,6,193,80,5021,536,19171,25,1379,226,"East TN",2455501,218.570466882319,0.113424769096933,188.230426295896,25.3308795231604,204.479656086477,11.3424769096933
2020-08-01,24944,559,24380,542,564,17,28270,636,355917,6974,384187,7610,1,194,152,5173,406,19577,16,1395,229,"East TN",2455501,201.506739357874,0.109445100354191,309.91638773513,22.7652116614899,210.669838863841,10.9445100354191
2020-08-02,25375,431,24800,420,575,11,28754,484,359715,3798,388469,4282,4,198,49,5222,378,19955,19,1414,234,"East TN",2455501,187.497378335419,0.11029947303029,174.383964820214,17.5524261647623,212.665358311807,11.029947303029
2020-08-03,26001,626,25408,608,593,18,29462,708,363859,4144,393321,4852,3,201,-43,5179,666,20621,33,1447,242,"East TN",2455501,186.682880601555,0.11110392131487,197.597150235329,25.4937790699332,210.914188184,11.110392131487
2020-08-04,26487,486,25874,466,613,20,29988,526,369230,5371,399218,5897,6,207,-219,4960,699,21320,33,1480,251,"East TN",2455501,173.284392879498,0.109250917196861,240.154656829706,19.7922949328874,201.995437998193,10.9250917196861
2020-08-05,26955,468,26334,460,621,8,30509,521,373443,4213,403952,4734,9,216,-223,4737,682,22002,19,1499,257,"East TN",2455501,178.375003716146,0.106943718417843,192.791613605533,19.0592469724101,192.913788265613,10.6943718417843
2020-08-06,27686,731,27027,693,659,38,31361,852,380513,7070,411874,7922,7,223,201,4938,523,22525,36,1535,263,"East TN",2455501,159.763730497361,0.109747238157268,322.622552383404,29.7698921727175,201.099490490943,10.9747238157268
2020-08-07,28241,555,27568,541,673,14,31980,619,384483,3970,416463,4589,6,229,38,4976,511,23036,34,1569,276,"East TN",2455501,157.035163088917,0.108960537531966,186.886505035021,22.6023121147171,202.647036185284,10.8960537531966
2020-08-08,28916,675,28231,663,685,12,32780,800,394559,10076,427339,10876,8,237,289,5265,378,23414,19,1588,286,"East TN",2455501,161.759249945327,0.104514275120504,442.923867675069,27.4892985178992,214.416528439614,10.4514275120504
2020-08-09,29444,528,28747,516,697,12,33414,634,398860,4301,432274,4935,2,239,115,5380,411,23825,19,1607,293,"East TN",2455501,165.709563954566,0.106380550165506,200.977315830863,21.5027401740012,219.09989040933,10.6380550165506
2020-08-10,29747,303,29039,292,708,11,33742,328,401149,2289,434891,2617,3,242,-478,4902,778,24603,26,1633,297,"East TN",2455501,152.555425552667,0.102958864565793,106.577028476063,12.3396406680348,199.633394569988,10.2958864565793
2020-08-11,30359,612,29634,595,725,17,34427,685,407249,6100,441676,6785,17,259,-7,4895,602,25205,28,1661,302,"East TN",2455501,157.686761276008,0.104550379198267,276.318356213253,24.9236306562286,199.348320363136,10.4550379198267
2020-08-12,30804,445,30058,424,746,21,34901,474,410998,3749,445899,4223,6,265,-251,4644,690,25895,25,1686,307,"East TN",2455501,156.750088882065,0.104703554485422,171.981196505316,18.1225745784669,189.126373803146,10.4703554485422
2020-08-13,31621,817,30862,804,759,13,36018,1117,419560,8562,455578,9679,6,271,202,4846,609,26504,44,1730,315,"East TN",2455501,160.252429137679,0.106557752150833,394.176178303328,33.2722324283313,197.35280091517,10.6557752150833
2020-08-14,32082,461,31294,432,788,29,36552,534,424216,4656,460768,5190,4,275,-142,4704,599,27103,18,1748,322,"East TN",2455501,156.42428978852,0.103193770454802,211.362161937625,18.7741727655578,191.569867004738,10.3193770454802
2020-08-15,32732,650,31932,638,800,12,37429,877,431149,6933,468578,7810,4,279,216,4920,430,27533,17,1765,331,"East TN",2455501,155.40616762119,0.11273309246102,318.061365073767,26.4711763505696,200.366442530465,11.273309246102
2020-08-16,33206,474,32395,463,811,11,38022,593,436615,5466,474637,6059,2,281,110,5030,362,27895,10,1775,340,"East TN",2455501,153.207023739758,0.108774166135543,246.752088474002,19.3035962925692,204.846180066716,10.8774166135543
2020-08-17,33479,273,32598,203,881,70,38249,227,438087,1472,476336,1699,8,289,-397,4633,662,28557,12,1787,346,"East TN",2455501,151.985277138963,0.108746531547834,69.1915824917196,11.1178940672392,188.678400049521,10.8746531547834
2020-08-18,34109,630,33163,565,946,65,39061,812,448684,10597,487745,11409,8,297,52,4685,570,29127,22,1809,349,"East TN",2455501,152.71832509944,0.100588248062689,464.630232282536,25.6566786167059,190.796094157567,10.0588248062689
2020-08-19,34564,455,33597,434,967,21,39558,497,453468,4784,493026,5281,7,304,-113,4572,561,29688,22,1831,356,"East TN",2455501,153.125573966372,0.0988180872960299,215.068126626705,18.5298234453987,186.194181961237,9.88180872960299
2020-08-20,35342,778,34354,757,988,21,40432,874,465007,11539,505439,12413,6,310,264,4836,508,30196,26,1857,364,"East TN",2455501,151.537303385338,0.0885261025651311,505.518018522493,31.6839618472971,196.945552048238,8.85261025651311
2020-08-21,35551,209,34551,197,1000,12,40645,213,467458,2451,508103,2664,17,327,-321,4515,513,30709,17,1874,371,"East TN",2455501,141.274631938655,0.0864687863103412,108.491098150642,8.51150131887546,183.872863419726,8.64687863103412
2020-08-22,36421,870,35409,858,1012,12,41618,973,480825,13367,522443,14340,2,329,454,4969,414,31123,20,1894,378,"East TN",2455501,150.234107011156,0.077768495312355,583.994875180259,35.4306514230701,202.361961978431,7.7768495312355
2020-08-23,36674,253,35651,242,1023,11,41872,254,485932,5107,527804,5361,0,329,-94,4875,347,31470,20,1914,383,"East TN",2455501,141.233907051962,0.0724133391013222,218.326117562159,10.3033963333756,198.533822629272,7.24133391013222
2020-08-24,36866,192,35826,175,1040,17,42070,198,487275,1343,529345,1541,8,337,-486,4389,670,32140,15,1929,393,"East TN",2455501,137.935191229814,0.0720820992661624,62.7570503941965,7.81917824509133,178.741527696385,7.20820992661624
2020-08-25,37480,614,36415,589,1065,25,42755,685,497011,9736,539766,10421,16,353,119,4508,479,32619,22,1951,401,"East TN",2455501,137.283593042723,0.0710097845101017,424.39404422967,25.005080429615,183.587789212873,7.10097845101017
2020-08-26,37825,345,36735,320,1090,25,43139,384,500973,3962,544112,4346,6,359,-208,4300,547,33166,11,1962,409,"East TN",2455501,132.803855506473,0.0700974826762714,176.990357568578,14.0500859091485,175.117012780691,7.00974826762714
2020-08-27,38686,861,37579,844,1107,17,44115,976,511264,10291,555379,11267,8,367,387,4687,466,33632,29,1991,416,"East TN",2455501,136.184021102007,0.0737484981978374,458.847298372104,35.0641274428314,190.877543930953,7.37484981978374
2020-08-28,39020,334,37893,314,1127,20,44453,338,513872,2608,558325,2946,12,379,-182,4505,504,34136,10,2001,422,"East TN",2455501,141.274631938655,0.0758233443510812,119.97551619812,13.6021121555235,183.465614552794,7.58233443510812
2020-08-29,39471,451,38328,435,1143,16,44981,528,520391,6519,565372,7047,8,387,61,4566,382,34518,16,2017,431,"East TN",2455501,124.210904414211,0.0783386521931561,286.988276526868,18.366923898626,185.949832641078,7.83386521931561
2020-08-30,39734,263,38580,252,1154,11,45248,267,522272,1881,567520,2148,8,395,-55,4511,310,34828,14,2031,434,"East TN",2455501,124.618153281143,0.0850035250276966,87.4770566169592,10.7106452003074,183.709963872953,8.50035250276967
2020-08-31,40141,407,38958,378,1183,29,45698,450,525759,3487,571457,3937,2,397,-133,4378,538,35366,16,2047,439,"East TN",2455501,133.374003920178,0.0861512158054711,160.333878911065,16.5750288841259,178.29355394276,8.61512158054711
2020-09-01,40748,607,39523,565,1225,42,46372,674,531424,5665,577796,6339,6,403,105,4483,496,35862,28,2075,448,"East TN",2455501,133.088929713325,0.095109124375493,258.155056748093,24.7200062227627,182.569667045544,9.5109124375493
2020-09-02,41236,488,39982,459,1254,29,46825,453,536217,4793,583042,5246,7,410,22,4505,459,36321,22,2097,455,"East TN",2455501,138.912588510451,0.0946827639352684,213.642755592443,19.8737447062738,183.465614552794,9.46827639352684
2020-09-03,41791,555,40504,522,1287,33,47472,647,544474,8257,591946,8904,6,416,-39,4466,588,36909,22,2119,458,"East TN",2455501,126.450773182336,0.0918040856509968,362.61439111611,22.6023121147171,181.87734397176,9.18040856509968
2020-09-04,42148,357,40847,343,1301,14,47820,348,547806,3332,595626,3680,7,423,-40,4426,390,37299,11,2130,459,"East TN",2455501,127.38744557628,0.0902656765234176,149.867583030917,14.5387845494667,180.248348504032,9.02656765234176
2020-09-05,43146,998,41830,983,1316,15,48910,1090,557124,9318,606034,10408,1,424,640,5066,357,37656,26,2156,465,"East TN",2455501,149.663958597451,0.0966258423097733,423.864620702659,40.6434369197976,206.31227598767,9.66258423097733
2020-09-06,43409,263,42077,247,1332,16,49178,268,559752,2628,608930,2896,0,424,-50,5016,313,37969,9,2165,479,"East TN",2455501,149.663958597451,0.0949046124124608,117.939271863461,10.7106452003074,204.276031653011,9.49046124124608
2020-09-07,43613,204,42274,197,1339,7,49415,237,561088,1336,610503,1573,3,427,-342,4674,543,38512,13,2178,483,"East TN",2455501,141.396806598735,0.0951954105414127,64.0602467683784,8.30787688540954,190.348120403942,9.51954105414127
2020-09-08,43924,311,42563,289,1361,22,49735,320,564514,3426,614249,3746,7,434,-302,4372,606,39118,24,2202,490,"East TN",2455501,129.342240137552,0.0922557814171673,152.555425552667,12.6654397615802,178.0492046226,9.22557814171673
2020-09-09,44257,333,42879,316,1378,17,50110,375,569660,5146,619770,5521,6,440,-161,4211,488,39606,16,2218,497,"East TN",2455501,123.029882700109,0.089441298192115,224.842099433069,13.5613872688303,171.492497864998,8.9441298192115
2020-09-10,44932,675,43517,638,1415,37,50817,707,577471,7811,628288,8518,18,458,194,4405,463,40069,39,2257,508,"East TN",2455501,127.916869103291,0.0920422651477629,346.894584852541,27.4892985178992,179.393125883476,9.20422651477629
2020-09-11,45258,326,43820,303,1438,23,51172,355,581630,4159,632802,4514,17,475,-206,4199,515,40584,26,2283,519,"East TN",2455501,126.654397615802,0.0901656982999785,183.832138533033,13.276313061978,171.00379922468,9.01656982999785
2020-09-12,45677,419,44221,401,1456,18,51684,512,588616,6986,640300,7498,10,485,92,4291,317,40901,14,2297,530,"East TN",2455501,103.074688220449,0.080954882390708,305.355200425494,17.0637275244441,174.750488800453,8.0954882390708
2020-09-13,46118,441,44642,421,1476,20,52187,503,594189,5573,646376,6076,2,487,51,4342,388,41289,21,2318,535,"East TN",2455501,110.323718051835,0.0803557122256049,247.444411547786,17.9596750316941,176.827458021805,8.03557122256049
2020-09-14,46562,444,45071,429,1491,15,52672,485,599162,4973,651834,5458,9,496,-150,4192,585,41874,23,2341,545,"East TN",2455501,120.0976908582,0.0788028356439476,222.276431571398,18.0818496917737,170.718725017827,7.88028356439477
2020-09-15,47055,493,45527,456,1528,37,53212,540,607338,8176,660550,8716,7,503,-66,4126,552,42426,19,2360,548,"East TN",2455501,127.509620236359,0.0750955702900585,354.958112417792,20.0773691397397,168.030882496077,7.50955702900585
2020-09-16,47408,353,45837,310,1571,43,53606,394,610751,3413,664357,3807,6,509,-175,3951,522,42948,17,2377,557,"East TN",2455501,128.324117970223,0.0784085047211071,155.039643640951,14.375885002694,160.90402732477,7.84085047211071
2020-09-17,47959,551,46356,519,1603,32,54183,577,617927,7176,672110,7753,8,517,119,4070,424,43372,21,2398,568,"East TN",2455501,123.274232020268,0.0768107343343526,315.740046532256,22.4394125679444,165.750288841259,7.68107343343526
2020-09-18,48493,534,46842,486,1651,48,54750,567,626042,8115,680792,8682,17,534,-29,4041,546,43918,29,2427,574,"East TN",2455501,131.74500845245,0.0745571994165451,353.573466270223,21.7470894941603,164.569267127157,7.45571994165451
2020-09-19,49001,508,47327,485,1674,23,55323,573,634396,8354,689719,8927,3,537,193,4234,312,44230,29,2456,576,"East TN",2455501,135.369523368144,0.073635646208948,363.551063510054,20.6882424401375,172.429170258941,7.3635646208948
2020-09-20,49307,306,47608,281,1699,25,55652,329,639354,4958,695006,5287,1,538,-19,4215,324,44554,13,2469,587,"East TN",2455501,129.871663664564,0.0712523133867983,215.312475946864,12.4618153281143,171.655397411771,7.12523133867983
2020-09-21,49470,163,47741,133,1729,30,55804,152,640871,1517,696675,1669,3,541,-210,4005,370,44924,9,2478,593,"East TN",2455501,118.427970503779,0.0698467919983943,67.9698358909241,6.63815653098899,163.103171206202,6.98467919983943
2020-09-22,49930,460,48143,402,1787,58,56294,490,647021,6150,703315,6640,6,547,-55,3950,509,45433,28,2506,600,"East TN",2455501,117.084049242904,0.0720682801356249,270.413247642742,18.7334478788646,160.863302438077,7.20682801356249
2020-09-23,50224,294,48397,254,1827,40,56576,282,649114,2093,705690,2375,8,555,-217,3733,503,45936,11,2517,609,"East TN",2455501,114.681280928006,0.0718554181888564,96.721605896312,11.9731166877961,152.026002025656,7.18554181888564
2020-09-24,50687,463,48839,442,1848,21,57057,481,656008,6894,713065,7375,11,566,-36,3697,488,46424,27,2544,614,"East TN",2455501,111.097490899006,0.070174581858137,300.346039362232,18.8556225389442,150.559906104701,7.0174581858137
2020-09-25,51141,454,49269,430,1872,24,57543,486,662680,6672,720223,7158,11,577,14,3711,429,46853,18,2562,621,"East TN",2455501,107.839499963551,0.0708325936445943,291.508738949811,18.4890985587055,151.130054518406,7.08325936445944
2020-09-26,51699,558,49803,534,1896,24,58181,638,673236,10556,731417,11194,5,582,194,3905,359,47212,28,2590,628,"East TN",2455501,109.87574429821,0.0685404575759029,455.874381643502,22.7244867747967,159.030682536884,6.85404575759029
2020-09-27,52092,393,50168,365,1924,28,58588,407,679255,6019,737843,6426,3,585,91,3996,299,47511,30,2620,635,"East TN",2455501,113.418809440517,0.0685388799402386,261.6981218904,16.0048804704213,162.736647225963,6.85388799402386
2020-09-28,52326,234,50363,195,1963,39,58813,225,680942,1687,739755,1912,4,589,-315,3681,545,48056,14,2634,642,"East TN",2455501,116.310276395733,0.0698467966573816,77.8659833573678,9.52962348620506,149.90830791761,6.98467966573816
2020-09-29,52709,383,50703,340,2006,43,59210,397,686753,5811,745963,6208,9,598,-43,3638,417,48473,30,2664,644,"East TN",2455501,113.174460120358,0.0683736634777715,252.820096591286,15.5976316034895,148.157137789803,6.83736634777715
2020-09-30,53191,482,51153,450,2038,32,59686,476,690191,3438,749877,3914,6,604,79,3717,397,48870,21,2685,648,"East TN",2455501,120.830738818677,0.070382691741915,159.397206517122,19.6293953861147,151.374403838565,7.0382691741915
2020-10-01,53579,388,51502,349,2077,39,60065,379,693471,3280,753536,3659,11,615,0,3717,377,49247,30,2715,653,"East TN",2455501,117.776372316688,0.0743248251834647,149.01236041036,15.8012560369554,151.374403838565,7.43248251834647
2020-10-02,54044,465,51939,437,2105,28,60528,463,697092,3621,757620,4084,2,617,24,3741,439,49686,17,2732,657,"East TN",2455501,118.224346070313,0.0798192368371795,166.320437254963,18.9370723123306,152.351801119201,7.98192368371795
2020-10-03,54449,405,52327,388,2122,17,61011,483,704551,7459,765562,7942,12,629,83,3824,310,49996,21,2753,663,"East TN",2455501,111.993438406256,0.0828818275003661,323.437050117267,16.4935791107395,155.731966714736,8.28818275003661
2020-10-04,54904,455,52752,425,2152,30,61550,539,714674,10123,776224,10662,4,633,145,3969,306,50302,26,2779,676,"East TN",2455501,114.518381381233,0.0771736015215862,434.208741922728,18.5298234453987,161.637075285247,7.71736015215862
2020-10-05,55576,672,53365,613,2211,59,62302,752,721922,7248,784224,8000,5,638,153,4122,514,50816,38,2817,685,"East TN",2455501,132.355881752848,0.0784591513188963,325.799093545472,27.3671238578196,167.867982949304,7.84591513188963
2020-10-06,56326,750,54031,666,2295,84,63042,740,728562,6640,791604,7380,8,646,302,4424,440,51256,42,2859,694,"East TN",2455501,147.301915169247,0.0839595977301111,300.549663795698,30.543665019888,180.166898730646,8.39595977301111
2020-10-07,57063,737,54690,659,2373,78,63750,708,735315,6753,799065,7461,3,649,293,4717,441,51697,36,2895,700,"East TN",2455501,157.686761276008,0.0826217776693502,303.848379617846,30.0142414928766,192.099290531749,8.26217776693503
2020-10-08,57781,718,55347,657,2434,61,64428,678,741776,6461,806204,7139,10,659,266,4983,442,52139,31,2926,706,"East TN",2455501,171.125973884759,0.0828396749449381,290.734966102641,29.2404686457061,202.932110392136,8.28396749449381
2020-10-09,58322,541,55846,499,2476,42,64988,560,747255,5479,812243,6039,4,663,123,5106,414,52553,20,2946,713,"East TN",2455501,174.221065273441,0.0816505867491716,245.937590740138,22.0321637010125,207.941271455397,8.16505867491716
2020-10-10,58940,618,56434,588,2506,30,65657,669,755680,8425,821337,9094,12,675,252,5358,354,52907,19,2965,727,"East TN",2455501,182.895466139089,0.083298969072165,370.352119587815,25.1679799763877,218.20394290208,8.3298969072165
2020-10-11,59883,943,57346,912,2537,31,66686,1029,766108,10428,832794,11457,1,676,586,5944,356,53263,36,3001,734,"East TN",2455501,202.769210845363,0.0907901714689765,466.585026843809,38.4035681516725,242.068726504286,9.07901714689765
2020-10-12,60239,356,57632,286,2607,70,67003,317,769029,2921,836032,3238,6,682,-337,5607,687,53950,18,3019,745,"East TN",2455501,189.900146650317,0.0907388820259419,131.86718311253,14.4980596627735,228.344439688683,9.07388820259419
2020-10-13,60744,505,58085,453,2659,52,67487,484,773414,4385,840901,4869,9,691,7,5614,489,54439,22,3041,752,"East TN",2455501,179.922549410487,0.0901677586871412,198.289473309113,20.5660677800579,228.629513895535,9.01677586871412
2020-10-14,61618,874,58897,812,2721,62,68335,848,779600,6186,847935,7034,1,692,328,5942,545,54984,40,3081,759,"East TN",2455501,185.501858887453,0.0938203396766933,286.458852999856,35.5935509698428,241.987276730899,9.38203396766933
2020-10-15,62127,509,59337,440,2790,69,68800,465,783754,4154,852554,4619,14,706,-67,5875,562,55546,19,3100,768,"East TN",2455501,176.990357568578,0.0943257820927724,188.108251635817,20.7289673268307,239.258709322456,9.43257820927724
2020-10-16,62766,639,59933,596,2833,43,69384,584,787843,4089,857227,4673,2,708,-135,5740,772,56318,21,3121,780,"East TN",2455501,180.98139646451,0.0977236350702472,190.307395517249,26.0232025969446,233.760849618876,9.77236350702472
2020-10-17,63484,718,60614,681,2870,37,70243,859,796626,8783,866869,9642,6,714,236,5976,476,56794,36,3157,787,"East TN",2455501,185.053885133828,0.100720372485285,392.66935749568,29.2404686457061,243.371922878468,10.0720372485285
2020-10-18,64290,806,61374,760,2916,46,71115,872,804736,8110,875851,8982,3,717,349,6325,454,57248,34,3191,795,"East TN",2455501,179.474575656862,0.102863645864784,365.790932278179,32.8242586747063,257.584908334389,10.2863645864784
2020-10-19,65038,748,62059,685,2979,63,71874,759,809635,4899,881509,5658,3,720,-19,6306,764,58012,65,3256,806,"East TN",2455501,195.43873124059,0.107109088110473,230.421408910035,30.4622152465016,256.811135487218,10.7109088110473
2020-10-20,65724,686,62668,609,3056,77,72565,691,813251,3616,885816,4307,15,735,35,6341,636,58648,27,3283,819,"East TN",2455501,202.809935732056,0.113057998441501,175.402086987543,27.9372722715242,258.23650652148,11.3057998441501
2020-10-21,66318,594,63221,553,3097,41,73182,617,816995,3744,890177,4361,5,740,-128,6213,717,59365,24,3307,833,"East TN",2455501,191.406967457965,0.114743620093746,177.601230868975,24.1905826957513,253.023721024752,11.4743620093746
2020-10-22,67448,1130,64257,1036,3191,94,74283,1101,825561,8566,899844,9667,10,750,440,6653,680,60045,42,3349,848,"East TN",2455501,216.697122094432,0.115944174244026,393.68747966301,46.0191219632979,270.942671169753,11.5944174244026
2020-10-23,68419,971,65161,904,3258,67,75253,970,832677,7116,907930,8086,19,769,290,6943,662,60707,36,3385,856,"East TN",2455501,230.217784476569,0.115752519574779,329.301433801086,39.5438649790817,282.752888310776,11.5752519574779
2020-10-24,69656,1237,66336,1175,3320,62,76580,1327,843203,10526,919783,11853,12,781,643,7586,582,61289,48,3433,873,"East TN",2455501,251.354000670332,0.119760365876706,482.71208197431,50.3766848394686,308.938990454494,11.9760365876706
2020-10-25,70586,930,67209,873,3377,57,77627,1047,851081,7878,928708,8925,9,790,438,8024,483,61772,40,3473,884,"East TN",2455501,256.403886620286,0.123200332973873,363.469613736667,37.8741446246611,326.776490826108,12.3200332973873
2020-10-26,71048,462,67615,406,3433,56,78061,434,853836,2755,931897,3189,6,796,-450,7574,906,62678,20,3493,898,"East TN",2455501,244.756569026036,0.122787171548781,129.871663664564,18.814897652251,308.450291814176,12.2787171548781
2020-10-27,71890,842,68327,712,3563,130,78844,783,858221,4385,937065,5168,12,808,80,7654,750,63428,52,3545,922,"East TN",2455501,251.109651350173,0.122519463794416,210.466214430375,34.2903545956609,311.70828274963,12.2519463794416
2020-10-28,72887,997,69238,911,3649,86,79814,970,865439,7218,945253,8188,13,821,199,7853,785,64213,39,3584,936,"East TN",2455501,267.521780687526,0.12041542595686,333.455372243791,40.6027120331044,319.812535201574,12.041542595686
2020-10-29,73795,908,70031,793,3764,115,80648,834,871942,6503,952590,7337,11,832,151,8004,746,64959,40,3624,948,"East TN",2455501,258.480855841639,0.120672657642286,298.798493667891,36.9781971174111,325.961993092245,12.0672657642286
2020-10-30,74695,900,70838,807,3857,93,81488,840,876800,4858,958288,5698,28,860,50,8054,822,65781,38,3662,964,"East TN",2455501,255.589388886423,0.123813495373128,232.050404377762,36.6523980238656,327.998237426904,12.3813495373128
2020-10-31,74709,14,70852,14,3857,0,81504,16,876821,21,958325,37,5,865,-603,7451,612,66393,0,3662,975,"East TN",2455501,205.782852460659,0.127756732914742,1.50682080764781,0.570148413704576,303.441130750914,12.7756732914742
2020-11-01,75216,507,71242,390,3974,117,81974,470,883389,6568,965363,7038,0,865,-139,7312,646,67039,26,3688,991,"East TN",2455501,188.556225389442,0.118592279361615,286.621752546629,20.6475175534443,297.780371500561,11.8592279361615
2020-11-02,76028,812,71986,744,4042,68,82751,777,887617,4228,970368,5005,11,876,-228,7084,1029,68068,37,3725,1005,"East TN",2455501,202.809935732056,0.121910010137506,203.828057899386,33.0686079948654,288.495097334515,12.1910010137506
2020-11-03,77068,1040,72946,960,4122,80,83827,1076,894480,6863,978307,7939,31,907,30,7114,979,69047,26,3751,1018,"East TN",2455501,210.873463297307,0.120823432423258,323.314875457188,42.3538821609114,289.716843935311,12.0823432423258
2020-11-04,77979,911,73758,812,4221,99,84674,847,899365,4885,984039,5732,6,913,-5,7109,910,69957,34,3785,1042,"East TN",2455501,207.371123041693,0.125302944361367,233.435050525331,37.1003717774906,289.513219501845,12.5302944361367
2020-11-05,78557,578,74242,484,4315,94,85175,501,902028,2663,987203,3164,17,930,-368,6741,929,70886,27,3812,1056,"East TN",2455501,193.931910432942,0.130789009909572,128.853541497234,23.5389845086603,274.526461198753,13.0789009909572
2020-11-06,79523,966,75090,848,4433,118,86102,927,908438,6410,994540,7337,10,940,42,6783,914,71800,36,3848,1080,"East TN",2455501,196.619752954692,0.127275736511089,298.798493667891,39.3402405456157,276.236906439867,12.7275736511089
2020-11-07,80850,1327,76331,1241,4519,86,87521,1419,919360,10922,1006881,12341,21,961,649,7432,657,72457,48,3896,1090,"East TN",2455501,250.091529182843,0.123918774198863,502.585826680584,54.0419246418552,302.667357903743,12.3918774198863
2020-11-08,82406,1556,77769,1438,4637,118,89187,1666,932261,12901,1021448,14567,3,964,888,8320,665,73122,50,3946,1107,"East TN",2455501,292.811935323993,0.128608362307212,593.239424459611,63.3679236945943,338.831057287291,12.8608362307212
2020-11-09,83026,620,78309,540,4717,80,89768,581,935713,3452,1025481,4033,9,973,-467,7853,1078,74200,18,3964,1117,"East TN",2455501,284.992757078902,0.127320232975886,164.243468033611,25.2494297497741,319.812535201574,12.7320232975886
2020-11-10,83965,939,79159,850,4806,89,90691,923,940715,5002,1031406,5925,27,1000,6,7859,906,75106,42,4006,1135,"East TN",2455501,280.87954352289,0.129267971148233,241.294953657115,38.2406686048998,320.056884521733,12.9267971148233
2020-11-11,85269,1304,80259,1100,5010,204,91860,1169,947261,6546,1039121,7715,26,1026,383,8242,895,76001,51,4057,1149,"East TN",2455501,296.884423993311,0.130460041392833,314.192500837915,53.1052522479119,335.654516125222,13.0460041392833
2020-11-12,86106,837,80964,705,5142,132,92624,764,951477,4216,1044101,4980,15,1041,8,8250,814,76815,34,4091,1167,"East TN",2455501,307.432169646846,0.130918485711273,202.809935732056,34.086730162195,335.980315218768,13.0918485711273
2020-11-13,87566,1460,82253,1289,5313,171,93924,1300,957339,5862,1051263,7162,27,1068,527,8777,906,77721,46,4137,1183,"East TN",2455501,327.550263673279,0.137898207076495,291.671638496584,59.4583345720486,357.442330506076,13.7898207076495
2020-11-14,89041,1475,83644,1391,5397,84,95458,1534,966236,8897,1061694,10431,7,1075,917,9694,551,78272,49,4186,1212,"East TN",2455501,333.57754690387,0.144801415722548,424.801293096602,60.0692078724464,394.787051603726,14.4801415722548
2020-11-15,90993,1952,85377,1733,5616,219,97418,1960,977410,11174,1074828,13134,7,1082,1338,11032,607,78879,54,4240,1229,"East TN",2455501,349.704602034371,0.154196328212814,534.880661828279,79.4949788250952,449.276949999206,15.4196328212814
2020-11-16,92518,1525,86776,1399,5742,126,98954,1536,985032,7622,1083986,9158,10,1092,172,11204,1343,80222,37,4277,1248,"East TN",2455501,386.560624491703,0.157012221177677,372.958512336179,62.1054522071056,456.281630510434,15.7012221177677
2020-11-17,93730,1212,87895,1119,5835,93,100175,1221,990176,5144,1090351,6365,31,1123,90,11294,1091,81313,42,4319,1275,"East TN",2455501,397.678518558942,0.160895750275681,259.213903802116,49.358562672139,459.94687031282,16.0895750275681
2020-11-18,94928,1198,88851,956,6077,242,101209,1034,995318,5142,1096527,6176,14,1137,56,11350,1128,82441,52,4371,1290,"East TN",2455501,393.361680569464,0.162857541023586,251.516900217104,48.7884142584344,462.227463967638,16.2857541023586
2020-11-19,96007,1079,89730,879,6277,200,102066,857,999979,4661,1102045,5518,45,1182,-243,11107,1277,83718,50,4421,1310,"East TN",2455501,403.217103149215,0.162950434902665,224.719924772989,43.9421527419455,452.331316501195,16.2950434902665
2020-11-20,97133,1126,90693,963,6440,163,103089,1023,1004880,4901,1107969,5924,28,1210,-127,10980,1225,84943,33,4454,1336,"East TN",2455501,389.614990993691,0.16162310866575,241.254228770422,45.8562224165252,447.15925589116,16.162310866575
2020-11-21,98351,1218,91757,1064,6594,154,104188,1099,1011286,6406,1115474,7505,3,1213,362,11342,853,85796,45,4499,1360,"East TN",2455501,379.148695113543,0.162328002975084,305.640274632346,49.6029119922981,461.901664874093,16.2328002975084
2020-11-22,99937,1586,93186,1429,6751,157,105854,1666,1020891,9605,1126745,11271,17,1230,804,12146,765,86561,56,4555,1387,"East TN",2455501,364.243386583838,0.162490128474296,459.010197918877,64.5896702953898,494.644473775413,16.2490128474296
2020-11-23,100828,891,93944,758,6884,133,106556,702,1024008,3117,1130564,3819,18,1248,-1160,10986,2033,88594,35,4590,1414,"East TN",2455501,338.423808420359,0.163210099188458,155.52834228127,36.2858740436269,447.403605211319,16.3210099188458
2020-11-24,101739,911,94677,733,7062,178,107261,705,1027035,3027,1134296,3732,13,1261,-736,10250,1634,90228,53,4643,1442,"East TN",2455501,326.165617525711,0.161247013312095,151.985277138963,37.1003717774906,417.430088605136,16.1247013312095
2020-11-25,102647,908,95364,687,7283,221,107806,545,1029343,2308,1137149,2853,38,1299,-492,9758,1362,91590,54,4697,1467,"East TN",2455501,314.355400384687,0.162399684899808,116.188101735654,36.9781971174111,397.393444352089,16.2399684899808
2020-11-26,104113,1466,96751,1387,7362,79,109477,1671,1037710,8367,1147187,10038,18,1317,-441,9317,1889,93479,22,4719,1486,"East TN",2455501,330.115931534949,0.164170838686811,408.796412626181,59.7026838922077,379.433769320395,16.4170838686811
2020-11-27,105817,1704,98318,1567,7499,137,111227,1750,1045250,7540,1156477,9290,5,1322,161,9478,1538,95017,48,4767,1514,"East TN",2455501,353.65491604361,0.167766141667354,378.334197379679,69.3952069251855,385.990476077998,16.7766141667354
2020-11-28,107442,1625,99700,1382,7742,243,112721,1494,1052782,7532,1165503,9026,2,1324,569,10047,1054,96071,43,4810,1542,"East TN",2455501,370.229944927736,0.170561074576745,367.582827292679,66.177940876424,409.16293660642,17.0561074576745
2020-11-29,109730,2288,101821,2121,7909,167,115047,2326,1063480,10698,1178527,13024,4,1328,1279,11326,1005,97076,50,4860,1567,"East TN",2455501,398.818815386351,0.177532733382256,530.400924292028,93.178540754005,461.250066687002,17.7532733382256
2020-11-30,111968,2238,103830,2009,8138,229,117268,2221,1072931,9451,1190199,11672,15,1343,-110,11216,2333,99409,53,4913,1598,"East TN",2455501,453.67523776207,0.17962605852268,475.340877482844,91.1422964193458,456.770329150752,17.962605852268
2020-12-01,114231,2263,105838,2008,8393,255,119406,2138,1081768,8837,1201174,10975,20,1363,421,11637,1822,101231,62,4975,1626,"East TN",2455501,508.735284571255,0.181599330123508,446.955631457694,92.1604185866754,473.915506448582,18.1599330123508
2020-12-02,115288,1057,106751,913,8537,144,120282,876,1084678,2910,1204960,3786,15,1378,-692,10945,1734,102965,41,5016,1659,"East TN",2455501,514.803292688539,0.183981949831148,154.184421020395,43.0462052346955,445.733884856899,18.3981949831148
2020-12-03,117098,1810,108322,1571,8776,239,122004,1722,1090668,5990,1212672,7712,33,1411,319,11264,1458,104423,45,5061,1680,"East TN",2455501,528.812653710994,0.191295716576315,314.070326177835,73.712044914663,458.725123712025,19.1295716576315
2020-12-04,118824,1726,109708,1386,9116,340,123461,1457,1096190,5522,1219651,6979,37,1448,-299,10965,1988,106411,35,5096,1715,"East TN",2455501,529.708601218244,0.193655617817457,284.218984231731,70.2911544324356,446.548382590763,19.3655617817457
2020-12-05,119957,1133,110617,909,9340,224,124390,929,1099252,3062,1223642,3991,5,1453,123,11088,1005,107416,23,5119,1741,"East TN",2455501,509.671956965198,0.200708646519548,162.533022792497,46.1412966233775,451.557543654024,20.0708646519548
2020-12-06,121425,1468,111879,1262,9546,206,125631,1241,1103743,4491,1229374,5732,20,1473,484,11572,964,108380,37,5156,1777,"East TN",2455501,476.277549876787,0.20815387338486,233.435050525331,59.7841336655941,471.268388813525,20.815387338486
2020-12-07,124148,2723,114284,2405,9864,318,128202,2571,1113291,9548,1241493,12119,31,1504,-205,11367,2897,111277,50,5206,1799,"East TN",2455501,496.029119922981,0.213163332943424,493.544901834697,110.89386646554,462.919787041422,21.3163332943424
2020-12-08,126913,2765,116647,2363,10266,402,130733,2531,1121651,8360,1252384,10891,45,1549,729,12096,1991,113268,70,5276,1823,"East TN",2455501,516.473013042959,0.221187268111697,443.534740975467,112.604311706654,492.608229440754,22.1187268111697
2020-12-09,129559,2646,119032,2385,10527,261,133311,2578,1128749,7098,1262060,9676,21,1570,580,12676,2045,115313,56,5332,1846,"East TN",2455501,581.184857998429,0.228178633975482,394.054003643248,107.758050190165,516.2286637228,22.8178633975482
2020-12-10,132633,3074,121713,2681,10920,393,136259,2948,1140220,11471,1276479,14419,30,1600,2530,15206,514,115827,70,5402,1883,"East TN",2455501,632.661114778613,0.223408090021471,587.21214122902,125.188301694848,619.262627056556,22.3408090021471
2020-12-11,134619,1986,123463,1750,11156,236,138051,1792,1147395,7175,1285446,8967,35,1635,452,15658,1499,117326,50,5452,1908,"East TN",2455501,643.249585318841,0.221749373052664,365.180058977781,80.8796249726634,637.670275841875,22.1749373052664
2020-12-12,137880,3261,126190,2727,11690,534,141025,2974,1158629,11234,1299654,14208,21,1656,1903,17561,1337,118663,73,5525,1933,"East TN",2455501,729.912144201937,0.218847024154081,578.619190136758,132.803855506473,715.169735219004,21.8847024154081
2020-12-13,142172,4292,130051,3861,12121,431,145391,4366,1175915,17286,1321306,21652,15,1671,2979,20540,1298,119961,62,5587,1967,"East TN",2455501,844.919224223488,0.214941478484097,881.77524668082,174.791213687146,836.489172677999,21.4941478484097
2020-12-14,145031,2859,132508,2457,12523,402,148064,2673,1185193,9278,1333257,11951,37,1708,-1137,19403,3959,123920,65,5652,2001,"East TN",2455501,850.457808813761,0.216446536768232,486.703120870242,116.432451055813,790.184976507849,21.6446536768232
2020-12-15,149159,4128,136050,3542,13109,586,151928,3864,1200214,15021,1352142,18885,34,1742,1607,21010,2487,126407,89,5741,2032,"East TN",2455501,905.965829376571,0.212464163275126,769.08948520078,168.112332269464,855.629869423796,21.2464163275126
2020-12-16,152377,3218,138306,2256,14071,962,154314,2386,1208109,7895,1362423,10281,19,1761,653,21663,2546,128953,57,5798,2074,"East TN",2455501,929.260464565072,0.209270348634457,418.692560092625,131.052685378666,882.223220434445,20.9270348634457
2020-12-17,156445,4068,141678,3372,14767,696,157923,3609,1218809,10700,1376732,14309,58,1819,1449,23112,2561,131514,72,5870,2114,"East TN",2455501,969.741001938097,0.216093283991501,582.73240369277,165.668839067872,941.233581252869,21.6093283991501
2020-12-18,159652,3207,144414,2736,15238,471,160802,2879,1227499,8690,1388301,11569,43,1862,836,23948,2328,133842,57,5927,2144,"East TN",2455501,1019.46608859048,0.22119488600457,471.146214153446,130.604711625041,975.27958652837,22.119488600457
2020-12-19,162292,2640,146656,2242,15636,398,163270,2468,1235863,8364,1399133,10832,27,1889,1286,25234,1327,135169,39,5966,2181,"East TN",2455501,994.175933954008,0.223615034328853,441.131972660569,107.513700870006,1027.65179081581,22.3615034328853
2020-12-20,165923,3631,149622,2966,16301,665,166588,3318,1249808,13945,1416396,17263,16,1905,2296,27530,1319,136488,52,6018,2215,"East TN",2455501,967.256783849813,0.222915133031865,703.033718984435,147.872063582951,1121.15613066336,22.2915133031865
2020-12-21,168237,2314,151364,1742,16873,572,168491,1903,1256724,6916,1425215,8819,14,1919,-1342,26188,3642,140130,35,6053,2250,"East TN",2455501,945.061720602028,0.222134017703734,359.15277574719,94.2373878080278,1066.5033327211,22.2134017703734
2020-12-22,170892,2655,153066,1702,17826,953,170292,1801,1261778,5054,1432070,6855,62,1981,-297,25891,2890,143020,57,6110,2295,"East TN",2455501,885.073962502968,0.229756781102993,279.169098281776,108.124574170404,1054.40804137323,22.9756781102993
2020-12-23,173110,2218,154512,1446,18598,772,171834,1542,1267556,5778,1439390,7320,41,2022,-561,25330,2738,145758,34,6144,2336,"East TN",2455501,844.349075809784,0.22763002325672,298.106170594107,90.3277986854821,1031.56137993835,22.763002325672
2020-12-24,175201,2091,155969,1457,19232,634,173432,1598,1273847,6291,1447279,7889,15,2037,-586,24744,2662,148420,30,6174,2376,"East TN",2455501,763.835974817359,0.219839256098771,321.278631122529,85.1557380754477,1007.69659633614,21.9839256098771
2020-12-25,177568,2367,157949,1980,19619,387,175598,2166,1282395,8548,1457993,10714,3,2040,-305,24439,2669,151089,26,6200,2412,"East TN",2455501,729.627069995085,0.212305573093038,436.326436030773,96.3958068027665,995.275505894724,21.2305573093038
2020-12-26,179508,1940,159417,1468,20091,472,177211,1613,1288048,5653,1465259,7266,2,2042,424,24863,1514,152603,42,6242,2450,"East TN",2455501,701.119649309856,0.210824789039107,295.907026712675,79.006280184777,1012.54285785263,21.0824789039107
2020-12-27,180804,1296,160327,910,20477,386,178201,990,1290841,2793,1469042,3783,27,2069,-183,24680,1452,154055,41,6283,2481,"East TN",2455501,606.027038881271,0.220586559282757,154.062246360315,52.7794531543665,1005.09020358778,22.0586559282757
2020-12-28,182200,1396,161305,978,20895,418,179220,1019,1292661,1820,1471881,2839,25,2094,-2427,22253,3798,157853,41,6324,2517,"East TN",2455501,568.641592896928,0.229910427291818,115.617953321949,56.8519418236849,906.250903583423,22.9910427291818
2020-12-29,185106,2906,163032,1727,22074,1179,181000,1780,1296750,4089,1477750,5869,50,2144,-110,22143,2966,160819,64,6388,2559,"East TN",2455501,578.863539456917,0.234413309982487,239.014360002297,118.346520730393,901.771166047173,23.4413309982487
2020-12-30,187433,2327,164648,1616,22785,711,182681,1681,1301230,4480,1483911,6161,40,2184,-551,21592,2838,163657,44,6432,2597,"East TN",2455501,583.302552106474,0.243637833831226,250.906026916707,94.7668113350392,879.331753479229,24.3637833831226
2020-12-31,190877,3444,167327,2679,23550,765,185576,2895,1308351,7121,1493927,10016,52,2236,598,22190,2794,166451,29,6461,2640,"East TN",2455501,638.403323802352,0.260332704510376,407.900465118931,140.256509771326,903.685235721753,26.0332704510376
2021-01-01,193117,2240,169043,1716,24074,524,187432,1856,1314552,6201,1501984,8057,24,2260,-445,21745,2661,169112,29,6490,2678,"East TN",2455501,633.231263192318,0.269009570139347,328.120412086983,91.2237461927322,885.562661143286,26.9009570139347
2021-01-02,195840,2723,171152,2109,24688,614,189683,2251,1321113,6561,1510796,8812,4,2264,1167,22912,1552,170664,62,6552,2713,"East TN",2455501,665.118849473081,0.273887168676022,358.867701540337,110.89386646554,933.088603914232,27.3887168676022
2021-01-03,197154,1314,172056,904,25098,410,190620,937,1324484,3371,1515104,4308,15,2279,-182,22730,1481,172145,23,6575,2755,"East TN",2455501,665.851897433558,0.269614866918501,175.442811874237,53.5125011148438,925.676674536072,26.9614866918501
2021-01-04,198710,1556,173180,1124,25530,432,191800,1180,1326849,2365,1518649,3545,46,2325,-1579,21151,3089,175234,33,6608,2802,"East TN",2455501,672.367879304468,0.268987341772152,144.369723327337,63.3679236945943,861.372078447535,26.8987341772152
2021-01-05,201613,2903,174919,1739,26694,1164,193629,1829,1332122,5273,1525751,7102,43,2368,-440,20711,3300,178534,58,6666,2845,"East TN",2455501,672.245704644388,0.263098685444053,289.228145294993,118.224346070313,843.453128302534,26.3098685444053
2021-01-06,204159,2546,176713,1794,27446,752,195532,1903,1337706,5584,1533238,7487,52,2420,65,20776,2429,180963,61,6727,2888,"East TN",2455501,681.164454830195,0.260526689237132,304.907226671869,103.685561520846,846.100245937591,26.0526689237132
2021-01-07,206671,2512,178852,2139,27819,373,197854,2322,1344815,7109,1542669,9431,33,2453,979,21755,1500,182463,44,6771,2920,"East TN",2455501,643.208860432148,0.251897747322638,384.076406403418,102.300915373278,885.969910010218,25.1897747322638
2021-01-08,209021,2350,180712,1860,28309,490,199845,1991,1352161,7346,1552006,9337,50,2503,1674,23429,626,183089,47,6818,2974,"East TN",2455501,647.688597968398,0.248150813641998,380.248267054259,95.7034837289824,954.143370334608,24.8150813641998
2021-01-09,211597,2576,182715,2003,28882,573,202024,2179,1360352,8191,1562376,10370,27,2530,755,24184,1794,184883,32,6850,3002,"East TN",2455501,641.7020396245,0.239259402869329,422.317075008318,104.907308121642,984.890659787962,23.9259402869329
2021-01-10,213265,1668,183849,1134,29416,534,203276,1252,1366158,5806,1569434,7058,36,2566,2,24186,1630,186513,41,6891,3041,"East TN",2455501,656.118649513887,0.232946806552549,287.436250280493,67.9291110042309,984.972109561348,23.2946806552549
2021-01-11,214690,1425,184863,1014,29827,411,204374,1098,1369431,3273,1573805,4371,28,2594,-2183,22003,3580,190093,40,6931,3080,"East TN",2455501,650.78368935708,0.227971571542534,178.008479735907,58.0329635377872,896.069681910128,22.7971571542534
2021-01-12,216508,1818,186000,1137,30508,681,205569,1195,1373635,4204,1579204,5399,60,2654,-2160,19843,3918,194011,39,6970,3117,"East TN",2455501,606.597187294976,0.223373805024975,219.8736632565,74.0378440082085,808.10392665285,22.3373805024975
2021-01-13,218037,1529,187078,1078,30959,451,206705,1136,1378373,4738,1585078,5874,49,2703,-1344,18499,2824,196835,32,7002,3142,"East TN",2455501,565.179977528007,0.215528549382716,239.217984435763,62.2683517538783,753.369678937211,21.5528549382716
2021-01-14,220288,2251,188859,1781,31429,470,208671,1966,1386898,8525,1595569,10491,38,2741,-199,18300,2412,199247,49,7051,3183,"East TN",2455501,554.550782101086,0.204480151228733,427.244786298193,91.6717199463572,745.265426485267,20.4480151228733
2021-01-15,221253,965,189530,671,31723,294,209365,694,1389956,3058,1599321,3752,23,2764,-366,17934,1308,200555,29,7080,3223,"East TN",2455501,498.146814031027,0.201204691958153,152.799774872826,39.2995156589226,730.360117955562,20.1204691958153
2021-01-16,223687,2434,191281,1751,32406,683,211368,2003,1400847,10891,1612215,12894,13,2777,359,18293,2062,202617,54,7134,3264,"East TN",2455501,492.363880120595,0.187483697505969,525.106689021914,99.1243742112099,744.980352278415,18.7483697505969
2021-01-17,224543,856,191887,606,32656,250,212040,672,1404466,3619,1616506,4291,13,2790,-829,17464,1672,204289,24,7158,3296,"East TN",2455501,459.295272125729,0.186182868796737,174.750488800453,34.8605030093655,711.219421209765,18.6182868796737
2021-01-18,225105,562,192206,319,32899,243,212394,354,1406550,2084,1618944,2438,13,2803,-2442,15022,2991,207280,21,7179,3327,"East TN",2455501,424.149694909511,0.177673408803917,99.2872737579826,22.8873863215694,611.76924790501,17.7673408803917
2021-01-19,226783,1678,193177,971,33606,707,213459,1065,1410758,4208,1624217,5273,21,2824,-1175,13847,2832,210112,51,7230,3365,"East TN",2455501,418.448210772466,0.175282696110013,214.742327533159,68.3363598711627,563.917506040519,17.5282696110013
2021-01-20,227767,984,193835,658,33932,326,214156,697,1414754,3996,1628910,4693,32,2856,-1005,12842,1957,212069,29,7259,3404,"East TN",2455501,396.25314752468,0.169989961671838,191.121893251113,40.073288506093,522.988994913869,16.9989961671838
2021-01-21,229333,1566,194977,1142,34356,424,215437,1281,1421688,6934,1637125,8215,65,2921,-770,12072,2271,214340,37,7296,3449,"East TN",2455501,368.356600139849,0.162816440465877,334.554944184507,63.7751725615261,491.630832160117,16.2816440465877
2021-01-22,230320,987,195684,707,34636,280,216254,817,1427133,5445,1643387,6262,32,2953,-734,11338,1689,216029,28,7324,3480,"East TN",2455501,369.252547647099,0.156333681296237,255.019240472718,40.1954631661726,461.73876532732,15.6333681296237
2021-01-23,231753,1433,196654,970,35099,463,217355,1101,1435415,8282,1652770,9383,19,2972,206,11544,1208,217237,40,7364,3503,"East TN",2455501,328.486936067222,0.147626679817532,382.121611842145,58.3587626313327,470.128091986116,14.7626679817532
2021-01-24,232378,625,197145,491,35233,134,217898,543,1438791,3376,1656689,3919,19,2991,-590,10954,1196,218433,19,7383,3529,"East TN",2455501,319.079487241097,0.145783042580196,159.600830950588,25.45305418324,446.100408837138,14.5783042580196
2021-01-25,233119,741,197657,512,35462,229,218447,549,1440548,1757,1658995,2306,44,3035,-1155,9799,1852,220285,20,7403,3559,"East TN",2455501,326.369241959177,0.151132306309455,93.9115887144823,30.1771410396493,399.06316470651,15.1132306309455
2021-01-26,234151,1032,198385,728,35766,304,219231,784,1445014,4466,1664245,5250,63,3098,-918,8881,1887,222172,25,7428,3581,"East TN",2455501,300.06096515538,0.14419906065754,213.805655139216,42.0280830673659,361.677718722167,14.419906065754
2021-01-27,235104,953,199089,704,36015,249,219986,755,1449537,4523,1669523,5278,55,3153,-384,8497,1282,223454,27,7455,3603,"East TN",2455501,298.798493667891,0.143550094797232,214.945951966625,38.8108170186043,346.039362231984,14.3550094797232
2021-01-28,236430,1326,199803,714,36627,612,220782,796,1453969,4432,1674751,5228,46,3199,-182,8315,1462,224916,28,7483,3630,"East TN",2455501,289.024520861527,0.142056025089034,212.909707631966,54.001199755162,338.627432853825,14.2056025089034
2021-01-29,237022,592,200154,351,36868,241,221179,397,1456636,2667,1677815,3064,17,3216,-681,7634,1256,226172,16,7499,3649,"East TN",2455501,272.938190617719,0.143052166840943,124.781052827916,24.1091329223649,310.893785015767,14.3052166840943
2021-01-30,238176,1154,201120,966,37056,188,222276,1097,1465687,9051,1687963,10148,44,3260,239,7873,871,227043,27,7526,3668,"East TN",2455501,261.575947230321,0.139828943255761,413.276150162431,46.9965192439343,320.627032935438,13.9828943255761
2021-01-31,238857,681,201562,442,37295,239,222767,491,1469614,3927,1692381,4418,29,3289,-85,7788,737,227780,30,7556,3689,"East TN",2455501,263.856540885139,0.136417124285554,179.922549410487,27.7336478380583,317.165417566517,13.6417124285554
2021-02-01,239549,692,201969,407,37580,285,223208,441,1471310,1696,1694518,2137,39,3328,-546,7242,1199,228979,11,7567,3715,"East TN",2455501,261.861021437173,0.134025842411958,87.0290828633342,28.1816215916833,294.929629432038,13.4025842411958
2021-02-02,240085,536,202318,349,37767,187,223571,363,1472369,1059,1695940,1422,57,3385,-839,6403,1318,230297,11,7578,3730,"East TN",2455501,241.661477637354,0.13693011516012,57.9107888777077,21.8285392675466,260.761449496457,13.693011516012
2021-02-03,241196,1111,203077,759,38119,352,224399,828,1478373,6004,1702772,6832,46,3431,37,6440,1028,231325,39,7617,3742,"East TN",2455501,248.096009734877,0.132725796264549,278.232425887833,45.2453491161274,262.268270304105,13.2725796264549
2021-02-04,242290,1094,203856,779,38434,315,225265,866,1486088,7715,1711353,8581,58,3489,-3,6437,1039,232364,35,7652,3761,"East TN",2455501,238.647836022058,0.122479645920988,349.460252714212,44.5530260423433,262.146095644025,12.2479645920988
2021-02-05,243107,817,204415,559,38692,258,225871,606,1489894,3806,1715765,4412,67,3556,-153,6284,903,233267,28,7680,3774,"East TN",2455501,247.810935528025,0.123636363636364,179.678200090328,33.2722324283313,255.915187979968,12.3636363636364
2021-02-06,244340,1233,205237,822,39103,411,226832,961,1498549,8655,1725381,9616,27,3583,502,6786,704,233971,22,7702,3804,"East TN",2455501,251.028201576786,0.121759580950345,391.610510441657,50.2137852926959,276.359081099947,12.1759580950345
2021-02-07,244857,517,205590,353,39267,164,227238,406,1501633,3084,1728871,3490,2,3585,-118,6668,633,234604,9,7711,3818,"East TN",2455501,244.349320159104,0.122526719649219,142.129854559212,21.0547664203761,271.553544470151,12.2526719649219
2021-02-08,245368,511,205889,299,39479,212,227558,320,1502996,1363,1730554,1683,32,3617,-628,6040,1107,235711,9,7720,3833,"East TN",2455501,236.978115667638,0.120712620712621,68.5399843046287,20.810417100217,245.978315626831,12.0712620712621
2021-02-09,246396,1028,206521,632,39875,396,228226,668,1507230,4234,1735456,4902,16,3633,-55,5985,1067,236778,37,7757,3844,"East TN",2455501,257.014759920684,0.117800384654317,199.633394569988,41.8651835205931,243.738446858706,11.7800384654317
2021-02-10,247243,847,207104,583,40139,264,228863,637,1513217,5987,1742080,6624,39,3672,-31,5954,839,237617,28,7785,3857,"East TN",2455501,246.263389833684,0.113564668769716,269.761649455651,34.4939790291268,242.475975371218,11.3564668769716
2021-02-11,248111,868,207687,583,40424,285,229514,651,1518791,5574,1748305,6225,37,3709,-100,5854,931,238548,31,7816,3875,"East TN",2455501,237.059565441024,0.114987010175363,253.51241966507,35.3492016496837,238.403486701899,11.4987010175363
2021-02-12,248943,832,208280,593,40663,239,230163,649,1524304,5513,1754467,6162,34,3743,57,5911,741,239289,11,7827,3884,"East TN",2455501,237.670438741422,0.110898661567878,250.9467518034,33.8831057287291,240.724805243411,11.0898661567878
2021-02-13,249537,594,208653,373,40884,221,230597,434,1528732,4428,1759329,4862,12,3755,-22,5889,604,239893,17,7844,3896,"East TN",2455501,211.647236144477,0.11090491339696,198.004399102261,24.1905826957513,239.828857736161,11.090491339696
2021-02-14,250078,541,209068,415,41010,126,231050,453,1531700,2968,1762750,3421,15,3770,-48,5841,574,240467,14,7858,3909,"East TN",2455501,212.624633425114,0.112518079046017,139.319837377382,22.0321637010125,237.874063174888,11.2518079046017
2021-02-15,250453,375,209277,209,41176,166,231278,228,1533024,1324,1764302,1552,5,3775,-575,5266,945,241412,9,7867,3919,"East TN",2455501,207.086048834841,0.110228754296551,63.2050241478216,15.271832509944,214.457253326307,11.0228754296551
2021-02-16,251219,766,209705,428,41514,338,231750,472,1536433,3409,1768183,3881,8,3783,-43,5223,801,242213,21,7888,3929,"East TN",2455501,196.416128521226,0.10767867510007,158.053285256247,31.1952632069789,212.7060831985,10.767867510007
2021-02-17,251840,621,210124,419,41716,202,232201,451,1539687,3254,1771888,3705,11,3794,-94,5129,704,242917,11,7899,3945,"East TN",2455501,187.212304128567,0.111983360171766,150.885705198247,25.2901546364673,208.877943849341,11.1983360171766
2021-02-18,252634,794,210676,552,41958,242,232807,606,1545407,5720,1778214,6326,42,3836,25,5154,727,243644,20,7919,3961,"East TN",2455501,184.198662513271,0.110100638603765,257.625633221082,32.3355600343881,209.89606601667,11.0100638603765
2021-02-19,253113,479,210980,304,42133,175,233152,345,1548115,2708,1781267,3053,5,3841,-222,4932,696,244340,11,7930,3970,"East TN",2455501,169.822777510577,0.111529850746269,124.333079074291,19.5072207260351,200.855141170783,11.1529850746269
2021-02-20,253735,622,211427,447,42308,175,233657,505,1553342,5227,1786999,5732,18,3859,73,5005,531,244871,18,7948,3980,"East TN",2455501,170.963074337986,0.110589085652331,233.435050525331,25.3308795231604,203.828057899386,11.0589085652331
2021-02-21,254083,348,211654,227,42429,121,233920,263,1555476,2134,1789396,2397,7,3866,-82,4923,423,245294,11,7959,3996,"East TN",2455501,163.103171206202,0.107708474067402,97.617553403562,14.172260569228,200.488617190545,10.7708474067402
2021-02-22,254441,358,211850,196,42591,162,234148,228,1556859,1383,1791007,1611,7,3873,-481,4442,832,246126,22,7981,4011,"East TN",2455501,162.410848132418,0.107470511140236,65.6077924627194,14.5795094361599,180.899946691123,10.7470511140236
2021-02-23,255084,643,212199,349,42885,294,234516,368,1559805,2946,1794321,3314,26,3899,-144,4298,761,246887,27,8008,4016,"East TN",2455501,157.401687069156,0.105822939781162,134.962274501212,26.1861021437173,175.035563007305,10.5822939781162
2021-02-24,255825,741,212748,549,43077,192,235126,610,1566007,6202,1801133,6812,19,3918,55,4353,667,247554,20,8028,4022,"East TN",2455501,162.288673472338,0.100017096939648,277.417928153969,30.1771410396493,177.27543177543,10.0017096939648
2021-02-25,256460,635,213193,445,43267,190,235621,495,1570775,4768,1806396,5263,21,3939,-96,4257,710,248264,16,8044,4031,"East TN",2455501,155.813416488122,0.0998509687034277,214.335078666227,25.8603030501718,173.365842652884,9.98509687034277
2021-02-26,256922,462,213517,324,43405,138,235989,368,1573897,3122,1809886,3490,14,3953,-184,4073,632,248896,11,8055,4035,"East TN",2455501,155.121093414338,0.0991299486355219,142.129854559212,18.814897652251,165.872463501338,9.91299486355219
2021-02-27,257361,439,213742,225,43619,214,236263,274,1577993,4096,1814256,4370,7,3960,12,4085,420,249316,15,8070,4041,"East TN",2455501,147.668439149485,0.0956084675496203,177.967754849214,17.8782252583078,166.361162141657,9.56084675496203
2021-02-28,257727,366,214016,274,43711,92,236576,313,1580553,2560,1817129,2873,5,3965,-54,4031,415,249731,10,8080,4047,"East TN",2455501,148.401487109962,0.0957703818555511,117.002599469518,14.9053085297053,164.162018260225,9.57703818555511
2021-03-01,257970,243,214164,148,43806,95,236732,156,1581332,779,1818064,935,4,3969,-413,3618,652,250383,11,8091,4051,"East TN",2455501,143.718125140246,0.0955020881842037,38.077769058127,9.89614746644371,147.34264005594,9.55020881842037
2021-03-02,258590,620,214554,390,44036,230,237179,447,1584789,3457,1821968,3904,7,3976,3,3621,610,250993,23,8114,4056,"East TN",2455501,142.781452746303,0.0963214815350671,158.98995765019,25.2494297497741,147.464814716019,9.63214815350671
2021-03-03,259072,482,214857,303,44215,179,237534,355,1588961,4172,1826495,4527,7,3983,-147,3474,622,251615,16,8130,4059,"East TN",2455501,132.233707092768,0.0949451935967195,184.361562060044,19.6293953861147,141.478256372121,9.49451935967195
2021-03-04,259678,606,215271,414,44407,192,238006,472,1593783,4822,1831789,5294,18,4001,46,3520,542,252157,16,8146,4064,"East TN",2455501,131.052685378666,0.093923522230536,215.597550153716,24.6792813360695,143.351601160008,9.3923522230536
2021-03-05,260148,470,215582,311,44566,159,238360,354,1597466,3683,1835826,4037,15,4016,-64,3456,519,252676,15,8161,4068,"East TN",2455501,131.378484472212,0.0914032382420971,164.406367580384,19.1406967457965,140.745208411644,9.14032382420971
2021-03-06,260611,463,215905,323,44706,140,238732,372,1601742,4276,1840474,4648,1,4017,49,3505,413,253089,8,8169,4073,"East TN",2455501,132.355881752848,0.0941719429399649,189.289273349919,18.8556225389442,142.74072785961,9.41719429399649
2021-03-07,260866,255,216069,164,44797,91,238916,184,1603472,1730,1842388,1914,1,4018,-111,3394,365,253454,4,8173,4077,"East TN",2455501,127.835419329905,0.0926402470406588,77.9474331307542,10.3848461067619,138.220265436666,9.26402470406588
2021-03-08,261322,456,216361,292,44961,164,239228,312,1605054,1582,1844282,1894,3,4021,-127,3267,580,254034,9,8182,4085,"East TN",2455501,136.509820195553,0.0952017697764894,77.1329353968905,18.5705483320919,133.048204826632,9.52017697764894
2021-03-09,261861,539,216643,282,45218,257,239547,319,1607630,2576,1847177,2895,6,4027,25,3292,508,254542,17,8199,4096,"East TN",2455501,133.211104373405,0.0939347058590186,117.898546976768,21.9507139276262,134.066326993962,9.39347058590186
2021-03-10,262510,649,217106,463,45404,186,240054,507,1613101,5471,1853155,5978,7,4034,174,3466,468,255010,24,8223,4104,"East TN",2455501,140.012160451167,0.0945236309077269,243.453372651854,26.4304514638764,141.152457278576,9.45236309077269
2021-03-11,263044,534,217446,340,45598,194,240419,365,1616440,3339,1856859,3704,5,4039,88,3554,441,255451,8,8231,4111,"East TN",2455501,137.079968609257,0.0962504986039091,150.844980311554,21.7470894941603,144.736247307576,9.62504986039091
2021-03-12,263507,463,217814,368,45693,95,240835,416,1619788,3348,1860623,3764,5,4044,5,3559,453,255904,10,8241,4119,"East TN",2455501,136.794894402405,0.099810460942856,153.288473513145,18.8556225389442,144.939871741042,9.9810460942856
2021-03-13,263954,447,218030,216,45924,231,241115,280,1623428,3640,1864543,3920,2,4046,42,3601,403,256307,20,8261,4125,"East TN",2455501,136.143296215314,0.0990070214799119,159.641555837281,18.2040243518532,146.650316982156,9.90070214799119
2021-03-14,264216,262,218206,176,46010,86,241326,211,1625270,1842,1866596,2053,0,4046,-50,3551,312,256619,10,8271,4130,"East TN",2455501,136.428370422166,0.0995538664904164,83.6081923811067,10.6699203136142,144.614072647496,9.95538664904164
2021-03-15,264572,356,218391,185,46181,171,241543,217,1626466,1196,1868009,1413,4,4050,-168,3383,520,257139,15,8286,4134,"East TN",2455501,132.355881752848,0.0975681712816622,57.544264897469,14.4980596627735,137.772291683041,9.75681712816622
2021-03-16,265271,699,218842,451,46429,248,242039,496,1629734,3268,1871773,3764,4,4054,195,3578,500,257639,35,8321,4135,"East TN",2455501,138.871863623757,0.101317287363799,153.288473513145,28.4666957985356,145.713644588212,10.1317287363799
2021-03-17,265696,425,219174,332,46522,93,242403,364,1633457,3723,1875860,4087,1,4055,-31,3547,455,258094,15,8336,4143,"East TN",2455501,129.749489004484,0.103457388240476,166.442611915043,17.3080768446032,144.451173100724,10.3457388240476
2021-03-18,266246,550,219523,349,46723,201,242788,385,1636748,3291,1879536,3676,6,4061,99,3646,445,258539,31,8367,4149,"East TN",2455501,130.401087191575,0.104467081183578,149.704683484144,22.3986876812512,148.482936883349,10.4467081183578
2021-03-19,267038,792,220053,530,46985,262,243351,563,1641794,5046,1885145,5609,15,4076,336,3982,441,258980,25,8392,4153,"East TN",2455501,143.799574913633,0.102601745371503,228.425889462069,32.2541102610017,162.166498812259,10.2601745371503
2021-03-20,267311,273,220219,166,47092,107,243545,194,1643915,2121,1887460,2315,1,4077,-42,3940,314,259294,15,8407,4154,"East TN",2455501,136.713444629019,0.10603482131169,94.278112694721,11.1178940672392,160.456053571145,10.603482131169
2021-03-21,267592,281,220415,196,47177,85,243770,225,1645715,1800,1889485,2025,-7,4070,-32,3908,320,259614,8,8415,4160,"East TN",2455501,137.487217476189,0.106776180698152,82.4678955536976,11.4436931607847,159.152857196963,10.6776180698152
2021-03-22,268117,525,220754,339,47363,186,244126,356,1647804,2089,1891930,2445,14,4084,-12,3896,523,260137,19,8434,4166,"East TN",2455501,144.369723327337,0.107980435600518,99.5723479648349,21.3805655139216,158.664158556645,10.7980435600518
2021-03-23,268554,437,221002,248,47552,189,244393,267,1650260,2456,1894653,2723,11,4095,-76,3820,502,260639,16,8450,4171,"East TN",2455501,133.699803013723,0.102884615384615,110.89386646554,17.7967754849214,155.569067167963,10.2884615384615
2021-03-24,269151,597,221459,457,47692,140,244886,493,1654958,4698,1899844,5191,4,4099,84,3904,509,261148,24,8474,4175,"East TN",2455501,140.704483524951,0.103527351567712,211.402886824318,24.3127573558308,158.98995765019,10.3527351567712
2021-03-25,269551,400,221766,307,47785,93,245219,333,1657926,2968,1903145,3301,8,4107,-66,3838,458,261606,23,8497,4177,"East TN",2455501,134.595750520973,0.102969206658478,134.4328509742,16.2899546772736,156.30211512844,10.2969206658478
2021-03-26,269961,410,222088,322,47873,88,245565,346,1660559,2633,1906124,2979,7,4114,-63,3775,466,262072,12,8509,4182,"East TN",2455501,119.038843804177,0.105534105534106,121.319437458995,16.6972035442054,153.73644726677,10.5534105534106
2021-03-27,270164,203,222268,180,47896,23,245775,210,1663071,2512,1908846,2722,2,4116,-165,3610,366,262438,11,8520,4187,"East TN",2455501,116.188101735654,0.104273823997007,110.853141578847,8.26715199871635,147.016840962394,10.4273823997007
2021-03-28,270480,316,222487,219,47993,97,246020,245,1665143,2072,1911163,2317,5,4121,-67,3543,378,262816,17,8537,4193,"East TN",2455501,117.613472769915,0.103791862717963,94.3595624681073,12.8690641950461,144.288273553951,10.3791862717963
2021-03-29,270919,439,222724,237,48195,202,246275,255,1666999,1856,1913274,2111,18,4139,-96,3447,517,263333,17,8554,4196,"East TN",2455501,114.111132514302,0.100684032983508,85.9702358093114,17.8782252583078,140.378684431405,10.0684032983508
2021-03-30,271293,374,222982,258,48311,116,246597,322,1669475,2476,1916072,2798,5,4144,-146,3301,515,263848,19,8573,4200,"East TN",2455501,111.545464652631,0.102899295018442,113.948232967529,15.2311076232508,134.4328509742,10.2899295018442
2021-03-31,271954,661,223424,442,48530,219,247085,488,1674291,4816,1921376,5304,4,4148,167,3468,490,264338,17,8590,4203,"East TN",2455501,114.151857400995,0.102127066691436,216.004799020648,26.9191501041946,141.233907051962,10.2127066691436
2021-04-01,272402,448,223745,321,48657,127,247435,350,1677120,2829,1924555,3179,1,4149,-88,3380,535,264873,13,8603,4204,"East TN",2455501,116.106651962268,0.103503035964503,129.464414797632,18.2447492385464,137.650117022962,10.3503035964503
2021-04-02,272753,351,223980,235,48773,116,247687,252,1680142,3022,1927829,3274,0,4149,-81,3299,432,265305,9,8612,4208,"East TN",2455501,113.70388364737,0.0977654918221608,133.333279033484,14.2944352293076,134.351401200814,9.77654918221608
2021-04-03,273096,343,224231,251,48865,92,247962,275,1682493,2351,1930455,2626,0,4149,-54,3245,397,265702,12,8624,4214,"East TN",2455501,119.405367784415,0.101207830070804,106.943552456301,13.9686361357621,132.152257319382,10.1207830070804
2021-04-04,273267,171,224354,123,48913,48,248103,141,1684088,1595,1932191,1736,6,4155,-179,3066,344,266046,6,8630,4217,"East TN",2455501,113.500259213904,0.0990583983260415,70.6984032993674,6.96395562453446,124.862502601302,9.90583983260415
2021-04-05,273673,406,224589,235,49084,171,248326,223,1685307,1219,1933633,1442,6,4161,-95,2971,495,266541,37,8667,4220,"East TN",2455501,112.156337953029,0.100741686723316,58.7252866115713,16.5343039974327,120.99363836545,10.0741686723316
2021-04-06,274104,431,224839,250,49265,181,248604,278,1687395,2088,1935999,2366,3,4164,-8,2963,436,266977,22,8689,4221,"East TN",2455501,114.47765649454,0.100717619310483,96.3550819160733,17.5524261647623,120.667839271904,10.0717619310483
2021-04-07,274736,632,225302,463,49434,169,249112,508,1692087,4692,1941199,5200,5,4169,207,3170,420,267397,21,8710,4221,"East TN",2455501,113.296634780438,0.10225495636382,211.769410804557,25.7381283900923,129.097890817393,10.225495636382
2021-04-08,275141,405,225557,255,49584,150,249401,289,1695100,3013,1944501,3302,-1,4168,42,3212,364,267761,16,8726,4224,"East TN",2455501,111.545464652631,0.0985661285470771,134.473575860894,16.4935791107395,130.808336058507,9.85661285470771
2021-04-09,275659,518,225963,406,49696,112,249851,450,1698976,3876,1948827,4326,4,4172,107,3319,407,268168,27,8753,4225,"East TN",2455501,118.346520730393,0.103057434041337,176.175859834714,21.0954913070693,135.165898934678,10.3057434041337
2021-04-10,275963,304,226178,215,49785,89,250098,247,1701757,2781,1951855,3028,1,4173,-15,3304,318,268486,14,8767,4229,"East TN",2455501,116.758250149359,0.0998130841121495,123.314956906961,12.3803655547279,134.55502563428,9.98130841121495
2021-04-11,276200,237,226341,163,49859,74,250272,174,1703470,1713,1953742,1887,2,4175,-87,3217,322,268808,9,8776,4232,"East TN",2455501,119.446092671109,0.100644981671384,76.8478611900382,9.65179814628461,131.011960491973,10.0644981671384
2021-04-12,276664,464,226663,322,50001,142,250602,330,1705233,1763,1955835,2093,3,4178,12,3229,449,269257,15,8791,4239,"East TN",2455501,121.808136099313,0.102513287091253,85.2371878488341,18.8963474256374,131.500659132291,10.2513287091253
2021-04-13,277042,378,226903,240,50139,138,250852,250,1707291,2058,1958143,2308,3,4181,-57,3172,432,269689,14,8805,4241,"East TN",2455501,119.649717104575,0.101517341040462,93.9930384878687,15.3940071700236,129.17934059078,10.1517341040462
2021-04-14,277722,680,227405,502,50317,178,251409,557,1712112,4821,1963521,5378,0,4181,269,3441,411,270100,25,8830,4242,"East TN",2455501,121.604511665847,0.102902965684078,219.018440635944,27.6929229513651,140.134335111246,10.2902965684078
2021-04-15,278261,539,227771,366,50490,173,251789,380,1715257,3145,1967046,3525,2,4183,114,3555,423,270523,24,8854,4246,"East TN",2455501,127.061646482734,0.105921490352628,143.555225593474,21.9507139276262,144.776972194269,10.5921490352628
2021-04-16,279239,978,228666,895,50573,83,252894,1105,1722741,7484,1975635,8589,3,4186,633,4188,342,270865,32,8886,4247,"East TN",2455501,145.795094361599,0.113510892270964,349.786051807757,39.8289391859339,170.555825471055,11.3510892270964
2021-04-17,279441,202,228813,147,50628,55,253067,173,1724972,2231,1978039,2404,0,4186,-92,4096,294,271159,10,8896,4248,"East TN",2455501,141.641155918894,0.113389856400855,97.9026276104143,8.22642711202317,166.809135895282,11.3389856400855
2021-04-18,279659,218,229000,187,50659,31,253270,203,1726775,1803,1980045,2006,6,4192,-122,3974,334,271493,7,8903,4253,"East TN",2455501,140.867383071723,0.113979393985477,81.6941227065271,8.87802529911411,161.840699718713,11.3979393985477
2021-04-19,279987,328,229195,195,50792,133,253480,210,1728224,1449,1981704,1659,8,4200,-214,3760,534,272027,14,8917,4255,"East TN",2455501,135.32879848145,0.111252850902625,67.5625870239923,13.3577628353644,153.125573966372,11.1252850902625
2021-04-20,280340,353,229472,277,50868,76,253761,281,1730672,2448,1984433,2729,4,4204,-112,3648,461,272488,20,8937,4258,"East TN",2455501,134.310676314121,0.11065043742868,111.138215785699,14.375885002694,148.564386656735,11.065043742868
2021-04-21,280853,513,229802,330,51051,183,254100,339,1734453,3781,1988553,4120,4,4208,29,3677,480,272968,12,8949,4263,"East TN",2455501,127.509620236359,0.107502396931927,167.786533175918,20.8918668736034,149.745408370838,10.7502396931927
2021-04-22,281495,642,230200,398,51295,244,254551,451,1738705,4252,1993256,4703,3,4211,192,3869,447,273415,21,8970,4265,"East TN",2455501,131.704283565757,0.10537962609691,191.529142118044,26.1453772570241,157.564586615929,10.537962609691
2021-04-23,281879,384,230478,278,51401,106,254859,308,1741908,3203,1996767,3511,0,4211,-10,3859,394,273809,10,8980,4266,"East TN",2455501,107.513700870006,0.0929869392390687,142.985077179769,15.6383564901827,157.157337748997,9.29869392390687
2021-04-24,282139,260,230666,188,51473,72,255068,209,1744906,2998,1999974,3207,0,4211,-131,3728,391,274200,19,8999,4270,"East TN",2455501,109.87574429821,0.0912240711192159,130.604711625041,10.5884705402278,151.82237759219,9.12240711192159
2021-04-25,282339,200,230814,148,51525,52,255227,159,1746557,1651,2001784,1810,4,4215,-114,3614,310,274510,17,9016,4273,"East TN",2455501,109.142696337733,0.0900225401352408,73.712044914663,8.1449773386368,147.179740509167,9.00225401352408
2021-04-26,282726,387,231057,243,51669,144,255479,252,1748529,1972,2004008,2224,6,4221,-142,3472,523,275033,15,9031,4277,"East TN",2455501,111.545464652631,0.0896251793400287,90.5721480056412,15.7605311502622,141.396806598735,8.96251793400287
2021-04-27,283114,388,231260,203,51854,185,255697,218,1750893,2364,2006590,2582,3,4224,-54,3418,439,275472,23,9054,4280,"East TN",2455501,112.970835686892,0.087376449880399,105.151657441801,15.8012560369554,139.197662717303,8.7376449880399
2021-04-28,283601,487,231606,346,51995,141,256078,381,1755020,4127,2011098,4508,6,4230,8,3426,473,275945,22,9076,4285,"East TN",2455501,111.91198863287,0.0877356398314482,183.587789212873,19.8330198195806,139.523461810848,8.77356398314482
2021-04-29,283993,392,231885,279,52108,113,256382,304,1757952,2932,2014334,3236,1,4231,18,3444,373,276318,20,9096,4287,"East TN",2455501,101.730766959574,0.0868678242717525,131.785733339143,15.9641555837281,140.256509771326,8.68678242717525
2021-04-30,284363,370,232113,228,52250,142,256622,240,1761219,3267,2017841,3507,0,4231,-2,3442,372,276690,15,9111,4290,"East TN",2455501,101.160618545869,0.0836575875486381,142.822177632996,15.0682080764781,140.175059997939,8.36575875486381
2021-05-01,284598,235,232295,182,52303,53,256811,189,1763710,2491,2020521,2680,-1,4230,-31,3411,267,276957,15,9126,4290,"East TN",2455501,100.142496378539,0.0848299021755001,109.142696337733,9.57034837289824,138.912588510451,8.48299021755001
2021-05-02,284773,175,232423,128,52350,47,256944,133,1765186,1476,2022130,1609,1,4231,-76,3335,250,277207,11,9137,4294,"East TN",2455501,99.1243742112099,0.0843900520986926,65.526342689333,7.1268551713072,135.817497121769,8.43900520986926
2021-05-03,284985,212,232537,114,52448,98,257070,126,1766670,1484,2023740,1610,5,4236,-224,3111,431,277638,16,9153,4296,"East TN",2455501,91.9975190399027,0.0806304480032435,65.5670675760262,8.63367597895501,126.695122502495,8.06304480032435
2021-05-04,285306,321,232758,221,52548,100,257315,245,1769070,2400,2026385,2645,7,4243,-79,3032,393,278031,12,9165,4302,"East TN",2455501,89.2689516314593,0.0817378125789341,107.717325303472,13.0726886285121,123.477856453734,8.17378125789341
2021-05-05,285770,464,233051,293,52719,171,257626,311,1773219,4149,2030845,4460,5,4248,127,3159,332,278363,22,9187,4307,"East TN",2455501,88.3322792375161,0.0783916544285208,181.632994651601,18.8963474256374,128.649917063768,7.83916544285208
2021-05-06,286056,286,233248,197,52808,89,257857,231,1775657,2438,2033514,2669,4,4252,-101,3058,383,278746,10,9197,4312,"East TN",2455501,84.0154412480386,0.076903023983316,108.694722584108,11.6473175942506,124.536703507757,7.6903023983316
2021-05-07,286422,366,233497,249,52925,117,258126,269,1779106,3449,2037232,3718,0,4252,17,3075,349,279095,15,9212,4313,"East TN",2455501,83.8525417012658,0.0775617554535609,151.415128725258,14.9053085297053,125.229026581541,7.75617554535609
2021-05-08,286593,171,233600,103,52993,68,258240,114,1781001,1895,2039241,2009,0,4252,-98,2977,269,279364,7,9219,4315,"East TN",2455501,81.2461489529021,0.0763354700854701,81.8162973666066,6.96395562453446,121.237987685609,7.63354700854701
2021-05-09,286739,146,233715,115,53024,31,258372,132,1782712,1711,2041084,1843,4,4256,-161,2816,303,279667,11,9230,4317,"East TN",2455501,80.0651272387997,0.0753402975625198,75.0559661755381,5.94583345720486,114.681280928006,7.53402975625198
2021-05-10,286974,235,233851,136,53123,99,258517,145,1784228,1516,2042745,1661,7,4263,-200,2616,428,280095,19,9249,4318,"East TN",2455501,81.001799632743,0.0761378584583004,67.6440367973786,9.57034837289824,106.536303589369,7.61378584583004
2021-05-11,287288,314,234079,228,53209,86,258761,244,1786907,2679,2045668,2923,1,4264,-59,2557,372,280467,19,9268,4320,"East TN",2455501,80.7167254258907,0.0749883316911269,119.038843804177,12.7876144216598,104.133535274471,7.49883316911269
2021-05-12,287592,304,234296,217,53296,87,259012,251,1790972,4065,2049984,4316,3,4267,-53,2504,354,280821,15,9283,4322,"East TN",2455501,74.2007435549812,0.0724175766758974,175.768610967782,12.3803655547279,101.975116279733,7.24175766758974
2021-05-13,287802,210,234432,136,53370,74,259157,145,1793705,2733,2052862,2878,1,4268,-134,2370,343,281164,9,9292,4324,"East TN",2455501,71.1056521662993,0.067190407277238,117.206223902984,8.55222620556864,96.5179814628461,6.7190407277238
2021-05-14,288103,301,234651,219,53452,82,259405,248,1796391,2686,2055796,2934,1,4269,33,2403,267,281431,19,9311,4327,"East TN",2455501,68.4585345312423,0.0688967894850248,119.486817557802,12.2581908946484,97.8619027237211,6.88967894850248
2021-05-15,288211,108,234732,81,53479,27,259507,102,1798379,1988,2057886,2090,0,4269,-155,2248,263,281694,5,9316,4330,"East TN",2455501,65.8928666695717,0.0679538750335211,85.1150131887546,4.39828776286387,91.5495452862776,6.79538750335211
2021-05-16,288311,100,234806,74,53505,26,259592,85,1799828,1449,2059420,1534,3,4272,-123,2125,220,281914,4,9320,4333,"East TN",2455501,64.0195218816853,0.0665357766143106,62.4719761873443,4.0724886693184,86.540384223016,6.65357766143106
2021-05-17,288510,199,234910,104,53600,95,259702,110,1801397,1569,2061099,1679,6,4278,-117,2008,310,282224,10,9330,4337,"East TN",2455501,62.5534259607306,0.064563582870219,68.3770847578559,8.10425245194362,81.7755724799135,6.4563582870219
2021-05-18,288723,213,235045,135,53678,78,259848,146,1803635,2238,2063483,2384,8,4286,-102,1906,307,282531,20,9350,4340,"East TN",2455501,58.440212404719,0.0610159977547011,97.0881298765507,8.67440086564819,77.6216340372087,6.10159977547011
2021-05-19,288940,217,235209,164,53731,53,260015,167,1806905,3270,2066920,3437,1,4287,-53,1853,269,282800,19,9369,4342,"East TN",2455501,54.897147262412,0.0592229570146434,139.971435564473,8.83730041242093,75.46321504247,5.92229570146434
2021-05-20,289118,178,235342,133,53776,45,260171,156,1821074,14169,2081245,14325,3,4290,-92,1761,267,283067,7,9376,4344,"East TN",2455501,53.5939508882301,0.0357256104005919,583.384001879861,7.24902983138675,71.716525466697,3.57256104005919
2021-05-21,289282,164,235450,108,53832,56,260292,121,1823352,2278,2083644,2399,0,4290,-59,1702,223,283290,9,9385,4346,"East TN",2455501,48.0146414112639,0.0318514794599253,97.6990031769484,6.67888141768218,69.3137571517992,3.18514794599253
2021-05-22,289353,71,235498,48,53855,23,260354,62,1824939,1587,2085293,1649,0,4290,-107,1595,178,283468,10,9395,4346,"East TN",2455501,46.5078206036161,0.0309045134454701,67.1553381570604,2.89146695521606,64.9561942756285,3.09045134454701
2021-05-23,289427,74,235549,51,53878,23,260415,61,1826004,1065,2086419,1126,3,4293,-129,1466,200,283668,5,9400,4348,"East TN",2455501,45.4489735495933,0.0304826104670543,45.8562224165252,3.01364161529562,59.7026838922077,3.04826104670543
2021-05-24,289587,160,235660,111,53927,49,260541,126,1827929,1925,2088470,2051,0,4293,-91,1375,251,283919,7,9407,4349,"East TN",2455501,43.8607029685592,0.0306528807862336,83.5267426077204,6.51598187090944,55.996719203128,3.06528807862336
2021-05-25,289731,144,235756,96,53975,48,260629,88,1829656,1727,2090285,1815,0,4293,-72,1303,216,284135,8,9415,4353,"East TN",2455501,41.0506857867295,0.0291396164465338,73.915669348129,5.8643836838185,53.0645273612188,2.91396164465338
2021-05-26,289915,184,235896,140,54019,44,260794,165,1832540,2884,2093334,3049,7,4300,-33,1270,210,284345,13,9428,4355,"East TN",2455501,39.7067645258544,0.0294919360944953,124.170179527518,7.49337915154586,51.7206061003437,2.94919360944953
2021-05-27,290039,124,235972,76,54067,48,260933,139,1835512,2972,2096445,3111,4,4304,-81,1189,201,284546,9,9437,4359,"East TN",2455501,37.5076206444225,0.0501315789473684,126.695122502495,5.04988594995482,48.4218902781958,5.01315789473684
2021-05-28,290156,117,236062,90,54094,27,261031,98,1837624,2112,2098655,2210,0,4304,-61,1128,178,284724,5,9442,4360,"East TN",2455501,35.5935509698428,0.0492305642528812,90.0019995919366,4.76481174310253,45.9376721899116,4.92305642528812
2021-05-29,290207,51,236094,32,54113,19,261068,37,1838701,1077,2099769,1114,0,4304,-89,1039,140,284864,7,9449,4362,"East TN",2455501,34.7790532359791,0.0493230174081238,45.367523776207,2.07696922135238,42.3131572742182,4.93230174081238
2021-05-30,290262,55,236134,40,54128,15,261114,46,1839787,1086,2100901,1132,0,4304,-66,973,121,284985,7,9456,4364,"East TN",2455501,34.0052803888086,0.0482668139759702,46.1005717366843,2.23986876812512,39.625314752468,4.82668139759702
2021-05-31,290342,80,236200,66,54142,14,261185,71,1841214,1427,2102399,1498,6,4310,-95,878,169,285154,4,9460,4365,"East TN",2455501,30.7472894533539,0.0462344748366717,61.0058802663896,3.25799093545472,35.7564505166156,4.62344748366717
2021-06-01,290472,130,236293,93,54179,37,261279,94,1842529,1315,2103808,1409,3,4313,-37,841,164,285318,11,9471,4365,"East TN",2455501,30.1771410396493,0.048066257487244,57.3813653506963,5.29423527011392,34.2496297089677,4.8066257487244
2021-06-02,290591,119,236364,71,54227,48,261352,73,1844509,1980,2105861,2053,1,4314,-20,821,138,285456,9,9480,4369,"East TN",2455501,27.5300234045924,0.0445437854234853,83.6081923811067,4.8462615164889,33.4351319751041,4.45437854234853
2021-06-03,290679,88,236421,57,54258,31,261471,119,1847675,3166,2109146,3285,1,4315,-43,778,130,285586,6,9486,4372,"East TN",2455501,26.0639274836378,0.0423588693803637,133.781252787109,3.58379002900019,31.6839618472971,4.23588693803637
2021-06-04,290770,91,236480,59,54290,32,261549,78,1849826,2151,2111375,2229,1,4316,-32,746,122,285708,7,9493,4372,"East TN",2455501,25.005080429615,0.0407232704402516,90.7757724391071,3.70596468907974,30.3807654731153,4.07232704402516
2021-06-05,290811,41,236506,26,54305,15,261579,30,1851209,1383,2112788,1413,-1,4315,-69,677,111,285819,2,9495,4374,"East TN",2455501,24.5978315626831,0.0392503264459636,57.544264897469,1.66972035442054,27.5707482912856,3.92503264459636
2021-06-06,290837,26,236522,16,54315,10,261598,19,1852125,916,2113723,935,-1,4314,-57,620,84,285903,2,9497,4374,"East TN",2455501,23.4168098485808,0.037747621275932,38.077769058127,1.05884705402278,25.2494297497741,3.7747621275932
2021-06-07,290909,72,236556,34,54353,38,261650,52,1853395,1270,2115045,1322,3,4317,-71,549,140,286043,10,9507,4375,"East TN",2455501,23.0910107550353,0.0367705203226317,53.8383002083892,2.93219184190925,22.357962794558,3.67705203226317
2021-06-08,290996,87,236623,67,54373,20,261720,70,1854874,1479,2116594,1549,3,4320,-28,521,112,286155,4,9511,4378,"East TN",2455501,21.3398406272284,0.0344908493664946,63.082849487742,3.54306514230701,21.2176659671489,3.44908493664946
2021-06-09,291044,48,236661,38,54383,10,261774,54,1857605,2731,2119379,2785,0,4320,-64,457,112,286267,3,9514,4379,"East TN",2455501,18.4483736720124,0.0312176357449327,113.418809440517,1.95479456127283,18.6112732187851,3.12176357449327
2021-06-10,291119,75,236718,57,54401,18,261840,66,1859390,1785,2121230,1851,4,4324,-22,435,93,286360,4,9518,4382,"East TN",2455501,17.918950145001,0.0305362462760675,75.3817652690836,3.0543665019888,17.715325711535,3.05362462760675
2021-06-11,291189,70,236764,46,54425,24,261896,56,1860874,1484,2122770,1540,2,4326,-5,430,73,286433,4,9522,4383,"East TN",2455501,17.0637275244441,0.0304519526107942,62.7163255075034,2.85074206852288,17.5117012780691,3.04519526107942
2021-06-12,291218,29,236786,22,54432,7,261927,31,1862068,1194,2123995,1225,3,4329,-24,406,50,286483,1,9523,4386,"East TN",2455501,16.5750288841259,0.0310520210582672,49.8879861991504,1.18102171410234,16.5343039974327,3.10520210582672
2021-06-13,291236,18,236800,14,54436,4,261948,21,1862912,844,2124860,865,1,4330,-41,365,58,286541,1,9524,4386,"East TN",2455501,16.2492297905804,0.0314267756128221,35.2270269896042,0.733047960477312,14.8645836430122,3.14267756128221
2021-06-14,291289,53,236833,33,54456,20,261989,41,1864165,1253,2126154,1294,3,4333,-9,356,59,286600,3,9527,4386,"East TN",2455501,15.4754569434099,0.0305157980016203,52.6980033809801,2.15841899473875,14.4980596627735,3.05157980016203
2021-06-15,291377,88,236901,68,54476,20,262077,88,1866047,1882,2128124,1970,0,4333,-6,350,94,286694,4,9531,4387,"East TN",2455501,15.5161818301031,0.0309627059843885,80.2280267855725,3.58379002900019,14.2537103426144,3.09627059843885
2021-06-16,291444,67,236941,40,54503,27,262115,38,1867953,1906,2130068,1944,2,4335,-14,336,79,286773,7,9538,4389,"East TN",2455501,16.2899546772736,0.0319019552811301,79.1691797315497,2.72856740844333,13.6835619289098,3.19019552811301
2021-06-17,291496,52,236980,39,54516,13,262161,46,1870303,2350,2132464,2396,1,4336,-6,330,57,286830,1,9539,4393,"East TN",2455501,15.3532822833304,0.0285739718711056,97.5768285168689,2.11769410804557,13.4392126087507,2.85739718711056
2021-06-18,291559,63,237032,52,54527,11,262216,55,1872031,1728,2134247,1783,2,4338,1,331,60,286890,4,9543,4395,"East TN",2455501,15.0682080764781,0.0278818506578374,72.6124729739471,2.56566786167059,13.4799374954439,2.78818506578374
2021-06-19,291587,28,237049,17,54538,11,262234,18,1873182,1151,2135416,1169,0,4338,-16,315,44,286934,4,9547,4396,"East TN",2455501,15.0274831897849,0.0268803082041853,47.6073925443321,1.14029682740915,12.828339308353,2.68803082041853
2021-06-20,291612,25,237070,21,54542,4,262251,17,1873936,754,2136187,771,3,4341,-13,302,35,286969,2,9549,4399,"East TN",2455501,15.3125573966372,0.0267502427827315,31.3988876404449,1.0181221673296,12.2989157813416,2.67502427827315
2021-06-21,291679,67,237110,40,54569,27,262303,52,1875208,1272,2137511,1324,6,4347,3,305,58,287027,2,9551,4400,"East TN",2455501,15.8827058103418,0.0276481465175663,53.9197499817756,2.72856740844333,12.4210904414211,2.76481465175663
2021-06-22,291772,93,237156,46,54616,47,262354,51,1876635,1427,2138989,1478,5,4352,36,341,52,287079,7,9558,4404,"East TN",2455501,16.0863302438077,0.0254947077772665,60.1913825325259,3.78741446246611,13.8871863623757,2.54947077772665
2021-06-23,291841,69,237204,48,54637,21,262409,55,1878422,1787,2140831,1842,2,4354,6,347,61,287140,5,9563,4408,"East TN",2455501,16.167780017194,0.0273158041438261,75.0152412888449,2.8100171818297,14.1315356825348,2.73158041438261
2021-06-24,291924,83,237255,51,54669,32,262471,62,1880266,1844,2142737,1906,3,4357,27,374,53,287193,4,9567,4409,"East TN",2455501,17.4302515046828,0.0301761900126545,77.6216340372087,3.38016559553427,15.2311076232508,3.01761900126545
2021-06-25,292003,79,237311,56,54692,23,262540,69,1882074,1808,2144614,1877,0,4357,32,406,47,287240,2,9569,4411,"East TN",2455501,18.0818496917737,0.0312530143725282,76.4406123231064,3.21726604876154,16.5343039974327,3.12530143725282
2021-06-26,292038,35,237329,18,54709,17,262561,21,1883258,1184,2145819,1205,0,4357,1,407,34,287274,2,9571,4413,"East TN",2455501,18.366923898626,0.0314332404114198,49.0734884652867,1.42537103426144,16.5750288841259,3.14332404114198
2021-06-27,292067,29,237349,20,54718,9,262585,24,1883972,714,2146557,738,2,4359,-9,398,36,287310,3,9574,4415,"East TN",2455501,18.5298234453987,0.0322082931533269,30.0549663795698,1.18102171410234,16.2085049038872,3.22082931533269
2021-06-28,292111,44,237373,24,54738,20,262610,25,1884524,552,2147134,577,4,4363,-16,382,56,287366,3,9577,4415,"East TN",2455501,17.5931510514555,0.0319027330354359,23.4982596219672,1.7918950145001,15.5569067167963,3.19027330354359
2021-06-29,292242,131,237459,86,54783,45,262707,97,1886538,2014,2149245,2111,0,4363,80,462,51,287417,6,9583,4418,"East TN",2455501,19.1406967457965,0.0344188767550702,85.9702358093114,5.3349601568071,18.814897652251,3.44188767550702
2021-06-30,292327,85,237522,63,54805,22,262782,75,1888182,1644,2150964,1719,3,4366,29,491,53,287470,3,9586,4418,"East TN",2455501,19.7922949328874,0.0368104213954406,70.0060802255833,3.46161536892064,19.9959193663533,3.68104213954406
2021-07-01,292433,106,237575,53,54858,53,262847,65,1890734,2552,2153581,2617,1,4367,57,548,48,287518,2,9588,4421,"East TN",2455501,20.7289673268307,0.0346735521947621,106.577028476063,4.3168379894775,22.3172379078648,3.46735521947621
2021-07-02,292515,82,237638,63,54877,19,262921,74,1892416,1682,2155337,1756,0,4367,30,578,52,287570,2,9590,4423,"East TN",2455501,20.8511419869102,0.035531101370885,71.5129010332311,3.33944070884109,23.5389845086603,3.5531101370885
2021-07-03,292563,48,237674,36,54889,12,262961,40,1893504,1088,2156465,1128,1,4368,1,579,46,287616,3,9593,4426,"East TN",2455501,21.3805655139216,0.0375727972947586,45.9376721899116,1.95479456127283,23.5797093953535,3.75727972947586
2021-07-04,292590,27,237695,21,54895,6,262986,25,1894204,700,2157190,725,0,4368,-13,566,40,287656,1,9594,4427,"East TN",2455501,21.2991157405352,0.0377127809649205,29.5255428525584,1.09957194071597,23.0502858683421,3.77127809649205
2021-07-05,292633,43,237719,24,54914,19,263011,25,1894686,482,2157697,507,0,4368,-30,536,73,287729,2,9596,4427,"East TN",2455501,21.258390853842,0.037962699990533,20.6475175534443,1.75117012780691,21.8285392675466,3.7962699990533
2021-07-06,292795,162,237823,104,54972,58,263124,113,1896011,1325,2159135,1438,5,4373,82,618,75,287804,6,9602,4427,"East TN",2455501,22.5208623413308,0.0421638018200202,58.5623870647986,6.59743164429581,25.1679799763877,4.21638018200202
2021-07-07,292937,142,237903,80,55034,62,263212,88,1897470,1459,2160682,1547,4,4377,81,699,57,287861,6,9608,4429,"East TN",2455501,24.8421808828422,0.0442477876106195,63.0013997143556,5.78293391043213,28.4666957985356,4.42477876106195
2021-07-08,293077,140,238005,102,55072,38,263329,117,1899325,1855,2162654,1972,2,4379,76,775,62,287923,3,9611,4431,"East TN",2455501,26.2268270304105,0.0531246555714758,80.3094765589588,5.70148413704576,31.5617871872176,5.31246555714758
2021-07-09,293241,164,238127,122,55114,42,263460,131,1901070,1745,2164530,1876,0,4379,100,875,64,287987,4,9615,4433,"East TN",2455501,29.5662677392516,0.0586315674970086,76.3998874364132,6.67888141768218,35.634275856536,5.86315674970086
2021-07-10,293345,104,238200,73,55145,31,263534,74,1902126,1056,2165660,1130,0,4379,56,931,48,288035,13,9628,4434,"East TN",2455501,31.8468613940699,0.0623164763458401,46.0191219632979,4.23538821609114,37.9148695113543,6.23164763458401
2021-07-11,293393,48,238235,35,55158,13,263577,43,1902881,755,2166458,798,2,4381,4,935,42,288077,7,9635,4434,"East TN",2455501,32.7020840146267,0.0637678031937851,32.4984595811608,1.95479456127283,38.077769058127,6.37678031937851
2021-07-12,293566,173,238352,117,55214,56,263702,125,1904247,1366,2167949,1491,1,4382,92,1027,80,288157,13,9648,4435,"East TN",2455501,37.9963192847407,0.0674014826375341,60.7208060595373,7.04540539792083,41.8244586339,6.74014826375341
2021-07-13,293780,214,238488,136,55292,78,263847,145,1905868,1621,2169715,1766,4,4386,149,1176,61,288218,14,9662,4438,"East TN",2455501,40.1140133927862,0.0683364839319471,71.9201499001629,8.71512575234138,47.8924667511844,6.83364839319471
2021-07-14,293953,173,238624,136,55329,37,263989,142,1907431,1563,2171420,1705,0,4386,103,1279,70,288288,11,9673,4439,"East TN",2455501,41.3764848802749,0.0723598435462842,69.4359318118787,7.04540539792083,52.0871300805823,7.23598435462842
2021-07-15,294173,220,238774,150,55399,70,264156,167,1909232,1801,2173388,1968,0,4386,118,1397,102,288390,14,9687,4439,"East TN",2455501,44.6344758157297,0.0770449040432271,80.1465770121861,8.95947507250048,56.892666710378,7.70449040432271
2021-07-16,294403,230,238916,142,55487,88,264310,154,1910761,1529,2175071,1683,0,4386,164,1561,66,288456,10,9697,4443,"East TN",2455501,47.3223183374798,0.0806375106726117,68.5399843046287,9.36672393943232,63.5715481280602,8.06375106726117
2021-07-17,294547,144,239016,100,55531,44,264420,110,1911979,1218,2176399,1328,0,4386,54,1615,90,288546,5,9702,4445,"East TN",2455501,48.9513138052072,0.0825030263525468,54.0826495285484,5.8643836838185,65.7706920094922,8.25030263525468
2021-07-18,294691,144,239137,121,55554,23,264552,132,1913105,1126,2177657,1258,0,4386,50,1665,94,288640,6,9708,4447,"East TN",2455501,52.8609029277528,0.0870613447629253,51.2319074600255,5.8643836838185,67.8069363441514,8.70613447629253
2021-07-19,294995,304,239349,212,55646,92,264769,217,1914795,1690,2179564,1907,3,4389,165,1830,136,288776,12,9720,4448,"East TN",2455501,58.1958630845599,0.0918639690055962,77.6623589239019,12.3803655547279,74.5265426485267,9.18639690055962
2021-07-20,295351,356,239587,238,55764,118,265023,254,1916456,1661,2181479,1915,2,4391,214,2044,140,288916,22,9742,4449,"East TN",2455501,63.9787969949921,0.0999659979598776,77.9881580174473,14.4980596627735,83.2416684008681,9.99659979598776
2021-07-21,295752,401,239880,293,55872,108,265333,310,1918572,2116,2183905,2426,3,4394,248,2292,150,289066,23,9765,4453,"East TN",2455501,73.264071161038,0.107649179014818,98.7985751176644,16.3306795639668,93.3414403007777,10.7649179014818
2021-07-22,296226,474,240213,333,56013,141,265700,367,1920941,2369,2186641,2736,5,4399,321,2613,148,289214,19,9784,4455,"East TN",2455501,83.6081923811067,0.116501924092658,111.423289992551,19.3035962925692,106.41412892929,11.6501924092658
2021-07-23,296690,464,240533,320,56157,144,266033,333,1922844,1903,2188877,2236,1,4400,331,2944,132,289346,21,9805,4460,"East TN",2455501,93.1378158673118,0.124800811241489,91.0608466459594,18.8963474256374,119.894066424734,12.4800811241489
2021-07-24,297048,358,240782,249,56266,109,266298,265,1924595,1751,2190893,2016,0,4400,226,3170,132,289478,19,9824,4464,"East TN",2455501,101.852941619653,0.129570856906306,82.1013715734589,14.5795094361599,129.097890817393,12.9570856906306
2021-07-25,297276,228,240972,190,56304,38,266501,203,1925910,1315,2192411,1518,3,4403,97,3267,128,289606,14,9838,4469,"East TN",2455501,105.273832101881,0.132099769554019,61.8203780002533,9.28527416604595,133.048204826632,13.2099769554019
2021-07-26,297943,667,241433,461,56510,206,266987,486,1927639,1729,2194626,2215,10,4413,448,3715,209,289815,30,9868,4473,"East TN",2455501,120.056965971506,0.147258000265569,90.2056240254026,27.1634994243537,151.292954065179,14.7258000265569
2021-07-27,298671,728,241923,490,56748,238,267502,515,1929960,2321,2197462,2836,2,4415,535,4250,191,290006,25,9893,4479,"East TN",2455501,135.206623821371,0.155102296189702,115.49577866187,29.6477175126379,173.080768446032,15.5102296189702
2021-07-28,299490,819,242471,548,57019,271,268115,613,1932828,2868,2200943,3481,2,4417,559,4809,258,290264,31,9924,4482,"East TN",2455501,152.229626459122,0.163282075360958,141.763330578973,33.3536822017177,195.845980107522,16.3282075360958
2021-07-29,300178,688,242925,454,57253,234,268611,496,1935256,2428,2203867,2924,3,4420,474,5283,211,290475,18,9942,4486,"East TN",2455501,160.944752211463,0.168988737954255,119.07956869087,28.0187220449106,215.149576400091,16.8988737954255
2021-07-30,301177,999,243672,747,57505,252,269413,802,1937059,1803,2206472,2605,4,4424,753,6036,242,290717,38,9980,4489,"East TN",2455501,182.732566592317,0.192100028417164,106.088329835744,40.6841618064908,245.815416080059,19.2100028417164
2021-07-31,301712,535,244037,365,57675,170,269809,396,1939029,1970,2208838,2366,2,4426,319,6355,214,290931,32,10012,4498,"East TN",2455501,189.94087153701,0.195653385344107,96.3550819160733,21.7878143808534,258.806654935184,19.5653385344107
2021-08-01,302246,534,244459,422,57787,112,270270,461,1941167,2138,2211437,2599,3,4429,321,6676,210,291141,27,10039,4501,"East TN",2455501,202.402686865124,0.198097340481446,105.843980515585,21.7470894941603,271.879343563696,19.8097340481446
2021-08-02,303096,850,244995,536,58101,314,270806,536,1943502,2335,2214308,2871,9,4438,416,7092,425,291566,32,10071,4509,"East TN",2455501,209.855341129977,0.194035159028554,116.921149696131,34.6161536892064,288.820896428061,19.4035159028554
2021-08-03,304434,1338,245963,968,58471,370,271821,1015,1947277,3775,2219098,4790,4,4442,895,7987,439,292005,33,10104,4518,"East TN",2455501,234.697522012819,0.199621002033648,195.072207260351,54.4898983954802,325.269670018461,19.9621002033648
2021-08-04,305521,1087,246796,833,58725,254,272708,887,1950897,3620,2223605,4507,8,4450,646,8633,433,292438,34,10138,4524,"East TN",2455501,245.611791646593,0.202674079957638,183.54706432618,44.267951835491,351.577946822257,20.2674079957638
2021-08-05,306701,1180,247685,889,59016,291,273659,951,1954862,3965,2228521,4916,10,4460,666,9299,504,292942,37,10175,4531,"East TN",2455501,265.648435899639,0.204753792488034,200.203542983693,48.0553662979571,378.700721359918,20.4753792488034
2021-08-06,308042,1341,248671,986,59371,355,274742,1083,1959490,4628,2234232,5711,3,4463,909,10208,429,293371,46,10221,4544,"East TN",2455501,279.576347148708,0.191966858789625,232.579827904774,54.6120730555597,415.719643364022,19.1966858789625
2021-08-07,308766,724,249195,524,59571,200,275326,584,1962494,3004,2237820,3588,0,4463,326,10534,398,293769,25,10246,4553,"East TN",2455501,287.27335073372,0.190359533503554,146.120893455144,29.4848179658652,428.995956426,19.0359533503554
2021-08-08,309402,636,249646,451,59756,185,275852,526,1964609,2115,2240461,2641,5,4468,219,10753,412,294181,27,10273,4562,"East TN",2455501,291.427289176425,0.192323594266814,107.554425756699,25.901027936865,437.914706611808,19.2323594266814
2021-08-09,310771,1369,250607,961,60164,408,276860,1008,1968148,3539,2245008,4547,14,4482,571,11324,784,294965,58,10331,4574,"East TN",2455501,312.563505370187,0.197198697068404,185.176059793908,55.7523698829689,461.168616913616,19.7198697068404
2021-08-10,312098,1327,251455,848,60643,479,277777,917,1971400,3252,2249177,4169,6,4488,548,11872,773,295738,43,10374,4588,"East TN",2455501,312.115531616562,0.198011901991423,169.782052623884,54.0419246418552,483.48585482148,19.8011901991423
2021-08-11,313985,1887,252757,1302,61228,585,279160,1383,1976756,5356,2255916,6739,8,4496,1062,12934,817,296555,60,10434,4603,"East TN",2455501,344.695440971109,0.199684318034106,274.445011425367,76.8478611900382,526.735684489642,19.9684318034106
2021-08-12,315447,1462,253819,1062,61628,400,280322,1162,1981238,4482,2261560,5644,10,4506,584,13518,868,297423,38,10472,4617,"East TN",2455501,356.179859018587,0.201670752746754,229.85126049633,59.539784345435,550.519018318461,20.1670752746754
2021-08-13,317097,1650,254936,1117,62161,533,281496,1174,1986657,5419,2268153,6593,11,4517,797,14315,842,298265,26,10498,4637,"East TN",2455501,368.763849006781,0.199109696058489,268.499177968162,67.1960630437536,582.976753012929,19.9109696058489
2021-08-14,318628,1531,256025,1089,62603,442,282696,1200,1992132,5475,2274828,6675,1,4518,911,15226,619,298884,26,10524,4650,"East TN",2455501,401.628832568181,0.199146130566364,271.838618677003,62.3498015272647,620.07712479042,19.9146130566364
2021-08-15,319774,1146,256990,965,62784,181,283753,1057,1995942,3810,2279695,4867,11,4529,426,15652,709,299593,20,10544,4662,"East TN",2455501,422.398524781704,0.20138145486058,198.208023535727,46.6707201503889,637.425926521716,20.138145486058
2021-08-16,321216,1442,257905,915,63311,527,284715,962,1999002,3060,2283717,4022,17,4546,171,15823,1254,300847,29,10573,4680,"East TN",2455501,425.371441510307,0.202924384510062,163.795494279986,58.7252866115713,644.38988214625,20.2924384510062
2021-08-17,322953,1737,259120,1215,63833,522,286036,1321,2003862,4860,2289898,6181,10,4556,514,16337,1213,302060,25,10598,4695,"East TN",2455501,442.068645054512,0.20281918420471,251.72052465057,70.7391281860606,665.322473906547,20.281918420471
2021-08-18,325048,2095,260506,1386,64542,709,287515,1479,2009282,5420,2296797,6899,13,4569,936,17273,1146,303206,31,10629,4706,"East TN",2455501,450.539421486695,0.204373669920012,280.960993296276,85.3186376222205,703.440967851367,20.4373669920012
2021-08-19,327440,2392,261996,1490,65444,902,289093,1578,2019233,9951,2308326,11529,23,4592,1117,18390,1252,304458,40,10669,4724,"East TN",2455501,488.413566111356,0.187550784758158,469.517218685718,97.4139289700961,748.930666287654,18.7550784758158
2021-08-20,329896,2456,263974,1978,65922,478,291201,2108,2026127,6894,2317328,9002,4,4596,1273,19663,1179,305637,33,10702,4754,"East TN",2455501,521.237824786062,0.19735638027453,366.605430012042,100.02032171846,800.773447048077,19.735638027453
2021-08-21,332820,2924,265936,1962,66884,962,293319,2118,2035057,8930,2328376,11048,0,4596,2168,21831,756,306393,55,10757,4776,"East TN",2455501,577.967591949667,0.198382759393441,449.928548186297,119.07956869087,889.0650013989,19.8382759393441
2021-08-22,334305,1485,267277,1341,67028,144,294835,1516,2040569,5512,2335404,7028,7,4603,544,22375,934,307327,17,10774,4794,"East TN",2455501,591.773328538657,0.198926564827945,286.214503679697,60.4764567393782,911.219339759992,19.8926564827945
2021-08-23,336253,1948,268404,1127,67849,821,296021,1186,2044536,3967,2340557,5153,18,4621,183,22558,1747,309074,34,10808,4811,"East TN",2455501,612.380121205408,0.198909218859958,209.855341129977,79.3320792783224,918.671994024845,19.8909218859958
2021-08-24,338240,1987,269791,1387,68449,600,297459,1438,2048315,3779,2345774,5217,15,4636,151,22709,1821,310895,25,10833,4845,"East TN",2455501,622.561342878704,0.204434819958479,212.461733878341,80.9203498593566,924.821451915515,20.4434819958479
2021-08-25,340472,2232,270999,1208,69473,1024,298706,1247,2052351,4036,2351057,5283,17,4653,610,23319,1605,312500,39,10872,4879,"East TN",2455501,628.14065235567,0.206247696277184,215.149576400091,90.8979470991867,949.663632798358,20.6247696277184
2021-08-26,343133,2661,272831,1832,70302,829,300668,1962,2059195,6844,2359863,8806,24,4677,742,24061,1895,314395,37,10909,4903,"East TN",2455501,639.095646876136,0.224595921376875,358.623352220178,108.368923490563,979.8814987247,22.4595921376875
2021-08-27,346146,3013,275102,2271,71044,742,303029,2361,2066264,7069,2369293,9430,19,4696,1312,25373,1682,316077,43,10952,4921,"East TN",2455501,661.77940876424,0.22761474069085,384.035681516725,122.704083606563,1033.31255006616,22.761474069085
2021-08-28,348292,2146,276642,1540,71650,606,304700,1671,2072131,5867,2376831,7538,1,4697,923,26296,1222,317299,30,10982,4955,"East TN",2455501,630.095446916943,0.234877721597358,306.984195893221,87.3956068435729,1070.90162048397,23.4877721597358
2021-08-29,350633,2341,278470,1828,72163,513,306720,2020,2079125,6994,2385845,9014,9,4706,1082,27378,1250,318549,43,11025,4983,"East TN",2455501,664.955949926308,0.235621815586527,367.094128652361,95.3369597487437,1114.96594788599,23.5621815586527
2021-08-30,353877,3244,280883,2413,72994,831,309324,2604,2088168,9043,2397492,11647,21,4727,473,27851,2750,321299,59,11084,5018,"East TN",2455501,717.735403080675,0.233652410643717,474.322755315514,132.111532432689,1134.22881929187,23.3652410643717
2021-08-31,357470,3593,283289,2406,74181,1187,311935,2611,2096755,8587,2408690,11198,7,4734,910,28761,2676,323975,73,11157,5049,"East TN",2455501,783.139571109928,0.230084557187361,456.037281190274,146.32451788861,1171.28846618266,23.0084557187361
2021-09-01,358906,1436,284239,950,74667,486,312924,989,2099038,2283,2411962,3272,15,4749,-963,27798,2384,326359,29,11186,5087,"East TN",2455501,750.722561302154,0.233445529923652,133.251829260098,58.4809372914122,1132.07040029713,23.3445529923652
2021-09-02,361223,2317,285729,1490,75494,827,314440,1516,2103300,4262,2417740,5778,19,4768,-581,27217,2879,329238,38,11224,5114,"East TN",2455501,736.713200279699,0.237952900115763,235.308395313217,94.3595624681073,1108.40924112839,23.7952900115763
2021-09-03,362978,1755,286946,1217,76032,538,315735,1295,2107406,4106,2423141,5401,17,4785,-1006,26211,2744,331982,30,11254,5136,"East TN",2455501,685.481292819673,0.235960481354925,219.955113029887,71.4721761465379,1067.44000511505,23.5960481354925
2021-09-04,366243,3265,289289,2343,76954,922,318313,2578,2115454,8048,2433767,10626,3,4788,1527,27738,1735,333717,52,11306,5163,"East TN",2455501,731.052441029346,0.239093016720528,432.742646001773,132.966755053246,1129.62690709554,23.9093016720528
2021-09-05,370701,4458,292542,3253,78159,1205,321801,3488,2127964,12510,2449765,15998,8,4796,2742,30480,1708,335425,58,11364,5210,"East TN",2455501,817.267026158817,0.235935544430538,651.516737317558,181.551544878214,1241.29454640825,23.5935544430538
2021-09-06,375614,4913,296481,3939,79133,974,326090,4289,2143604,15640,2469694,19929,11,4807,984,31464,3918,339343,93,11457,5241,"East TN",2455501,885.236862049741,0.232209634082158,811.606266908464,200.081368323613,1281.36783491434,23.2209634082158
2021-09-07,377697,2083,297937,1456,79760,627,327607,1517,2148030,4426,2475637,5943,34,4841,-1782,29682,3831,343174,59,11516,5260,"East TN",2455501,823.742283143033,0.234095627884745,242.028001617593,84.8299389819023,1208.79608682709,23.4095627884745
2021-09-08,379372,1675,299113,1176,80259,499,328869,1262,2152410,4380,2481279,5642,20,4861,-1783,27899,3438,346612,58,11574,5280,"East TN",2455501,833.475531062704,0.230030151333728,229.769810722944,68.2141852110832,1136.18361385314,23.0030151333728
2021-09-09,381284,1912,300120,1007,81164,905,329949,1080,2156076,3666,2486025,4746,7,4868,-1650,26249,3555,350167,50,11624,5301,"East TN",2455501,816.981951951964,0.227121622611115,193.280312245851,77.8659833573678,1068.98755080939,22.7121622611115
2021-09-10,386772,5488,303954,3834,82818,1654,334079,4130,2168182,12106,2502261,16236,23,4891,2194,28443,3271,353438,135,11759,5322,"East TN",2455501,969.00795397762,0.231850353892821,661.209260350535,223.498178172194,1158.33795221423,23.1850353892821
2021-09-11,391059,4287,307064,3110,83995,1177,337397,3318,2180004,11822,2517401,15140,8,4899,2508,30951,1771,355209,112,11871,5351,"East TN",2455501,1010.62878817805,0.228184709567879,616.574784534806,174.58758925368,1260.47596804074,22.8184709567879
2021-09-12,392641,1582,308490,1426,84151,156,338952,1555,2185248,5244,2524200,6799,23,4922,-142,30809,1701,356910,42,11913,5376,"East TN",2455501,893.504014048457,0.230415799019279,276.888504626958,64.4267707486171,1254.69303413031,23.0415799019279
2021-09-13,394993,2352,309939,1449,85054,903,340456,1504,2190371,5123,2530827,6627,63,4985,-1967,28842,4256,361166,75,11988,5406,"East TN",2455501,789.207579227213,0.234995828766787,269.88382411573,95.7849335023688,1174.58718200481,23.4995828766787
2021-09-14,397807,2814,311892,1953,85915,861,342530,2074,2196593,6222,2539123,8296,43,5028,-978,27864,3749,364915,61,12049,5434,"East TN",2455501,818.97747139993,0.235059698201178,337.853660006654,114.59983115462,1134.75824281888,23.5059698201178
2021-09-15,399602,1795,313085,1193,86517,602,343746,1216,2200368,3775,2544114,4991,23,5051,-1551,26313,3323,368238,34,12083,5454,"East TN",2455501,823.864457803112,0.236762950584865,203.257909485681,73.1011716142653,1071.59394355775,23.6762950584865
2021-09-16,402256,2654,314935,1850,87321,804,345703,1957,2207027,6659,2552730,8616,23,5074,-561,25752,3192,371430,61,12144,5477,"East TN",2455501,854.082323729455,0.236174199835095,350.885623748473,108.08384928371,1048.74728212287,23.6174199835095
2021-09-17,404945,2689,316813,1878,88132,811,347707,2004,2214231,7204,2561938,9208,23,5097,-72,25680,2738,374168,76,12220,5509,"East TN",2455501,740.093365875233,0.228362685791846,374.994756670838,109.509220317972,1045.81509028097,22.8362685791846
2021-09-18,406402,1457,317992,1179,88410,278,349044,1337,2219703,5472,2568747,6809,3,5100,-281,25399,1735,375903,35,12255,5547,"East TN",2455501,624.841936533522,0.226833638452849,277.29575349389,59.3361599119691,1034.37139712018,22.6833638452849
2021-09-19,407046,644,318438,446,88608,198,349557,513,2221780,2077,2571337,2590,17,5117,-1067,24332,1694,377597,23,12278,5576,"East TN",2455501,586.641992815315,0.224982497825487,105.477456535347,26.2268270304105,990.917943018553,22.4982497825487
2021-09-20,409031,1985,319696,1258,89335,727,350928,1371,2227417,5637,2578345,7008,48,5165,189,24521,1748,379345,64,12342,5602,"East TN",2455501,571.695959398917,0.22037964560798,285.400005945833,80.8389000859702,998.614946603565,22.037964560798
2021-09-21,410906,1875,320796,1100,90110,775,352068,1140,2231722,4305,2583790,5445,31,5196,-2066,22455,3910,383255,57,12399,5629,"East TN",2455501,533.455290794017,0.213535719882687,221.747008044387,76.35916254972,914.477330695447,21.3535719882687
2021-09-22,412497,1591,321912,1116,90585,475,353287,1219,2237081,5359,2590368,6578,14,5210,-1361,21094,2938,386193,44,12443,5651,"East TN",2455501,525.147413908608,0.206274051973883,267.888304667764,64.7932947288557,859.050759906023,20.6274051973883
2021-09-23,414850,2353,323420,1508,91430,845,354949,1662,2243438,6357,2598387,8019,32,5242,-409,20685,2730,388923,52,12495,5667,"East TN",2455501,512.889223013959,0.202510020369275,326.572866392642,95.8256583890619,842.394281248511,20.2510020369275
2021-09-24,416392,1542,324403,983,91989,559,356048,1099,2248321,4883,2604369,5982,37,5279,-936,19749,2441,391364,37,12532,5694,"East TN",2455501,466.177777976877,0.19657797365134,243.616272198627,62.7977752808897,804.275787303691,19.657797365134
2021-09-25,417092,700,324889,486,92203,214,356610,562,2251343,3022,2607953,3584,2,5281,-909,18840,1607,392971,20,12552,5720,"East TN",2455501,435.349038750137,0.192980666224557,145.957993908371,28.5074206852288,767.256865299586,19.2980666224557
2021-09-26,417952,860,325514,625,92438,235,357331,721,2255320,3977,2612651,4698,6,5287,-428,18412,1282,394253,26,12578,5736,"East TN",2455501,444.145614275865,0.188168659534298,191.325517684578,35.0234025561382,749.826613794904,18.8168659534298
2021-09-27,419412,1460,326346,832,93066,628,358253,922,2258911,3591,2617164,4513,47,5334,-1408,17004,2821,397074,42,12620,5753,"East TN",2455501,422.765048761943,0.188696256987558,183.791413646339,59.4583345720486,692.485973330901,18.8696256987558
2021-09-28,420707,1295,327135,789,93572,506,359116,863,2262573,3662,2621689,4525,14,5348,-1039,15965,2320,399394,31,12651,5766,"East TN",2455501,399.144614479896,0.185967967492546,184.280112286658,52.7387282676733,650.172816056683,18.5967967492546
2021-09-29,422389,1682,328144,1009,94245,673,360255,1139,2268071,5498,2628326,6637,30,5378,-378,15587,2030,401424,46,12697,5792,"East TN",2455501,402.850579168976,0.183571315664682,270.291072982662,68.4992594179355,634.778808886659,18.3571315664682
2021-09-30,423599,1210,328904,760,94695,450,361075,820,2272743,4672,2633818,5492,11,5389,-805,14782,2004,403428,38,12735,5809,"East TN",2455501,356.302033678667,0.172899438344952,223.661077718967,49.2771128987526,601.995275098646,17.2899438344952
2021-10-01,424972,1373,329875,971,95097,402,362150,1075,2277716,4973,2639866,6048,14,5403,-318,14464,1677,405105,45,12780,5828,"East TN",2455501,349.419527827519,0.171901850860636,246.304114720377,55.9152694297416,589.044761130213,17.1901850860636
2021-10-02,425526,554,330226,351,95300,203,362545,395,2280386,2670,2642931,3065,11,5414,-457,14007,1000,406105,18,12798,5849,"East TN",2455501,343.473694370314,0.169678083366688,124.821777714609,22.5615872280239,570.433487911428,16.9678083366688
2021-10-03,426065,539,330691,465,95374,74,363069,524,2283478,3092,2646547,3616,13,5427,-357,13650,883,406988,14,12812,5868,"East TN",2455501,330.401005741802,0.169282511210762,147.261190282553,21.9507139276262,555.894703361962,16.9282511210762
2021-10-04,427417,1352,331549,858,95868,494,364010,941,2287616,4138,2651626,5079,22,5449,-638,13012,1968,408956,29,12841,5881,"East TN",2455501,326.002717978938,0.167053566246881,206.841699514682,55.0600468091848,529.91222565171,16.7053566246881
2021-10-05,428680,1263,332301,752,96379,511,364823,813,2292078,4462,2656901,5275,17,5466,-461,12551,1707,410663,39,12880,5905,"East TN",2455501,324.699521604756,0.16207542883108,214.823777306546,51.4355318934914,511.138052886152,16.207542883108
2021-10-06,429617,937,333008,707,96609,230,365604,781,2296499,4421,2662103,5202,18,5484,-422,12129,1341,412004,25,12905,5927,"East TN",2455501,294.359481018334,0.158362199129585,211.850860577943,38.1592188315134,493.952150701629,15.8362199129585
2021-10-07,430731,1114,333796,788,96935,326,366460,856,2301283,4784,2667743,5640,24,5508,-398,11731,1488,413492,26,12931,5948,"East TN",2455501,290.449891895788,0.158732498157701,229.688360949558,45.367523776207,477.743645797742,15.8732498157701
2021-10-08,431790,1059,334381,585,97409,474,367103,643,2305530,4247,2672633,4890,9,5517,-120,11611,1170,414662,28,12959,5963,"East TN",2455501,277.662277474128,0.151158177434614,199.14469592967,43.1276550080819,472.856659394559,15.1158177434614
2021-10-09,432331,541,334736,355,97595,186,367520,417,2308339,2809,2675859,3226,4,5521,-290,11321,827,415489,29,12988,5983,"East TN",2455501,277.132853947117,0.151087220602527,131.378484472212,22.0321637010125,461.046442253536,15.1087220602527
2021-10-10,432651,320,335004,268,97647,52,367830,310,2310572,2233,2678402,2543,6,5527,-525,10796,839,416328,15,13003,5996,"East TN",2455501,268.21410376131,0.149458483754513,103.563386860767,13.0319637418189,439.665876739614,14.9458483754513
2021-10-11,433871,1220,335538,534,98333,686,368378,548,2314018,3446,2682396,3994,52,5579,-293,10503,1461,417789,31,13034,6002,"East TN",2455501,262.83841871781,0.141956451088723,162.655197452577,49.6843617656845,427.733484938511,14.1956451088723
2021-10-12,434811,940,336178,640,98633,300,369383,1005,2317662,3644,2687045,4649,29,5608,-367,10136,1278,419067,29,13063,6023,"East TN",2455501,249.684280315911,0.151273885350318,189.329998236612,38.281393491593,412.787451522113,15.1273885350318
2021-10-13,435663,852,336723,545,98940,307,370032,649,2321527,3865,2691559,4514,25,5633,-429,9707,1256,420323,37,13100,6039,"East TN",2455501,246.22266494699,0.150325909831613,183.832138533033,34.6976034625928,395.316475130737,15.0325909831613
2021-10-14,436615,952,337374,651,99241,301,370754,722,2325530,4003,2696284,4725,31,5664,-182,9525,1103,421426,30,13130,6056,"East TN",2455501,239.625233302695,0.150450229494412,192.425089625294,38.7700921319112,387.904545752578,15.0450229494412
2021-10-15,437416,801,337882,508,99534,293,371329,575,2329424,3894,2700753,4469,24,5688,-310,9215,1087,422513,29,13159,6068,"East TN",2455501,229.118212535853,0.150284495021337,181.999518631839,32.6206342412404,375.279830877691,15.0284495021337
2021-10-16,437723,307,338120,238,99603,69,371600,271,2331654,2230,2703254,2501,7,5695,-380,8835,680,423193,10,13169,6076,"East TN",2455501,219.588589049648,0.14893228691367,101.852941619653,12.5025402148075,359.804373934281,14.893228691367
2021-10-17,437974,251,338329,209,99645,42,371847,247,2333317,1663,2705164,1910,7,5702,-439,8396,683,423876,13,13182,6082,"East TN",2455501,216.778571867818,0.150100889320679,77.7845335839814,10.2219465599892,341.926148675973,15.0100889320679
2021-10-18,438764,790,338793,464,99971,326,372363,516,2336508,3191,2708871,3707,23,5725,-489,7907,1256,425132,37,13219,6095,"East TN",2455501,199.266870589749,0.150519357884797,150.967154971633,32.1726604876154,322.011679083006,15.0519357884797
2021-10-19,439596,832,339232,439,100364,393,372837,474,2339836,3328,2712673,3802,25,5750,-282,7625,1089,426221,21,13240,6102,"East TN",2455501,194.868582826885,0.134774465428438,154.836019207486,33.8831057287291,310.527261035528,13.4774465428438
2021-10-20,440359,763,339720,488,100639,275,373378,541,2343857,4021,2717235,4562,15,5765,-225,7400,973,427194,19,13259,6113,"East TN",2455501,191.244067911192,0.130316248636859,185.786933094305,31.0730885468994,301.364161529562,13.0316248636859
2021-10-21,440987,628,340141,421,100846,207,373848,470,2347495,3638,2721343,4108,17,5782,-252,7148,863,428057,19,13278,6122,"East TN",2455501,178.0492046226,0.123468614070793,167.2978345356,25.5752288433196,291.101490082879,12.3468614070793
2021-10-22,441534,547,340479,338,101055,209,374234,386,2350599,3104,2724833,3490,6,5788,-325,6823,866,428923,17,13295,6129,"East TN",2455501,167.705083402532,0.120639534883721,142.129854559212,22.2765130211716,277.865901907594,12.0639534883721
2021-10-23,441893,359,340722,243,101171,116,374507,273,2352984,2385,2727491,2658,0,5788,-191,6632,550,429473,14,13309,6140,"East TN",2455501,169.822777510577,0.119940586706276,108.246748830483,14.6202343228531,270.087448549196,11.9940586706276
2021-10-24,442137,244,340885,163,101252,81,374703,196,2354881,1897,2729584,2093,7,5795,-302,6330,539,430012,14,13323,6145,"East TN",2455501,169.537703303725,0.116953316953317,85.2371878488341,9.9368723531369,257.788532767855,11.6953316953317
2021-10-25,442560,423,341133,248,101427,175,374973,270,2357313,2432,2732286,2702,28,5823,-495,5835,890,430902,20,13343,6151,"East TN",2455501,154.591669887326,0.111467008327995,110.038643844983,17.2266270712168,237.629713854729,11.1467008327995
2021-10-26,443086,526,341457,324,101629,202,375311,338,2359953,2640,2735264,2978,12,5835,-230,5605,744,431646,26,13369,6158,"East TN",2455501,142.129854559212,0.109512637776106,121.278712572302,21.4212904006148,228.262989915296,10.9512637776106
2021-10-27,443707,621,341847,390,101860,231,375735,424,2364150,4197,2739885,4621,10,5845,-96,5509,707,432353,19,13388,6172,"East TN",2455501,136.34692064878,0.104061810154525,188.189701409203,25.2901546364673,224.353400792751,10.4061810154525
2021-10-28,444123,416,342100,253,102023,163,376027,292,2366947,2797,2742974,3089,16,5861,-208,5301,608,432961,15,13403,6183,"East TN",2455501,127.713244669825,0.100735056169387,125.799174995245,16.9415528643645,215.882624360568,10.0735056169387
2021-10-29,444582,459,342405,305,102177,154,376360,333,2370465,3518,2746825,3851,4,5865,-159,5142,614,433575,10,13413,6190,"East TN",2455501,124.129454640825,0.0966715169152419,156.831538655452,18.6927229921715,209.407367376352,9.66715169152419
2021-10-30,444844,262,342604,199,102240,63,376588,228,2373039,2574,2749627,2802,0,5865,-153,4989,415,433990,15,13428,6197,"East TN",2455501,120.179140631586,0.0940097578604987,114.111132514302,10.6699203136142,203.176459712295,9.40097578604987
2021-10-31,445015,171,342730,126,102285,45,376734,146,2374664,1625,2751398,1771,0,5865,-224,4765,395,434385,4,13432,6204,"East TN",2455501,117.206223902984,0.0931053451911616,72.1237743336289,6.96395562453446,194.054085093022,9.31053451911616
2021-11-01,445611,596,343088,358,102523,238,377124,390,2377782,3118,2754906,3508,14,5879,-185,4580,767,435152,20,13452,6210,"East TN",2455501,124.251629300904,0.0950928381962865,142.862902519689,24.2720324691377,186.519981054783,9.50928381962865
2021-11-02,446023,412,343304,216,102719,196,377349,225,2379993,2211,2757342,2436,25,5904,-188,4392,575,435727,14,13466,6224,"East TN",2455501,119.608992217881,0.0923090859679319,99.2058239845962,16.7786533175918,178.863702356464,9.23090859679319
2021-11-03,446597,574,343679,375,102918,199,377742,393,2384571,4578,2762313,4971,6,5910,81,4473,487,436214,13,13479,6231,"East TN",2455501,117.694922543302,0.0894863563402889,202.443411751818,23.3760849618876,182.162418178612,8.94863563402889
2021-11-04,447018,421,343979,300,103039,121,378072,330,2388107,3536,2766179,3866,13,5923,-71,4402,479,436693,7,13486,6235,"East TN",2455501,117.898546976768,0.088127558715794,157.442411955849,17.1451772978305,179.270951223396,8.8127558715794
2021-11-05,447452,434,344262,283,103190,151,378396,324,2391689,3582,2770085,3906,2,5925,18,4420,414,437107,12,13498,6237,"East TN",2455501,116.880424809438,0.0875322441960447,159.071407423577,17.6746008248419,180.003999183873,8.75322441960447
2021-11-06,447685,233,344432,170,103253,63,378585,189,2393929,2240,2772514,2429,0,5925,-84,4336,317,437424,11,13509,6241,"East TN",2455501,115.699403095336,0.0872547734521781,98.9207497777439,9.48889859951187,176.583108701646,8.72547734521781
2021-11-07,447883,198,344556,124,103327,74,378739,154,2395831,1902,2774570,2056,6,5931,-124,4212,316,437740,6,13515,6248,"East TN",2455501,116.798975036052,0.0865268427412394,83.7303670411863,8.06352756525043,171.533222751691,8.65268427412394
2021-11-08,448424,541,344900,344,103524,197,379124,385,2399364,3533,2778488,3918,25,5956,-31,4181,547,438287,20,13535,6255,"East TN",2455501,114.559106267927,0.0848104486472733,159.560106063895,22.0321637010125,170.270751264202,8.48104486472733
2021-11-09,449294,870,345515,615,103779,255,379925,801,2406641,7277,2786566,8078,10,5966,418,4599,442,438729,20,13555,6267,"East TN",2455501,133.211104373405,0.0881467287161237,328.97563470754,35.4306514230701,187.293753901953,8.81467287161237
2021-11-10,449924,630,345950,435,103974,195,380427,502,2411893,5252,2792320,5754,7,5973,180,4779,443,439172,21,13576,6274,"East TN",2455501,135.491698028223,0.0894791215383077,234.330998032581,25.6566786167059,194.624233506726,8.94791215383077
2021-11-11,450430,506,346330,380,104100,126,380831,404,2416183,4290,2797014,4694,5,5978,86,4865,415,439587,8,13584,6282,"East TN",2455501,138.953313397144,0.0894762445273228,191.162618137806,20.6067926667511,198.12657376234,8.94762445273228
2021-11-12,450914,484,346650,320,104264,164,381163,332,2419633,3450,2800796,3782,2,5980,119,4984,363,439950,16,13600,6288,"East TN",2455501,140.989557731803,0.0900980104848426,154.021521473622,19.7108451595011,202.972835278829,9.00980104848426
2021-11-13,451151,237,346789,139,104362,98,381312,149,2421632,1999,2802944,2148,4,5984,-102,4882,335,440285,10,13610,6293,"East TN",2455501,141.152457278576,0.0896155110088728,87.4770566169592,9.65179814628461,198.818896836124,8.96155110088728
2021-11-14,451512,361,347103,314,104409,47,381656,344,2424611,2979,2806267,3323,1,5985,62,4944,298,440583,10,13620,6298,"East TN",2455501,147.790613809565,0.0920276366848598,135.32879848145,14.7016840962394,201.343839811102,9.20276366848598
2021-11-15,452088,576,347390,287,104698,289,381957,301,2427379,2768,2809336,3069,26,6011,-30,4914,580,441163,12,13632,6299,"East TN",2455501,149.215984843826,0.0918373962655602,124.984677261382,23.457534735274,200.122093210306,9.18373962655602
2021-11-16,452760,672,347817,427,104943,245,382417,460,2430986,3607,2813403,4067,24,6035,181,5095,467,441630,7,13639,6304,"East TN",2455501,141.152457278576,0.0928568767000783,165.628114181179,27.3671238578196,207.493297701772,9.28568767000782
2021-11-17,453474,714,348280,463,105194,251,382926,509,2435632,4646,2818558,5155,5,6040,300,5395,409,442039,18,13657,6309,"East TN",2455501,144.573347760803,0.0952435399039561,209.936790903364,29.0775690989334,219.710763709728,9.52435399039561
2021-11-18,454102,628,348689,409,105413,219,383404,478,2440495,4863,2823899,5341,12,6052,180,5575,436,442475,13,13670,6314,"East TN",2455501,149.541783937372,0.0957039241212572,217.511619828296,25.5752288433196,227.041243314501,9.57039241212572
2021-11-19,454715,613,349127,438,105588,175,383864,460,2444969,4474,2828833,4934,7,6059,214,5789,392,442867,8,13678,6317,"East TN",2455501,154.795294320792,0.0963369832721047,200.93659094417,24.9643555429218,235.756369066842,9.63369832721047
2021-11-20,455036,321,349372,245,105664,76,384151,287,2447673,2704,2831824,2991,0,6059,23,5812,298,443165,8,13686,6322,"East TN",2455501,158.21618480302,0.098303324099723,121.808136099313,13.0726886285121,236.693041460785,9.8303324099723
2021-11-21,455299,263,349522,150,105777,113,384314,163,2449157,1484,2833471,1647,9,6068,-91,5721,345,443510,5,13691,6329,"East TN",2455501,154.225145907088,0.0977062196735774,67.073888383674,10.7106452003074,232.987076771706,9.77062196735774
2021-11-22,456054,755,350015,493,106039,262,384826,512,2453025,3868,2837851,4380,21,6089,157,5878,577,444087,23,13714,6333,"East TN",2455501,161.514900625168,0.100613712081361,178.375003716146,30.7472894533539,239.380883982536,10.0613712081361
2021-11-23,456731,677,350478,463,106253,214,385316,490,2456326,3301,2841642,3791,21,6110,126,6004,530,444617,6,13720,6336,"East TN",2455501,161.718525058634,0.102659442614823,154.388045453861,27.5707482912856,244.512219705877,10.2659442614823
2021-11-24,457467,736,351001,523,106466,213,385888,572,2460354,4028,2846242,4600,6,6116,257,6261,473,445090,8,13728,6340,"East TN",2455501,162.614472565884,0.106993209073833,187.334478788646,29.9735166061834,254.978515586025,10.6993209073833
2021-11-25,457752,285,351158,157,106594,128,386061,173,2461990,1636,2848051,1809,1,6117,-193,6068,477,445567,6,13734,6345,"East TN",2455501,148.645836430122,0.110011593242796,73.6713200279699,11.6065927075574,247.11861245424,11.0011593242796
2021-11-26,457984,232,351360,202,106624,30,386303,242,2463667,1677,2849970,1919,1,6118,-281,5787,512,446079,10,13744,6347,"East TN",2455501,133.129654600018,0.115390074277334,78.1510575642201,9.44817371281869,235.674919293456,11.5390074277334
2021-11-27,458268,284,351585,225,106683,59,386557,254,2465262,1595,2851819,1849,0,6118,-86,5701,370,446449,5,13749,6353,"East TN",2455501,131.622833792371,0.12033008252063,75.3003154956972,11.5658678208643,232.172579037842,12.033008252063
2021-11-28,458582,314,351793,208,106789,106,386774,217,2466772,1510,2853546,1727,7,6125,-89,5612,396,446845,11,13760,6357,"East TN",2455501,133.699803013723,0.122540473225405,70.3318793191288,12.7876144216598,228.548064122149,12.2540473225405
2021-11-29,459683,1101,352493,700,107190,401,387511,737,2471320,4548,2858831,5285,19,6144,452,6064,630,447475,12,13772,6360,"East TN",2455501,147.790613809565,0.127979027645377,215.231026173477,44.8381002491956,246.955712907468,12.7979027645377
2021-11-30,460522,839,352991,498,107531,341,388016,505,2474687,3367,2862703,3872,64,6208,217,6281,558,448033,13,13785,6367,"East TN",2455501,154.388045453861,0.12819904088125,157.686761276008,34.1681799355814,255.793013319889,12.819904088125
2021-12-01,461601,1079,353745,754,107856,325,388818,802,2479860,5173,2868678,5975,48,6256,546,6827,485,448518,13,13798,6378,"East TN",2455501,168.356681589623,0.130593688714566,243.331197991774,43.9421527419455,278.028801454367,13.0593688714566
2021-12-02,462492,891,354356,611,108136,280,389476,658,2484521,4661,2873997,5319,39,6295,317,7144,535,449053,9,13807,6386,"East TN",2455501,193.035962925692,0.131619517459339,216.615672321046,36.2858740436269,290.938590536106,13.1619517459339
2021-12-03,463505,1013,355073,717,108432,296,390253,777,2489499,4978,2879752,5755,21,6316,524,7668,468,449521,9,13816,6389,"East TN",2455501,224.842099433069,0.132630447921563,234.371722919274,41.2543102201954,312.278431163335,13.2630447921563
2021-12-04,463919,414,355393,320,108526,94,390625,372,2492251,2752,2882876,3124,3,6319,54,7722,357,449878,8,13824,6395,"East TN",2455501,230.136334703183,0.130984963132305,127.224546029507,16.8601030909782,314.477575044767,13.0984963132305
2021-12-05,464304,385,355596,203,108708,182,390856,231,2494183,1932,2885039,2163,12,6331,-6,7716,379,450257,6,13830,6398,"East TN",2455501,233.027801658399,0.129616105166227,88.087929917357,15.6790813768758,314.233225724608,12.9616105166227
2021-12-06,465227,923,356224,628,109003,295,391537,681,2498367,4184,2889904,4865,69,6400,73,7789,781,451038,8,13838,6404,"East TN",2455501,225.778771827012,0.129565861036913,198.12657376234,37.5890704178088,317.20614245321,12.9565861036913
2021-12-07,466049,822,356722,498,109327,324,392053,516,2501843,3476,2893896,3992,8,6408,168,7957,646,451684,3,13841,6406,"East TN",2455501,225.086448753228,0.129420062193441,162.573747679191,33.4758568617972,324.047923417665,12.9420062193441
