"DATE","TOTAL_CASES","NEW_CASES","TOTAL_CONFIRMED","NEW_CONFIRMED","TOTAL_PROBABLE","NEW_PROBABLE","POS_TESTS","NEW_POS_TESTS","NEG_TESTS","NEW_NEG_TESTS","TOTAL_TESTS","NEW_TESTS","NEW_DEATHS","TOTAL_DEATHS","ACTIVE_CHANGE","TOTAL_ACTIVE","NEW_INACTIVE_RECOVERED","TOTAL_INACTIVE_RECOVERED","NEW_HOSPITALIZED","TOTAL_HOSPITALIZED","TOTAL_DEATHS_BY_DOD","Region","Population","New_cases_per_100k_per_week","PositivityRate_per_week","Tests_per_100k","New_cases_per_100k","Active_cases_per_100k","PositivityPercentage_per_week"
2022-01-29,116195,673,91155,584,25040,89,98363,642,524291,912,622654,1554,0,1166,16,13356,657,101673,3,2469,1173,"Knox County",470313,NA,NA,330.418253375943,143.096193386107,2839.81093442027,NA
2022-01-28,115522,934,90571,772,24951,162,97721,834,523379,1040,621100,1874,3,1166,-305,13340,1236,101016,9,2466,1172,"Knox County",470313,NA,NA,398.458048150912,198.591150999441,2836.40894468152,NA
2022-01-27,114588,1421,89799,1194,24789,227,96887,1272,522339,1472,619226,2744,7,1163,124,13645,1290,99780,10,2457,1169,"Knox County",470313,NA,NA,583.441240195359,302.139213672597,2901.25937407641,NA
2022-01-26,113167,997,88605,800,24562,197,95615,853,520867,985,616482,1838,4,1156,-439,13521,1432,98490,4,2447,1163,"Knox County",470313,NA,NA,390.803571238728,211.986485595763,2874.89395360111,NA
2022-01-25,112170,1024,87805,764,24365,260,94762,803,519882,930,614644,1733,7,1152,-272,13960,1289,97058,5,2443,1158,"Knox County",470313,NA,NA,368.478013578192,217.727343279901,2968.23604705802,NA
2022-01-24,111146,1321,87041,1081,24105,240,93959,1165,518952,1550,612911,2715,13,1145,-81,14232,1389,95769,13,2438,1155,"Knox County",470313,NA,NA,577.275133793878,280.876777805419,3026.06987261675,NA
2022-01-23,109825,769,85960,680,23865,89,92794,709,517402,818,610196,1527,0,1132,152,14313,617,94380,4,2425,1152,"Knox County",470313,1517.92529655782,0.448909545942081,324.677395691805,163.508131818597,3043.29244566916,44.8909545942081
2022-01-22,109056,903,85280,738,23776,165,92085,770,516584,1056,608669,1826,0,1132,246,14161,657,93763,11,2421,1143,"Knox County",470313,1566.82889905233,0.449323139510416,388.252078934667,191.999795880616,3010.97354315105,44.9323139510416
2022-01-21,108153,1519,84542,1230,23611,289,91315,1292,515528,1348,606843,2640,1,1132,659,13915,859,93106,4,2410,1140,"Knox County",470313,1691.21414887532,0.456899420887972,561.328306893494,322.976400822431,2958.66795091779,45.6899420887972
2022-01-20,106634,1410,83312,1171,23322,239,90023,1218,514180,1152,604203,2370,11,1131,503,13256,896,92247,6,2406,1135,"Knox County",470313,1688.87528092993,0.464878148679091,503.919730052114,299.800345727207,2818.54849855309,46.4878148679091
2022-01-19,105224,1675,82141,1311,23083,364,88805,1344,513028,1331,601833,2675,4,1120,428,12753,1243,91351,3,2400,1133,"Knox County",470313,1833.0345961094,0.47145809117913,568.770159447007,356.145800775228,2711.59844614119,47.145809117913
2022-01-18,103549,1045,80830,666,22719,379,87461,692,511697,686,599158,1378,6,1116,-247,12325,1286,90108,6,2397,1131,"Knox County",470313,1837.49970764151,0.475183398321327,292.99636624971,222.192454812008,2620.59522062967,47.5183398321327
2022-01-17,102504,1088,80164,856,22340,232,86769,900,511011,1279,597780,2179,7,1110,-68,12572,1149,88822,11,2391,1128,"Knox County",470313,1787.95823207098,0.474477560808496,463.308477545805,231.335302234895,2673.11343722159,47.4477560808496
2022-01-16,101416,773,79308,693,22108,80,85869,718,509732,1073,595601,1791,0,1103,283,12640,490,87673,7,2380,1125,"Knox County",470313,1788.80872950567,0.466653206810687,380.810226381155,164.358629253285,2687.57189361128,46.6653206810687
2022-01-15,100643,750,78615,598,22028,152,85151,627,508659,816,593810,1443,1,1103,490,12357,259,87183,10,2373,1123,"Knox County",470313,1756.27720262889,0.469121304227687,306.816949563376,159.468269003834,2627.39920010716,46.9121304227687
2022-01-14,99893,1314,78017,1058,21876,256,84524,1097,507843,1188,592367,2285,6,1102,849,11867,459,86924,8,2363,1121,"Knox County",470313,1712.68920910117,0.467105729056016,485.846659565013,279.388407294717,2523.21326435799,46.7105729056016
2022-01-13,98579,1406,76959,1055,21620,351,83427,1105,506655,1402,590082,2507,6,1096,643,11018,757,86465,10,2355,1116,"Knox County",470313,1711.83871166649,0.454692102679198,533.049267190148,298.94984829252,2342.69518384565,45.4692102679198
2022-01-12,97173,1167,75904,888,21269,279,82322,936,505253,1058,587575,1994,1,1090,460,10375,706,85708,3,2345,1110,"Knox County",470313,1603.82553746122,0.447447889813655,423.972971191526,248.132626569965,2205.9777212197,44.7447889813655
2022-01-11,96006,1367,75016,1058,20990,309,81386,1096,504195,1283,585581,2379,2,1089,739,9915,626,85002,10,2342,1110,"Knox County",470313,1672.29058095354,0.444436822609411,505.83334928016,290.657498304321,2108.17051623068,44.4436822609411
2022-01-10,94639,1002,73958,684,20681,318,80290,715,502912,812,583202,1527,3,1087,414,9176,585,84376,5,2332,1107,"Knox County",470313,1654.00488610776,0.451960361912969,324.677395691805,213.049607389122,1951.04111517224,45.1960361912969
2022-01-09,93637,741,73274,625,20363,116,79575,663,502100,1205,581675,1868,5,1084,468,8762,268,83791,2,2327,1106,"Knox County",470313,1647.20090663027,0.445547382703706,397.182301998882,157.554649775788,1863.01463068212,44.5547382703706
2022-01-08,92896,624,72649,477,20247,147,78912,509,500895,912,579807,1421,0,1079,528,8294,96,83523,9,2325,1105,"Knox County",470313,1620.41023743762,0.437808454330878,302.139213672597,132.67759981119,1763.50643082373,43.7808454330878
2022-01-07,92272,965,72172,748,20100,217,78403,763,499983,1091,578386,1854,0,1079,806,7766,159,83427,7,2316,1101,"Knox County",470313,1546.20433626117,0.427084870848708,394.205560977477,205.182506118266,1651.24076944503,42.7084870848709
2022-01-06,91307,1170,71424,743,19883,427,77640,781,498892,1011,576532,1792,2,1079,957,6960,211,83268,7,2309,1101,"Knox County",470313,1496.02498761463,0.425633034670822,381.022850739826,248.77049964598,1479.86553635558,42.5633034670822
2022-01-05,90137,1216,70681,905,19456,311,76859,943,497881,1255,574740,2198,1,1077,995,6003,220,83057,8,2302,1097,"Knox County",470313,1506.44358118955,0.419510698673211,467.348340360568,258.551220144882,1276.38402510668,41.9510698673211
2022-01-04,88921,925,69776,577,19145,348,75916,567,496626,1040,572542,1607,0,1076,725,5008,200,82837,5,2294,1096,"Knox County",470313,1412.46361465662,0.402787967718269,341.687344385547,196.677531771395,1064.82278822826,40.2787967718269
2022-01-03,87996,715,69199,537,18797,178,75349,505,495586,820,570935,1325,6,1076,540,4283,169,82637,6,2289,1091,"Knox County",470313,1351.44042371782,0.392125984251968,281.727275240106,152.026416450321,910.670128191226,39.2125984251969
2022-01-02,87281,290,68662,206,18619,84,74844,265,494766,651,569610,916,3,1070,182,3743,105,82468,8,2283,1089,"Knox County",470313,1255.54683795685,0.389903716368217,194.763912543349,61.6610640148157,795.852974508466,38.9903716368217
2022-01-01,86991,265,68456,215,18535,50,74579,237,494115,767,568694,1004,0,1067,171,3561,94,82363,15,2275,1087,"Knox County",470313,1179.21469319368,0.379674644727001,213.474856106465,56.3454550480212,757.155341230202,37.9674644727001
2021-12-31,86726,591,68241,429,18485,162,74342,470,493348,1008,567690,1478,0,1067,485,3390,106,82269,4,2260,1087,"Knox County",470313,1099.69318305044,0.365116279069767,314.258802116888,125.660995975021,720.796575897328,36.5116279069767
2021-12-30,86135,582,67812,403,18323,179,73872,404,492340,918,566212,1322,2,1067,472,2905,108,82163,6,2256,1084,"Knox County",470313,974.670060151431,0.344263959390863,281.089402164091,123.747376746975,617.673761941516,34.4263959390863
2021-12-29,85553,631,67409,473,18144,158,73468,502,491422,1195,564890,1697,1,1065,506,2433,124,82055,5,2250,1082,"Knox County",470313,850.284810328441,0.315541769173174,360.823536666007,134.165970321892,517.315064648436,31.5541769173174
2021-12-28,84922,429,66936,262,17986,167,72966,283,490227,979,563193,1262,1,1064,304,1927,124,81931,4,2245,1080,"Knox County",470313,744.823128427239,0.296090626388272,268.331940643784,91.2158498701928,409.727139160517,29.6090626388272
2021-12-27,84493,314,66674,234,17819,80,72683,254,489248,905,561931,1159,2,1063,201,1623,111,81807,1,2241,1080,"Knox County",470313,659.560760599856,0.273251866938221,246.431631700591,66.7640486229383,345.089334124296,27.3251866938221
2021-12-26,84179,61,66440,49,17739,12,72429,60,488343,426,560772,486,7,1061,-35,1422,89,81696,1,2240,1079,"Knox County",470313,610.869782464019,0.262844909609895,103.335438314484,12.9700858789785,302.351838031269,26.2844909609895
2021-12-25,84118,85,66391,63,17727,22,72369,74,487917,489,560286,563,1,1054,5,1457,79,81607,1,2239,1079,"Knox County",470313,572.597397903099,0.256934856282164,119.707513932211,18.0730704871011,309.793690584781,25.6934856282164
2021-12-24,84033,174,66328,122,17705,52,72295,137,487428,848,559723,985,0,1053,92,1452,82,81528,2,2238,1079,"Knox County",470313,483.933040336967,0.229328338239229,209.434993291702,36.9966384088894,308.730568791422,22.9328338239229
2021-12-23,83859,218,66206,159,17653,59,72158,166,486580,960,558738,1126,5,1053,113,1360,100,81446,5,2236,1079,"Knox County",470313,406.53777378044,0.20280296784831,239.415027864422,46.3521101904476,289.169127793618,20.280296784831
2021-12-22,83641,177,66047,101,17594,76,71992,101,485620,814,557612,915,48,1048,14,1247,115,81346,11,2231,1078,"Knox County",470313,310.006314943453,0.16548645320197,194.551288184677,37.6345114849047,265.142575263707,16.548645320197
2021-12-21,83464,176,65946,123,17518,53,71891,119,484806,912,556697,1031,3,1000,70,1233,103,81231,6,2220,1076,"Knox County",470313,256.212352199493,0.145411013567438,219.215713790603,37.421887126233,262.165834242302,14.5411013567438
2021-12-20,83288,114,65823,80,17465,34,71772,84,483894,623,555666,707,1,997,-8,1163,121,81128,3,2214,1074,"Knox County",470313,213.687480465137,0.127472905556511,150.325421580947,24.2391768885827,247.282129135278,12.7472905556511
2021-12-19,83174,70,65743,50,17431,20,71688,58,483271,557,554959,615,3,996,-18,1171,85,81007,6,2211,1073,"Knox County",470313,215.601099693183,0.124368899360485,130.763980583144,14.8837051070245,248.983124004652,12.4368899360485
2021-12-18,83104,88,65693,56,17411,32,71630,65,482714,660,554344,725,0,993,13,1189,75,80922,3,2205,1072,"Knox County",470313,216.238972769198,0.11959370904325,154.152660037039,18.7109435631165,252.810362460744,11.959370904325
2021-12-17,83016,119,65637,77,17379,42,71565,83,482054,1034,553619,1117,2,993,6,1176,111,80847,6,2202,1070,"Knox County",470313,204.544633042251,0.108402822322001,237.501408636376,25.3022986819416,250.046245798011,10.8402822322001
2021-12-16,82897,139,65560,107,17337,32,71482,108,481020,661,552502,769,2,991,34,1170,103,80736,3,2196,1068,"Knox County",470313,187.74730870718,0.105119918353461,163.508131818597,29.5547858553772,248.77049964598,10.5119918353461
2021-12-15,82758,157,65453,113,17305,44,71374,125,480359,841,551733,966,0,989,33,1136,124,80633,5,2193,1066,"Knox County",470313,183.494821533745,0.108263069139966,205.395130476938,33.3820243114692,241.54127145114,10.8263069139966
2021-12-14,82601,97,65340,58,17261,39,71249,63,479518,811,550767,874,3,989,-54,1103,148,80509,3,2188,1063,"Knox County",470313,166.697497198674,0.101507015416594,185.833689479134,20.6245627911625,234.524667614971,10.1507015416594
2021-12-13,82504,111,65282,72,17222,39,71186,79,478707,627,549893,706,4,986,-50,1157,157,80361,3,2185,1060,"Knox County",470313,166.059624122659,0.100658350658351,150.112797222275,23.6013038125674,246.006382983247,10.0658350658351
2021-12-12,82393,54,65210,30,17183,24,71107,40,478080,493,549187,533,6,982,-38,1207,86,80204,5,2182,1060,"Knox County",470313,162.65763438391,0.0989455184534271,113.328783172058,11.481715368276,256.637600916836,9.89455184534271
2021-12-11,82339,65,65180,45,17159,20,71067,51,477587,541,548654,592,0,976,-21,1245,86,80118,1,2177,1059,"Knox County",470313,157.767274134459,0.0987943134784956,125.873620333693,13.8205833136656,264.717326546364,9.87943134784956
2021-12-10,82274,84,65135,47,17139,37,71016,57,477046,856,548062,913,0,976,-13,1266,97,80032,3,2176,1056,"Knox County",470313,150.325421580947,0.0977022230524939,194.126039467333,17.8604461284294,269.182438078471,9.77022230524939
2021-12-09,82190,164,65088,96,17102,68,70959,107,476190,1017,547149,1124,3,976,101,1279,60,79935,2,2173,1055,"Knox County",470313,155.641030547742,0.0914505956552207,238.989779147079,34.8703948221716,271.946554741204,9.14505956552208
2021-12-08,82026,130,64992,65,17034,65,70852,65,475173,751,546025,816,0,973,32,1178,98,79875,7,2171,1054,"Knox County",470313,149.900172863604,0.0831234256926952,173.501476676171,27.6411666273312,250.471494515355,8.31234256926952
2021-12-07,81896,127,64927,70,16969,57,70787,76,474422,631,545209,707,2,973,17,1146,108,79777,2,2164,1053,"Knox County",470313,156.278903623757,0.0881098126507142,150.325421580947,27.0032935513158,243.667515037858,8.81098126507142
2021-12-06,81769,148,64857,106,16912,42,70711,115,473791,759,544502,874,8,971,38,1129,102,79669,4,2162,1053,"Knox County",470313,164.146004894613,0.0919230077352042,185.833689479134,31.4684050834232,240.052900940438,9.19230077352042
2021-12-05,81621,43,64751,28,16870,15,70596,33,473032,342,543628,375,2,963,-21,1091,62,79567,1,2158,1050,"Knox County",470313,161.807136949223,0.093316052582855,79.7341345019168,9.14284742288646,231.97317531091,9.3316052582855
2021-12-04,81578,69,64723,49,16855,20,70563,55,472690,499,543253,554,0,961,15,1112,54,79505,3,2157,1050,"Knox County",470313,162.65763438391,0.0947231027410032,117.793894704165,14.6710807483527,236.438286843017,9.47231027410032
2021-12-03,81509,147,64674,103,16835,44,70508,108,472191,1009,542699,1117,3,961,62,1097,82,79451,2,2154,1048,"Knox County",470313,176.052968980232,0.100413148913239,237.501408636376,31.2557807247514,233.248921462941,10.0413148913239
2021-12-02,81362,133,64571,86,16791,47,70400,85,471182,794,541582,879,0,958,31,1035,102,79369,4,2152,1046,"Knox County",470313,169.461613861407,0.100901916572717,186.896811272493,28.2790397033465,220.06621122529,10.0901916572717
2021-12-01,81229,185,64485,142,16744,43,70315,147,470388,1009,540703,1156,4,958,91,1004,90,79267,7,2148,1044,"Knox County",470313,181.155953588355,0.109325326739668,245.793758624576,39.335506354279,213.474856106465,10.9325326739668
2021-11-30,81044,116,64343,65,16701,51,70168,68,469379,693,539547,761,3,954,17,913,96,79177,6,2141,1043,"Knox County",470313,178.817085642965,0.106892932120364,161.807136949223,24.6644256059263,194.126039467333,10.6892932120364
2021-11-29,80928,165,64278,128,16650,37,70100,139,468686,967,538786,1106,2,951,75,896,88,79081,5,2135,1040,"Knox County",470313,182.431699740386,0.106758574310693,235.162540690987,35.0830191808434,190.511425369913,10.6758574310693
2021-11-28,80763,33,64150,22,16613,11,69961,22,467719,270,537680,292,3,949,-22,821,52,78993,5,2130,1039,"Knox County",470313,180.305456153668,0.106393861892583,62.0863127321592,7.01660383616868,174.56459846953,10.6393861892583
2021-11-27,80730,59,64128,30,16602,29,69939,32,467449,266,537388,298,0,946,-1,843,60,78941,1,2125,1038,"Knox County",470313,178.17921256695,0.107149224460688,63.3620588841899,12.5448371616349,179.242334360309,10.7149224460688
2021-11-26,80671,20,64098,18,16573,2,69907,20,467183,298,537090,318,0,946,-46,844,66,78881,4,2124,1036,"Knox County",470313,151.175919015634,0.106652806652807,67.6145460576254,4.25248717343556,179.454958718981,10.6652806652807
2021-11-25,80651,52,64080,26,16571,26,69887,29,466885,331,536772,360,0,946,-17,890,69,78815,3,2120,1035,"Knox County",470313,133.95334596322,0.106501980890235,76.5447691218401,11.0564666509325,189.235679217883,10.6501980890235
2021-11-24,80599,105,64054,66,16545,39,69858,73,466554,742,536412,815,0,946,19,907,86,78746,3,2117,1030,"Knox County",470313,116.943397269478,0.0969620253164557,173.288852317499,22.3255576605367,192.850293315303,9.69620253164557
2021-11-23,80494,99,63988,63,16506,36,69785,65,465812,674,535597,739,0,946,37,888,62,78660,2,2114,1026,"Knox County",470313,113.328783172058,0.0967413441955193,157.129401058444,21.049811508506,188.810430500539,9.67413441955193
2021-11-22,80395,107,63925,83,16470,24,69720,82,465138,740,534858,822,0,946,38,851,69,78598,3,2112,1026,"Knox County",470313,100.996570369095,0.0886388583973655,174.777222828202,22.7508063778803,180.943329229683,8.86388583973655
2021-11-21,80288,44,63842,32,16446,12,69638,37,464398,284,534036,321,0,946,-8,813,52,78529,2,2109,1026,"Knox County",470313,103.335438314484,0.0920228695888919,68.2524191336408,9.35547178155824,172.863603600156,9.20228695888919
2021-11-20,80244,54,63810,37,16434,17,69601,44,464114,537,533715,581,0,946,14,821,40,78477,1,2107,1024,"Knox County",470313,102.272316521125,0.0884732052578362,123.534752388303,11.481715368276,174.56459846953,8.84732052578362
2021-11-19,80190,112,63773,83,16417,29,69557,81,463577,825,533134,906,0,946,62,807,50,78437,0,2106,1024,"Knox County",470313,121.833757518929,0.0904489436619718,192.637668956631,23.8139281712392,171.587857448125,9.04489436619718
2021-11-18,80078,80,63690,44,16388,36,69476,49,462752,937,532228,986,3,946,18,745,59,78387,2,2106,1024,"Knox County",470313,127.787239561739,0.0833655705996132,209.647617650373,17.0099486937423,158.405147210475,8.33655705996132
2021-11-17,79998,105,63646,64,16352,41,69427,66,461815,834,531242,900,0,943,45,727,60,78328,1,2104,1024,"Knox County",470313,127.787239561739,0.0806850618458611,191.3619228046,22.3255576605367,154.577908754383,8.06850618458611
2021-11-16,79893,73,63582,51,16311,22,69361,67,460981,777,530342,844,0,943,8,682,65,78268,2,2103,1023,"Knox County",470313,122.259006236272,0.0794776119402985,179.454958718981,15.5215781830398,145.009812614153,7.94776119402985
2021-11-15,79820,84,63531,44,16289,40,69294,34,460204,460,529498,494,3,943,21,674,60,78203,0,2101,1020,"Knox County",470313,117.368645986822,0.0751192368839428,105.036433183858,17.8604461284294,143.308817744778,7.51192368839428
2021-11-14,79736,72,63487,62,16249,10,69260,68,459744,624,529004,692,0,940,16,653,56,78143,2,2101,1020,"Knox County",470313,123.322128029631,0.0756986859152323,147.13605620087,15.308953824368,138.843706212671,7.56986859152323
2021-11-13,79664,29,63425,12,16239,17,69192,12,459120,317,528312,329,0,940,-14,637,43,78087,2,2099,1018,"Knox County",470313,118.006519062837,0.0731896719083673,69.953414003015,6.16610640148157,135.441716473923,7.31896719083673
2021-11-12,79635,66,63413,49,16222,17,69180,51,458803,687,527983,738,0,940,17,651,49,78044,4,2097,1018,"Knox County",470313,108.225798563935,0.0696367650010034,156.916776699772,14.0332076723374,138.418457495328,6.96367650010034
2021-11-11,79569,67,63364,46,16205,21,69129,54,458116,962,527245,1016,0,940,-3,634,70,77995,0,2093,1016,"Knox County",470313,105.461681901202,0.0702174346698584,216.026348410527,14.2458320310091,134.803843397907,7.02174346698584
2021-11-10,79502,74,63318,50,16184,24,69075,69,457154,855,526229,924,1,940,7,637,66,77925,2,2093,1016,"Knox County",470313,98.8703267823768,0.0704784594004368,196.464907412723,15.7342025417116,135.441716473923,7.04784594004368
2021-11-09,79428,106,63268,76,16160,30,69006,134,456299,1174,525305,1308,1,939,34,630,71,77859,1,2091,1016,"Knox County",470313,105.886930618546,0.0767133248500273,278.112661142686,22.5381820192085,133.95334596322,7.67133248500273
2021-11-08,79322,78,63192,58,16130,20,68872,70,455125,687,523997,757,6,938,-10,596,82,77788,1,2090,1015,"Knox County",470313,104.611184466515,0.0794587092297016,160.956639514536,16.5846999763987,126.72411776838,7.94587092297016
2021-11-07,79244,31,63134,20,16110,11,68802,23,454438,390,523240,413,0,932,-20,606,51,77706,1,2089,1012,"Knox County",470313,95.8935857609719,0.0752962625341841,87.8138601314444,6.59135511882512,128.850361355098,7.52962625341841
2021-11-06,79213,41,63114,27,16099,14,68779,30,454048,453,522827,483,0,932,-2,626,43,77655,2,2088,1009,"Knox County",470313,98.4450780650333,0.0764319914878525,102.697565238469,8.7175987055429,133.102848528533,7.64319914878525
2021-11-05,79172,52,63087,32,16085,20,68749,36,453595,605,522344,641,0,932,-27,628,79,77612,2,2086,1008,"Knox County",470313,95.4683370436284,0.0750631540959942,136.29221390861,11.0564666509325,133.528097245877,7.50631540959942
2021-11-04,79120,68,63055,45,16065,23,68713,49,452990,668,521703,717,0,932,-1,655,69,77533,1,2084,1008,"Knox County",470313,95.6809614023002,0.0783902345985123,152.451665167665,14.4584563896809,139.268954930015,7.83902345985123
2021-11-03,79052,80,63010,60,16042,20,68664,66,452322,969,520986,1035,0,932,-1,656,81,77464,2,2083,1007,"Knox County",470313,96.9567075543308,0.0762047067613,220.06621122529,17.0099486937423,139.481579288686,7.62047067613
2021-11-02,78972,41,62950,19,16022,22,68598,22,451353,301,519951,323,4,932,-52,657,89,77383,1,2081,1005,"Knox County",470313,83.1361242406653,0.0677500572213321,68.6776678509843,8.7175987055429,139.694203647358,6.77500572213321
2021-11-01,78931,95,62931,71,16000,24,68576,83,451052,661,519628,744,1,928,-19,709,113,77294,3,2080,1002,"Knox County",470313,86.7507383380855,0.0709366391184573,158.192522851803,20.1993140738189,150.750670298291,7.09366391184573
2021-10-31,78836,26,62860,20,15976,6,68493,19,450391,278,518884,297,0,927,-43,728,69,77181,1,2077,1001,"Knox County",470313,85.6876165447266,0.0719339622641509,63.1494345255181,5.52823332546623,154.790533113054,7.19339622641509
2021-10-30,78810,56,62840,41,15970,15,68474,43,450113,522,518587,565,0,927,-23,771,79,77112,4,2076,1000,"Knox County",470313,88.8769819248033,0.0735770476631189,120.132762649555,11.9069640856196,163.933380535941,7.35770476631189
2021-10-29,78754,73,62799,59,15955,14,68431,66,449591,846,518022,912,1,927,-37,794,109,77033,1,2072,1000,"Knox County",470313,93.3420934569106,0.0757674722403658,193.913415108662,15.5215781830398,168.823740785392,7.57674722403658
2021-10-28,78681,54,62740,32,15941,22,68365,39,448745,561,517110,600,4,926,-52,831,102,76924,3,2071,999,"Knox County",470313,90.3653524355057,0.0755138516532618,127.574615203067,11.481715368276,176.690842056248,7.55138516532618
2021-10-27,78627,88,62708,57,15919,31,68326,65,448184,759,516510,824,1,922,-29,883,116,76822,3,2068,997,"Knox County",470313,92.0663473048799,0.0790152403282532,175.202471545545,18.7109435631165,187.74730870718,7.90152403282532
2021-10-26,78539,96,62651,58,15888,38,68261,55,447425,554,515686,609,0,921,-18,912,114,76706,5,2065,994,"Knox County",470313,103.760687031828,0.0813008130081301,129.488234431113,20.4119384324907,193.913415108662,8.13008130081301
2021-10-25,78443,71,62593,47,15850,24,68206,54,446871,491,515077,545,6,921,-73,930,138,76592,3,2060,992,"Knox County",470313,98.6577024237051,0.0783547794117647,115.880275476119,15.0963294656962,197.740653564754,7.83547794117647
2021-10-24,78372,38,62546,20,15826,18,68152,23,446380,337,514532,360,1,915,-73,1003,110,76454,5,2057,991,"Knox County",470313,101.209194727766,0.0781426953567384,76.5447691218401,8.07972562952757,213.262231747793,7.81426953567384
2021-10-23,78334,59,62526,40,15808,19,68129,42,446043,471,514172,513,0,914,-15,1076,74,76344,1,2052,988,"Knox County",470313,101.847067803782,0.0788448315379326,109.076295998622,12.5448371616349,228.783809930833,7.88448315379326
2021-10-22,78275,90,62486,55,15789,35,68087,55,445572,551,513659,606,0,914,-69,1091,159,76270,2,2051,986,"Knox County",470313,105.461681901202,0.0820803549420754,128.850361355098,19.13619228046,231.97317531091,8.20803549420754
2021-10-21,78185,124,62431,71,15754,53,68032,78,445021,712,513053,790,3,914,-22,1160,143,76111,2,2049,984,"Knox County",470313,120.345387008226,0.0875912408759124,167.973243350705,26.3654204753005,246.644256059263,8.75912408759124
2021-10-20,78061,149,62360,83,15701,66,67954,90,444309,959,512263,1049,3,911,-47,1182,193,75968,3,2047,982,"Knox County",470313,133.315472887205,0.0887745974955277,223.042952246695,31.6810294420949,251.321991950042,8.87745974955277
2021-10-19,77912,131,62277,85,15635,46,67864,92,443350,724,511214,816,4,908,-40,1229,167,75775,4,2044,980,"Knox County",470313,140.757325440717,0.0927548621500321,173.501476676171,27.8537909860029,261.315336807615,9.27548621500321
2021-10-18,77781,121,62192,90,15589,31,67772,106,442626,607,510398,713,9,904,-74,1269,186,75608,8,2040,978,"Knox County",470313,151.388543374306,0.100268207138436,151.601167732978,25.7275473992852,269.820311154486,10.0268207138436
2021-10-17,77660,63,62102,56,15558,7,67666,61,442019,303,509685,364,1,895,-65,1343,127,75422,4,2032,975,"Knox County",470313,156.7041523411,0.108018965161822,77.3952665565272,13.395334596322,285.554513696198,10.8018965161822
2021-10-16,77597,55,62046,41,15551,14,67605,44,441716,372,509321,416,0,894,-83,1408,138,75295,1,2028,973,"Knox County",470313,155.853654906413,0.110643668489693,88.4517332074597,11.6943397269478,299.375097009864,11.0643668489693
2021-10-15,77542,125,62005,89,15537,36,67561,100,441344,794,508905,894,9,894,-68,1491,184,75157,5,2027,969,"Knox County",470313,163.295507459926,0.113248710829036,190.08617665257,26.5780448339723,317.022918779621,11.3248710829036
2021-10-14,77417,192,61916,135,15501,57,67461,143,440550,699,508011,842,0,885,9,1559,183,74973,7,2022,967,"Knox County",470313,177.753963849607,0.124852767962309,179.029710001637,40.8238768649814,331.481375169302,12.4852767962309
2021-10-13,77225,121,61781,88,15444,33,67318,99,439851,764,507169,863,7,885,-78,1550,192,74790,5,2015,962,"Knox County",470313,171.800481806797,0.131418092909535,183.494821533745,25.7275473992852,329.567755941256,13.1418092909535
2021-10-12,77104,136,61693,104,15411,32,67219,109,439087,821,506306,930,4,878,-81,1628,213,74598,3,2010,961,"Knox County",470313,172.863603600156,0.131819992035046,197.740653564754,28.9169127793618,346.152455917655,13.1819992035046
2021-10-11,76968,194,61589,136,15379,58,67110,149,438266,581,505376,730,3,874,-86,1709,277,74385,12,2007,952,"Knox County",470313,188.385181783195,0.139908712046041,155.215781830398,41.249125582325,363.375028970069,13.9908712046041
2021-10-10,76774,54,61453,41,15321,13,66961,51,437685,489,504646,540,0,871,-89,1795,143,74108,4,1995,951,"Knox County",470313,186.471562555149,0.13326941514861,114.81715368276,11.481715368276,381.660723815842,13.326941514861
2021-10-09,76720,66,61412,37,15308,29,66910,48,437196,490,504106,538,0,871,-66,1884,132,73965,7,1991,948,"Knox County",470313,188.810430500539,0.1309724564362,114.391904965417,14.0332076723374,400.58429173763,13.09724564362
2021-10-08,76654,289,61375,114,15279,175,66862,123,436706,936,503568,1059,-1,871,77,1950,213,73833,5,1984,944,"Knox County",470313,223.680825322711,0.131225009087605,225.169195833413,61.4484396561439,414.617499409967,13.1225009087605
2021-10-07,76365,259,61261,170,15104,89,66739,176,435770,1106,502509,1282,6,872,-9,1873,262,73620,9,1979,940,"Knox County",470313,237.92665735372,0.127061595422417,272.58442781722,55.0697088959905,398.24542379224,12.7061595422417
2021-10-06,76106,139,61091,103,15015,36,66563,112,434664,835,501227,947,1,866,-120,1882,258,73358,4,1970,939,"Knox County",470313,241.753895809812,0.12744772651842,201.355267662174,29.5547858553772,400.159043020287,12.744772651842
2021-10-05,75967,210,60988,118,14979,92,66451,138,433829,915,500280,1053,3,865,-71,2002,278,73100,4,1966,934,"Knox County",470313,257.488098351523,0.129614571475037,223.893449681382,44.6511153210734,425.6739660609,12.9614571475037
2021-10-04,75757,317,60870,225,14887,92,66313,246,432914,829,499227,1075,3,862,-13,2073,327,72822,4,1962,930,"Knox County",470313,283.640894468152,0.137665537419156,228.571185572162,67.4019216989537,440.770295526596,13.7665537419156
2021-10-03,75440,102,60645,93,14795,9,66067,107,432085,678,498152,785,1,859,-67,2086,168,72495,6,1958,928,"Knox County",470313,293.846863684397,0.140970470396201,166.910121557346,21.6876845845214,443.534412189329,14.0970470396201
2021-10-02,75338,67,60552,43,14786,24,65960,50,431407,472,497367,522,5,858,-144,2153,206,72327,2,1952,927,"Knox County",470313,294.059488043069,0.141603450840399,110.989915226668,14.2458320310091,457.780244220338,14.1603450840399
2021-10-01,75271,225,60509,151,14762,74,65910,167,430935,965,496845,1132,0,853,-76,2297,301,72121,9,1950,923,"Knox County",470313,280.451529088075,0.146556798116539,240.690774016453,47.8404807011501,488.398151869074,14.6556798116539
2021-09-30,75046,240,60358,166,14688,74,65743,186,429970,1104,495713,1290,1,853,-112,2373,351,71820,8,1941,920,"Knox County",470313,276.411666273312,0.147854203409759,274.285422686594,51.0298460812268,504.55760312813,14.7854203409759
2021-09-29,74806,361,60192,170,14614,191,65557,192,428866,1111,494423,1303,6,852,-96,2485,451,71469,7,1933,918,"Knox County",470313,323.614273898446,0.151675977653631,277.049539349327,76.7573934805119,528.371531299369,15.1675977653631
2021-09-28,74445,348,60022,248,14423,100,65365,270,427755,778,493120,1048,2,846,-75,2581,421,71018,1,1926,915,"Knox County",470313,352.956435395152,0.170230607966457,222.830327888024,73.9932768177788,548.783469731859,17.0230607966457
2021-09-27,74097,239,59774,162,14323,77,65095,186,426977,760,492072,946,7,844,-303,2656,535,70597,12,1925,913,"Knox County",470313,336.371735418753,0.164816396242528,201.142643303502,50.817221722555,564.730296632243,16.4816396242528
2021-09-26,73858,124,59612,99,14246,25,64909,117,426217,703,491126,820,2,837,-143,2959,265,70062,1,1913,907,"Knox County",470313,341.049471309532,0.165415663503753,174.351974110858,26.3654204753005,629.155477309792,16.5415663503753
2021-09-25,73734,110,59513,90,14221,20,64792,102,425514,705,490306,807,0,835,-178,3102,288,69797,3,1912,902,"Knox County",470313,350.192318732419,0.166076776476994,171.587857448125,23.3886794538956,659.560760599856,16.6076776476994
2021-09-24,73624,244,59423,165,14201,79,64690,182,424809,939,489499,1121,13,835,-233,3280,464,69509,5,1909,895,"Knox County",470313,354.232181547182,0.168370824812543,238.351906071063,51.8803435159139,697.407896443432,16.8370824812543
2021-09-23,73380,355,59258,245,14122,110,64508,268,423870,1370,488378,1638,14,822,-221,3513,562,69045,8,1904,892,"Knox County",470313,378.683982794437,0.171417415072237,348.278699504373,75.4816473284812,746.949372013957,17.1417415072237
2021-09-22,73025,251,59013,187,14012,64,64240,202,422500,1261,486740,1463,3,808,-329,3734,577,68483,4,1896,889,"Knox County",470313,355.295303340541,0.169195460920566,311.069436736811,53.3687140266163,793.93935528042,16.9195460920566
2021-09-21,72774,397,58826,216,13948,181,64038,230,421239,996,485277,1226,10,805,-352,4063,739,67906,7,1892,880,"Knox County",470313,365.713896915458,0.160453808752026,260.6774637316,84.4118703926959,863.892769283435,16.0453808752026
2021-09-20,72377,432,58610,310,13767,122,63808,343,420243,1295,484051,1638,5,795,113,4415,314,67167,9,1885,876,"Knox County",470313,406.750398139112,0.165729369907035,348.278699504373,91.8537229462082,938.736543535901,16.5729369907035
2021-09-19,71945,120,58300,87,13645,33,63465,97,418948,432,482413,529,1,790,-176,4302,295,66853,7,1876,869,"Knox County",470313,405.899900704425,0.169080978389931,112.478285737371,25.5149230406134,914.70999100599,16.9080978389931
2021-09-18,71825,226,58213,183,13612,43,63368,197,418516,1075,481884,1272,0,789,-107,4478,333,66558,7,1869,861,"Knox County",470313,430.564326310351,0.170923821312029,270.458184230502,48.0531050598219,952.131878132223,17.0923821312029
2021-09-17,71599,547,58030,422,13569,125,63171,449,417441,1310,480612,1759,5,789,5,4585,537,66225,12,1862,848,"Knox County",470313,494.9895069879,0.18750656167979,374.006246903658,116.305524193463,974.882684510103,18.750656167979
2021-09-16,71052,588,57608,456,13444,132,62722,487,416131,1518,478853,2005,7,784,10,4580,571,65688,16,1850,843,"Knox County",470313,544.530982558424,0.202689041649818,426.311839136915,125.023122899006,973.819562716744,20.2689041649818
2021-09-15,70464,338,57152,249,13312,89,62235,267,414613,808,476848,1075,6,777,-308,4570,640,65117,5,1834,840,"Knox County",470313,563.029301762869,0.21780303030303,228.571185572162,71.867033231061,971.693319130026,21.780303030303
2021-09-14,70126,555,56903,443,13223,112,61968,476,413805,1406,475773,1882,12,771,-160,4878,703,64477,8,1829,836,"Knox County",470313,596.62395043301,0.227952755905512,400.159043020287,118.006519062837,1037.18162160093,22.7952755905512
2021-09-13,69571,399,56460,299,13111,100,61492,333,412399,1134,473891,1467,20,759,-435,5038,814,63774,15,1821,833,"Knox County",470313,589.607346596841,0.230853939333267,311.919934171499,84.8371191100395,1071.20151898842,23.0853939333267
2021-09-12,69172,387,56161,358,13011,29,61159,376,411265,1460,472424,1836,0,739,80,5473,307,62960,5,1806,824,"Knox County",470313,646.378050362206,0.228842067988669,390.378322521385,82.2856268059781,1163.69311501064,22.8842067988669
2021-09-11,68785,866,55803,707,12982,159,60783,763,409805,2621,470588,3384,4,739,500,5393,362,62653,26,1801,816,"Knox County",470313,782.457639912144,0.235008949880668,719.520829745297,184.13269460976,1146.6831663169,23.5008949880668
2021-09-10,67919,1026,55096,748,12823,278,60020,803,407184,2513,467204,3316,1,735,481,4893,544,62291,24,1775,806,"Knox County",470313,884.304707715925,0.234213164049449,705.062373355616,218.152591997244,1040.37098698101,23.4213164049449
2021-09-09,66893,310,54348,167,12545,143,59217,173,404671,685,463888,858,1,734,-370,4412,679,61747,18,1751,799,"Knox County",470313,825.195136005171,0.230930670140397,182.431699740386,65.9135511882512,938.098670459885,23.0930670140397
2021-09-08,66583,290,54181,226,12402,64,59044,250,403986,837,463030,1087,5,733,-405,4782,690,61068,11,1733,794,"Knox County",470313,814.989166788926,0.229501084598698,231.122677876223,61.6610640148157,1016.76968316844,22.9501084598698
2021-09-07,66293,414,53955,299,12338,115,58794,311,403149,979,461943,1290,3,728,-221,5187,632,60378,13,1722,788,"Knox County",470313,785.009132216205,0.227300196404291,274.285422686594,88.0264844901162,1102.88254843051,22.7300196404291
2021-09-06,65879,991,53656,791,12223,200,58483,844,402170,3221,460653,4065,1,725,341,5408,649,59746,20,1709,787,"Knox County",470313,910.882752549898,0.222278353119475,864.318018000778,210.710739443732,1149.87253169698,22.2278353119475
2021-09-05,64888,969,52865,799,12023,170,57639,834,398949,2999,456588,3833,2,724,623,5067,344,59097,15,1689,784,"Knox County",470313,1034.63012929687,0.223069590085796,814.989166788926,206.033003552953,1077.3676253899,22.3069590085796
2021-09-04,63919,543,52066,389,11853,154,56805,408,395950,1502,452755,1910,2,722,224,4444,317,58753,10,1674,779,"Knox County",470313,965.952461445888,0.221468304908613,406.112525063096,115.455026758776,944.902649937382,22.1468304908613
2021-09-03,63376,334,51677,238,11699,96,56397,249,394448,909,450845,1158,5,720,-155,4220,484,58436,8,1664,775,"Knox County",470313,818.816405245018,0.216111541440744,246.219007341919,71.0165357963739,897.274793594904,21.6111541440744
2021-09-02,63042,323,51439,180,11603,143,56148,200,393539,681,449687,881,3,715,-158,4375,478,57952,5,1656,770,"Knox County",470313,821.580521907751,0.217660292463442,187.322059989837,68.6776678509843,930.231569189029,21.7660292463442
2021-09-01,62719,276,51259,211,11460,65,55948,226,392858,645,448806,871,3,712,-119,4533,392,57474,2,1651,767,"Knox County",470313,818.603780886346,0.219303255282696,185.195816403119,58.6843229934108,963.82621785917,21.9303255282696
2021-08-31,62443,594,51048,433,11395,161,55722,479,392213,1894,447935,2373,2,709,190,4652,402,57082,8,1649,764,"Knox County",470313,856.876165447266,0.214697501822278,504.55760312813,126.298869051036,989.128516541112,21.4697501822278
2021-08-30,61849,513,50615,403,11234,110,55243,430,390319,1630,445562,2060,9,707,96,4462,408,56680,12,1641,760,"Knox County",470313,755.241722002156,0.21595598349381,438.006178863863,109.076295998622,948.729888393474,21.595598349381
2021-08-29,61336,483,50212,407,11124,76,54813,439,388689,1485,443502,1924,1,698,255,4366,227,56272,5,1629,754,"Knox County",470313,651.906283687672,0.217500223673615,409.089266084501,102.697565238469,928.317949960983,21.7500223673615
2021-08-28,60853,397,49805,301,11048,96,54374,320,387204,1065,441578,1385,0,697,191,4111,206,56045,4,1624,747,"Knox County",470313,620.863127321592,0.219958693203154,294.484736760413,84.4118703926959,874.09873849968,21.9958693203154
2021-08-27,60456,472,49504,373,10952,99,54054,390,386139,1166,440193,1556,5,697,195,3920,272,55839,5,1620,744,"Knox County",470313,650.205288818298,0.224796380090498,330.843502093287,100.358697293079,833.48748599337,22.4796380090498
2021-08-26,59984,449,49131,347,10853,102,53664,368,384973,1426,438637,1794,5,692,154,3725,290,55567,0,1615,743,"Knox County",470313,676.995958010942,0.221683524199615,381.44809945717,95.4683370436284,792.025736052374,22.1683524199615
2021-08-25,59535,351,48784,224,10751,127,53296,238,383547,642,436843,880,2,687,91,3571,258,55277,4,1615,738,"Knox County",470313,692.942784911325,0.222519211493485,187.109435631165,74.6311498937941,759.28158481692,22.2519211493485
2021-08-24,59184,342,48560,222,10624,120,53058,237,382905,677,435963,914,4,685,76,3480,262,55019,5,1611,728,"Knox County",470313,639.361446526037,0.230381432512128,194.338663826005,72.7175306657481,739.932768177788,23.0381432512128
2021-08-23,58842,287,48338,206,10504,81,52821,227,382228,825,435049,1052,1,681,30,3404,256,54757,1,1606,728,"Knox County",470313,591.308341466215,0.233456075749605,223.680825322711,61.0231909388003,723.773316918733,23.3456075749605
2021-08-22,58555,240,48132,217,10423,23,52594,233,381403,889,433997,1122,2,680,70,3374,168,54501,0,1605,724,"Knox County",470313,539.640622308973,0.231299551878663,238.564530429735,51.0298460812268,717.39458615858,23.1299551878663
2021-08-21,58315,496,47915,373,10400,123,52361,411,380514,1904,432875,2315,0,678,381,3304,115,54333,8,1605,722,"Knox County",470313,560.690433817479,0.218415862140558,492.225390325166,105.461681901202,702.510881051555,21.8415862140558
2021-08-20,57819,425,47542,331,10277,94,51950,357,378610,1148,430560,1505,0,678,232,2923,193,54218,6,1597,719,"Knox County",470313,550.697088959905,0.216134418701732,319.999659801026,90.3653524355057,621.501000397608,21.6134418701732
2021-08-19,57394,368,47211,254,10183,114,51593,264,377462,952,429055,1216,1,678,204,2691,163,54025,6,1591,716,"Knox County",470313,533.474515907491,0.218458462905375,258.551220144882,78.2457639912144,572.172149185755,21.8458462905375
2021-08-18,57026,263,46957,191,10069,72,51329,200,376510,914,427839,1114,2,677,98,2487,163,53862,5,1585,716,"Knox County",470313,514.763572344375,0.208811431045681,236.863535560361,55.9202063306777,528.796780016712,20.8811431045681
2021-08-17,56763,263,46766,180,9997,83,51129,197,375596,1042,426725,1239,0,675,102,2389,161,53699,5,1580,716,"Knox County",470313,497.966248009304,0.197532155181428,263.441580394333,55.9202063306777,507.959592866878,19.7532155181428
2021-08-16,56500,185,46586,126,9914,59,50932,132,374554,422,425486,554,2,675,-26,2287,209,53538,5,1575,713,"Knox County",470313,476.278563424783,0.197904026475455,117.793894704165,39.335506354279,486.271908282357,19.7904026475455
2021-08-15,56315,204,46460,181,9855,23,50800,198,374132,953,424932,1151,3,673,80,2313,121,53329,6,1570,713,"Knox County",470313,468.624086512599,0.193424235759842,244.730636831217,43.3753691690427,491.800141607823,19.3424235759842
2021-08-14,56111,219,46279,147,9832,72,50602,154,373179,794,423781,948,0,670,96,2233,123,53208,4,1564,712,"Knox County",470313,409.727139160517,0.194383331176394,201.567892020846,46.5647345491194,474.790192914081,19.4383331176394
2021-08-13,55892,266,46132,205,9760,61,50448,220,372385,1470,422833,1690,1,670,124,2137,141,53085,5,1560,710,"Knox County",470313,375.919866131704,0.172522750252781,359.335166155305,56.558079406693,454.37825448159,17.2522750252781
2021-08-12,55626,222,45927,145,9699,77,50228,153,370915,643,421143,796,2,669,82,2013,138,52944,8,1555,707,"Knox County",470313,344.876709765624,0.167378537106247,169.248989502735,47.2026076251348,428.012834006289,16.7378537106247
2021-08-11,55404,316,45782,238,9622,78,50075,248,370272,989,420347,1237,1,667,183,1931,132,52806,10,1547,705,"Knox County",470313,356.145800775228,0.170978332239002,263.01633167699,67.1892973402819,410.577636595204,17.0978332239002
2021-08-10,55088,173,45544,109,9544,64,49827,121,369283,621,419110,742,1,666,56,1748,116,52674,2,1537,702,"Knox County",470313,337.009608494768,0.172239393087946,157.767274134459,36.7840140502176,371.667378958268,17.2239393087946
2021-08-09,54915,197,45435,159,9480,38,49706,167,368662,753,418368,920,1,665,75,1692,121,52558,4,1535,698,"Knox County",470313,339.56110079883,0.168492784607162,195.614409978036,41.8869986583403,359.760414872649,16.8492784607162
2021-08-08,54718,88,45276,66,9442,22,49539,75,367909,418,417448,493,1,664,22,1617,65,52437,4,1531,697,"Knox County",470313,314.896675192903,0.166715499560504,104.823808825187,18.7109435631165,343.813587972265,16.6715499560504
2021-08-07,54630,105,45210,75,9420,30,49464,80,367491,638,416955,718,0,663,44,1595,61,52372,2,1527,697,"Knox County",470313,290.657498304321,0.161309884778654,152.664289526337,22.3255576605367,339.135852081486,16.1309884778654
2021-08-06,54525,203,45135,147,9390,56,49384,163,366853,879,416237,1042,0,663,139,1551,64,52311,11,1525,697,"Knox County",470313,277.262163707999,0.169300605245461,221.554581735993,43.162744810371,329.780380299928,16.9300605245461
2021-08-05,54322,174,44988,131,9334,43,49221,147,365974,850,415195,997,2,663,102,1412,70,52247,4,1514,696,"Knox County",470313,267.056194491753,0.162790697674419,211.986485595763,36.9966384088894,300.225594444551,16.2790697674419
2021-08-04,54148,144,44857,101,9291,43,49074,104,365124,656,414198,760,1,661,70,1310,73,52177,4,1510,694,"Knox County",470313,230.484804800208,0.151093088857546,161.594512590551,30.6179076487361,278.537909860029,15.1093088857546
2021-08-03,54004,238,44756,177,9248,61,48970,183,364468,814,413438,997,0,660,161,1240,77,52104,5,1506,693,"Knox County",470313,244.305388113873,0.155053146617176,211.986485595763,50.6045973638832,263.654204753005,15.5053146617176
2021-08-02,53766,97,44579,75,9187,22,48787,82,363654,532,412441,614,2,660,-3,1079,98,52027,3,1501,690,"Knox County",470313,223.042952246695,0.148372175769436,130.551356224472,20.6245627911625,229.421683006849,14.8372175769436
2021-08-01,53669,107,44504,91,9165,16,48705,99,363122,526,411827,625,0,658,63,1082,44,51929,2,1498,690,"Knox County",470313,227.082815061459,0.149139579349904,132.890224169861,22.7508063778803,230.059556082864,14.9139579349904
2021-07-31,53562,104,44413,64,9149,40,48606,68,362596,399,411202,467,1,658,46,1019,57,51885,6,1496,688,"Knox County",470313,226.870190702787,0.153762268266085,99.2955754997204,22.1129333018649,216.664221486542,15.3762268266085
2021-07-30,53458,118,44349,83,9109,35,48538,90,362197,339,410735,429,1,657,79,973,38,51828,0,1490,688,"Knox County",470313,208.797120215686,0.158110042953569,91.2158498701928,25.0896743232698,206.88350098764,15.8110042953569
2021-07-29,53340,117,44266,65,9074,52,48448,68,361858,483,410306,551,0,656,82,894,35,51790,1,1490,687,"Knox County",470313,196.677531771395,0.156200765248706,117.15602162815,24.877049964598,190.08617665257,15.6200765248706
2021-07-28,53223,131,44201,90,9022,41,48380,95,361375,536,409755,631,0,656,80,812,51,51755,4,1489,686,"Knox County",470313,193.913415108662,0.15878535002318,134.165970321892,27.8537909860029,172.650979241484,15.878535002318
2021-07-27,53092,117,44111,78,8981,39,48285,84,360839,499,409124,583,0,656,85,732,32,51704,4,1485,686,"Knox County",470313,168.185867709377,0.15025641025641,123.960001105647,24.877049964598,155.641030547742,15.025641025641
2021-07-26,52975,97,44033,73,8942,24,48201,79,360340,371,408541,450,1,656,61,647,35,51672,4,1481,686,"Knox County",470313,168.185867709377,0.156049250535332,95.6809614023002,20.6245627911625,137.56796006064,15.6049250535332
2021-07-25,52878,51,43960,43,8918,8,48122,44,359969,320,408091,364,3,655,22,586,26,51637,5,1477,686,"Knox County",470313,156.278903623757,0.151942446043165,77.3952665565272,10.8438422922607,124.597874181662,15.1942446043165
2021-07-24,52827,64,43917,42,8910,22,48078,44,359649,348,407727,392,0,652,39,564,25,51611,1,1472,685,"Knox County",470313,147.773929276886,0.148235294117647,83.348748599337,13.6079589549938,119.920138290883,14.8235294117647
2021-07-23,52763,56,43875,31,8888,25,48034,32,359301,321,407335,353,1,652,24,525,31,51586,3,1471,683,"Knox County",470313,134.591219039236,0.134175691937425,75.0563986111377,11.9069640856196,111.627788302684,13.4175691937425
2021-07-22,52707,94,43844,69,8863,25,48002,78,358980,474,406982,552,0,651,70,501,24,51555,3,1468,682,"Knox County",470313,129.700858789785,0.137142857142857,117.368645986822,19.9866897151471,106.524803694561,13.7142857142857
2021-07-21,52613,61,43775,47,8838,14,47924,46,358506,411,406430,457,1,651,33,431,27,51531,1,1465,682,"Knox County",470313,114.81715368276,0.129165344335132,97.1693319130026,12.9700858789785,91.6410985875364,12.9165344335132
2021-07-20,52552,78,43728,43,8824,35,47878,45,358095,299,405973,344,0,650,54,398,24,51504,3,1464,682,"Knox County",470313,106.524803694561,0.126373626373626,73.1427793830917,16.5846999763987,84.6244947513677,12.6373626373626
2021-07-19,52474,48,43685,36,8789,12,47833,42,357796,348,405629,390,0,650,28,344,20,51480,0,1461,682,"Knox County",470313,96.1062101196437,0.116058906030856,82.9234998819935,10.2059692162454,73.1427793830917,11.6058906030856
2021-07-18,52426,36,43649,30,8777,6,47791,31,357448,272,405239,303,0,650,27,316,9,51460,1,1461,682,"Knox County",470313,92.9168447395671,0.113937656753852,64.4251806775488,7.65447691218401,67.1892973402819,11.3937656753852
2021-07-17,52390,27,43619,20,8771,7,47760,21,357176,202,404936,223,0,650,12,289,15,51451,1,1460,681,"Knox County",470313,85.0497434687113,0.112509534706331,47.4152319838065,5.74085768413801,61.4484396561439,11.2509534706331
2021-07-16,52363,37,43599,21,8764,16,47739,22,356974,291,404713,313,0,650,25,277,12,51436,1,1459,681,"Knox County",470313,81.0098806539475,0.110379550735864,66.5514242642666,7.86710127085579,58.8969473520825,11.0379550735864
2021-07-15,52326,55,43578,42,8748,13,47717,44,356683,364,404400,408,-1,650,36,252,20,51424,1,1458,681,"Knox County",470313,72.7175306657481,0.102953240360952,86.7507383380855,11.6943397269478,53.5813383852881,10.2953240360952
2021-07-14,52271,21,43536,17,8735,4,47673,16,356319,269,403992,285,0,651,8,216,13,51404,2,1457,681,"Knox County",470313,64.212556318877,0.0975286849073257,60.5979422214568,4.46511153210734,45.9268614731041,9.75286849073257
2021-07-13,52250,42,43519,26,8731,16,47657,29,356050,355,403707,384,3,651,28,208,11,51391,3,1455,681,"Knox County",470313,56.558079406693,0.0888985255854293,81.6477537299628,8.93022306421468,44.2258666037299,8.88985255854293
2021-07-12,52208,27,43493,21,8715,6,47628,24,355695,270,403323,294,0,648,16,180,11,51380,1,1452,681,"Knox County",470313,52.0929678745856,0.0846153846153846,62.5115614495028,5.74085768413801,38.2723845609201,8.46153846153846
2021-07-11,52181,8,43472,3,8709,5,47604,4,355425,136,403029,140,0,648,1,164,7,51369,0,1451,680,"Knox County",470313,46.1394858317759,0.0781631656082071,29.7674102140489,1.70099486937423,34.8703948221716,7.81631656082071
2021-07-10,52173,20,43469,16,8704,4,47600,16,355289,191,402889,207,0,648,12,163,8,51362,2,1451,680,"Knox County",470313,44.6511153210734,0.0763170851797144,44.0132422450581,4.25248717343556,34.6577704634998,7.63170851797144
2021-07-09,52153,27,43453,21,8700,6,47584,21,355098,338,402682,359,0,648,12,151,15,51354,0,1449,680,"Knox County",470313,42.5248717343556,0.0741454020221473,76.3321447631684,5.74085768413801,32.1062781594385,7.41454020221473
2021-07-08,52126,19,43432,14,8694,5,47563,16,354760,317,402323,333,0,648,6,139,13,51339,0,1449,679,"Knox County",470313,34.8703948221716,0.0629370629370629,70.8039114377021,4.03986281476378,29.5547858553772,6.29370629370629
2021-07-07,52107,18,43418,5,8689,13,47547,5,354443,333,401990,338,1,648,8,133,9,51326,1,1449,677,"Knox County",470313,34.2325217461563,0.0559610705596107,71.867033231061,3.82723845609201,28.2790397033465,5.59610705596107
2021-07-06,52089,24,43413,9,8676,15,47542,14,354110,263,401652,277,0,647,14,125,10,51317,2,1448,677,"Knox County",470313,30.4052832900643,0.0513347022587269,58.8969473520825,5.10298460812268,26.5780448339723,5.13347022587269
2021-07-05,52065,10,43404,7,8661,3,47528,6,353847,105,401375,111,0,647,0,111,10,51307,1,1446,677,"Knox County",470313,26.790669192644,0.0464589235127479,23.6013038125674,2.12624358671778,23.6013038125674,4.64589235127479
2021-07-04,52055,8,43397,7,8658,1,47522,7,353742,143,401264,150,0,647,0,111,8,51297,1,1445,677,"Knox County",470313,26.790669192644,0.047887323943662,31.8936538007667,1.70099486937423,23.6013038125674,4.7887323943662
2021-07-03,52047,9,43390,7,8657,2,47515,7,353599,185,401114,192,0,647,-2,111,11,51289,1,1444,677,"Knox County",470313,24.4518012472545,0.0431818181818182,40.8238768649814,1.913619228046,23.6013038125674,4.31818181818182
2021-07-02,52038,17,43383,13,8655,4,47508,17,353414,342,400922,359,-1,647,11,113,7,51278,0,1443,677,"Knox County",470313,22.3255576605367,0.0409090909090909,76.3321447631684,3.61461409742023,24.0265525299109,4.09090909090909
2021-07-01,52021,18,43370,15,8651,3,47491,17,353072,248,400563,265,-1,648,13,102,6,51271,1,1443,677,"Knox County",470313,22.1129333018649,0.0431442080378251,56.3454550480212,3.82723845609201,21.6876845845214,4.31442080378251
2021-06-30,52003,18,43355,12,8648,6,47474,11,352824,299,400298,310,0,649,9,89,9,51265,0,1442,677,"Knox County",470313,22.1129333018649,0.0474759615384615,65.9135511882512,3.82723845609201,18.9235679217883,4.74759615384615
2021-06-29,51985,21,43343,16,8642,5,47463,19,352525,438,399988,457,0,649,8,80,13,51256,1,1442,677,"Knox County",470313,21.4750602258496,0.0455531453362256,97.1693319130026,4.46511153210734,17.0099486937423,4.55531453362256
2021-06-28,51964,9,43327,2,8637,7,47444,2,352087,113,399531,115,0,649,-4,72,13,51243,0,1441,677,"Knox County",470313,21.2624358671778,0.0432900432900433,24.4518012472545,1.913619228046,15.308953824368,4.32900432900433
2021-06-27,51955,5,43325,3,8630,2,47442,3,351974,151,399416,154,0,649,0,76,5,51230,0,1441,677,"Knox County",470313,20.6245627911625,0.041036717062635,32.7441512354538,1.06312179335889,16.1594512590551,4.1036717062635
2021-06-26,51950,3,43322,2,8628,1,47439,2,351823,206,399262,208,0,649,0,76,3,51225,0,1441,677,"Knox County",470313,19.3488166391318,0.0380085653104925,44.2258666037299,0.637873076015334,16.1594512590551,3.80085653104925
2021-06-25,51947,13,43320,9,8627,4,47437,11,351617,311,399054,322,0,649,4,76,9,51222,0,1441,677,"Knox County",470313,18.4983192044447,0.0354997269251775,68.4650434923126,2.76411666273312,16.1594512590551,3.54997269251775
2021-06-24,51934,14,43311,9,8623,5,47426,10,351306,364,398732,374,1,649,8,72,5,51213,1,1441,677,"Knox County",470313,17.6478217697576,0.0298969072164948,79.521510143245,2.97674102140489,15.308953824368,2.98969072164948
2021-06-23,51920,13,43302,6,8618,7,47416,8,350942,282,398358,290,0,648,6,64,7,51208,0,1440,676,"Knox County",470313,16.5846999763987,0.0286458333333333,61.6610640148157,2.76411666273312,13.6079589549938,2.86458333333333
2021-06-22,51907,14,43296,5,8611,9,47408,5,350660,247,398068,252,2,648,10,58,2,51201,1,1440,675,"Knox County",470313,15.0963294656962,0.0239067055393586,53.5813383852881,2.97674102140489,12.3322128029631,2.39067055393586
2021-06-21,51893,9,43291,8,8602,1,47403,9,350413,289,397816,298,0,646,5,48,4,51199,1,1439,674,"Knox County",470313,15.0963294656962,0.0252897787144362,63.3620588841899,1.913619228046,10.2059692162454,2.52897787144363
2021-06-20,51884,3,43283,2,8601,1,47394,3,350124,161,397518,164,1,646,-2,43,4,51195,0,1438,674,"Knox County",470313,14.6710807483527,0.0251572327044025,34.8703948221716,0.637873076015334,9.14284742288646,2.51572327044025
2021-06-19,51881,3,43281,1,8600,2,47391,1,349963,191,397354,192,0,645,-3,45,6,51191,0,1438,674,"Knox County",470313,14.6710807483527,0.0248414376321353,40.8238768649814,0.637873076015334,9.56809614023002,2.48414376321353
2021-06-18,51878,5,43280,3,8598,2,47390,3,349772,283,397162,286,1,645,-7,48,11,51185,0,1438,674,"Knox County",470313,12.9700858789785,0.0210129310344828,60.8105665801286,1.06312179335889,10.2059692162454,2.10129310344828
2021-06-17,51873,12,43277,8,8596,4,47387,9,349489,515,396876,524,0,644,6,55,6,51174,0,1438,674,"Knox County",470313,12.5448371616349,0.0189431704885344,111.415163944012,2.55149230406134,11.6943397269478,1.89431704885344
2021-06-16,51861,7,43269,4,8592,3,47378,4,348974,362,396352,366,1,644,-6,49,12,51168,0,1438,673,"Knox County",470313,11.2690910096042,0.0163304514889529,77.8205152738708,1.48837051070245,10.4185935749171,1.63304514889529
2021-06-15,51854,13,43265,9,8589,4,47374,14,348612,428,395986,442,0,643,-2,55,15,51156,0,1438,673,"Knox County",470313,11.0564666509325,0.0189260563380282,93.9799665329259,2.76411666273312,11.6943397269478,1.89260563380282
2021-06-14,51841,7,43256,2,8585,5,47360,3,348184,260,395544,263,1,643,-5,57,11,51141,0,1438,673,"Knox County",470313,10.6312179335889,0.0165400089405454,55.9202063306777,1.48837051070245,12.1195884442914,1.65400089405454
2021-06-13,51834,3,43254,3,8580,0,47357,4,347924,128,395281,132,0,642,-5,62,8,51130,1,1438,673,"Knox County",470313,10.6312179335889,0.0172335600907029,28.0664153446747,0.637873076015334,13.1827102376502,1.72335600907029
2021-06-12,51831,2,43251,1,8580,1,47353,1,347796,226,395149,227,0,642,-6,67,8,51122,0,1437,673,"Knox County",470313,10.4185935749171,0.0169642857142857,48.2657294184936,0.425248717343556,14.2458320310091,1.69642857142857
2021-06-11,51829,7,43250,3,8579,4,47352,2,347570,318,394922,320,0,642,-2,73,9,51114,0,1437,672,"Knox County",470313,10.8438422922607,0.0162708883025506,68.039794774969,1.48837051070245,15.5215781830398,1.62708883025506
2021-06-10,51822,7,43247,4,8575,3,47350,5,347252,358,394602,363,0,642,-1,75,8,51105,0,1437,671,"Knox County",470313,9.7807204989018,0.0156176053005206,77.1826421978555,1.48837051070245,15.9468269003834,1.56176053005206
2021-06-09,51815,2,43243,1,8572,1,47345,1,346894,367,394239,368,1,642,-17,76,18,51097,0,1437,671,"Knox County",470313,8.7175987055429,0.0141843971631206,78.2457639912144,0.425248717343556,16.1594512590551,1.41843971631206
2021-06-08,51813,5,43242,3,8571,2,47344,4,346527,266,393871,270,1,641,-17,93,21,51079,0,1437,670,"Knox County",470313,7.01660383616868,0.0102933607822954,57.4085768413801,1.06312179335889,19.7740653564754,1.02933607822954
2021-06-07,51808,16,43239,10,8569,6,47340,10,346261,316,393601,326,0,640,-7,110,23,51058,2,1437,669,"Knox County",470313,8.93022306421468,0.0134596211365902,69.3155409269997,3.40198973874845,23.3886794538956,1.34596211365902
2021-06-06,51792,4,43229,2,8563,2,47330,2,345945,178,393275,180,0,640,-5,117,9,51035,0,1435,669,"Knox County",470313,9.14284742288646,0.0121713729308666,38.2723845609201,0.850497434687113,24.877049964598,1.21713729308666
2021-06-05,51788,5,43227,2,8561,3,47328,3,345767,258,393095,261,0,640,-9,122,14,51026,0,1435,668,"Knox County",470313,9.7807204989018,0.0129310344827586,55.4949576133341,1.06312179335889,25.9401717579569,1.29310344827586
2021-06-04,51783,7,43225,2,8558,5,47325,3,345509,325,392834,328,1,640,-9,131,15,51012,0,1435,668,"Knox County",470313,9.7807204989018,0.0133587786259542,69.7407896443432,1.48837051070245,27.8537909860029,1.33587786259542
2021-06-03,51776,7,43223,4,8553,3,47322,6,345184,458,392506,464,0,639,-12,140,19,50997,0,1435,668,"Knox County",470313,9.7807204989018,0.0131998179335457,98.6577024237051,1.48837051070245,29.7674102140489,1.31998179335457
2021-06-02,51769,20,43219,7,8550,13,47316,6,344726,282,392042,288,0,639,5,152,15,50978,1,1435,668,"Knox County",470313,13.6079589549938,0.0160604629192253,61.2358152974721,4.25248717343556,32.3189025181103,1.60604629192253
2021-06-01,51749,12,43212,9,8537,3,47310,10,344444,291,391754,301,0,639,-10,147,22,50963,1,1434,668,"Knox County",470313,15.0963294656962,0.0186219739292365,63.9999319602052,2.55149230406134,31.2557807247514,1.86219739292365
2021-05-31,51737,17,43203,14,8534,3,47300,12,344153,354,391453,366,0,639,-1,157,18,50941,0,1433,668,"Knox County",470313,15.308953824368,0.0191956124314442,77.8205152738708,3.61461409742023,33.3820243114692,1.91956124314442
2021-05-30,51720,3,43189,1,8531,2,47288,1,343799,203,391087,204,0,639,-9,158,12,50923,0,1433,668,"Knox County",470313,15.0963294656962,0.0185352622061483,43.3753691690427,0.637873076015334,33.5946486701409,1.85352622061483
2021-05-29,51717,14,43188,8,8529,6,47287,6,343596,199,390883,205,0,639,-14,167,28,50911,1,1433,667,"Knox County",470313,17.0099486937423,0.0204081632653061,43.5879935277145,2.97674102140489,35.508267898187,2.04081632653061
2021-05-28,51703,11,43180,6,8523,5,47281,10,343397,390,390678,400,0,639,-9,181,20,50883,1,1432,665,"Knox County",470313,17.8604461284294,0.0228904847396768,85.0497434687113,2.33886794538956,38.4850089195918,2.28904847396768
2021-05-27,51692,23,43174,8,8518,15,47271,9,343007,341,390278,350,0,639,-5,190,28,50863,1,1431,665,"Knox County",470313,21.2624358671778,0.0255439924314096,74.4185255351224,4.8903602494509,40.3986281476379,2.55439924314096
2021-05-26,51669,16,43166,8,8503,8,47262,11,342666,571,389928,582,0,639,-8,195,24,50835,0,1430,665,"Knox County",470313,20.4119384324907,0.0245016611295681,123.747376746975,3.40198973874845,41.4617499409967,2.45016611295681
2021-05-25,51653,18,43158,8,8495,10,47251,7,342095,311,389346,318,0,639,-10,203,28,50811,1,1430,665,"Knox County",470313,21.6876845845214,0.0230927835051546,67.6145460576254,3.82723845609201,43.162744810371,2.30927835051546
2021-05-24,51635,25,43150,21,8485,4,47244,24,341784,425,389028,449,0,639,-11,213,36,50783,1,1429,665,"Knox County",470313,23.3886794538956,0.0271132376395534,95.4683370436284,5.31560896679445,45.2889883970888,2.71132376395534
2021-05-23,51610,16,43129,8,8481,8,47220,8,341359,225,388579,233,1,639,-5,224,20,50747,1,1428,664,"Knox County",470313,26.1527961166287,0.0295624753646039,49.5414755705243,3.40198973874845,47.6278563424783,2.95624753646039
2021-05-22,51594,8,43121,4,8473,4,47212,4,341134,269,388346,273,0,638,-6,229,14,50727,0,1427,663,"Knox County",470313,24.877049964598,0.0280230326295585,58.0464499173954,1.70099486937423,48.6909781358372,2.80230326295585
2021-05-21,51586,16,43117,12,8469,4,47208,14,340865,377,388073,391,0,638,-16,235,32,50713,1,1427,663,"Knox County",470313,25.9401717579569,0.0296610169491525,83.1361242406653,3.40198973874845,49.9667242878679,2.96610169491525
2021-05-20,51570,34,43105,26,8465,8,47194,27,340488,594,387682,621,0,638,6,251,28,50681,1,1426,662,"Knox County",470313,28.2790397033465,0.0331356818974538,132.039726735174,7.22922819484046,53.3687140266163,3.31356818974538
2021-05-19,51536,14,43079,6,8457,8,47167,6,339894,544,387061,550,0,638,-29,245,43,50653,1,1425,661,"Knox County",470313,27.8537909860029,0.0317460317460317,116.943397269478,2.97674102140489,52.0929678745856,3.17460317460317
2021-05-18,51522,24,43073,14,8449,10,47161,14,339350,444,386511,458,1,638,-21,274,44,50610,0,1424,661,"Knox County",470313,29.1295371380336,0.0326050420168067,97.3819562716744,5.10298460812268,58.2590742760672,3.26050420168067
2021-05-17,51498,15,43059,8,8439,7,47147,8,338906,420,386053,428,0,637,-18,295,33,50566,0,1424,660,"Knox County",470313,27.0032935513158,0.0274204468517265,91.0032255115211,3.18936538007667,62.7241858081746,2.74204468517265
2021-05-16,51483,22,43051,13,8432,9,47139,12,338486,272,385625,284,1,637,-10,313,31,50533,1,1424,660,"Knox County",470313,28.2790397033465,0.0282861896838602,60.385317862785,4.67773589077912,66.5514242642666,2.82861896838602
2021-05-15,51461,23,43038,13,8423,10,47127,17,338214,336,385341,353,0,636,-8,323,31,50502,2,1423,659,"Knox County",470313,31.4684050834232,0.0317666126418152,75.0563986111377,4.8903602494509,68.6776678509843,3.17666126418152
2021-05-14,51438,36,43025,25,8413,11,47110,26,337878,498,384988,524,0,636,4,331,32,50471,4,1421,658,"Knox County",470313,35.7208922568587,0.0341827221876942,111.415163944012,7.65447691218401,70.3786627203586,3.41827221876942
2021-05-13,51402,31,43000,17,8402,14,47084,17,337380,376,384464,393,0,636,-17,327,48,50439,0,1417,658,"Knox County",470313,35.0830191808434,0.0334448160535117,83.5613729580088,6.59135511882512,69.5281652856715,3.34448160535117
2021-05-12,51371,34,42983,28,8388,6,47067,26,337004,506,384071,532,0,636,-15,344,49,50391,0,1417,658,"Knox County",470313,39.335506354279,0.0403768506056528,113.116158813386,7.22922819484046,73.1427793830917,4.03768506056528
2021-05-11,51337,36,42955,30,8382,6,47041,31,336498,555,383539,586,0,636,-11,359,47,50342,4,1417,658,"Knox County",470313,41.8869986583403,0.0441935483870968,124.597874181662,7.65447691218401,76.3321447631684,4.41935483870968
2021-05-10,51301,21,42925,14,8376,7,47010,13,335943,277,382953,290,1,636,-26,370,46,50295,1,1413,658,"Knox County",470313,43.162744810371,0.0479405806887238,61.6610640148157,4.46511153210734,78.6710127085579,4.79405806887238
2021-05-09,51280,17,42911,14,8369,3,46997,17,335666,369,382663,386,0,635,-22,396,39,50249,1,1412,657,"Knox County",470313,42.0996230170121,0.047976501305483,82.0730024473064,3.61461409742023,84.1992460340241,4.7976501305483
2021-05-08,51263,20,42897,11,8366,9,46980,14,335297,307,382277,321,0,635,-18,418,38,50210,1,1411,657,"Knox County",470313,41.4617499409967,0.0474934036939314,68.2524191336408,4.25248717343556,88.8769819248033,4.74934036939314
2021-05-07,51243,43,42886,31,8357,12,46966,33,334990,576,381956,609,0,635,3,436,40,50172,0,1410,657,"Knox County",470313,42.9501204516992,0.0484440166827077,129.488234431113,9.14284742288646,92.7042203808953,4.84440166827077
2021-05-06,51200,40,42855,26,8345,14,46933,28,334414,340,381347,368,1,635,-8,433,47,50132,0,1410,657,"Knox County",470313,44.8637396797452,0.0523932729624838,78.2457639912144,8.50497434687113,92.0663473048799,5.23932729624838
2021-05-05,51160,51,42829,32,8331,19,46905,38,334074,585,380979,623,0,634,5,441,46,50085,4,1410,656,"Knox County",470313,48.4783537771654,0.0546654099905749,132.464975452518,10.8438422922607,93.7673421742542,5.46654099905749
2021-05-04,51109,50,42797,32,8312,18,46867,34,333489,536,380356,570,0,634,6,436,44,50039,0,1406,656,"Knox County",470313,51.4550947985703,0.0558888538048626,121.195884442914,10.6312179335889,92.7042203808953,5.58888538048626
2021-05-03,51059,24,42765,9,8294,15,46833,7,332953,309,379786,316,1,634,-37,430,60,49995,1,1406,656,"Knox County",470313,52.0929678745856,0.053554650798622,67.1892973402819,5.10298460812268,91.4284742288646,5.3554650798622
2021-05-02,51035,25,42756,18,8279,7,46826,20,332644,288,379470,308,0,633,-17,467,42,49935,2,1405,655,"Knox County",470313,53.7939627439599,0.0558587479935795,65.4883024709077,5.31560896679445,99.2955754997204,5.58587479935795
2021-05-01,51010,45,42738,35,8272,10,46806,38,332356,450,379162,488,0,633,7,484,38,49893,2,1403,655,"Knox County",470313,59.1095717107543,0.0603290676416819,103.760687031828,9.56809614023002,102.910189597141,6.03290676416819
2021-04-30,50965,58,42703,30,8262,28,46768,29,331906,567,378674,596,0,633,-9,477,67,49855,3,1401,655,"Knox County",470313,62.298937090831,0.0593453655552157,126.72411776838,12.3322128029631,101.421819086438,5.93453655552157
2021-04-29,50907,54,42673,34,8234,20,46739,35,331339,571,378078,606,0,633,-2,486,56,49788,2,1398,654,"Knox County",470313,65.2756781122359,0.0573139435414885,128.850361355098,11.481715368276,103.335438314484,5.73139435414885
2021-04-28,50853,47,42639,28,8214,19,46704,34,330768,543,377472,577,4,633,-38,488,81,49732,1,1396,654,"Knox County",470313,64.4251806775488,0.0569199653279399,122.684254953616,9.99334485757357,103.760687031828,5.69199653279399
2021-04-27,50806,39,42611,17,8195,22,46670,20,330225,392,376895,412,1,629,-33,526,71,49651,2,1395,652,"Knox County",470313,62.0863127321592,0.0554041780199818,87.6012357727726,8.29234998819935,111.840412661355,5.54041780199818
2021-04-26,50767,69,42594,36,8173,33,46650,40,329833,480,376483,520,1,628,2,559,66,49580,0,1393,651,"Knox County",470313,71.6544088723892,0.0615911035072712,110.564666509325,14.6710807483527,118.857016497524,6.15911035072712
2021-04-25,50698,38,42558,25,8140,13,46610,26,329353,341,375963,367,0,627,-4,557,42,49514,3,1393,649,"Knox County",470313,74.4185255351224,0.0622546270330903,78.0331396325426,8.07972562952757,118.43176778018,6.22546270330903
2021-04-24,50660,35,42533,22,8127,13,46584,28,329012,510,375596,538,0,627,-28,561,63,49472,3,1390,649,"Knox County",470313,72.2922819484046,0.0586283185840708,114.391904965417,7.44185255351224,119.282265214868,5.86283185840708
2021-04-23,50625,43,42511,31,8114,12,46556,36,328502,553,375058,589,0,627,-4,589,47,49409,2,1387,648,"Knox County",470313,69.1029165683279,0.0606816292601829,125.235747257677,9.14284742288646,125.235747257677,6.06816292601829
2021-04-22,50582,79,42480,62,8102,17,46520,65,327949,787,374469,852,1,627,15,593,63,49362,1,1385,647,"Knox County",470313,74.4185255351224,0.064591439688716,181.155953588355,16.7973243350705,126.086244692364,6.4591439688716
2021-04-21,50503,62,42418,34,8085,28,46455,35,327162,479,373617,514,1,626,-2,578,63,49299,1,1384,646,"Knox County",470313,77.607890915199,0.0659282700421941,109.288920357294,13.1827102376502,122.896879312288,6.59282700421941
2021-04-20,50441,38,42384,34,8057,4,46420,39,326683,474,373103,513,1,625,-32,580,69,49236,1,1383,645,"Knox County",470313,77.3952665565272,0.0690983817107629,109.076295998622,8.07972562952757,123.322128029631,6.90983817107629
2021-04-19,50403,65,42350,41,8053,24,46381,39,326209,336,372590,375,0,624,-3,612,68,49167,0,1382,644,"Knox County",470313,76.5447691218401,0.0715048025613661,79.7341345019168,13.8205833136656,130.126107507128,7.15048025613661
2021-04-18,50338,38,42309,27,8029,11,46342,32,325873,364,372215,396,0,624,-12,615,50,49099,1,1382,644,"Knox County",470313,76.5447691218401,0.0725443473656341,84.1992460340241,8.07972562952757,130.763980583144,7.25443473656341
2021-04-17,50300,37,42282,18,8018,19,46310,23,325509,335,371819,358,0,624,-23,627,60,49049,1,1381,643,"Knox County",470313,76.9700178391837,0.0747845426744509,76.1195204044966,7.86710127085579,133.315472887205,7.47845426744509
2021-04-16,50263,346,42264,330,7999,16,46287,369,325174,2088,371461,2457,1,624,279,650,66,48989,4,1380,643,"Knox County",470313,141.395198516732,0.110155535224154,522.418049256559,73.5680281004352,138.205833136656,11.0155535224154
2021-04-15,49917,86,41934,54,7983,32,45918,55,323086,577,369004,632,1,623,12,371,73,48923,0,1376,642,"Knox County",470313,142.883569027435,0.112869399428027,134.378594680564,18.2856948457729,78.8836370672297,11.2869399428027
2021-04-14,49831,85,41880,60,7951,25,45863,62,322509,684,368372,746,0,622,-1,359,86,48850,3,1376,641,"Knox County",470313,147.773929276886,0.113018075588826,158.617771569146,18.0730704871011,76.3321447631684,11.3018075588826
2021-04-13,49746,68,41820,38,7926,30,45801,43,321825,339,367626,382,-5,622,-8,360,81,48764,1,1373,641,"Knox County",470313,154.152660037039,0.116535727646839,81.2225050126193,14.4584563896809,76.5447691218401,11.6535727646839
2021-04-12,49678,63,41782,43,7896,20,45758,50,321486,360,367244,410,1,627,-24,368,86,48683,0,1372,641,"Knox County",470313,153.727411319696,0.11782196617729,87.175987055429,13.395334596322,78.2457639912144,11.782196617729
2021-04-11,49615,26,41739,14,7876,12,45708,14,321126,296,366834,310,2,626,-26,392,50,48597,0,1372,640,"Knox County",470313,151.175919015634,0.116336166194523,65.9135511882512,5.52823332546623,83.348748599337,11.6336166194523
2021-04-10,49589,50,41725,33,7864,17,45694,41,320830,571,366524,612,0,624,6,418,44,48547,1,1372,640,"Knox County",470313,153.940035678367,0.114254820688412,130.126107507128,10.6312179335889,88.8769819248033,11.4254820688412
2021-04-09,49539,82,41692,62,7847,20,45653,71,320259,620,365912,691,5,624,11,412,66,48503,2,1371,639,"Knox County",470313,97.8072049890179,0.0888183980967486,146.923431842199,17.4351974110858,87.6012357727726,8.88183980967486
2021-04-08,49457,49,41630,26,7827,23,45582,26,319639,465,365221,491,-6,619,-23,401,78,48437,0,1369,639,"Knox County",470313,89.9401037181622,0.0842943437671609,104.398560107843,10.4185935749171,85.262367827383,8.42943437671609
2021-04-07,49408,77,41604,54,7804,23,45556,57,319174,768,364730,825,2,625,9,424,66,48359,1,1369,638,"Knox County",470313,88.2391088487879,0.0811609782316582,175.415095904217,16.3720756177269,90.1527280768339,8.11609782316582
2021-04-06,49331,75,41550,41,7781,34,45499,45,318406,421,363905,466,2,623,-4,415,77,48293,0,1368,638,"Knox County",470313,89.7274793594904,0.0798948751642576,99.0829511410486,15.9468269003834,88.2391088487879,7.98948751642576
2021-04-05,49256,44,41509,32,7747,12,45454,35,317985,266,363439,301,0,621,-60,419,104,48216,3,1368,638,"Knox County",470313,85.6876165447266,0.0781926406926407,63.9999319602052,9.35547178155824,89.089606283475,7.81926406926407
2021-04-04,49212,49,41477,31,7735,18,45419,40,317719,341,363138,381,3,621,-27,479,73,48112,0,1365,636,"Knox County",470313,90.5779767941775,0.0836209185027874,81.0098806539475,10.4185935749171,101.847067803782,8.36209185027874
2021-04-03,49163,81,41446,64,7717,17,45379,71,317378,593,362757,664,0,618,6,506,75,48039,0,1365,635,"Knox County",470313,97.1693319130026,0.0903377847604085,141.182574158061,17.222573052414,107.58792548792,9.03377847604085
2021-04-02,49082,76,41382,45,7700,31,45308,45,316785,529,362093,574,0,618,6,500,70,47964,2,1365,632,"Knox County",470313,95.8935857609719,0.0861696380334954,122.046381877601,16.1594512590551,106.312179335889,8.61696380334954
2021-04-01,49006,75,41337,63,7669,12,45263,67,316256,580,361519,647,1,618,-20,494,94,47894,1,1363,630,"Knox County",470313,101.421819086438,0.0933125972006221,137.56796006064,15.9468269003834,105.036433183858,9.33125972006221
2021-03-31,48931,87,41274,66,7657,21,45196,72,315676,765,360872,837,3,617,-16,514,100,47800,2,1362,630,"Knox County",470313,103.548062673156,0.0968992248062016,177.966588208278,18.4983192044447,109.288920357294,9.68992248062016
2021-03-30,48844,57,41208,33,7636,24,45124,38,314911,460,360035,498,1,614,-25,530,81,47700,2,1360,628,"Knox County",470313,99.7208242170639,0.0943106099436187,105.886930618546,12.1195884442914,112.690910096042,9.43106099436187
2021-03-29,48787,43,41175,21,7612,22,45086,22,314451,399,359537,421,5,613,-58,555,96,47619,0,1358,626,"Knox County",470313,99.5081998583922,0.0882645450024863,89.5148550008186,9.14284742288646,118.006519062837,8.82645450024863
2021-03-28,48744,80,41154,46,7590,34,45064,49,314052,484,359116,533,2,608,13,613,65,47523,5,1358,625,"Knox County",470313,106.099554977217,0.0872065165309056,113.328783172058,17.0099486937423,130.3387318658,8.72065165309056
2021-03-27,48664,42,41108,39,7556,3,45015,42,313568,442,358583,484,0,606,-16,600,58,47458,2,1353,624,"Knox County",470313,97.8072049890179,0.0838758137205809,102.910189597141,8.93022306421468,127.574615203067,8.38758137205809
2021-03-26,48622,79,41069,54,7553,25,44973,60,313126,416,358099,476,0,606,1,616,78,47400,2,1351,622,"Knox County",470313,98.4450780650333,0.0898357289527721,101.209194727766,16.7973243350705,130.976604941815,8.98357289527721
2021-03-25,48543,88,41015,64,7528,24,44913,67,312710,570,357623,637,0,606,6,615,82,47322,4,1349,620,"Knox County",470313,101.209194727766,0.0900669068450849,135.441716473923,18.7109435631165,130.763980583144,9.00669068450849
2021-03-24,48455,123,40951,91,7504,32,44846,95,312140,780,356986,875,1,606,39,609,83,47240,3,1345,619,"Knox County",470313,108.86367163995,0.0950560652395515,186.046313837806,26.1527961166287,129.488234431113,9.50560652395515
2021-03-23,48332,87,40860,57,7472,30,44751,63,311360,530,356111,593,1,605,16,570,70,47157,3,1342,618,"Knox County",470313,115.242402400104,0.0990296093555611,126.086244692364,18.4983192044447,121.195884442914,9.90296093555611
2021-03-22,48245,115,40803,78,7442,37,44688,81,310830,517,355518,598,2,604,31,554,82,47087,1,1339,617,"Knox County",470313,130.551356224472,0.108913250714967,127.149366485723,24.4518012472545,117.793894704165,10.8913250714967
2021-03-21,48130,50,40725,33,7405,17,44607,34,310313,330,354920,364,0,602,4,523,46,47005,1,1338,617,"Knox County",470313,124.172625464318,0.109759125900174,77.3952665565272,10.6312179335889,111.20253958534,10.9759125900174
2021-03-20,48080,59,40692,29,7388,30,44573,33,309983,315,354556,348,0,602,3,519,56,46959,4,1337,616,"Knox County",470313,127.787239561739,0.111282446671807,73.9932768177788,12.5448371616349,110.352042150653,11.1282446671807
2021-03-19,48021,146,40663,102,7358,44,44540,117,309668,955,354208,1072,3,602,51,516,92,46903,3,1333,616,"Knox County",470313,142.033071592748,0.109204368174727,227.933312496146,31.0431563660796,109.714169074638,10.9204368174727
2021-03-18,47875,68,40561,50,7314,18,44423,66,308713,627,353136,693,2,599,-16,465,82,46811,1,1330,615,"Knox County",470313,137.780584419312,0.107638124587277,147.348680559542,14.4584563896809,98.8703267823768,10.7638124587277
2021-03-17,47807,46,40511,36,7296,10,44357,41,308086,498,352443,539,1,597,-40,481,85,46729,3,1329,615,"Knox County",470313,121.408508801585,0.103399096743523,114.604529324088,9.7807204989018,102.272316521125,10.3399096743523
2021-03-16,47761,128,40475,84,7286,44,44316,100,307588,698,351904,798,0,596,47,521,81,46644,3,1326,613,"Knox County",470313,130.126107507128,0.106980961015413,169.674238220079,27.2159179099876,110.777290867996,10.6980961015413
2021-03-15,47633,44,40391,28,7242,16,44216,40,306890,290,351106,330,1,596,-65,474,108,46563,1,1323,612,"Knox County",470313,115.029778041432,0.104005791505792,70.1660383616868,9.35547178155824,100.783946010423,10.4005791505792
2021-03-14,47589,60,40363,38,7226,22,44176,46,306600,405,350776,451,0,595,-13,539,73,46455,0,1322,611,"Knox County",470313,117.15602162815,0.104703379815646,95.893585760972,12.7574615203067,114.604529324088,10.4703379815646
2021-03-13,47529,71,40325,34,7204,37,44130,41,306195,623,350325,664,1,595,-11,552,81,46382,1,1322,611,"Knox County",470313,119.707513932211,0.0991862766659336,141.182574158061,15.0963294656962,117.368645986822,9.91862766659336
2021-03-12,47458,63,40291,60,7167,3,44089,67,305572,691,349661,758,0,594,-52,563,115,46301,1,1321,609,"Knox County",470313,102.059692162454,0.0947318686510749,161.169263873208,13.395334596322,119.707513932211,9.47318686510749
2021-03-11,47395,83,40231,56,7164,27,44022,66,304881,627,348903,693,2,594,-22,615,103,46186,0,1320,607,"Knox County",470313,105.24905754253,0.0947318686510749,147.348680559542,17.6478217697576,130.763980583144,9.47318686510749
2021-03-10,47312,95,40175,72,7137,23,43956,82,304254,1001,348210,1083,2,592,26,637,67,46083,1,1320,606,"Knox County",470313,115.667651117447,0.0925266903914591,230.272180441536,20.1993140738189,135.441716473923,9.25266903914591
2021-03-09,47217,80,40103,50,7114,30,43874,55,303253,597,347127,652,0,590,-5,611,85,46016,2,1319,606,"Knox County",470313,105.461681901202,0.085726624919024,138.631081853999,17.0099486937423,129.913483148456,8.5726624919024
2021-03-08,47137,85,40053,57,7084,28,43819,63,302656,411,346475,474,1,590,-30,616,114,45931,0,1317,601,"Knox County",470313,114.179280606745,0.0879581151832461,100.783946010423,18.0730704871011,130.976604941815,8.79581151832461
2021-03-07,47052,64,39996,40,7056,24,43756,42,302245,327,346001,369,0,589,-5,646,69,45817,0,1317,599,"Knox County",470313,115.029778041432,0.0886426592797784,78.4583883498861,13.6079589549938,137.355335701969,8.86426592797784
2021-03-06,46988,125,39956,87,7032,38,43714,95,301918,848,345632,943,0,589,40,651,85,45748,1,1317,599,"Knox County",470313,126.511493409708,0.0945293644408689,200.504770227487,26.5780448339723,138.418457495328,9.45293644408689
2021-03-05,46863,70,39869,44,6994,26,43619,49,301070,520,344689,569,2,589,-19,611,87,45663,2,1316,599,"Knox County",470313,127.99986392041,0.0945013589797198,120.983260084242,14.8837051070245,129.913483148456,9.45013589797198
2021-03-04,46793,112,39825,85,6968,27,43570,100,300550,1094,344120,1194,5,587,-1,630,108,45576,1,1314,597,"Knox County",470313,134.165970321892,0.0919757759273278,253.873484254103,23.8139281712392,133.95334596322,9.19757759273278
2021-03-03,46681,74,39740,33,6941,41,43470,40,299456,497,342926,537,1,582,-49,631,122,45468,4,1313,595,"Knox County",470313,129.700858789785,0.0937104263402279,114.179280606745,15.7342025417116,134.165970321892,9.37104263402279
2021-03-02,46607,133,39707,91,6900,42,43430,99,298959,807,342389,906,-1,581,9,680,125,45346,2,1309,594,"Knox County",470313,140.969949799389,0.0977564102564103,192.637668956631,28.2790397033465,144.584563896809,9.77564102564103
2021-03-01,46474,59,39616,33,6858,26,43331,35,298152,165,341483,200,1,582,-58,671,116,45221,1,1307,589,"Knox County",470313,135.441716473923,0.0974989402289105,42.5248717343556,12.5448371616349,142.670944668763,9.74989402289106
2021-02-28,46415,77,39583,53,6832,24,43296,63,297987,563,341283,626,2,581,-19,729,94,45105,2,1306,589,"Knox County",470313,138.205833136656,0.0966834170854271,133.102848528533,16.3720756177269,155.003157471726,9.66834170854271
2021-02-27,46338,82,39530,47,6808,35,43233,58,297424,670,340657,728,1,579,-33,748,114,45011,3,1304,588,"Knox County",470313,129.062985713769,0.0932773109243697,154.790533113054,17.4351974110858,159.04302028649,9.32773109243698
2021-02-26,46256,107,39483,70,6773,37,43175,80,296754,506,339929,586,5,578,-17,781,119,44897,1,1301,587,"Knox County",470313,136.930086984625,0.0994347917102784,124.597874181662,22.7508063778803,166.059624122659,9.94347917102784
2021-02-25,46149,131,39413,92,6736,39,43095,97,296248,1029,339343,1126,2,573,-7,798,136,44778,5,1300,587,"Knox County",470313,140.969949799389,0.100233595243151,239.415027864422,27.8537909860029,169.674238220079,10.0233595243151
2021-02-24,46018,102,39321,72,6697,30,42998,80,295219,969,338217,1049,2,571,-30,805,130,44642,2,1295,586,"Knox County",470313,146.923431842199,0.0980655046925876,223.042952246695,21.6876845845214,171.162608730781,9.80655046925876
2021-02-23,45916,122,39249,68,6667,54,42918,75,294250,758,337168,833,5,569,-32,835,149,44512,6,1293,585,"Knox County",470313,144.584563896809,0.0947940947940948,177.116090773591,25.9401717579569,177.541339490935,9.47940947940948
2021-02-22,45794,62,39181,33,6613,29,42843,38,293492,306,336335,344,3,564,-110,867,169,44363,3,1287,583,"Knox County",470313,145.222436972824,0.0927815570672714,73.1427793830917,13.1827102376502,184.345318968432,9.27815570672714
2021-02-21,45732,82,39148,41,6584,41,42805,45,293186,499,335991,544,2,561,-31,977,111,44194,3,1284,581,"Knox County",470313,146.285558766183,0.0907869481765835,115.667651117447,17.4351974110858,207.733998422327,9.07869481765835
2021-02-20,45650,137,39107,98,6543,39,42760,115,292687,1007,335447,1122,1,559,8,1008,128,44083,2,1281,578,"Knox County",470313,157.979898493131,0.0945753033547466,238.564530429735,29.1295371380336,214.325353541152,9.45753033547466
2021-02-19,45513,95,39009,43,6504,52,42645,48,291680,274,334325,322,1,558,-83,1000,177,43955,2,1279,577,"Knox County",470313,155.42840618907,0.0932584269662921,68.4650434923126,20.1993140738189,212.624358671778,9.32584269662921
2021-02-18,45418,155,38966,111,6452,44,42597,119,291406,987,334003,1106,4,557,-37,1083,188,43778,6,1277,575,"Knox County",470313,160.531390797193,0.0977443609022556,235.162540690987,32.9567755941256,230.272180441536,9.77443609022556
2021-02-17,45263,114,38855,68,6408,46,42478,76,290419,892,332897,968,1,553,-49,1120,162,43590,4,1271,569,"Knox County",470313,163.082883101254,0.098492078640962,205.820379194281,24.2391768885827,238.139281712392,9.8492078640962
2021-02-16,45149,146,38787,90,6362,56,42402,101,289527,818,331929,919,2,552,-41,1169,185,43428,4,1267,566,"Knox County",470313,168.185867709377,0.101784037558685,195.401785619364,31.0431563660796,248.557875287309,10.1784037558685
2021-02-15,45003,76,38697,36,6306,40,42301,43,288709,312,331010,355,2,550,-140,1210,214,43243,1,1263,566,"Knox County",470313,171.162608730781,0.102511244377811,75.4816473284812,16.1594512590551,257.275473992852,10.2511244377811
2021-02-14,44927,165,38661,135,6266,30,42258,135,288397,706,330655,841,2,548,20,1350,143,43029,5,1262,565,"Knox County",470313,188.810430500539,0.113083614415054,178.817085642965,35.0830191808434,287.042884206901,11.3083614415054
2021-02-13,44762,135,38526,91,6236,44,42123,106,287691,870,329814,976,4,546,-9,1330,140,42886,7,1257,564,"Knox County",470313,188.385181783195,0.114452341899034,207.521374063655,28.7042884206901,282.790397033465,11.4452341899034
2021-02-12,44627,179,38435,114,6192,65,42017,124,286821,995,328838,1119,3,542,13,1339,163,42746,3,1250,560,"Knox County",470313,206.245627911625,0.112030553787397,237.92665735372,38.0597602022483,284.704016261511,11.2030553787397
2021-02-11,44448,162,38321,112,6127,50,41893,118,285826,1133,327719,1251,5,539,-34,1326,191,42583,5,1247,559,"Knox County",470313,207.733998422327,0.109348265671177,265.993072698394,34.4451461048281,281.939899598778,10.9348265671177
2021-02-10,44286,148,38209,106,6077,42,41775,112,284693,1032,326468,1144,7,534,-47,1360,188,42392,6,1242,557,"Knox County",470313,214.963226617168,0.111884935654807,243.242266320514,31.4684050834232,289.169127793618,11.1884935654807
2021-02-09,44138,209,38103,154,6035,55,41663,165,283661,1022,325324,1187,0,527,12,1407,197,42204,6,1236,555,"Knox County",470313,228.35856121349,0.116833988069257,252.385113743401,44.4384909624016,299.162472651192,11.6833988069257
2021-02-08,43929,107,37949,72,5980,35,41498,76,282639,371,324137,447,4,527,-159,1395,262,42007,2,1230,550,"Knox County",470313,234.949916332315,0.120028715003589,95.0430883262848,22.7508063778803,296.610980347131,12.0028715003589
2021-02-07,43822,108,37877,75,5945,33,41422,83,282268,716,323690,799,1,523,-28,1554,135,41745,2,1228,547,"Knox County",470313,222.830327888024,0.11324570273003,169.886862578751,22.963430736552,330.418253375943,11.324570273003
2021-02-06,43714,304,37802,176,5912,128,41339,197,281552,1396,322891,1593,2,522,136,1582,166,41610,6,1226,546,"Knox County",470313,258.763844503554,0.11604774535809,338.710603364143,64.6378050362206,336.371735418753,11.604774535809
2021-02-05,43410,177,37626,131,5784,46,41142,143,280156,727,321298,870,8,520,-5,1446,174,41444,4,1220,542,"Knox County",470313,258.33859578621,0.122616924975998,184.983192044447,37.6345114849047,307.454822639391,12.2616924975998
2021-02-04,43233,199,37495,148,5738,51,40999,161,279429,1581,320428,1742,2,512,-1,1451,198,41270,7,1216,539,"Knox County",470313,266.205697057066,0.120406065278849,370.391632806238,42.3122473756839,308.51794443275,12.0406065278849
2021-02-03,43034,230,37347,165,5687,65,40838,172,277848,1634,318686,1806,5,510,-9,1452,234,41072,7,1209,531,"Knox County",470313,283.640894468152,0.118072003789673,383.999591761231,48.903602494509,308.730568791422,11.8072003789673
2021-02-02,42804,91,37182,70,5622,21,40666,77,276214,291,316880,368,7,505,-159,1461,243,40838,1,1202,531,"Knox County",470313,258.551220144882,0.119213114754098,78.2457639912144,19.3488166391318,310.644188019468,11.9213114754098
2021-02-01,42713,153,37112,82,5601,71,40589,97,275923,425,316512,522,4,498,-125,1620,274,40595,2,1201,529,"Knox County",470313,268.331940643784,0.120779220779221,110.989915226668,32.5315268767821,344.451461048281,12.0779220779221
2021-01-31,42560,174,37030,120,5530,54,40492,129,275498,939,315990,1068,7,494,13,1745,154,40321,4,1199,526,"Knox County",470313,282.365148316121,0.122474589032501,227.082815061459,36.9966384088894,371.029505882253,12.2474589032501
2021-01-30,42386,277,36910,233,5476,44,40363,250,274559,1518,314922,1768,7,487,92,1732,178,40167,9,1195,524,"Knox County",470313,276.624290631983,0.12635068762279,375.919866131704,58.8969473520825,368.26538921952,12.635068762279
2021-01-29,42109,101,36677,52,5432,49,40113,62,273041,376,313154,438,4,480,-140,1640,237,39989,1,1186,518,"Knox County",470313,260.464839372928,0.122925311203319,93.1294690982388,21.4750602258496,348.703948221716,12.2925311203319
2021-01-28,42008,157,36625,116,5383,41,40051,129,272665,656,312716,785,9,476,-75,1780,223,39752,5,1185,513,"Knox County",470313,251.534616308714,0.13560325684678,166.910121557346,33.3820243114692,378.471358435765,13.560325684678
2021-01-27,41851,168,36509,123,5342,45,39922,125,272009,894,311931,1019,12,467,-73,1855,229,39529,2,1180,509,"Knox County",470313,238.351906071063,0.145609919571046,216.664221486542,35.7208922568587,394.418185336148,14.5609919571046
2021-01-26,41683,234,36386,173,5297,61,39797,193,271115,1041,310912,1234,3,455,-26,1928,257,39300,7,1178,505,"Knox County",470313,268.757189361128,0.144132279777583,262.378458600974,49.7540999291961,409.939763519188,14.4132279777583
2021-01-25,41449,157,36213,105,5236,52,39604,115,270074,415,309678,530,9,452,-201,1954,349,39043,1,1171,498,"Knox County",470313,269.607686795815,0.146594562993277,112.690910096042,33.3820243114692,415.467996844654,14.6594562993277
2021-01-24,41292,157,36108,104,5184,53,39489,111,269659,791,309148,902,4,443,-98,2155,251,38694,2,1170,494,"Knox County",470313,265.993072698394,0.147543439185141,191.787171521944,33.3820243114692,458.205492937682,14.7543439185141
2021-01-23,41135,309,36004,222,5131,87,39378,232,268868,1492,308246,1724,7,439,63,2253,239,38443,7,1168,488,"Knox County",470313,272.797052175891,0.1458082026538,366.564394350146,65.7009268295794,479.042680087516,14.58082026538
2021-01-22,40826,178,35782,143,5044,35,39146,176,267376,1173,306522,1349,3,432,-151,2190,326,38204,8,1161,484,"Knox County",470313,289.169127793618,0.143311679703036,286.830259848229,37.8471358435765,465.647345491194,14.3311679703036
2021-01-21,40648,268,35639,195,5009,73,38970,203,266203,1080,305173,1283,11,429,-124,2341,381,37878,6,1153,476,"Knox County",470313,312.770431606186,0.143638850889193,272.797052175891,56.9833281240365,497.753623650633,14.3638850889193
2021-01-20,40380,192,35444,131,4936,61,38767,131,265123,736,303890,867,10,418,-156,2465,338,37497,8,1147,470,"Knox County",470313,317.873416214308,0.147166941310686,184.345318968432,40.8238768649814,524.119044125933,14.7166941310686
2021-01-19,40188,310,35313,195,4875,115,38636,219,264387,957,303023,1176,8,408,-86,2621,388,37159,14,1139,460,"Knox County",470313,334.032867473363,0.151577065508875,250.046245798011,65.9135511882512,557.288444078731,15.1577065508875
2021-01-18,39878,129,35118,80,4760,49,38417,87,263430,472,301847,559,7,400,-365,2707,487,36771,4,1125,457,"Knox County",470313,328.079385430554,0.147455470737913,118.857016497524,27.4285422686594,575.574138924503,14.7455470737913
2021-01-17,39749,181,35038,138,4711,43,38330,151,262958,690,301288,841,3,393,-207,3072,385,36284,8,1121,448,"Knox County",470313,333.182370038676,0.153737658674189,178.817085642965,38.4850089195918,653.182029839703,15.3737658674189
2021-01-16,39568,421,34900,340,4668,81,38179,389,262268,1757,300447,2146,1,390,8,3279,412,35899,7,1113,442,"Knox County",470313,356.996298209916,0.164943437538012,456.291873709636,89.5148550008186,697.195272084761,16.4943437538012
2021-01-15,39147,187,34560,149,4587,38,37790,153,260511,755,298301,908,0,389,-94,3271,281,35487,4,1106,434,"Knox County",470313,358.909917437962,0.17133676092545,193.062917673975,39.7607550716225,695.494277215386,17.133676092545
2021-01-14,38960,338,34411,267,4549,71,37637,290,259756,1479,297393,1769,6,389,-92,3365,424,35206,8,1102,424,"Knox County",470313,373.793622544986,0.171788047423179,376.132490490376,71.867033231061,715.480966930533,17.1788047423179
2021-01-13,38622,249,34144,201,4478,48,37347,206,258277,946,295624,1152,12,383,-249,3457,486,34782,6,1094,417,"Knox County",470313,385.913210989277,0.174833352824231,244.943261189888,52.9434653092728,735.042407928337,17.4833352824231
2021-01-12,38373,332,33943,261,4430,71,37141,283,257331,1181,294472,1464,10,371,-176,3706,498,34296,6,1088,415,"Knox County",470313,390.590946880056,0.176377418259984,311.282061095483,70.5912870790304,787.98587323761,17.6377418259984
2021-01-11,38041,244,33682,197,4359,47,36858,228,256150,726,293008,954,4,361,-396,3882,636,33798,5,1082,410,"Knox County",470313,415.042748127311,0.184102230885857,202.843638172876,51.8803435159139,825.407760363843,18.4102230885857
2021-01-10,37797,328,33485,205,4312,123,36630,222,255424,1013,292054,1235,5,357,-4,4278,327,33162,17,1077,404,"Knox County",470313,446.298528852062,0.183942667220607,262.591082959646,69.7407896443432,909.607006397867,18.3942667220607
2021-01-09,37469,475,33280,393,4189,82,36408,426,254411,1384,290819,1810,5,352,101,4282,369,32835,12,1060,398,"Knox County",470313,457.780244220338,0.194575979337064,384.850089195918,100.996570369095,910.457503832554,19.4575979337064
2021-01-08,36994,459,32887,371,4107,88,35982,392,253027,1432,289009,1824,7,347,267,4181,185,32466,6,1048,396,"Knox County",470313,515.614069779062,0.200528996865204,387.826830217323,97.5945806303462,888.982443606704,20.0528996865204
2021-01-07,36535,389,32516,346,4019,43,35590,354,251595,1309,287185,1663,10,340,73,3914,306,32281,10,1042,388,"Knox County",470313,526.457912071323,0.208968521084934,353.594308471167,82.7108755233217,832.21173984134,20.8968521084934
2021-01-06,36146,496,32170,362,3976,134,35236,378,250286,1187,285522,1565,9,330,58,3841,429,31975,15,1032,385,"Knox County",470313,578.976128663252,0.217118402282454,332.757121321333,105.461681901202,816.6901616583,21.7118402282454
2021-01-05,35650,520,31808,328,3842,192,34858,345,249099,1193,283957,1538,14,321,32,3783,474,31546,14,1017,376,"Knox County",470313,618.949508093546,0.221456228161299,327.016263637195,110.564666509325,804.357948855337,22.1456228161299
2021-01-04,35130,322,31480,228,3650,94,34513,249,247906,654,282419,903,6,307,-222,3751,538,31072,6,1003,370,"Knox County",470313,635.534208069945,0.224520781932055,191.999795880616,68.4650434923126,797.55396937784,22.4520781932055
2021-01-03,34808,285,31252,182,3556,103,34264,195,247252,608,281516,803,2,301,-15,3973,298,30534,10,997,362,"Knox County",470313,626.391360647058,0.231446665347318,170.737360013438,60.5979422214568,844.756577002974,23.1446665347318
2021-01-02,34523,422,31070,319,3453,103,34069,345,246644,1095,280713,1440,0,299,105,3988,317,30236,22,987,353,"Knox County",470313,615.122269637454,0.231922760887428,306.179076487361,89.7274793594904,847.945942383051,23.1922760887428
2021-01-01,34101,419,30751,349,3350,70,33724,374,245549,1297,279273,1671,2,299,2,3883,415,29919,8,965,349,"Knox County",470313,606.617295290583,0.233747260774288,355.295303340541,89.089606283475,825.620384722515,23.3747260774288
2020-12-31,33682,448,30402,311,3280,137,33350,322,244252,929,277602,1251,12,297,0,3881,436,29504,8,957,343,"Knox County",470313,619.162132452218,0.240758913967942,265.993072698394,95.2557126849566,825.195136005171,24.0758913967942
2020-12-30,33234,363,30091,248,3143,115,33028,271,243323,931,276351,1202,6,285,-146,3881,503,29068,9,949,340,"Knox County",470313,590.883092748871,0.238533151680291,255.574479123477,77.1826421978555,825.195136005171,23.8533151680291
2020-12-29,32871,590,29843,398,3028,192,32757,420,242392,1081,275149,1501,7,279,111,4027,472,28565,14,940,336,"Knox County",470313,605.766797855896,0.248090297571543,319.149162366339,125.448371616349,856.238292371251,24.8090297571543
2020-12-28,32281,252,29445,174,2836,78,32337,185,241311,565,273648,750,4,272,-331,3916,579,28093,4,926,328,"Knox County",470313,590.883092748871,0.245068461359944,159.468269003834,53.5813383852881,832.636988558683,24.5068461359944
2020-12-27,32029,230,29271,156,2758,74,32152,172,240746,489,272898,661,3,268,-74,4247,301,27514,8,922,323,"Knox County",470313,579.188753021924,0.246460594620104,140.544701082045,48.903602494509,903.015651279042,24.6460594620104
2020-12-26,31799,358,29115,288,2684,70,31980,328,240257,1064,272237,1392,0,265,59,4321,299,27213,10,914,316,"Knox County",470313,565.58079406693,0.245847176079734,295.973107271115,76.1195204044966,918.749853820754,24.5847176079734
2020-12-25,31441,353,28827,287,2614,66,31652,308,239193,1070,270845,1378,1,265,-101,4262,453,26914,5,904,310,"Knox County",470313,551.547586394592,0.246588813767671,292.99636624971,75.0563986111377,906.205016659119,24.6588813767671
2020-12-24,31088,351,28540,277,2548,74,31344,311,238123,1273,269467,1584,5,264,-111,4363,457,26461,8,899,303,"Knox County",470313,530.92302360343,0.235592820028342,336.796984136097,74.6311498937941,927.680076884968,23.5592820028342
2020-12-23,30737,472,28263,351,2474,121,31033,371,236850,1411,267883,1782,6,259,-14,4474,480,26004,9,891,296,"Knox County",470313,554.099078698654,0.231542882404951,378.896607153109,100.358697293079,951.281380697535,23.1542882404951
2020-12-22,30265,530,27912,392,2353,138,30662,432,235439,1470,266101,1902,7,253,-26,4488,549,25524,15,882,289,"Knox County",470313,541.341617178347,0.222986559424278,404.411530193722,112.690910096042,954.25812171894,22.2986559424278
2020-12-21,29735,442,27520,361,2215,81,30230,391,233969,1423,264199,1814,2,246,-136,4514,576,24975,5,867,283,"Knox County",470313,581.740245325985,0.22001331684581,385.700586630606,93.9799665329259,959.786355044406,22.001331684581
2020-12-20,29293,514,27159,431,2134,83,29839,478,232546,2245,262385,2723,2,244,235,4650,277,24399,7,862,280,"Knox County",470313,642.12556318877,0.208270377733598,578.976128663252,109.288920357294,988.703267823768,20.8270377733598
2020-12-19,28779,525,26728,441,2051,84,29361,489,230301,1445,259662,1934,6,242,252,4415,267,24122,14,855,274,"Knox County",470313,677.633831086957,0.211938705496684,411.215509671219,111.627788302684,938.736543535901,21.1938705496684
2020-12-18,28254,480,26287,420,1967,60,28872,430,228856,1358,257728,1788,4,236,98,4163,378,23855,11,841,267,"Knox County",470313,704.637124638273,0.214533895172618,380.172353305139,102.059692162454,885.155205150612,21.4533895172618
2020-12-17,27774,733,25867,635,1907,98,28442,663,227498,1898,255940,2561,11,232,288,4065,434,23477,11,830,261,"Knox County",470313,785.859629650892,0.224351902923331,544.530982558424,155.853654906413,864.318018000778,22.4351902923332
2020-12-16,27041,564,25232,453,1809,111,27779,472,225600,1729,253379,2201,8,221,99,3777,457,23043,11,819,257,"Knox County",470313,805.421070648696,0.224820746498693,467.986213436584,119.920138290883,803.082202703306,22.4820746498693
2020-12-15,26477,765,24779,675,1698,90,27307,716,223871,2415,251178,3131,2,213,324,3678,439,22586,15,808,253,"Knox County",470313,855.387794936564,0.225297176820208,665.726867001337,162.65763438391,782.0323911948,22.5297176820208
2020-12-14,25712,472,24104,411,1608,61,26591,461,221456,1624,248047,2085,6,211,-11,3354,477,22147,7,793,245,"Knox County",470313,861.766525696717,0.225841807221579,443.321787830657,100.358697293079,713.142098985144,22.5841807221579
2020-12-13,25240,628,23693,572,1547,56,26130,754,219832,2935,245962,3689,2,205,400,3365,226,21670,10,786,237,"Knox County",470313,886.0057025853,0.229167864742078,784.37125914019,133.528097245877,715.480966930533,22.9167864742078
2020-12-12,24612,464,23121,392,1491,72,25376,454,216897,2171,242273,2625,3,203,182,2965,279,21444,19,776,231,"Knox County",470313,873.035616706321,0.218473451327434,558.138941513418,98.6577024237051,630.431223461822,21.8473451327434
2020-12-11,24148,557,22729,523,1419,34,24922,429,214726,1407,239648,1836,6,200,281,2783,270,21165,10,757,227,"Knox County",470313,889.407692324048,0.217839805825243,390.378322521385,118.43176778018,591.733590183559,21.7839805825243
2020-12-10,23591,473,22206,415,1385,58,24493,538,213319,1910,237812,2448,8,194,325,2502,140,20895,9,747,225,"Knox County",470313,834.125359069386,0.212267554815432,520.504430028513,100.571321651751,531.986145396789,21.2267554815432
2020-12-09,23118,407,21791,337,1327,70,23955,359,211409,924,235364,1283,2,186,77,2177,328,20755,13,738,215,"Knox County",470313,800.743334757917,0.217055623793648,272.797052175891,86.5381139794137,462.883228828461,21.7055623793648
2020-12-08,22711,491,21454,446,1257,45,23596,538,210485,2077,234081,2615,9,184,126,2100,356,20427,10,725,212,"Knox County",470313,742.484260481849,0.213075206561727,556.0126979267,104.398560107843,446.511153210734,21.3075206561727
2020-12-07,22220,323,21008,271,1212,52,23058,317,208408,1135,231466,1452,3,175,-128,1974,448,20071,6,715,210,"Knox County",470313,710.803231039754,0.212503135189365,308.730568791422,68.6776678509843,419.72048401809,21.2503135189365
2020-12-06,21897,332,20737,291,1160,41,22741,187,207273,668,230014,855,6,172,103,2102,223,19623,6,709,207,"Knox County",470313,647.866420872908,0.215189873417722,181.79382666437,70.5912870790304,446.936401928078,21.5189873417722
2020-12-05,21565,289,20446,263,1119,26,22554,213,206605,714,229159,927,2,166,55,1999,232,19400,8,703,203,"Knox County",470313,610.657158105347,0.226086194814296,197.102780488738,61.4484396561439,425.036092984885,22.6086194814296
2020-12-04,21276,354,20183,322,1093,32,22341,297,205891,1091,228232,1388,5,164,17,1944,332,19168,11,695,201,"Knox County",470313,567.494413294976,0.223285922684172,295.122609836428,75.2690229698095,413.341753257937,22.3285922684172
2020-12-03,20922,441,19861,424,1061,17,22044,448,204800,1215,226844,1663,2,159,180,1927,259,18836,10,684,196,"Knox County",470313,560.690433817479,0.231660610821958,353.594308471167,93.7673421742542,409.727139160517,23.1660610821958
2020-12-02,20481,192,19437,170,1044,22,21596,185,203585,575,225181,760,2,157,-144,1747,334,18577,7,674,194,"Knox County",470313,514.976196703047,0.226190476190476,161.594512590551,40.8238768649814,371.454754599596,22.6190476190476
2020-12-01,20289,403,19267,380,1022,23,21411,409,203010,1832,224421,2241,5,155,89,1891,309,18243,7,667,189,"Knox County",470313,496.26525313993,0.221408572043937,476.491187783455,85.6876165447266,402.072662248333,22.1408572043937
2020-11-30,19886,385,18887,371,999,14,21002,436,201178,1815,222180,2251,1,150,24,1802,360,17934,3,660,186,"Knox County",470313,509.44796337758,0.215666831928607,478.617431370173,81.8603780886346,383.149094326544,21.5666831928607
2020-11-29,19501,226,18516,218,985,8,20566,261,199363,1465,219929,1726,0,149,41,1778,185,17574,5,657,183,"Knox County",470313,486.909781358372,0.205275648046732,366.989643067489,48.0531050598219,378.046109718422,20.5275648046732
2020-11-28,19275,271,18298,257,977,14,20305,299,197898,1967,218203,2266,0,149,72,1737,199,17389,8,652,177,"Knox County",470313,483.08254290228,0.189914599430663,481.806796750249,57.6212012000519,369.328511012879,18.9914599430663
2020-11-27,19004,235,18041,215,963,20,20006,249,195931,1247,215937,1496,3,149,-6,1665,238,17190,12,644,173,"Knox County",470313,457.780244220338,0.184390873175845,318.08604057298,49.9667242878679,354.019557188511,18.4390873175845
2020-11-26,18769,344,17826,341,943,3,19757,441,194684,1429,214441,1870,4,146,48,1671,292,16952,5,632,170,"Knox County",470313,437.155681429176,0.18080888183981,397.607550716225,73.1427793830917,355.295303340541,18.080888183981
2020-11-25,18425,219,17485,193,940,26,19316,123,193255,325,212571,448,0,142,-58,1623,277,16660,3,627,164,"Knox County",470313,442.896539113314,0.180354529191738,95.2557126849566,46.5647345491194,345.089334124296,18.0354529191738
2020-11-24,18206,153,17292,130,914,23,19193,116,192930,673,212123,789,2,142,-111,1681,262,16383,6,624,162,"Knox County",470313,389.740449445369,0.177484787018256,167.760618992033,32.5315268767821,357.421546927259,17.7484787018256
2020-11-23,18053,167,17162,147,891,20,19077,100,192257,391,211334,491,3,140,-97,1792,261,16121,7,618,160,"Knox County",470313,343.388339254922,0.174884437596302,104.398560107843,35.508267898187,381.022850739826,17.4884437596302
2020-11-22,17886,220,17015,212,871,8,18977,258,191866,1804,210843,2062,2,137,86,1889,132,15860,5,611,153,"Knox County",470313,342.112593102891,0.168329441732116,438.431427581207,46.7773589077912,401.647413530989,16.8329441732116
2020-11-21,17666,173,16803,169,863,4,18719,198,190062,1465,208781,1663,0,135,2,1803,171,15728,4,606,151,"Knox County",470313,321.275405953057,0.168386438371697,353.594308471167,36.7840140502176,383.361718685216,16.8386438371697
2020-11-20,17493,178,16634,169,859,9,18521,163,188597,791,207118,954,7,135,-17,1801,188,15557,5,602,149,"Knox County",470313,309.155817508765,0.169022592726833,202.843638172876,37.8471358435765,382.936469967872,16.9022592726833
2020-11-19,17315,166,16465,148,850,18,18358,128,187806,663,206164,791,2,128,-28,1818,192,15369,4,597,145,"Knox County",470313,271.308681665189,0.15087524312309,168.185867709377,35.2956435395152,386.551084065293,15.087524312309
2020-11-18,17149,168,16317,163,832,5,18230,179,187143,874,205373,1053,0,126,-9,1846,177,15177,7,593,140,"Knox County",470313,260.464839372928,0.146353966423171,223.893449681382,35.7208922568587,392.504566108102,14.6353966423171
2020-11-17,16981,248,16154,240,827,8,18051,260,186269,1033,204320,1293,9,126,86,1855,153,15000,7,586,138,"Knox County",470313,280.664153446747,0.154809197062718,274.923295762609,52.730840950601,394.418185336148,15.4809197062718
2020-11-16,16733,272,15914,261,819,11,17791,286,185236,1409,203027,1695,2,117,79,1769,191,14847,6,579,137,"Knox County",470313,302.989711107284,0.154768163179476,360.398287948664,57.8338255587237,376.132490490376,15.4768163179476
2020-11-15,16461,274,15653,247,808,27,17505,295,183827,2278,201332,2573,2,115,162,1690,110,14656,3,573,135,"Knox County",470313,314.47142647556,0.150568748752744,547.082474862485,58.2590742760672,359.335166155305,15.0568748752744
2020-11-14,16187,306,15406,293,781,13,17210,321,181549,1699,198759,2020,0,113,188,1528,118,14546,7,570,131,"Knox County",470313,342.750466178906,0.157240581944311,429.501204516992,65.0630537535641,324.890020050477,15.7240581944311
2020-11-13,15881,219,15113,200,768,19,16889,190,179850,965,196739,1155,4,113,73,1340,142,14428,6,563,128,"Knox County",470313,351.468064884449,0.156805293005671,245.581134265904,46.5647345491194,284.916640620183,15.6805293005671
2020-11-12,15662,143,14913,130,749,13,16699,136,178885,955,195584,1091,1,109,-3,1267,145,14286,3,557,127,"Knox County",470313,346.577704634998,0.153216911764706,231.97317531091,30.4052832900643,269.395062437143,15.3216911764706
2020-11-11,15519,191,14783,177,736,14,16563,191,177930,1229,194493,1420,3,108,23,1270,165,14141,7,554,125,"Knox County",470313,351.468064884449,0.149284253578732,301.926589313925,40.6112525063096,270.032935513158,14.9284253578732
2020-11-10,15328,168,14606,163,722,5,16372,186,176701,1131,193073,1317,2,105,24,1247,142,13976,4,547,123,"Knox County",470313,334.458116190707,0.142400851743412,280.026280370732,35.7208922568587,265.142575263707,14.2400851743412
2020-11-09,15160,135,14443,121,717,14,16186,131,175570,490,191756,621,1,103,-15,1223,149,13834,2,543,121,"Knox County",470313,305.328579052673,0.142198685888006,132.039726735174,28.7042884206901,260.039590655585,14.2198685888006
2020-11-08,15025,215,14322,203,703,12,16055,252,175080,2625,191135,2877,1,102,94,1238,120,13685,3,541,119,"Knox County",470313,292.783741891039,0.133987239310542,611.720279898706,45.7142371144323,263.228956035661,13.3987239310542
2020-11-07,14810,169,14119,161,691,8,15803,187,172455,1918,188258,2105,1,101,59,1144,109,13565,5,538,114,"Knox County",470313,263.654204753005,0.120253164556962,447.574275004093,35.9335166155305,243.242266320514,12.0253164556962
2020-11-06,14641,155,13958,138,683,17,15616,160,170537,1236,186153,1396,0,100,24,1085,131,13456,5,533,114,"Knox County",470313,250.046245798011,0.114805578645978,296.823604705802,32.9567755941256,230.697429158879,11.4805578645978
2020-11-05,14486,158,13820,142,666,16,15456,151,169301,613,184757,764,1,100,34,1061,123,13325,6,528,111,"Knox County",470313,253.235611178088,0.119809523809524,162.445010025239,33.5946486701409,225.594444550757,11.9809523809524
2020-11-04,14328,145,13678,133,650,12,15305,148,168688,934,183993,1082,-1,99,20,1027,126,13202,5,522,110,"Knox County",470313,243.454890679186,0.119563078134226,230.059556082864,30.8305320074078,218.365216355916,11.9563078134226
2020-11-03,14183,196,13545,183,638,13,15157,195,167754,836,182911,1031,3,100,44,1007,149,13076,5,517,108,"Knox County",470313,249.408372721996,0.123936816524909,219.215713790603,41.6743742996685,214.112729182481,12.3936816524909
2020-11-02,13987,116,13362,110,625,6,14962,115,166918,807,181880,922,1,97,-36,963,151,12927,2,512,107,"Knox County",470313,245.368509907232,0.118699027218237,196.039658695379,24.6644256059263,204.757257400922,11.8699027218237
2020-11-01,13871,124,13252,116,619,8,14847,131,166111,1273,180958,1404,0,96,15,999,109,12776,3,510,105,"Knox County",470313,226.0196932681,0.124885110294118,298.524599575177,26.3654204753005,212.411734313106,12.4885110294118
2020-10-31,13747,5,13136,5,611,0,14716,7,164838,4,179554,11,0,96,-99,984,104,12667,0,507,103,"Knox County",470313,191.149298445929,0.137216338880484,2.33886794538956,1.06312179335889,209.22236893303,13.7216338880484
2020-10-30,13742,156,13131,146,611,10,14709,148,164834,853,179543,1001,1,96,27,1083,128,12563,4,507,102,"Knox County",470313,191.3619228046,0.144006436041834,212.83698303045,33.1693999527974,230.272180441536,14.4006436041834
2020-10-29,13586,152,12985,138,601,14,14561,136,163981,1569,178542,1705,0,95,49,1056,103,12435,4,503,102,"Knox County",470313,190.08617665257,0.122973728339855,362.524531535382,32.3189025181103,224.531322757398,12.2973728339855
2020-10-28,13434,103,12847,96,587,7,14425,102,162412,1055,176837,1157,3,95,-47,1007,147,12332,8,499,101,"Knox County",470313,181.155953588355,0.115336744571982,246.006382983247,21.9003089431931,214.112729182481,11.5336744571982
2020-10-27,13331,119,12751,113,580,6,14323,127,161357,799,175680,926,1,92,-6,1054,124,12185,3,491,100,"Knox County",470313,164.783877970628,0.107493685096829,196.890156130067,25.3022986819416,224.106074040054,10.7493685096829
2020-10-26,13212,81,12638,74,574,7,14196,73,160558,372,174754,445,2,91,-72,1060,151,12061,2,488,98,"Knox County",470313,157.342025417116,0.108888554669875,94.6178396089413,17.222573052414,225.381820192085,10.8888554669875
2020-10-25,13131,132,12564,121,567,11,14123,151,160186,1365,174309,1516,0,89,53,1132,79,11910,3,486,98,"Knox County",470313,159.04302028649,0.110042893063156,322.338527746416,28.0664153446747,240.690774016453,11.0042893063156
2020-10-24,12999,172,12443,167,556,5,13972,202,158821,1789,172793,1991,0,89,56,1079,116,11831,5,483,97,"Knox County",470313,194.551288184677,0.107424779773481,423.33509811551,36.5713896915458,229.421683006849,10.7424779773481
2020-10-23,12827,159,12276,148,551,11,13770,172,157032,1239,170802,1411,1,89,40,1023,118,11715,5,478,96,"Knox County",470313,195.189161260692,0.105234400611955,300.012970085879,33.8072730288127,217.514718921229,10.5234400611955
2020-10-22,12668,182,12128,168,540,14,13598,169,155793,1607,169391,1776,1,88,59,983,122,11597,5,473,96,"Knox County",470313,201.567892020846,0.108002602472349,377.620861001078,38.6976332782636,209.009744574358,10.8002602472349
2020-10-21,12486,72,11960,68,526,4,13429,74,154186,682,167615,756,0,87,-32,924,104,11475,1,468,96,"Knox County",470313,194.976536902021,0.109738124929146,160.744015155864,15.308953824368,196.464907412723,10.9738124929146
2020-10-20,12414,127,11892,121,522,6,13355,150,153504,739,166859,889,0,87,13,956,114,11371,7,467,95,"Knox County",470313,196.677531771395,0.112818761384335,189.023054859211,27.0032935513158,203.26888689022,11.2818761384335
2020-10-19,12287,112,11771,107,516,5,13205,117,152765,939,165970,1056,1,87,-9,943,120,11257,6,460,94,"Knox County",470313,203.26888689022,0.110164981373071,224.531322757398,23.8139281712392,200.504770227487,11.0164981373071
2020-10-18,12175,140,11664,135,511,5,13088,168,151826,1431,164914,1599,0,86,51,952,89,11137,7,454,94,"Knox County",470313,204.969881759594,0.11099388056552,339.986349516173,29.7674102140489,202.418389455533,11.099388056552
2020-10-17,12035,128,11529,125,506,3,12920,154,150395,1458,163315,1612,1,86,42,901,85,11048,3,447,93,"Knox County",470313,195.614409978036,0.110341795801736,342.750466178906,27.2159179099876,191.574547163272,11.0341795801736
2020-10-16,11907,72,11404,71,503,1,12766,61,148937,390,161703,451,1,85,-26,859,97,10963,3,444,92,"Knox County",470313,177.116090773591,0.109718638653397,95.893585760972,15.308953824368,182.644324099057,10.9718638653397
2020-10-15,11835,74,11333,62,502,12,12705,66,148547,941,161252,1007,1,84,-56,885,129,10866,3,441,90,"Knox County",470313,154.152660037039,0.10719131614654,214.112729182481,15.7342025417116,188.172557424524,10.719131614654
2020-10-14,11761,149,11271,143,490,6,12639,150,147606,1086,160245,1236,0,83,58,941,91,10737,5,438,88,"Knox County",470313,170.524735654766,0.11031847133758,262.803707318318,31.6810294420949,200.079521510143,11.031847133758
2020-10-13,11612,71,11128,68,484,3,12489,63,146520,581,159009,644,1,83,-36,883,106,10646,6,433,88,"Knox County",470313,158.617771569146,0.102432610124918,136.930086984625,15.0963294656962,187.74730870718,10.2432610124918
2020-10-12,11541,79,11060,66,481,13,12426,87,145939,806,158365,893,0,82,-42,919,121,10540,5,427,87,"Knox County",470313,151.601167732978,0.100644987906477,189.873552293898,16.7973243350705,195.401785619364,10.0644987906477
2020-10-11,11462,170,10994,163,468,7,12339,179,145133,1612,157472,1791,0,82,94,961,76,10419,8,422,85,"Knox County",470313,157.979898493131,0.0995546240503013,380.810226381155,36.1461409742023,204.332008683579,9.95546240503013
2020-10-10,11292,130,10831,122,461,8,12160,132,143521,1393,155681,1525,0,82,46,867,84,10343,3,414,85,"Knox County",470313,158.405147210475,0.0977872002120048,324.252146974462,27.6411666273312,184.345318968432,9.77872002120048
2020-10-09,11162,120,10709,118,453,2,12028,134,142128,1336,154156,1470,0,82,34,821,86,10259,3,411,85,"Knox County",470313,168.61111642672,0.0946766285314032,312.557807247514,25.5149230406134,174.56459846953,9.46766285314032
2020-10-08,11042,110,10591,102,451,8,11894,103,140792,943,152686,1046,1,82,32,787,77,10173,4,408,85,"Knox County",470313,176.265593338904,0.0985473561882626,222.40507917068,23.3886794538956,167.335370274689,9.85473561882626
2020-10-07,10932,104,10489,88,443,16,11791,95,139849,1650,151640,1745,0,81,11,755,93,10096,5,404,85,"Knox County",470313,166.697497198674,0.087008997147246,371.029505882253,22.1129333018649,160.531390797193,8.7008997147246
2020-10-06,10828,115,10401,102,427,13,11696,114,138199,1393,149895,1507,0,81,3,744,112,10003,4,399,84,"Knox County",470313,176.052968980232,0.0845945675052621,320.42490851837,24.4518012472545,158.192522851803,8.45945675052621
2020-10-05,10713,118,10299,109,414,9,11582,123,136806,1238,148388,1361,0,81,11,741,107,9891,5,395,84,"Knox County",470313,184.345318968432,0.0842508377213978,289.38175215229,25.0896743232698,157.554649775788,8.42508377213978
2020-10-04,10595,96,10190,89,405,7,11459,99,135568,1827,147027,1926,1,81,31,730,64,9784,2,390,82,"Knox County",470313,168.61111642672,0.0756143667296786,409.514514801845,20.4119384324907,155.215781830398,7.56143667296786
2020-10-03,10499,77,10101,76,398,1,11360,92,133741,1864,145101,1956,0,80,6,699,71,9720,2,388,82,"Knox County",470313,157.342025417116,0.0690218872037054,415.893245561998,16.3720756177269,148.624426711573,6.90218872037054
2020-10-02,10422,82,10025,79,397,3,11268,82,131877,602,143145,684,0,80,-17,693,99,9649,1,386,82,"Knox County",470313,149.262299787588,0.0692420537897311,145.435061331496,17.4351974110858,147.348680559542,6.92420537897311
2020-10-01,10340,71,9946,68,394,3,11186,73,131275,683,142461,756,0,80,2,710,69,9550,1,385,82,"Knox County",470313,140.969949799389,0.0682435832913941,160.744015155864,15.0963294656962,150.963294656962,6.82435832913941
2020-09-30,10269,75,9878,72,391,3,11113,70,130592,675,141705,745,1,80,-32,708,106,9481,2,384,82,"Knox County",470313,134.803843397907,0.0730833799664242,158.405147210475,15.9468269003834,150.538045939619,7.30833799664242
2020-09-29,10194,80,9806,75,388,5,11043,87,129917,1140,140960,1227,-1,79,-16,740,97,9375,2,382,82,"Knox County",470313,127.361990844395,0.0723281340265742,260.890088090272,17.0099486937423,157.342025417116,7.23281340265742
2020-09-28,10114,57,9731,51,383,6,10956,49,128777,431,139733,480,1,80,-70,756,126,9278,3,380,81,"Knox County",470313,114.391904965417,0.0710059171597633,102.059692162454,12.1195884442914,160.744015155864,7.10059171597633
2020-09-27,10057,72,9680,67,377,5,10907,79,128346,978,139253,1057,0,79,-18,826,90,9152,3,377,79,"Knox County",470313,109.288920357294,0.0770456191165822,224.74394711607,15.308953824368,175.627720262889,7.70456191165822
2020-09-26,9985,127,9613,122,372,5,10828,136,127368,2087,138196,2223,4,79,9,844,114,9062,5,374,79,"Knox County",470313,119.920138290883,0.0803123257110987,472.663949327363,27.0032935513158,179.454958718981,8.03123257110987
2020-09-25,9858,102,9491,100,367,2,10692,103,125281,1439,135973,1542,0,75,-3,835,105,8948,1,369,79,"Knox County",470313,124.172625464318,0.074346201743462,327.866761071882,21.6876845845214,177.541339490935,7.4346201743462
2020-09-24,9756,92,9391,89,365,3,10589,105,123842,1717,134431,1822,0,75,-52,838,144,8843,3,368,76,"Knox County",470313,128.637736996426,0.0691512752858399,387.40158149998,19.5614409978036,178.17921256695,6.91512752858399
2020-09-23,9664,53,9302,52,362,1,10484,49,122125,432,132609,481,2,75,-123,890,174,8699,2,365,76,"Knox County",470313,123.960001105647,0.0688405797101449,102.272316521125,11.2690910096042,189.235679217883,6.88405797101449
2020-09-22,9611,82,9250,75,361,7,10435,88,121693,1140,132128,1228,1,73,-53,1013,134,8525,3,363,76,"Knox County",470313,124.38524982299,0.0689459979621873,261.102712448944,17.4351974110858,215.388475334511,6.89459979621873
2020-09-21,9529,34,9175,30,354,4,10347,32,120553,379,130900,411,0,72,-103,1066,137,8391,2,360,76,"Knox County",470313,119.494889573539,0.0675490643541762,87.3886114141008,7.22922819484046,226.657566344116,6.75490643541762
2020-09-20,9495,97,9145,78,350,19,10315,88,120174,707,130489,795,0,72,-17,1169,114,8254,1,358,76,"Knox County",470313,124.810498540334,0.0706892495883322,169.036365144064,20.6245627911625,248.557875287309,7.06892495883322
2020-09-19,9398,132,9067,129,331,3,10227,136,119467,1466,129694,1602,1,72,31,1186,100,8140,5,357,74,"Knox County",470313,125.873620333693,0.0762593579494988,340.624222592189,28.0664153446747,252.172489384729,7.62593579494988
2020-09-18,9266,118,8938,114,328,4,10091,129,118001,1606,128092,1735,3,71,-16,1155,131,8040,3,352,74,"Knox County",470313,129.275610072441,0.0776566757493188,368.903262295535,25.0896743232698,245.581134265904,7.76566757493188
2020-09-17,9148,126,8824,119,324,7,9962,124,116395,1516,126357,1640,0,68,-15,1171,141,7909,6,349,74,"Knox County",470313,136.504838267282,0.0818550430816016,348.703948221716,26.790669192644,248.983124004652,8.18550430816016
2020-09-16,9022,99,8705,77,317,22,9838,117,114879,768,124717,885,1,68,-90,1186,188,7768,3,343,72,"Knox County",470313,146.285558766183,0.0860655737704918,188.172557424524,21.049811508506,252.172489384729,8.60655737704918
2020-09-15,8923,132,8628,126,295,6,9721,136,114111,1338,123832,1474,0,67,-65,1276,197,7580,3,340,71,"Knox County",470313,156.916776699772,0.089206274877078,313.408304682201,28.0664153446747,271.308681665189,8.9206274877078
2020-09-14,8791,127,8502,124,289,3,9585,136,112773,902,122358,1038,0,67,-68,1341,195,7383,5,337,71,"Knox County",470313,176.690842056248,0.0944486857890719,220.704084301306,27.0032935513158,285.129264978855,9.44486857890719
2020-09-13,8664,143,8378,136,286,7,9449,148,111871,1008,121320,1156,0,67,-8,1409,151,7188,0,332,71,"Knox County",470313,186.471562555149,0.0971668415529906,245.793758624576,30.4052832900643,299.587721368535,9.71668415529906
2020-09-12,8521,130,8242,123,279,7,9301,141,110863,1177,120164,1318,1,67,29,1417,100,7037,1,332,71,"Knox County",470313,186.046313837806,0.100692191217824,280.238904729404,27.6411666273312,301.28871623791,10.0692191217824
2020-09-11,8391,104,8119,95,272,9,9160,106,109686,773,118846,879,0,66,-17,1388,121,6937,5,331,69,"Knox County",470313,183.069572816401,0.108224076281287,186.896811272493,22.1129333018649,295.122609836428,10.8224076281287
2020-09-10,8287,192,8024,189,263,3,9054,192,108913,1501,117967,1693,0,66,89,1405,103,6816,5,326,67,"Knox County",470313,197.102780488738,0.115598720833827,359.97303923132,40.8238768649814,298.737223933848,11.5598720833827
2020-09-09,8095,91,7835,82,260,9,8862,93,107412,1710,116274,1803,0,66,-23,1316,114,6713,2,321,67,"Knox County",470313,195.401785619364,0.101698536481145,383.361718685216,19.3488166391318,279.81365601206,10.1698536481145
2020-09-08,8004,126,7753,124,251,2,8769,133,105702,702,114471,835,1,66,30,1339,95,6599,8,319,67,"Knox County",470313,194.126039467333,0.108805319880761,177.541339490935,26.790669192644,284.704016261511,10.8805319880761
2020-09-07,7878,95,7629,92,249,3,8636,98,105000,347,113636,445,1,65,11,1309,83,6504,0,311,67,"Knox County",470313,187.322059989837,0.112067905031369,94.6178396089413,20.1993140738189,278.325285501358,11.2067905031369
2020-09-06,7783,96,7537,92,246,4,8538,94,104653,476,113191,570,0,64,23,1298,73,6421,1,311,67,"Knox County",470313,177.328715132263,0.113615272438022,121.195884442914,20.4119384324907,275.986417555968,11.3615272438022
2020-09-05,7687,284,7445,282,242,2,8444,295,104177,1506,112621,1801,0,64,215,1275,69,6348,4,310,64,"Knox County",470313,210.072866367717,0.125965611761774,382.936469967872,60.385317862785,271.096057306517,12.5965611761774
2020-09-04,7403,93,7163,89,240,4,8149,97,102671,565,110820,662,1,64,16,1060,76,6279,0,306,64,"Knox County",470313,207.733998422327,0.12831348444103,140.757325440717,19.7740653564754,225.381820192085,12.831348444103
2020-09-03,7310,190,7074,184,236,6,8052,198,102106,1798,110158,1996,2,63,107,1044,81,6203,6,306,64,"Knox County",470313,207.308749704984,0.124260355029586,424.398219908869,40.3986281476379,221.979830453336,12.4260355029586
2020-09-02,7120,124,6890,120,230,4,7854,121,100308,1461,108162,1582,2,61,41,937,81,6122,5,300,63,"Knox County",470313,214.325353541152,0.131288810036751,336.371735418753,26.3654204753005,199.229024075456,13.1288810036751
2020-09-01,6996,153,6770,146,226,7,7733,158,98847,660,106580,818,2,59,64,896,87,6041,4,295,62,"Knox County",470313,220.06621122529,0.134747269494539,173.926725393515,32.5315268767821,190.511425369913,13.4747269494539
2020-08-31,6843,99,6624,93,219,6,7575,94,98187,431,105762,525,0,57,18,832,81,5954,3,291,59,"Knox County",470313,220.916708659978,0.132889112396279,111.627788302684,21.049811508506,176.903466414919,13.2889112396279
2020-08-30,6744,72,6531,71,213,1,7481,76,97756,423,105237,499,1,57,5,814,66,5873,1,288,59,"Knox County",470313,215.813724051855,0.131802613218318,106.099554977217,15.308953824368,173.076227958827,13.1802613218318
2020-08-29,6672,118,6460,113,212,5,7405,125,97333,1391,104738,1516,5,56,37,809,76,5807,3,287,57,"Knox County",470313,180.51808051234,0.114372203211371,322.338527746416,25.0896743232698,172.013106165469,11.4372203211371
2020-08-28,6554,89,6347,85,207,4,7280,91,95942,309,103222,400,0,51,-7,772,96,5731,3,284,57,"Knox County",470313,179.667583077653,0.117639040348964,85.0497434687113,18.9235679217883,164.146004894613,11.7639040348964
2020-08-27,6465,116,6262,112,203,4,7189,134,95633,1987,102822,2121,0,51,24,779,92,5635,2,281,57,"Knox County",470313,163.933380535941,0.107090202385739,450.976264742841,24.6644256059263,165.634375405315,10.7090202385739
2020-08-26,6349,77,6150,76,199,1,7055,86,93646,794,100701,880,0,51,-15,755,92,5543,3,279,56,"Knox County",470313,153.940035678367,0.113034472555112,187.109435631165,16.3720756177269,160.531390797193,11.3034472555112
2020-08-25,6272,87,6074,82,198,5,6969,96,92852,896,99821,992,2,51,-6,770,91,5451,3,276,55,"Knox County",470313,139.90682800603,0.101254868022501,210.923363802404,18.4983192044447,163.720756177269,10.1254868022501
2020-08-24,6185,32,5992,28,193,4,6873,29,91956,261,98829,290,0,49,-66,776,98,5360,1,273,55,"Knox County",470313,125.660995975021,0.0951030158256196,61.6610640148157,6.8039794774969,164.9965023293,9.51030158256196
2020-08-23,6153,76,5964,75,189,1,6844,74,91695,566,98539,640,0,49,13,842,63,5262,3,272,55,"Knox County",470313,126.511493409708,0.0928498318467612,136.079589549938,16.1594512590551,179.029710001637,9.28498318467612
2020-08-22,6077,136,5889,135,188,1,6770,153,91129,1892,97899,2045,0,49,69,829,67,5199,4,269,55,"Knox County",470313,130.3387318658,0.0899837133550489,434.816813483786,28.9169127793618,176.265593338904,8.99837133550489
2020-08-21,5941,30,5754,30,187,0,6617,41,89237,262,95854,303,1,49,-62,760,91,5132,1,265,55,"Knox County",470313,117.793894704165,0.0843075230367212,64.4251806775488,6.37873076015334,161.594512590551,8.43075230367212
2020-08-20,5911,119,5724,117,187,2,6576,130,88975,2068,95551,2198,3,48,24,822,92,5041,3,264,55,"Knox County",470313,118.43176778018,0.0828796951551443,467.348340360568,25.3022986819416,174.777222828202,8.28796951551443
2020-08-19,5792,46,5607,41,185,5,6446,48,86907,608,93353,656,2,45,-50,798,94,4949,4,261,55,"Knox County",470313,111.840412661355,0.0801516002245929,139.481579288686,9.7807204989018,169.674238220079,8.01516002245929
2020-08-18,5746,134,5566,132,180,2,6398,152,86299,1164,92697,1316,0,43,3,848,131,4855,4,257,55,"Knox County",470313,121.833757518929,0.0841836734693878,279.81365601206,28.4916640620183,180.305456153668,8.41836734693877
2020-08-17,5612,50,5434,42,178,8,6246,50,85135,289,91381,339,1,43,-70,845,119,4724,0,253,54,"Knox County",470313,125.660995975021,0.0864345738295318,72.0796575897328,10.6312179335889,179.667583077653,8.64345738295318
2020-08-16,5562,83,5392,78,170,5,6196,82,84846,587,91042,669,0,42,11,915,72,4605,1,253,53,"Knox County",470313,127.149366485723,0.0871644964124369,142.24569595142,17.6478217697576,194.551288184677,8.71644964124369
2020-08-15,5479,119,5314,116,165,3,6114,132,84259,1223,90373,1355,1,42,42,904,76,4533,2,252,52,"Knox County",470313,123.534752388303,0.0928905792861322,288.106006000259,25.3022986819416,192.212420239287,9.28905792861323
2020-08-14,5360,91,5198,83,162,8,5982,96,83036,1024,89018,1120,0,41,5,862,86,4457,2,250,52,"Knox County",470313,136.504838267282,0.0901607212857703,238.139281712392,19.3488166391318,183.282197175073,9.01607212857703
2020-08-13,5269,127,5115,126,154,1,5886,229,82012,1778,87898,2007,1,41,13,857,113,4371,4,248,51,"Knox County",470313,138.205833136656,0.105735727686947,426.737087854259,27.0032935513158,182.219075381714,10.5735727686947
2020-08-12,5142,79,4989,72,153,7,5657,88,80234,892,85891,980,0,40,-40,844,119,4258,1,244,50,"Knox County",470313,145.222436972824,0.106473156948369,208.371871498343,16.7973243350705,179.454958718981,10.6473156948369
2020-08-11,5063,111,4917,108,146,3,5569,117,79342,1121,84911,1238,0,40,2,884,109,4139,5,243,50,"Knox County",470313,140.332076723374,0.103009859885833,263.228956035661,23.6013038125674,187.959933065852,10.3009859885833
2020-08-10,4952,37,4809,35,143,2,5452,35,78221,365,83673,400,1,40,-94,882,130,4030,0,238,48,"Knox County",470313,137.56796006064,0.100270305058566,85.0497434687113,7.86710127085579,187.534684348508,10.0270305058566
2020-08-09,4915,85,4774,81,141,4,5417,109,77856,826,83273,935,1,39,25,976,59,3900,4,238,48,"Knox County",470313,137.993208777984,0.10031113876789,198.803775358113,18.0730704871011,207.521374063655,10.031113876789
2020-08-08,4830,157,4693,156,137,1,5308,176,77030,2284,82338,2460,1,38,96,951,60,3841,4,234,47,"Knox County",470313,146.072934407512,0.0929978118161926,523.055922332574,33.3820243114692,202.205765096861,9.29978118161926
2020-08-07,4673,50,4537,46,136,4,5132,44,74746,403,79878,447,0,37,-34,855,84,3781,0,230,45,"Knox County",470313,137.355335701969,0.0942482579426007,95.0430883262848,10.6312179335889,181.79382666437,9.42482579426007
2020-08-06,4623,113,4491,105,132,8,5088,121,74343,1463,79431,1584,-1,37,41,889,73,3697,5,230,43,"Knox County",470313,134.378594680564,0.0857782197911487,336.796984136097,24.0265525299109,189.023054859211,8.57782197911487
2020-08-05,4510,99,4386,99,124,0,4967,100,72880,1107,77847,1207,1,38,-1,848,99,3624,3,225,42,"Knox County",470313,138.631081853999,0.0848748639825898,256.637600916836,21.049811508506,180.305456153668,8.48748639825898
2020-08-04,4411,112,4287,111,124,1,4867,106,71773,1082,76640,1188,1,37,-31,849,142,3525,9,222,41,"Knox County",470313,138.843706212671,0.0840530349105948,252.597738102072,23.8139281712392,180.51808051234,8.40530349105948
2020-08-03,4299,50,4176,50,123,0,4761,81,70691,593,75452,674,2,36,-59,880,107,3383,1,213,41,"Knox County",470313,141.607822875404,0.0867569158328429,143.308817744778,10.6312179335889,187.109435631165,8.67569158328429
2020-08-02,4249,97,4126,91,123,6,4680,95,70098,692,74778,787,3,34,28,939,66,3276,2,212,40,"Knox County",470313,144.159315179466,0.0866179465676291,167.335370274689,20.6245627911625,199.6542727928,8.66179465676291
2020-08-01,4152,118,4035,110,117,8,4585,118,69406,1417,73991,1535,1,31,29,911,88,3210,1,210,40,"Knox County",470313,135.866965191266,0.0895984909727836,326.37839056118,25.0896743232698,193.70079074999,8.95984909727836
2020-07-31,4034,117,3925,114,109,3,4467,116,67989,1060,72456,1176,2,30,9,882,106,3122,1,209,39,"Knox County",470313,150.112797222275,0.0904183535762483,250.046245798011,24.877049964598,187.534684348508,9.04183535762483
2020-07-30,3917,189,3811,186,106,3,4351,227,66929,2420,71280,2647,1,28,78,873,110,3016,7,208,36,"Knox County",470313,166.272248481331,0.0914912090297374,562.816677404197,40.1860037889661,185.621065120462,9.14912090297373
2020-07-29,3728,75,3625,71,103,4,4124,60,64509,438,68633,498,0,27,-40,795,115,2906,3,201,34,"Knox County",470313,161.169263873208,0.0944150499706055,105.886930618546,15.9468269003834,169.036365144064,9.44150499706055
2020-07-28,3653,154,3554,152,99,2,4064,186,64071,1211,68135,1397,1,27,46,835,107,2791,3,198,30,"Knox County",470313,170.099486937423,0.101331191186596,297.036229064474,32.7441512354538,177.541339490935,10.1331191186596
2020-07-27,3499,83,3402,76,97,7,3878,85,62860,677,66738,762,3,26,-36,789,116,2684,2,195,30,"Knox County",470313,177.116090773591,0.100772551692797,162.019761307895,17.6478217697576,167.760618992033,10.0772551692797
2020-07-26,3416,118,3326,113,90,5,3793,132,62183,1473,65976,1605,0,23,49,825,69,2568,2,193,29,"Knox County",470313,181.581202305699,0.0960498960498961,341.262095668204,25.0896743232698,175.415095904217,9.6049896049896
2020-07-25,3298,175,3213,172,85,3,3661,197,60710,1949,64371,2146,2,23,95,776,78,2499,3,191,28,"Knox County",470313,193.70079074999,0.0980353826605415,456.291873709636,37.2092627675612,164.9965023293,9.80353826605415
2020-07-24,3123,106,3041,99,82,7,3464,113,58761,916,62225,1029,0,21,-15,681,121,2421,4,188,25,"Knox County",470313,191.3619228046,0.0991669972233241,218.79046507326,22.5381820192085,144.797188255481,9.91669972233241
2020-07-23,3017,205,2942,197,75,8,3351,254,57845,2389,61196,2643,0,21,89,696,116,2300,4,184,25,"Knox County",470313,194.763912543349,0.101884920634921,561.96617996951,43.5879935277145,147.986553635558,10.1884920634921
2020-07-22,2812,69,2745,61,67,8,3097,63,55456,437,58553,500,3,21,-68,607,134,2184,3,180,24,"Knox County",470313,193.488166391318,0.102162269390994,106.312179335889,14.6710807483527,129.062985713769,10.2162269390994
2020-07-21,2743,232,2684,228,59,4,3034,280,55019,1691,58053,1971,0,18,120,675,112,2050,12,177,24,"Knox County",470313,210.072866367717,0.10548048048048,419.082610942075,49.3288512118525,143.52144210345,10.548048048048
2020-07-20,2511,74,2456,70,55,4,2754,57,53328,364,56082,421,0,18,-59,555,133,1938,4,165,23,"Knox County",470313,208.159247139671,0.106253029568589,89.5148550008186,15.7342025417116,118.006519062837,10.6253029568589
2020-07-19,2437,84,2386,74,51,10,2697,74,52964,577,55661,651,0,18,-16,614,100,1805,0,161,22,"Knox County",470313,200.93001894483,0.110885589146459,138.418457495328,17.8604461284294,130.551356224472,11.0885589146459
2020-07-18,2353,112,2312,109,41,3,2623,146,52387,2258,55010,2404,1,18,36,630,75,1705,8,161,20,"Knox County",470313,187.534684348508,0.102609418858509,511.148958246955,23.8139281712392,133.95334596322,10.2609418858509
2020-07-17,2241,74,2203,74,38,0,2477,80,50129,347,52606,427,0,17,3,594,71,1630,6,153,19,"Knox County",470313,180.730704871011,0.105800155262282,90.7906011528493,15.7342025417116,126.298869051036,10.5800155262282
2020-07-16,2167,187,2129,185,38,2,2397,228,49782,2035,52179,2263,2,17,97,591,88,1559,3,147,17,"Knox County",470313,176.903466414919,0.107444714599977,481.168923674234,39.7607550716225,125.660995975021,10.7444714599977
2020-07-15,1980,78,1944,78,36,0,2169,80,47747,511,49916,591,3,15,-14,494,89,1471,4,144,17,"Knox County",470313,178.817085642965,0.10827222731439,125.660995975021,16.5846999763987,105.036433183858,10.827222731439
2020-07-14,1902,95,1866,95,36,0,2089,127,47236,777,49325,904,2,12,12,508,81,1382,1,140,16,"Knox County",470313,149.687548504932,0.103380759691946,192.212420239287,20.1993140738189,108.013174205263,10.3380759691946
2020-07-13,1807,94,1771,92,36,2,1962,59,46459,655,48421,714,1,10,20,496,73,1301,2,139,15,"Knox County",470313,153.940035678367,0.099823987930601,151.81379209165,19.9866897151471,105.461681901202,9.9823987930601
2020-07-12,1713,69,1679,67,34,2,1903,87,45804,916,47707,1003,0,9,27,476,42,1228,4,137,12,"Knox County",470313,150.750670298291,0.097158680471948,213.262231747793,14.6710807483527,101.209194727766,9.7158680471948
2020-07-11,1644,28,1612,27,32,1,1816,36,44888,883,46704,919,0,9,-16,449,44,1186,2,133,11,"Knox County",470313,132.890224169861,0.10218443043542,195.401785619364,5.95348204280979,95.4683370436284,10.218443043542
2020-07-10,1616,78,1585,74,31,4,1780,68,44005,418,45785,486,0,9,29,465,49,1142,6,131,10,"Knox County",470313,133.740721604548,0.0995639534883721,103.335438314484,16.5846999763987,98.8703267823768,9.95639534883721
2020-07-09,1538,70,1511,66,27,4,1712,88,43587,1652,45299,1740,0,9,23,436,47,1093,8,125,10,"Knox County",470313,108.86367163995,0.0857322636463741,369.966384088894,14.8837051070245,92.7042203808953,8.57322636463741
2020-07-08,1468,70,1445,65,23,5,1624,63,41935,594,43559,657,1,9,15,413,54,1046,5,117,10,"Knox County",470313,107.162676770576,0.0822045773003269,139.694203647358,14.8837051070245,87.8138601314444,8.2204577300327
2020-07-07,1398,79,1380,79,18,0,1561,104,41341,1304,42902,1408,0,8,38,398,41,992,7,112,10,"Knox County",470313,103.760687031828,0.0729031326692652,299.375097009864,16.7973243350705,84.6244947513677,7.29031326692652
2020-07-06,1319,35,1301,35,18,0,1457,34,40037,658,41494,692,1,8,-19,360,53,951,6,105,9,"Knox County",470313,91.2158498701928,0.0695148443157133,147.13605620087,7.44185255351224,76.5447691218401,6.95148443157133
2020-07-05,1284,77,1266,77,18,0,1423,109,39379,1080,40802,1189,2,7,34,379,41,898,6,99,9,"Knox County",470313,92.9168447395671,0.0707939641799464,252.810362460744,16.3720756177269,80.5846319366039,7.07939641799464
2020-07-04,1207,41,1189,40,18,1,1314,50,38299,1141,39613,1191,0,5,4,345,37,857,1,93,8,"Knox County",470313,95.6809614023002,0.0700801303816379,253.235611178088,8.7175987055429,73.3554037417635,7.00801303816379
2020-07-03,1166,62,1149,61,17,1,1264,49,37158,910,38422,959,0,5,27,341,35,820,4,92,6,"Knox County",470313,92.2789716635517,0.0634252169474222,203.906759966235,13.1827102376502,72.5049063070764,6.34252169474222
2020-07-02,1104,68,1088,68,16,0,1215,102,36248,1228,37463,1330,0,5,33,314,35,785,2,88,6,"Knox County",470313,91.8537229462082,0.0688122811742526,282.790397033465,14.4584563896809,66.7640486229383,6.88122811742526
2020-07-01,1036,49,1020,49,16,0,1113,34,35020,737,36133,771,0,5,25,281,24,750,4,86,6,"Knox County",470313,87.3886114141008,0.0639257294429708,163.933380535941,10.4185935749171,59.7474447867697,6.39257294429708
2020-06-30,987,40,971,39,16,1,1079,73,34283,1514,35362,1587,0,5,18,256,22,726,3,82,5,"Knox County",470313,79.0962614259015,0.0584272574167638,337.434857212112,8.50497434687113,54.4318358199752,5.84272574167638
2020-06-29,947,51,932,51,15,0,1006,79,32769,1333,33775,1412,0,5,20,238,31,704,3,79,5,"Knox County",470313,82.4982511646499,0.0587747363431686,300.225594444551,10.8438422922607,50.6045973638832,5.87747363431686
2020-06-28,896,10,881,10,15,0,927,30,31436,684,32363,714,0,5,-5,218,15,673,1,76,5,"Knox County",470313,68.2524191336408,0.0523606228026118,151.81379209165,2.12624358671778,46.3521101904476,5.23606228026117
2020-06-27,886,29,871,29,15,0,897,16,30752,111,31649,127,0,5,18,223,11,658,3,75,5,"Knox County",470313,65.7009268295794,0.0555072463768116,27.0032935513158,6.16610640148157,47.4152319838065,5.55072463768116
2020-06-26,857,37,842,37,15,0,881,14,30641,319,31522,333,0,5,17,205,20,647,8,72,5,"Knox County",470313,60.385317862785,0.0554670066942939,70.8039114377021,7.86710127085579,43.5879935277145,5.54670066942939
2020-06-25,820,32,805,32,15,0,867,52,30322,702,31189,754,0,5,13,188,19,627,1,64,5,"Knox County",470313,52.730840950601,0.0522990522990523,160.318766438521,6.8039794774969,39.9733794302943,5.22990522990523
2020-06-24,788,35,773,34,15,1,815,32,29620,272,30435,304,0,5,22,175,13,608,1,63,5,"Knox County",470313,49.7540999291961,0.0565857388644619,64.6378050362206,7.44185255351224,37.2092627675612,5.65857388644619
2020-06-23,753,27,739,24,14,3,783,25,29348,216,30131,241,0,5,18,153,9,595,4,62,5,"Knox County",470313,46.989983266463,0.0638352638352638,51.2424704398985,5.74085768413801,32.5315268767821,6.38352638352638
2020-06-22,726,36,715,36,11,0,758,31,29132,572,29890,603,0,5,20,135,16,586,0,58,5,"Knox County",470313,43.8006178863863,0.0650195058517555,128.212488279082,7.65447691218401,28.7042884206901,6.50195058517555
2020-06-21,690,31,679,31,11,0,727,37,28560,815,29287,852,0,5,16,115,15,570,1,58,5,"Knox County",470313,48.2657294184936,0.0644057249533292,181.155953588355,6.59135511882512,24.4518012472545,6.44057249533292
2020-06-20,659,17,648,17,11,0,690,9,27745,437,28435,446,0,5,11,99,6,555,2,57,5,"Knox County",470313,45.7142371144323,0.0566091140673648,94.8304639676131,3.61461409742023,21.049811508506,5.66091140673648
2020-06-19,642,30,631,28,11,2,681,10,27308,334,27989,344,0,5,8,88,22,549,1,55,5,"Knox County",470313,44.2258666037299,0.0553047404063205,73.1427793830917,6.37873076015334,18.7109435631165,5.53047404063205
2020-06-18,612,15,603,15,9,0,671,18,26974,804,27645,822,0,5,2,80,13,527,0,54,5,"Knox County",470313,40.6112525063096,0.0448504983388704,174.777222828202,3.18936538007667,17.0099486937423,4.48504983388704
2020-06-17,597,17,588,17,9,0,653,13,26170,282,26823,295,0,5,-3,78,20,514,0,54,5,"Knox County",470313,36.7840140502176,0.0396891479322787,62.7241858081746,3.61461409742023,16.5846999763987,3.96891479322787
2020-06-16,580,9,571,8,9,1,640,9,25888,178,26528,187,0,5,-2,81,11,494,0,54,5,"Knox County",470313,32.9567755941256,0.0357847280924204,39.7607550716225,1.913619228046,17.222573052414,3.57847280924204
2020-06-15,571,8,563,8,8,0,631,9,25710,218,26341,227,0,5,-5,83,13,483,0,54,5,"Knox County",470313,27.0032935513158,0.0330917113142137,48.2657294184936,1.70099486937423,17.6478217697576,3.30917113142137
2020-06-14,563,8,555,8,8,0,622,9,25492,624,26114,633,0,5,4,88,4,470,0,54,5,"Knox County",470313,22.1129333018649,0.0260663507109005,134.591219039236,1.70099486937423,18.7109435631165,2.60663507109005
2020-06-13,555,10,547,8,8,2,613,9,24868,213,25481,222,0,5,0,84,10,466,3,54,5,"Knox County",470313,20.6245627911625,0.0282051282051282,47.2026076251348,2.12624358671778,17.8604461284294,2.82051282051282
2020-06-12,545,19,539,19,6,0,604,19,24655,750,25259,769,0,5,1,84,18,456,0,51,5,"Knox County",470313,18.2856948457729,0.0272583201267829,163.508131818597,4.03986281476378,17.8604461284294,2.72583201267829
2020-06-11,526,7,520,7,6,0,585,10,23905,379,24490,389,0,5,1,83,6,438,2,51,5,"Knox County",470313,16.5846999763987,0.0286554004408523,82.7108755233217,1.48837051070245,17.6478217697576,2.86554004408523
2020-06-10,519,12,513,12,6,0,575,12,23526,706,24101,718,0,5,-6,82,18,432,0,49,5,"Knox County",470313,15.5215781830398,0.024483306836248,152.664289526337,2.55149230406134,17.4351974110858,2.4483306836248
2020-06-09,507,16,501,16,6,0,563,19,22820,508,23383,527,0,5,5,88,11,414,1,49,5,"Knox County",470313,17.0099486937423,0.0249641319942611,112.053037020027,3.40198973874845,18.7109435631165,2.49641319942611
2020-06-08,491,8,485,8,6,0,544,8,22312,336,22856,344,0,5,4,83,4,403,1,48,5,"Knox County",470313,17.0099486937423,0.0238756246529706,73.1427793830917,1.70099486937423,17.6478217697576,2.38756246529706
2020-06-07,483,7,477,7,6,0,536,8,21976,849,22512,857,0,5,0,79,7,399,1,47,5,"Knox County",470313,16.7973243350705,0.0222164140094093,182.219075381714,1.48837051070245,16.7973243350705,2.22164140094093
2020-06-06,476,11,470,11,6,0,528,12,21127,478,21655,490,0,5,5,79,6,392,0,46,5,"Knox County",470313,17.0099486937423,0.021494870542257,104.185935749171,2.33886794538956,16.7973243350705,2.1494870542257
2020-06-05,465,18,459,18,6,0,516,17,20649,518,21165,535,0,5,7,74,11,386,1,46,5,"Knox County",470313,16.7973243350705,0.022279792746114,113.754031889401,3.82723845609201,15.7342025417116,2.2279792746114
2020-06-04,447,4,441,4,6,0,499,4,20131,338,20630,342,0,5,-1,67,5,375,0,45,5,"Knox County",470313,16.1594512590551,0.02098085496984,72.7175306657481,0.850497434687113,14.2458320310091,2.098085496984
2020-06-03,443,4,437,4,6,0,495,4,19793,399,20288,403,0,5,-3,68,7,370,0,45,5,"Knox County",470313,14.4584563896809,0.0205831903945112,85.6876165447266,0.850497434687113,14.4584563896809,2.05831903945112
2020-06-02,439,26,433,25,6,1,491,24,19394,939,19885,963,0,5,21,71,5,363,2,45,5,"Knox County",470313,16.5846999763987,0.0195729537366548,204.757257400922,5.52823332546623,15.0963294656962,1.95729537366548
2020-06-01,413,17,408,17,5,0,467,20,18455,972,18922,992,0,5,4,50,13,358,0,43,5,"Knox County",470313,18.4983192044447,0.0194238323876037,210.923363802404,3.61461409742023,10.6312179335889,1.94238323876037
2020-05-31,396,7,391,7,5,0,447,7,17483,317,17930,324,0,5,3,46,4,345,0,43,5,"Knox County",470313,18.4983192044447,0.0217337614225735,68.8902922096561,1.48837051070245,9.7807204989018,2.17337614225735
2020-05-30,389,6,384,6,5,0,440,6,17166,294,17606,300,0,5,-1,43,7,341,2,43,5,"Knox County",470313,17.4351974110858,0.0212490282456595,63.7873076015334,1.27574615203067,9.14284742288646,2.12490282456595
2020-05-29,383,8,378,8,5,0,434,7,16872,205,17306,212,0,5,0,44,8,334,0,41,5,"Knox County",470313,15.308953824368,0.0203619909502262,45.076364038417,1.70099486937423,9.35547178155824,2.03619909502262
2020-05-28,375,11,370,11,5,0,427,11,16667,336,17094,347,0,5,7,44,4,326,0,41,5,"Knox County",470313,16.7973243350705,0.022310081897769,73.780652459107,2.33886794538956,9.35547178155824,2.2310081897769
2020-05-27,364,5,359,5,5,0,416,6,16331,420,16747,426,0,5,0,37,5,322,1,41,5,"Knox County",470313,17.0099486937423,0.0227272727272727,90.5779767941775,1.06312179335889,7.86710127085579,2.27272727272727
2020-05-26,359,9,354,9,5,0,410,10,15911,1142,16321,1152,0,5,7,37,2,317,0,40,5,"Knox County",470313,13.395334596322,0.0178523847588596,244.943261189888,1.913619228046,7.86710127085579,1.78523847588596
2020-05-25,350,9,345,9,5,0,400,11,14769,381,15169,392,0,5,5,30,4,315,1,40,5,"Knox County",470313,11.6943397269478,0.018395179194418,83.348748599337,1.913619228046,6.37873076015334,1.8395179194418
2020-05-24,341,2,336,2,5,0,389,3,14388,273,14777,276,0,5,1,25,1,311,0,39,5,"Knox County",470313,10.6312179335889,0.0173913043478261,58.6843229934108,0.425248717343556,5.31560896679445,1.73913043478261
2020-05-23,339,7,334,7,5,0,386,10,14115,360,14501,370,0,5,4,24,3,310,2,39,5,"Knox County",470313,10.8438422922607,0.0182677165354331,78.6710127085579,1.48837051070245,5.10298460812268,1.82677165354331
2020-05-22,332,1,327,1,5,0,376,1,13755,253,14131,254,0,5,-14,20,15,307,0,37,5,"Knox County",470313,9.35547178155824,0.0161641280696301,54.0065871026317,0.212624358671778,4.25248717343556,1.61641280696301
2020-05-21,331,0,326,0,5,0,375,0,13502,250,13877,250,0,5,-1,34,1,292,0,37,5,"Knox County",470313,7.01660383616868,0.0131410256410256,53.1560896679445,0,7.22922819484046,1.31410256410256
2020-05-20,331,7,326,7,5,0,375,7,13252,360,13627,367,0,5,4,35,3,291,0,37,5,"Knox County",470313,7.44185255351224,0.0137210062071219,78.0331396325426,1.48837051070245,7.44185255351224,1.37210062071219
2020-05-19,324,7,319,7,5,0,368,7,12892,369,13260,376,0,5,4,31,3,288,2,37,5,"Knox County",470313,7.01660383616868,0.0170678336980306,79.9467588605886,1.48837051070245,6.59135511882512,1.70678336980306
2020-05-18,317,3,312,3,5,0,361,4,12523,478,12884,482,0,5,0,27,3,285,0,35,5,"Knox County",470313,5.74085768413801,0.0134736842105263,102.484940879797,0.637873076015334,5.74085768413801,1.34736842105263
2020-05-17,314,3,309,3,5,0,357,5,12045,216,12402,221,0,5,1,27,2,282,1,35,5,"Knox County",470313,5.95348204280979,0.0146551724137931,46.989983266463,0.637873076015334,5.74085768413801,1.46551724137931
2020-05-16,311,0,306,0,5,0,352,0,11829,349,12181,349,0,5,-4,26,4,280,0,34,5,"Knox County",470313,4.46511153210734,0.0104393214441061,74.2059011764506,0,5.52823332546623,1.04393214441061
2020-05-15,311,1,306,1,5,0,352,4,11480,540,11832,544,0,5,-4,30,5,276,0,34,5,"Knox County",470313,4.46511153210734,0.0104287369640788,115.667651117447,0.212624358671778,6.37873076015334,1.04287369640788
2020-05-14,310,3,305,3,5,0,348,7,10940,458,11288,465,0,5,0,34,3,271,0,34,5,"Knox County",470313,5.10298460812268,0.0121255349500713,98.8703267823768,0.637873076015334,7.22922819484046,1.21255349500713
2020-05-13,307,7,302,7,5,0,341,5,10482,341,10823,346,0,5,1,34,6,268,0,34,5,"Knox County",470313,5.10298460812268,0.011498383039885,73.5680281004352,1.48837051070245,7.22922819484046,1.1498383039885
2020-05-12,300,6,295,6,5,0,336,8,10141,401,10477,409,0,5,3,33,3,262,0,34,5,"Knox County",470313,4.8903602494509,0.01171875,86.9633626967573,1.27574615203067,7.01660383616868,1.171875
2020-05-11,294,16,289,16,5,0,328,12,9740,254,10068,266,0,5,9,30,7,259,1,34,5,"Knox County",470313,7.65447691218401,0.0157692307692308,56.558079406693,3.40198973874845,6.37873076015334,1.57692307692308
2020-05-10,278,5,273,5,5,0,316,5,9486,221,9802,226,0,5,1,21,4,252,1,33,5,"Knox County",470313,8.07972562952757,0.0157389635316699,48.0531050598219,1.06312179335889,4.46511153210734,1.57389635316699
2020-05-09,273,2,268,2,5,0,311,4,9265,352,9576,356,0,5,-1,20,3,248,0,32,5,"Knox County",470313,8.50497434687113,0.0172281776416539,75.694271687153,0.425248717343556,4.25248717343556,1.72281776416539
2020-05-08,271,3,266,3,5,0,307,4,8913,265,9220,269,0,5,-2,21,5,245,0,32,5,"Knox County",470313,8.93022306421468,0.0192554557124519,57.1959524827083,0.637873076015334,4.46511153210734,1.92554557124519
2020-05-07,268,3,263,3,5,0,303,3,8648,220,8951,223,0,5,-2,23,5,240,0,32,5,"Knox County",470313,8.93022306421468,0.0195704057279236,47.4152319838065,0.637873076015334,4.8903602494509,1.95704057279236
2020-05-06,265,1,260,1,5,0,300,1,8428,185,8728,186,0,5,-7,25,8,235,0,32,5,"Knox County",470313,7.65447691218401,0.0191214470284238,39.5481307129507,0.212624358671778,5.31560896679445,1.91214470284238
2020-05-05,264,4,259,4,5,0,299,5,8243,305,8542,310,0,5,-1,32,5,227,0,32,5,"Knox County",470313,7.22922819484046,0.0185185185185185,65.9135511882512,0.850497434687113,6.8039794774969,1.85185185185185
2020-05-04,260,4,255,4,5,0,294,7,7938,259,8232,266,0,5,-3,33,7,222,0,32,5,"Knox County",470313,4.67773589077912,0.0157952069716776,56.558079406693,0.850497434687113,7.01660383616868,1.57952069716776
2020-05-03,256,7,251,5,5,2,287,6,7679,290,7966,296,0,5,6,36,1,215,2,32,5,"Knox County",470313,5.10298460812268,0.0157397691500525,62.9368101668463,1.48837051070245,7.65447691218401,1.57397691500525
2020-05-02,249,3,246,3,3,0,281,5,7389,308,7670,313,0,5,1,30,2,214,1,30,5,"Knox County",470313,5.31560896679445,0.0166398282340311,66.5514242642666,0.637873076015334,6.37873076015334,1.66398282340311
2020-05-01,246,9,243,8,3,1,276,7,7081,354,7357,361,0,5,4,29,5,212,0,29,5,"Knox County",470313,6.59135511882512,0.0173913043478261,76.7573934805119,1.913619228046,6.16610640148157,1.73913043478261
2020-04-30,237,4,235,4,2,0,269,3,6727,119,6996,122,0,5,-1,25,5,207,0,29,5,"Knox County",470313,6.8039794774969,0.0183387270765912,25.9401717579569,0.850497434687113,5.31560896679445,1.83387270765912
2020-04-29,233,8,231,8,2,0,266,10,6608,671,6874,681,0,5,5,26,3,202,0,29,5,"Knox County",470313,8.29234998819935,0.0183056619838229,144.797188255481,1.70099486937423,5.52823332546623,1.83056619838229
2020-04-28,225,8,223,8,2,0,256,10,5937,391,6193,401,1,5,4,21,3,199,0,29,5,"Knox County",470313,9.14284742288646,0.019672131147541,85.262367827383,1.70099486937423,4.46511153210734,1.9672131147541
2020-04-27,217,2,215,2,2,0,246,4,5546,161,5792,165,0,4,1,17,1,196,0,29,5,"Knox County",470313,8.7175987055429,0.0192389910218042,35.0830191808434,0.425248717343556,3.61461409742023,1.92389910218042
2020-04-26,215,1,213,1,2,0,242,1,5385,172,5627,173,0,4,-2,16,3,195,0,29,4,"Knox County",470313,7.44185255351224,0.0180505415162455,36.7840140502176,0.212624358671778,3.40198973874845,1.80505415162455
2020-04-25,214,0,212,0,2,0,241,0,5213,53,5454,53,0,4,-6,18,6,192,0,29,4,"Knox County",470313,6.8039794774969,0.0178936605316973,11.2690910096042,0,3.82723845609201,1.78936605316973
2020-04-24,214,8,212,8,2,0,241,10,5160,836,5401,846,0,4,5,24,3,186,1,29,4,"Knox County",470313,6.59135511882512,0.0155673904137649,179.880207436324,1.70099486937423,5.10298460812268,1.55673904137648
2020-04-23,206,1,204,1,2,0,231,2,4324,137,4555,139,0,4,0,19,1,183,0,28,4,"Knox County",470313,5.95348204280979,0.0150528885272579,29.5547858553772,0.212624358671778,4.03986281476378,1.50528885272579
2020-04-22,205,5,203,3,2,2,229,2,4187,189,4416,191,0,4,1,19,4,182,0,28,4,"Knox County",470313,5.31560896679445,0.0147357723577236,40.6112525063096,1.06312179335889,4.03986281476378,1.47357723577236
2020-04-21,200,4,200,4,0,0,227,5,3998,475,4225,480,0,4,-2,18,6,178,1,28,4,"Knox County",470313,4.46511153210734,0.0117244748412311,102.059692162454,0.850497434687113,3.82723845609201,1.17244748412311
2020-04-20,196,3,196,3,0,0,222,2,3523,175,3745,177,0,4,-1,20,4,172,1,27,4,"Knox County",470313,4.67773589077912,0.0106847984458475,37.6345114849047,0.637873076015334,4.25248717343556,1.06847984458475
2020-04-19,193,0,193,0,0,0,220,0,3348,72,3568,72,0,4,-4,21,4,168,0,26,4,"Knox County",470313,4.46511153210734,0.0107252298263534,15.308953824368,0,4.46511153210734,1.07252298263534
2020-04-18,193,0,193,0,0,0,220,1,3276,135,3496,136,0,4,-5,25,5,164,0,26,4,"Knox County",470313,4.46511153210734,0.0107790298873101,28.9169127793618,0,5.31560896679445,1.07790298873101
2020-04-17,193,2,193,2,0,0,219,3,3141,104,3360,107,0,4,-2,30,4,159,1,26,4,"Knox County",470313,3.18936538007667,0.0115207373271889,22.7508063778803,0.425248717343556,6.37873076015334,1.15207373271889
2020-04-16,191,7,191,7,0,0,216,9,3037,213,3253,222,0,4,2,32,5,155,2,25,4,"Knox County",470313,4.46511153210734,0.015884476534296,47.2026076251348,1.48837051070245,6.8039794774969,1.5884476534296
2020-04-15,184,9,184,9,0,0,207,10,2824,84,3031,94,0,4,3,30,6,150,1,23,4,"Knox County",470313,5.31560896679445,0.0232919254658385,19.9866897151471,1.913619228046,6.37873076015334,2.32919254658385
2020-04-14,175,4,175,4,0,0,197,4,2740,102,2937,106,0,4,1,27,3,144,1,22,4,"Knox County",470313,5.31560896679445,0.0317286652078775,22.5381820192085,0.850497434687113,5.74085768413801,3.17286652078775
2020-04-13,171,4,171,4,0,0,193,9,2638,242,2831,251,0,4,-2,26,6,141,1,21,4,"Knox County",470313,5.52823332546623,0.0364372469635627,53.3687140266163,0.850497434687113,5.52823332546623,3.64372469635628
2020-04-12,167,5,167,5,0,0,184,6,2396,166,2580,172,0,4,1,28,4,135,0,20,4,"Knox County",470313,6.59135511882512,0.0386029411764706,36.5713896915458,1.06312179335889,5.95348204280979,3.86029411764706
2020-04-11,162,5,162,5,0,0,178,8,2230,313,2408,321,1,4,-4,27,8,131,1,20,4,"Knox County",470313,7.65447691218401,0.0384917517674784,68.2524191336408,1.06312179335889,5.74085768413801,3.84917517674784
2020-04-10,157,4,157,4,0,0,170,5,1917,123,2087,128,0,3,0,31,4,123,0,19,4,"Knox County",470313,8.07972562952757,0.0394126738794436,27.2159179099876,0.850497434687113,6.59135511882512,3.94126738794436
2020-04-09,153,1,153,1,0,0,165,1,1794,81,1959,82,0,3,-2,31,3,119,0,19,4,"Knox County",470313,6.8039794774969,0.037261698440208,17.4351974110858,0.212624358671778,6.59135511882512,3.7261698440208
2020-04-08,152,8,152,8,0,0,164,12,1713,111,1877,123,0,3,-3,33,11,116,1,19,4,"Knox County",470313,6.59135511882512,0.0380388841927303,26.1527961166287,1.70099486937423,7.01660383616868,3.80388841927303
2020-04-07,144,20,144,20,0,0,152,25,1602,366,1754,391,0,3,11,36,9,105,2,18,3,"Knox County",470313,9.99334485757357,0.0449591280653951,83.1361242406653,4.25248717343556,7.65447691218401,4.49591280653951
2020-04-06,124,8,124,8,0,0,127,14,1236,54,1363,68,2,3,-2,25,8,96,1,16,3,"Knox County",470313,10.8438422922607,0.0552529182879377,14.4584563896809,1.70099486937423,5.31560896679445,5.52529182879377
2020-04-05,116,4,116,4,0,0,113,10,1182,75,1295,85,0,1,-2,27,6,88,0,15,3,"Knox County",470313,10.6312179335889,0.0626043405676127,18.0730704871011,0.850497434687113,5.74085768413801,6.26043405676127
2020-04-04,112,15,112,15,0,0,103,6,1107,127,1210,133,0,1,4,29,11,82,1,15,2,"Knox County",470313,12.7574615203067,0.0722772277227723,28.2790397033465,3.18936538007667,6.16610640148157,7.22772277227723
2020-04-03,97,4,97,4,0,0,97,3,980,51,1077,54,0,1,-8,25,12,71,1,14,1,"Knox County",470313,12.7574615203067,0.0758547008547008,11.481715368276,0.850497434687113,5.31560896679445,7.58547008547009
2020-04-02,93,7,93,7,0,0,94,7,929,106,1023,113,0,1,NA,33,8,59,0,13,1,"Knox County",470313,14.0332076723374,0.0796277145811789,24.0265525299109,1.48837051070245,7.01660383616868,7.96277145811789
2020-04-01,86,15,86,15,0,0,87,15,823,140,910,155,NA,NA,NA,NA,7,51,1,13,1,"Knox County",470313,15.5215781830398,0.0800800800800801,32.9567755941256,3.18936538007667,NA,8.00800800800801
2020-03-31,71,8,71,8,0,0,72,11,683,58,755,69,NA,NA,NA,NA,12,44,1,12,1,"Knox County",470313,12.9700858789785,0.0974889217134417,14.6710807483527,1.70099486937423,NA,9.74889217134417
2020-03-30,63,13,63,13,0,0,61,15,625,130,686,145,NA,NA,NA,NA,9,32,2,11,1,"Knox County",470313,14.0332076723374,0.0888594164456233,30.8305320074078,2.76411666273312,NA,8.88594164456233
2020-03-29,50,8,50,8,0,0,46,8,495,55,541,63,NA,NA,NA,NA,6,23,1,9,1,"Knox County",470313,14.8837051070245,0.0887978142076503,13.395334596322,1.70099486937423,NA,8.87978142076503
2020-03-28,42,7,42,7,0,0,38,6,440,62,478,68,NA,NA,NA,NA,1,17,1,8,0,"Knox County",470313,13.1827102376502,0.0974512743628186,14.4584563896809,1.48837051070245,NA,9.74512743628186
2020-03-27,35,2,35,2,0,0,32,2,378,54,410,56,NA,NA,NA,NA,5,16,1,7,0,"Knox County",470313,12.7574615203067,0.0956651718983558,11.9069640856196,0.425248717343556,NA,9.56651718983558
2020-03-26,33,7,33,7,0,0,30,7,324,82,354,89,NA,NA,NA,NA,3,11,2,6,0,"Knox County",470313,12.7574615203067,0.0992248062015504,18.9235679217883,1.48837051070245,NA,9.92248062015504
2020-03-25,26,6,26,6,0,0,23,7,242,68,265,75,NA,NA,NA,NA,3,8,1,4,0,"Knox County",470313,10.8438422922607,0.0991150442477876,15.9468269003834,1.27574615203067,NA,9.91150442477876
2020-03-24,20,7,20,7,0,0,16,7,174,43,190,50,NA,NA,NA,NA,2,5,0,3,0,"Knox County",470313,10.6312179335889,0.0952380952380952,10.6312179335889,1.48837051070245,NA,9.52380952380952
2020-03-23,13,4,13,4,0,0,9,4,131,22,140,26,NA,NA,NA,NA,3,3,2,3,0,"Knox County",470313,8.7175987055429,0.0960187353629977,5.52823332546623,0.850497434687113,NA,9.60187353629976
2020-03-22,9,2,9,2,0,0,5,0,109,9,114,9,NA,NA,NA,NA,0,0,1,1,0,"Knox County",470313,7.44185255351224,0.0884718498659517,1.913619228046,0.425248717343556,NA,8.84718498659517
2020-03-21,7,1,7,1,0,0,5,2,100,17,105,19,NA,NA,NA,NA,0,0,0,0,0,"Knox County",470313,6.16610640148157,0.0895061728395062,4.03986281476378,0.212624358671778,NA,8.95061728395062
2020-03-20,6,5,6,5,0,0,3,2,83,38,86,40,NA,NA,NA,NA,0,0,0,0,0,"Knox County",470313,6.8039794774969,0.0941558441558442,8.50497434687113,1.06312179335889,NA,9.41558441558442
2020-03-19,1,0,1,0,0,0,1,0,45,11,46,11,NA,NA,NA,NA,0,0,0,0,0,"Knox County",470313,5.31560896679445,0.0956521739130435,2.33886794538956,0,NA,9.56521739130435
2020-03-18,1,0,1,0,0,0,1,0,34,15,35,15,NA,NA,NA,NA,0,0,0,0,0,"Knox County",470313,4.03986281476378,0.0882352941176471,3.18936538007667,0,NA,8.82352941176471
2020-03-17,1,0,1,0,0,0,1,0,19,5,20,5,NA,NA,NA,NA,0,0,0,0,0,"Knox County",470313,2.55149230406134,0.064,1.06312179335889,0,NA,6.4
2020-03-16,1,1,1,1,0,0,1,1,14,3,15,4,NA,NA,NA,NA,0,0,0,0,0,"Knox County",470313,1.913619228046,0.0485436893203883,0.850497434687113,0.212624358671778,NA,4.85436893203883
2020-03-15,0,0,0,0,0,0,0,0,11,1,11,1,NA,NA,NA,NA,0,0,0,0,0,"Knox County",470313,1.48837051070245,0.0526315789473684,0.212624358671778,0,NA,5.26315789473684
2020-03-14,0,0,0,0,0,0,0,0,10,8,10,8,NA,NA,NA,NA,0,0,0,0,0,"Knox County",470313,1.27574615203067,0.0357142857142857,1.70099486937423,0,NA,3.57142857142857
2020-03-13,0,0,0,0,0,0,0,0,2,0,2,0,NA,NA,NA,NA,0,0,0,0,0,"Knox County",470313,0.212624358671778,0.0227272727272727,0,0,NA,2.27272727272727
2020-03-12,0,0,0,0,0,0,0,0,2,2,2,2,NA,NA,NA,NA,0,0,0,0,0,"Knox County",470313,0.212624358671778,0.0285714285714286,0.425248717343556,0,NA,2.85714285714286
2020-03-12,0,0,0,0,0,0,0,0,0,0,0,0,NA,NA,NA,NA,0,0,0,0,0,"Anderson",76978,NA,NA,0,0,NA,NA
2020-03-13,0,0,0,0,0,0,0,0,1,1,1,1,NA,NA,NA,NA,0,0,0,0,0,"Anderson",76978,NA,NA,1.29907246226194,0,NA,NA
2020-03-14,0,0,0,0,0,0,0,0,1,0,1,0,NA,NA,NA,NA,0,0,0,0,0,"Anderson",76978,NA,NA,0,0,NA,NA
2020-03-15,0,0,0,0,0,0,0,0,1,0,1,0,NA,NA,NA,NA,0,0,0,0,0,"Anderson",76978,NA,NA,0,0,NA,NA
2020-03-16,0,0,0,0,0,0,0,0,2,1,2,1,NA,NA,NA,NA,0,0,0,0,0,"Anderson",76978,NA,NA,1.29907246226194,0,NA,NA
2020-03-17,0,0,0,0,0,0,0,0,4,2,4,2,NA,NA,NA,NA,0,0,0,0,0,"Anderson",76978,NA,NA,2.59814492452389,0,NA,NA
2020-03-18,0,0,0,0,0,0,0,0,4,0,4,0,NA,NA,NA,NA,0,0,0,0,0,"Anderson",76978,0,0,0,0,NA,0
2020-03-19,1,1,1,1,0,0,2,2,5,1,7,3,NA,NA,NA,NA,0,0,0,0,0,"Anderson",76978,1.29907246226194,0.285714285714286,3.89721738678583,1.29907246226194,NA,28.5714285714286
2020-03-20,1,0,1,0,0,0,2,0,7,2,9,2,NA,NA,NA,NA,0,0,0,0,0,"Anderson",76978,1.29907246226194,0.25,2.59814492452389,0,NA,25
2020-03-21,1,0,1,0,0,0,2,0,7,0,9,0,NA,NA,NA,NA,0,0,0,0,0,"Anderson",76978,1.29907246226194,0.25,0,0,NA,25
2020-03-22,1,0,1,0,0,0,2,0,10,3,12,3,NA,NA,NA,NA,0,0,0,0,0,"Anderson",76978,1.29907246226194,0.181818181818182,3.89721738678583,0,NA,18.1818181818182
2020-03-23,1,0,1,0,0,0,2,0,15,5,17,5,NA,NA,NA,NA,0,0,0,0,0,"Anderson",76978,1.29907246226194,0.133333333333333,6.49536231130973,0,NA,13.3333333333333
2020-03-24,1,0,1,0,0,0,2,0,20,5,22,5,NA,NA,NA,NA,0,0,0,0,0,"Anderson",76978,1.29907246226194,0.111111111111111,6.49536231130973,0,NA,11.1111111111111
2020-03-25,2,1,2,1,0,0,4,2,29,9,33,11,NA,NA,NA,NA,1,1,0,0,0,"Anderson",76978,2.59814492452389,0.137931034482759,14.2897970848814,1.29907246226194,NA,13.7931034482759
2020-03-26,3,1,3,1,0,0,5,1,44,15,49,16,NA,NA,NA,NA,0,1,1,1,0,"Anderson",76978,2.59814492452389,0.0714285714285714,20.7851593961911,1.29907246226194,NA,7.14285714285714
2020-03-27,4,1,4,1,0,0,6,1,53,9,59,10,NA,NA,NA,NA,3,4,0,1,0,"Anderson",76978,3.89721738678583,0.08,12.9907246226195,1.29907246226194,NA,8
2020-03-28,7,3,7,3,0,0,9,3,72,19,81,22,NA,NA,NA,NA,0,4,1,2,0,"Anderson",76978,7.79443477357167,0.0972222222222222,28.5795941697628,3.89721738678583,NA,9.72222222222222
2020-03-29,7,0,7,0,0,0,9,0,83,11,92,11,NA,NA,NA,NA,0,4,0,2,0,"Anderson",76978,7.79443477357167,0.0875,14.2897970848814,0,NA,8.75
2020-03-30,8,1,8,1,0,0,10,1,127,44,137,45,NA,NA,NA,NA,1,5,0,2,0,"Anderson",76978,9.09350723583361,0.0666666666666667,58.4582608017875,1.29907246226194,NA,6.66666666666667
2020-03-31,9,1,9,1,0,0,11,1,142,15,153,16,NA,NA,NA,NA,1,6,0,2,0,"Anderson",76978,10.3925796980956,0.0687022900763359,20.7851593961911,1.29907246226194,NA,6.87022900763359
2020-04-01,9,0,9,0,0,0,11,0,163,21,174,21,NA,NA,NA,NA,0,6,0,2,0,"Anderson",76978,9.09350723583361,0.049645390070922,27.2805217075008,0,NA,4.9645390070922
2020-04-02,9,0,9,0,0,0,11,0,179,16,190,16,0,0,NA,3,0,6,0,2,0,"Anderson",76978,7.79443477357167,0.0425531914893617,20.7851593961911,0,3.89721738678583,4.25531914893617
2020-04-03,9,0,9,0,0,0,11,0,192,13,203,13,0,0,-2,1,2,8,0,2,0,"Anderson",76978,6.49536231130972,0.0347222222222222,16.8879420094053,0,1.29907246226194,3.47222222222222
2020-04-04,9,0,9,0,0,0,11,0,219,27,230,27,0,0,0,1,0,8,0,2,0,"Anderson",76978,2.59814492452389,0.0134228187919463,35.0749564810725,0,1.29907246226194,1.34228187919463
2020-04-05,9,0,9,0,0,0,11,0,248,29,259,29,0,0,0,1,0,8,0,2,0,"Anderson",76978,2.59814492452389,0.0119760479041916,37.6731014055964,0,1.29907246226194,1.19760479041916
2020-04-06,9,0,9,0,0,0,11,0,262,14,273,14,0,0,-1,0,1,9,0,2,0,"Anderson",76978,1.29907246226194,0.00735294117647059,18.1870144716672,0,0,0.735294117647059
2020-04-07,10,1,10,1,0,0,12,1,304,42,316,43,0,0,1,1,0,9,0,2,0,"Anderson",76978,1.29907246226194,0.00613496932515337,55.8601158772636,1.29907246226194,1.29907246226194,0.613496932515337
2020-04-08,10,0,10,0,0,0,12,0,322,18,334,18,1,1,-1,0,0,9,0,2,1,"Anderson",76978,1.29907246226194,0.00625,23.383304320715,0,0,0.625
2020-04-09,10,0,10,0,0,0,12,0,350,28,362,28,0,1,0,0,0,9,0,2,1,"Anderson",76978,1.29907246226194,0.00581395348837209,36.3740289433345,0,0,0.581395348837209
2020-04-10,10,0,10,0,0,0,12,0,366,16,378,16,0,1,0,0,0,9,0,2,1,"Anderson",76978,1.29907246226194,0.00571428571428571,20.7851593961911,0,0,0.571428571428571
2020-04-11,10,0,10,0,0,0,12,0,439,73,451,73,0,1,0,0,0,9,0,2,1,"Anderson",76978,1.29907246226194,0.00452488687782805,94.832289745122,0,0,0.452488687782805
2020-04-12,12,2,12,2,0,0,14,2,477,38,491,40,0,1,2,2,0,9,0,2,1,"Anderson",76978,3.89721738678583,0.0129310344827586,51.9628984904778,2.59814492452389,2.59814492452389,1.29310344827586
2020-04-13,13,1,13,1,0,0,15,1,514,37,529,38,0,1,0,2,1,10,0,2,1,"Anderson",76978,5.19628984904778,0.015625,49.3647535659539,1.29907246226194,2.59814492452389,1.5625
2020-04-14,13,0,13,0,0,0,15,0,526,12,541,12,0,1,0,2,0,10,0,2,1,"Anderson",76978,3.89721738678583,0.0133333333333333,15.5888695471433,0,2.59814492452389,1.33333333333333
2020-04-15,13,0,13,0,0,0,15,0,544,18,559,18,0,1,-2,0,2,12,0,2,1,"Anderson",76978,3.89721738678583,0.0133333333333333,23.383304320715,0,0,1.33333333333333
2020-04-16,13,0,13,0,0,0,15,0,566,22,581,22,0,1,0,0,0,12,0,2,1,"Anderson",76978,3.89721738678583,0.0136986301369863,28.5795941697628,0,0,1.36986301369863
2020-04-17,13,0,13,0,0,0,15,0,586,20,601,20,0,1,0,0,0,12,0,2,1,"Anderson",76978,3.89721738678583,0.0134529147982063,25.9814492452389,0,0,1.34529147982063
2020-04-18,13,0,13,0,0,0,15,0,616,30,631,30,0,1,0,0,0,12,0,2,1,"Anderson",76978,3.89721738678583,0.0166666666666667,38.9721738678584,0,0,1.66666666666667
2020-04-19,14,1,14,1,0,0,16,1,628,12,644,13,0,1,0,0,1,13,0,2,1,"Anderson",76978,2.59814492452389,0.0130718954248366,16.8879420094053,1.29907246226194,0,1.30718954248366
2020-04-20,19,5,18,4,1,1,19,3,648,20,667,23,0,1,5,5,0,13,0,2,1,"Anderson",76978,7.79443477357167,0.0289855072463768,29.8786666320247,6.49536231130973,6.49536231130973,2.89855072463768
2020-04-21,20,1,19,1,1,0,22,3,1071,423,1093,426,0,1,1,6,0,13,0,2,1,"Anderson",76978,9.09350723583361,0.0126811594202899,553.404868923589,1.29907246226194,7.79443477357167,1.26811594202899
2020-04-22,21,1,20,1,1,0,24,2,1141,70,1165,72,0,1,0,6,1,14,0,2,1,"Anderson",76978,10.3925796980956,0.0148514851485149,93.53321728286,1.29907246226194,7.79443477357167,1.48514851485149
2020-04-23,21,0,20,0,1,0,24,0,1191,50,1215,50,0,1,-1,5,1,15,0,2,1,"Anderson",76978,10.3925796980956,0.0141955835962145,64.9536231130973,0,6.49536231130973,1.41955835962145
2020-04-24,22,1,21,1,1,0,25,1,1299,108,1324,109,0,1,1,6,0,15,0,2,1,"Anderson",76978,11.6916521603575,0.0138312586445367,141.598898386552,1.29907246226194,7.79443477357167,1.38312586445367
2020-04-25,22,0,21,0,1,0,25,0,1336,37,1361,37,0,1,0,6,0,15,0,2,1,"Anderson",76978,11.6916521603575,0.0136986301369863,48.065681103692,0,7.79443477357167,1.36986301369863
2020-04-26,22,0,21,0,1,0,25,0,1372,36,1397,36,0,1,0,6,0,15,0,2,1,"Anderson",76978,10.3925796980956,0.0119521912350598,46.76660864143,0,7.79443477357167,1.19521912350598
2020-04-27,22,0,21,0,1,0,25,0,1411,39,1436,39,0,1,-1,5,1,16,0,2,1,"Anderson",76978,3.89721738678583,0.00780234070221066,50.6638260282159,0,6.49536231130973,0.780234070221066
2020-04-28,22,0,21,0,1,0,25,0,1690,279,1715,279,0,1,0,5,0,16,0,2,1,"Anderson",76978,2.59814492452389,0.00482315112540193,362.441216971083,0,6.49536231130973,0.482315112540193
2020-04-29,26,4,25,4,1,0,28,3,2070,380,2098,383,0,1,4,9,0,16,0,2,1,"Anderson",76978,6.49536231130972,0.00428724544480171,497.544753046325,5.19628984904778,11.6916521603575,0.428724544480171
2020-04-30,26,0,25,0,1,0,29,1,2102,32,2131,33,0,1,-1,8,1,17,0,2,1,"Anderson",76978,6.49536231130972,0.00545851528384279,42.8693912546442,0,10.3925796980956,0.545851528384279
2020-05-01,26,0,25,0,1,0,29,0,2154,52,2183,52,0,1,-2,6,2,19,0,2,1,"Anderson",76978,5.19628984904778,0.00465657741559953,67.5517680376211,0,7.79443477357167,0.465657741559953
2020-05-02,26,0,25,0,1,0,29,0,2221,67,2250,67,0,1,0,6,0,19,0,2,1,"Anderson",76978,5.19628984904778,0.00449943757030371,87.0378549715503,0,7.79443477357167,0.449943757030371
2020-05-03,27,1,26,1,1,0,30,1,2314,93,2344,94,0,1,1,7,0,19,0,2,1,"Anderson",76978,6.49536231130972,0.00527983104540655,122.112811452623,1.29907246226194,9.09350723583361,0.527983104540655
2020-05-04,27,0,26,0,1,0,30,0,2406,92,2436,92,0,1,-1,6,1,20,0,2,1,"Anderson",76978,6.49536231130972,0.005,119.514666528099,0,7.79443477357167,0.5
2020-05-05,28,1,27,1,1,0,30,0,2475,69,2505,69,0,1,-1,5,2,22,0,2,1,"Anderson",76978,7.79443477357167,0.00632911392405063,89.6359998960742,1.29907246226194,6.49536231130973,0.632911392405063
2020-05-06,30,2,29,2,1,0,31,1,2525,50,2556,51,0,1,2,7,0,22,0,2,1,"Anderson",76978,5.19628984904778,0.00655021834061135,66.2526955753592,2.59814492452389,9.09350723583361,0.655021834061135
2020-05-07,30,0,29,0,1,0,33,2,2597,72,2630,74,0,1,-1,6,1,23,0,2,1,"Anderson",76978,5.19628984904778,0.00801603206412826,96.1313622073839,0,7.79443477357167,0.801603206412826
2020-05-08,30,0,29,0,1,0,33,0,2652,55,2685,55,0,1,0,6,0,23,0,2,1,"Anderson",76978,5.19628984904778,0.00796812749003984,71.448985424407,0,7.79443477357167,0.796812749003984
2020-05-09,30,0,29,0,1,0,33,0,2734,82,2767,82,0,1,0,6,0,23,0,2,1,"Anderson",76978,5.19628984904778,0.00773694390715667,106.523941905479,0,7.79443477357167,0.773694390715667
2020-05-10,30,0,29,0,1,0,33,0,2827,93,2860,93,0,1,-3,3,3,26,0,2,1,"Anderson",76978,3.89721738678583,0.00581395348837209,120.813738990361,0,3.89721738678583,0.581395348837209
2020-05-11,32,2,31,2,1,0,33,0,2909,82,2942,82,0,1,2,5,0,26,0,2,1,"Anderson",76978,6.49536231130972,0.00592885375494071,106.523941905479,2.59814492452389,6.49536231130973,0.592885375494071
2020-05-12,33,1,32,1,1,0,35,2,3042,133,3077,135,0,1,1,6,0,26,0,2,1,"Anderson",76978,6.49536231130972,0.00874125874125874,175.374782405363,1.29907246226194,7.79443477357167,0.874125874125874
2020-05-13,35,2,34,2,1,0,38,3,3220,178,3258,181,0,1,1,7,1,27,1,3,1,"Anderson",76978,6.49536231130972,0.00997150997150997,235.132115669412,2.59814492452389,9.09350723583361,0.997150997150997
2020-05-14,35,0,34,0,1,0,39,1,3346,126,3385,127,0,1,-1,6,1,28,0,3,1,"Anderson",76978,6.49536231130972,0.00794701986754967,164.982202707267,0,7.79443477357167,0.794701986754967
2020-05-15,36,1,35,1,1,0,39,0,3417,71,3456,71,0,1,1,7,0,28,0,3,1,"Anderson",76978,7.79443477357167,0.00778210116731518,92.2341448205981,1.29907246226194,9.09350723583361,0.778210116731518
2020-05-16,36,0,35,0,1,0,41,2,3657,240,3698,242,0,1,-1,6,1,29,0,3,1,"Anderson",76978,7.79443477357167,0.00859291084854995,314.375535867391,0,7.79443477357167,0.859291084854995
2020-05-17,36,0,35,0,1,0,41,0,3727,70,3768,70,0,1,0,6,0,29,0,3,1,"Anderson",76978,7.79443477357167,0.00881057268722467,90.9350723583361,0,7.79443477357167,0.881057268722467
2020-05-18,37,1,36,1,1,0,42,1,3804,77,3846,78,0,1,-2,4,3,32,0,3,1,"Anderson",76978,6.49536231130972,0.00995575221238938,101.327652056432,1.29907246226194,5.19628984904778,0.995575221238938
2020-05-19,37,0,36,0,1,0,42,0,3856,52,3898,52,0,1,0,4,0,32,0,3,1,"Anderson",76978,5.19628984904778,0.00852618757612668,67.5517680376211,0,5.19628984904778,0.852618757612667
2020-05-20,37,0,36,0,1,0,43,1,3921,65,3964,66,0,1,0,4,0,32,0,3,1,"Anderson",76978,2.59814492452389,0.00708215297450425,85.7387825092884,0,5.19628984904778,0.708215297450425
2020-05-21,37,0,36,0,1,0,44,1,4001,80,4045,81,0,1,-1,3,1,33,0,3,1,"Anderson",76978,2.59814492452389,0.00757575757575758,105.224869443218,0,3.89721738678583,0.757575757575758
2020-05-22,38,1,37,1,1,0,45,1,4029,28,4074,29,0,1,-1,2,2,35,1,4,1,"Anderson",76978,2.59814492452389,0.00970873786407767,37.6731014055964,1.29907246226194,2.59814492452389,0.970873786407767
2020-05-23,38,0,37,0,1,0,46,1,4192,163,4238,164,0,1,0,2,0,35,0,4,1,"Anderson",76978,2.59814492452389,0.00925925925925926,213.047883810959,0,2.59814492452389,0.925925925925926
2020-05-24,38,0,37,0,1,0,46,0,4247,55,4293,55,0,1,0,2,0,35,0,4,1,"Anderson",76978,2.59814492452389,0.00952380952380952,71.448985424407,0,2.59814492452389,0.952380952380952
2020-05-25,38,0,37,0,1,0,47,1,4281,34,4328,35,0,1,0,2,0,35,0,4,1,"Anderson",76978,1.29907246226194,0.0103734439834025,45.4675361791681,0,2.59814492452389,1.03734439834025
2020-05-26,38,0,37,0,1,0,47,0,4412,131,4459,131,0,1,-1,1,1,36,0,4,1,"Anderson",76978,1.29907246226194,0.0089126559714795,170.178492556315,0,1.29907246226194,0.89126559714795
2020-05-27,38,0,37,0,1,0,47,0,4515,103,4562,103,0,1,0,1,0,36,0,4,1,"Anderson",76978,1.29907246226194,0.00668896321070234,133.80446361298,0,1.29907246226194,0.668896321070234
2020-05-28,38,0,37,0,1,0,47,0,4563,48,4610,48,0,1,0,1,0,36,0,4,1,"Anderson",76978,1.29907246226194,0.00530973451327434,62.3554781885734,0,1.29907246226194,0.530973451327434
2020-05-29,39,1,38,1,1,0,47,0,4613,50,4660,50,0,1,0,1,1,37,0,4,1,"Anderson",76978,1.29907246226194,0.00341296928327645,64.9536231130973,1.29907246226194,1.29907246226194,0.341296928327645
2020-05-30,39,0,38,0,1,0,48,1,4665,52,4713,53,0,1,0,1,0,37,0,4,1,"Anderson",76978,1.29907246226194,0.00421052631578947,68.8508404998831,0,1.29907246226194,0.421052631578947
2020-05-31,40,1,39,1,1,0,49,1,4731,66,4780,67,0,1,1,2,0,37,0,4,1,"Anderson",76978,2.59814492452389,0.00616016427104723,87.0378549715503,1.29907246226194,2.59814492452389,0.616016427104723
2020-06-01,40,0,39,0,1,0,49,0,4855,124,4904,124,0,1,0,2,0,37,0,4,1,"Anderson",76978,2.59814492452389,0.00347222222222222,161.084985320481,0,2.59814492452389,0.347222222222222
2020-06-02,40,0,39,0,1,0,49,0,4982,127,5031,127,0,1,0,2,0,37,0,4,1,"Anderson",76978,2.59814492452389,0.0034965034965035,164.982202707267,0,2.59814492452389,0.34965034965035
2020-06-03,41,1,40,1,1,0,50,1,5042,60,5092,61,0,1,1,3,0,37,0,4,2,"Anderson",76978,3.89721738678583,0.00566037735849057,79.2434201979787,1.29907246226194,3.89721738678583,0.566037735849057
2020-06-04,41,0,40,0,1,0,50,0,5090,48,5140,48,1,2,-2,1,1,38,0,4,2,"Anderson",76978,3.89721738678583,0.00566037735849057,62.3554781885734,0,1.29907246226194,0.566037735849057
2020-06-05,42,1,41,1,1,0,53,3,5147,57,5200,60,0,2,1,2,0,38,0,4,2,"Anderson",76978,3.89721738678583,0.0111111111111111,77.9443477357167,1.29907246226194,2.59814492452389,1.11111111111111
2020-06-06,43,1,42,1,1,0,54,1,5200,53,5254,54,0,2,1,3,0,38,0,4,2,"Anderson",76978,5.19628984904778,0.011090573012939,70.149912962145,1.29907246226194,3.89721738678583,1.1090573012939
2020-06-07,45,2,43,1,2,1,57,3,5295,95,5352,98,0,2,2,5,0,38,0,4,2,"Anderson",76978,6.49536231130972,0.013986013986014,127.309101301671,2.59814492452389,6.49536231130973,1.3986013986014
2020-06-08,46,1,44,1,2,0,57,0,5336,41,5393,41,0,2,1,6,0,38,0,4,2,"Anderson",76978,7.79443477357167,0.016359918200409,53.2619709527397,1.29907246226194,7.79443477357167,1.6359918200409
2020-06-09,47,1,45,1,2,0,60,3,5517,181,5577,184,0,2,1,7,0,38,0,4,2,"Anderson",76978,9.09350723583361,0.0201465201465201,239.029333056198,1.29907246226194,9.09350723583361,2.01465201465201
2020-06-10,52,5,50,5,2,0,63,3,5725,208,5788,211,0,2,2,9,3,41,0,4,2,"Anderson",76978,14.2897970848814,0.0186781609195402,274.10428953727,6.49536231130973,11.6916521603575,1.86781609195402
2020-06-11,55,3,53,3,2,0,66,3,5870,145,5936,148,0,2,2,11,1,42,1,5,2,"Anderson",76978,18.1870144716672,0.0201005025125628,192.262724414768,3.89721738678583,14.2897970848814,2.01005025125628
2020-06-12,57,2,55,2,2,0,70,4,5952,82,6022,86,0,2,2,13,0,42,0,5,2,"Anderson",76978,19.4860869339292,0.0206812652068127,111.720231754527,2.59814492452389,16.8879420094053,2.06812652068127
2020-06-13,58,1,55,0,3,1,70,0,5995,43,6065,43,0,2,0,13,1,43,0,5,2,"Anderson",76978,19.4860869339292,0.0197287299630086,55.8601158772636,1.29907246226194,16.8879420094053,1.97287299630086
2020-06-14,60,2,57,2,3,0,70,0,6170,175,6240,175,0,2,1,14,1,44,1,6,2,"Anderson",76978,19.4860869339292,0.0146396396396396,227.33768089584,2.59814492452389,18.1870144716672,1.46396396396396
2020-06-15,60,0,57,0,3,0,71,1,6228,58,6299,59,0,2,0,14,0,44,0,6,2,"Anderson",76978,18.1870144716672,0.0154525386313466,76.6452752734548,0,18.1870144716672,1.54525386313466
2020-06-16,64,4,61,4,3,0,75,4,6289,61,6364,65,0,2,3,17,1,45,0,6,2,"Anderson",76978,22.0842318584531,0.0190597204574333,84.4397100470264,5.19628984904778,22.0842318584531,1.90597204574333
2020-06-17,66,2,63,2,3,0,79,4,6326,37,6405,41,0,2,0,17,2,47,0,6,2,"Anderson",76978,18.1870144716672,0.0259319286871961,53.2619709527397,2.59814492452389,22.0842318584531,2.59319286871961
2020-06-18,70,4,67,4,3,0,84,5,6456,130,6540,135,0,2,2,19,2,49,0,6,2,"Anderson",76978,19.4860869339292,0.0298013245033113,175.374782405363,5.19628984904778,24.682376782977,2.98013245033113
2020-06-19,72,2,69,2,3,0,86,2,6521,65,6607,67,0,2,0,19,2,51,0,6,2,"Anderson",76978,19.4860869339292,0.0273504273504274,87.0378549715503,2.59814492452389,24.682376782977,2.73504273504274
2020-06-20,73,1,70,1,3,0,87,1,6559,38,6646,39,0,2,-1,18,2,53,0,6,2,"Anderson",76978,19.4860869339292,0.0292598967297762,50.6638260282159,1.29907246226194,23.383304320715,2.92598967297762
2020-06-21,74,1,71,1,3,0,88,1,6619,60,6707,61,0,2,-1,17,2,55,0,6,2,"Anderson",76978,18.1870144716672,0.0385438972162741,79.2434201979787,1.29907246226194,22.0842318584531,3.85438972162741
2020-06-22,76,2,73,2,3,0,90,2,6711,92,6801,94,0,2,0,17,2,57,1,7,2,"Anderson",76978,20.7851593961911,0.0378486055776892,122.112811452623,2.59814492452389,22.0842318584531,3.78486055776892
2020-06-23,76,0,73,0,3,0,90,0,6800,89,6890,89,0,2,-1,16,1,58,0,7,2,"Anderson",76978,15.5888695471433,0.0285171102661597,115.617449141313,0,20.7851593961911,2.85171102661597
2020-06-24,77,1,74,1,3,0,91,1,6831,31,6922,32,0,2,-2,14,3,61,0,7,2,"Anderson",76978,14.2897970848814,0.02321083172147,41.5703187923822,1.29907246226194,18.1870144716672,2.321083172147
2020-06-25,81,4,78,4,3,0,92,1,6944,113,7036,114,0,2,0,14,4,65,0,7,2,"Anderson",76978,14.2897970848814,0.0161290322580645,148.094260697862,5.19628984904778,18.1870144716672,1.61290322580645
2020-06-26,86,5,83,5,3,0,98,6,6972,28,7070,34,0,2,3,17,2,67,0,7,2,"Anderson",76978,18.1870144716672,0.0259179265658747,44.1684637169061,6.49536231130973,22.0842318584531,2.59179265658747
2020-06-27,87,1,83,0,4,1,98,0,6984,12,7082,12,0,2,-4,13,5,72,0,7,2,"Anderson",76978,18.1870144716672,0.0252293577981651,15.5888695471433,1.29907246226194,16.8879420094053,2.52293577981651
2020-06-28,91,4,87,4,4,0,106,8,7093,109,7199,117,0,2,3,16,1,73,0,7,2,"Anderson",76978,22.0842318584531,0.0365853658536585,151.991478084648,5.19628984904778,20.7851593961911,3.65853658536585
2020-06-29,97,6,92,5,5,1,114,8,7315,222,7429,230,0,2,3,19,3,76,1,8,2,"Anderson",76978,27.2805217075008,0.0382165605095541,298.786666320247,7.79443477357167,24.682376782977,3.82165605095541
2020-06-30,102,5,96,4,6,1,120,6,7479,164,7599,170,0,2,2,21,3,79,0,8,2,"Anderson",76978,33.7758840188106,0.0423131170662905,220.842318584531,6.49536231130973,27.2805217075008,4.23131170662905
2020-07-01,104,2,98,2,6,0,124,4,7600,121,7724,125,0,2,-2,19,4,83,0,8,2,"Anderson",76978,35.0749564810725,0.0411471321695761,162.384057782743,2.59814492452389,24.682376782977,4.11471321695761
2020-07-02,110,6,104,6,6,0,130,6,7839,239,7969,245,0,2,4,23,2,85,0,8,2,"Anderson",76978,37.6731014055964,0.0407288317256163,318.272753254177,7.79443477357167,29.8786666320247,4.07288317256163
2020-07-03,120,10,113,9,7,1,142,12,7964,125,8106,137,0,2,7,30,3,88,0,8,2,"Anderson",76978,44.1684637169061,0.0424710424710425,177.972927329886,12.9907246226195,38.9721738678584,4.24710424710425
2020-07-04,131,11,124,11,7,0,156,14,8148,184,8304,198,0,2,8,38,3,91,2,10,2,"Anderson",76978,57.1591883395256,0.0474631751227496,257.216347527865,14.2897970848814,49.3647535659539,4.74631751227496
2020-07-05,140,9,133,9,7,0,169,13,8304,156,8473,169,0,2,8,46,1,92,1,11,2,"Anderson",76978,63.6545506508353,0.0494505494505494,219.543246122269,11.6916521603575,59.7573332640495,4.94505494505495
2020-07-06,141,1,134,1,7,0,170,1,8331,27,8501,28,0,2,-4,42,5,97,0,11,2,"Anderson",76978,57.1591883395256,0.0522388059701493,36.3740289433345,1.29907246226194,54.5610434150017,5.22388059701492
2020-07-07,157,16,150,16,7,0,190,20,8564,233,8754,253,0,2,12,54,4,101,0,11,2,"Anderson",76978,71.448985424407,0.0606060606060606,328.665332952272,20.7851593961911,70.149912962145,6.06060606060606
2020-07-08,173,16,165,15,8,1,206,16,8704,140,8910,156,0,2,10,64,6,107,0,11,2,"Anderson",76978,89.6359998960742,0.0691399662731872,202.655304112863,20.7851593961911,83.1406375847645,6.91399662731872
2020-07-09,187,14,179,14,8,0,220,14,8972,268,9192,282,0,2,11,75,3,110,0,11,2,"Anderson",76978,100.02857959417,0.0735895339329518,366.338434357868,18.1870144716672,97.4304346696459,7.35895339329518
2020-07-10,193,6,185,6,8,0,227,7,9002,30,9229,37,0,2,1,76,5,115,1,12,2,"Anderson",76978,94.832289745122,0.0756901157613535,48.065681103692,7.79443477357167,98.7295071319078,7.56901157613535
2020-07-11,201,8,193,8,8,0,235,8,9171,169,9406,177,0,2,1,77,7,122,1,13,2,"Anderson",76978,90.9350723583361,0.0716878402903811,229.935825820364,10.3925796980956,100.02857959417,7.16878402903811
2020-07-12,212,11,204,11,8,0,248,13,9354,183,9602,196,0,2,6,83,5,127,0,13,2,"Anderson",76978,93.53321728286,0.0699734278122232,254.618202603341,14.2897970848814,107.823014367741,6.99734278122232
2020-07-13,218,6,209,5,9,1,255,7,9393,39,9648,46,0,2,-6,77,12,139,2,15,2,"Anderson",76978,100.02857959417,0.0741063644289451,59.7573332640495,7.79443477357167,100.02857959417,7.41063644289451
2020-07-14,229,11,219,10,10,1,266,11,9533,140,9799,151,0,2,0,77,11,150,0,15,2,"Anderson",76978,93.53321728286,0.0727272727272727,196.159941801554,14.2897970848814,100.02857959417,7.27272727272727
2020-07-15,245,16,234,15,11,1,285,19,9635,102,9920,121,0,2,0,77,16,166,0,15,2,"Anderson",76978,93.53321728286,0.0782178217821782,157.187767933695,20.7851593961911,100.02857959417,7.82178217821782
2020-07-16,263,18,252,18,11,0,308,23,9924,289,10232,312,0,2,4,81,14,180,1,16,2,"Anderson",76978,98.7295071319078,0.0846153846153846,405.310608225727,23.383304320715,105.224869443218,8.46153846153846
2020-07-17,270,7,259,7,11,0,317,9,9995,71,10312,80,0,2,-8,73,15,195,1,17,3,"Anderson",76978,100.02857959417,0.0831024930747922,103.925796980956,9.09350723583361,94.832289745122,8.31024930747922
2020-07-18,277,7,266,7,11,0,328,11,10209,214,10537,225,0,2,-4,69,11,206,0,17,3,"Anderson",76978,98.7295071319078,0.0822281167108753,292.291304008938,9.09350723583361,89.6359998960742,8.22281167108753
2020-07-19,285,8,274,8,11,0,337,9,10290,81,10627,90,0,2,-5,64,13,219,2,19,3,"Anderson",76978,94.832289745122,0.0868292682926829,116.916521603575,10.3925796980956,83.1406375847645,8.68292682926829
2020-07-20,313,28,302,28,11,0,367,30,10459,169,10826,199,1,3,9,73,18,237,0,19,3,"Anderson",76978,123.411883914885,0.0950764006791171,258.515419990127,36.3740289433345,94.832289745122,9.50764006791171
2020-07-21,336,23,324,22,12,1,391,24,10751,292,11142,316,0,3,12,85,11,248,1,20,3,"Anderson",76978,139.000753462028,0.0930752047654505,410.506898074775,29.8786666320247,110.421159292265,9.30752047654505
2020-07-22,365,29,353,29,12,0,424,33,10886,135,11310,168,0,3,13,98,16,264,0,20,3,"Anderson",76978,155.888695471433,0.1,218.244173660007,37.6731014055964,127.309101301671,10
2020-07-23,388,23,376,23,12,0,455,31,11313,427,11768,458,0,3,9,107,14,278,2,22,3,"Anderson",76978,162.384057782743,0.095703125,594.975187715971,29.8786666320247,139.000753462028,9.5703125
2020-07-24,394,6,382,6,12,0,463,8,11425,112,11888,120,0,3,-16,91,22,300,0,22,4,"Anderson",76978,161.084985320481,0.0926395939086294,155.888695471433,7.79443477357167,118.215594065837,9.26395939086294
2020-07-25,426,32,413,31,13,1,499,36,11682,257,12181,293,1,4,26,117,5,305,1,23,4,"Anderson",76978,193.56179687703,0.104014598540146,380.62823144275,41.5703187923822,151.991478084648,10.4014598540146
2020-07-26,465,39,451,38,14,1,541,42,12085,403,12626,445,0,4,31,148,8,313,2,25,4,"Anderson",76978,233.83304320715,0.102051025512756,578.087245706565,50.6638260282159,192.262724414768,10.2051025512756
2020-07-27,483,18,468,17,15,1,562,21,12265,180,12827,201,0,4,-19,129,37,350,1,26,4,"Anderson",76978,220.842318584531,0.0974512743628186,261.113564914651,23.383304320715,167.580347631791,9.74512743628186
2020-07-28,523,40,508,40,15,0,608,46,12645,380,13253,426,0,4,24,153,16,366,1,27,5,"Anderson",76978,242.926550442984,0.10279488394126,553.404868923589,51.9628984904778,198.758086726078,10.279488394126
2020-07-29,527,4,512,4,15,0,612,4,12681,36,13293,40,1,5,-15,138,18,384,0,27,5,"Anderson",76978,210.449738886435,0.0948058497226425,51.9628984904778,5.19628984904778,179.271999792148,9.48058497226425
2020-07-30,564,37,549,37,15,0,665,53,13166,485,13831,538,0,5,20,158,17,401,0,27,5,"Anderson",76978,228.636753358102,0.101793504604944,698.900984696926,48.065681103692,205.253449037387,10.1793504604944
2020-07-31,576,12,561,12,15,0,679,14,13348,182,14027,196,0,5,-8,150,20,421,0,27,5,"Anderson",76978,236.431188131674,0.100981767180926,254.618202603341,15.5888695471433,194.860869339292,10.0981767180926
2020-08-01,599,23,584,23,15,0,704,25,13757,409,14461,434,0,5,17,167,6,427,1,28,5,"Anderson",76978,224.739535971316,0.0899122807017544,563.797448621684,29.8786666320247,216.945101197745,8.99122807017544
2020-08-02,606,7,591,7,15,0,711,7,13885,128,14596,135,0,5,2,169,5,432,1,29,6,"Anderson",76978,183.169217178934,0.0862944162436548,175.374782405363,9.09350723583361,219.543246122269,8.62944162436548
2020-08-03,631,25,615,24,16,1,742,31,14112,227,14854,258,0,5,14,183,11,443,0,29,6,"Anderson",76978,192.262724414768,0.0888011840157869,335.160695263582,32.4768115565486,237.730260593936,8.88011840157869
2020-08-04,638,7,622,7,16,0,750,8,14355,243,15105,251,2,7,-19,164,24,467,0,29,6,"Anderson",76978,149.393333160124,0.0766738660907127,326.067188027748,9.09350723583361,213.047883810959,7.66738660907127
2020-08-05,653,15,637,15,16,0,769,19,14564,209,15333,228,-1,6,-1,163,17,484,0,29,6,"Anderson",76978,163.683130245005,0.0769607843137255,296.188521395723,19.4860869339292,211.748811348697,7.69607843137255
2020-08-06,675,22,659,22,16,0,799,30,14885,321,15684,351,0,6,3,166,19,503,1,30,6,"Anderson",76978,144.197043311076,0.0723151645979493,455.974434253943,28.5795941697628,215.646028735483,7.23151645979493
2020-08-07,679,4,663,4,16,0,803,4,14966,81,15769,85,0,6,-21,145,25,528,0,30,6,"Anderson",76978,133.80446361298,0.0711825487944891,110.421159292265,5.19628984904778,188.365507027982,7.11825487944891
2020-08-08,690,11,674,11,16,0,819,16,15286,320,16105,336,0,6,1,146,10,538,0,30,6,"Anderson",76978,118.215594065837,0.0699513381995134,436.488347320014,14.2897970848814,189.664579490244,6.99513381995134
2020-08-09,697,7,681,7,16,0,828,9,15423,137,16251,146,0,6,-9,137,16,554,0,30,6,"Anderson",76978,118.215594065837,0.0706948640483384,189.664579490244,9.09350723583361,177.972927329886,7.06948640483384
2020-08-10,702,5,686,5,16,0,834,6,15562,139,16396,145,0,6,-11,126,16,570,0,30,6,"Anderson",76978,92.2341448205981,0.059662775616083,188.365507027982,6.49536231130973,163.683130245005,5.9662775616083
2020-08-11,723,21,707,21,16,0,856,22,15765,203,16621,225,0,6,9,135,12,582,1,31,6,"Anderson",76978,110.421159292265,0.0699208443271768,292.291304008938,27.2805217075008,175.374782405363,6.99208443271768
2020-08-12,731,8,715,8,16,0,864,8,16004,239,16868,247,0,6,-8,127,16,598,0,31,6,"Anderson",76978,101.327652056432,0.0618892508143322,320.8708981787,10.3925796980956,164.982202707267,6.18892508143322
2020-08-13,749,18,733,18,16,0,888,24,16232,228,17120,252,1,7,3,130,14,612,2,33,6,"Anderson",76978,96.1313622073839,0.0619777158774373,327.36626049001,23.383304320715,168.879420094053,6.19777158774373
2020-08-14,766,17,749,16,17,1,910,22,16561,329,17471,351,0,7,-9,121,26,638,0,33,6,"Anderson",76978,113.019304216789,0.0628672150411281,455.974434253943,22.0842318584531,157.187767933695,6.28672150411281
2020-08-15,776,10,759,10,17,0,922,12,16784,223,17706,235,-1,6,5,126,6,644,0,33,6,"Anderson",76978,111.720231754527,0.0643347907557776,305.282028631557,12.9907246226195,163.683130245005,6.43347907557776
2020-08-16,788,12,771,12,17,0,936,14,16926,142,17862,156,0,6,7,133,5,649,0,33,7,"Anderson",76978,118.215594065837,0.0670391061452514,202.655304112863,15.5888695471433,172.776637480839,6.70391061452514
2020-08-17,792,4,775,4,17,0,939,3,16969,43,17908,46,0,6,-13,120,17,666,0,33,7,"Anderson",76978,116.916521603575,0.0694444444444444,59.7573332640495,5.19628984904778,155.888695471433,6.94444444444444
2020-08-18,806,14,789,14,17,0,956,17,17133,164,18089,181,0,6,5,125,9,675,0,33,7,"Anderson",76978,107.823014367741,0.0681198910081744,235.132115669412,18.1870144716672,162.384057782743,6.81198910081744
2020-08-19,820,14,803,14,17,0,970,14,17307,174,18277,188,0,6,0,125,14,689,0,33,7,"Anderson",76978,115.617449141313,0.0752306600425834,244.225622905246,18.1870144716672,162.384057782743,7.52306600425834
2020-08-20,835,15,818,15,17,0,986,16,17749,442,18735,458,0,6,5,130,10,699,0,33,8,"Anderson",76978,111.720231754527,0.0606811145510836,594.975187715971,19.4860869339292,168.879420094053,6.06811145510836
2020-08-21,838,3,821,3,17,0,989,3,17785,36,18774,39,1,7,-7,123,9,708,0,33,8,"Anderson",76978,93.53321728286,0.0606293169608596,50.6638260282159,3.89721738678583,159.785912858219,6.06293169608596
2020-08-22,856,18,839,18,17,0,1008,19,18329,544,19337,563,1,8,10,133,7,715,1,34,8,"Anderson",76978,103.925796980956,0.052728387492336,731.377796253475,23.383304320715,172.776637480839,5.2728387492336
2020-08-23,857,1,840,1,17,0,1009,1,18413,84,19422,85,0,8,-5,128,6,721,0,34,8,"Anderson",76978,89.6359998960742,0.0467948717948718,110.421159292265,1.29907246226194,166.281275169529,4.67948717948718
2020-08-24,858,1,840,0,18,1,1009,0,18452,39,19461,39,0,8,-19,109,20,741,0,34,8,"Anderson",76978,85.7387825092884,0.0450740502253702,50.6638260282159,1.29907246226194,141.598898386552,4.50740502253703
2020-08-25,866,8,848,8,18,0,1017,8,18604,152,19621,160,0,8,-2,107,10,751,1,35,8,"Anderson",76978,77.9443477357167,0.0398172323759791,207.851593961911,10.3925796980956,139.000753462028,3.98172323759791
2020-08-26,872,6,854,6,18,0,1023,6,18784,180,19807,186,0,8,-14,93,20,771,0,35,8,"Anderson",76978,67.5517680376211,0.034640522875817,241.627477980722,7.79443477357167,120.813738990361,3.4640522875817
2020-08-27,875,3,857,3,18,0,1026,3,19195,411,20221,414,0,8,-16,77,19,790,0,35,8,"Anderson",76978,51.9628984904778,0.0269179004037685,537.815999376445,3.89721738678583,100.02857959417,2.69179004037685
2020-08-28,875,0,857,0,18,0,1026,0,19233,38,20259,38,0,8,-20,57,20,810,0,35,8,"Anderson",76978,48.065681103692,0.0249158249158249,49.3647535659539,0,74.0471303489309,2.49158249158249
2020-08-29,884,9,865,8,19,1,1034,8,19495,262,20529,270,0,8,3,60,6,816,0,35,8,"Anderson",76978,36.3740289433345,0.0218120805369128,350.749564810725,11.6916521603575,77.9443477357167,2.18120805369128
2020-08-30,900,16,881,16,19,0,1050,16,19578,83,20628,99,0,8,8,68,8,824,0,35,8,"Anderson",76978,55.8601158772636,0.0339966832504146,128.608173763933,20.7851593961911,88.3369274338123,3.39966832504146
2020-08-31,902,2,883,2,19,0,1052,2,19636,58,20688,60,0,8,-15,53,17,841,0,35,8,"Anderson",76978,57.1591883395256,0.0350448247758761,77.9443477357167,2.59814492452389,68.8508404998831,3.50448247758761
2020-09-01,909,7,889,6,20,1,1058,6,19747,111,20805,117,0,8,0,53,7,848,0,35,8,"Anderson",76978,55.8601158772636,0.0346283783783784,151.991478084648,9.09350723583361,68.8508404998831,3.46283783783784
2020-09-02,917,8,895,6,22,2,1068,10,20063,316,21131,326,0,8,5,58,3,851,0,35,8,"Anderson",76978,58.4582608017875,0.033987915407855,423.497622697394,10.3925796980956,75.3462028111928,3.3987915407855
2020-09-03,933,16,909,14,24,2,1084,16,20387,324,21471,340,0,8,10,68,6,857,0,35,9,"Anderson",76978,75.3462028111928,0.0464,441.684637169061,20.7851593961911,88.3369274338123,4.64
2020-09-04,942,9,917,8,25,1,1094,10,20576,189,21670,199,0,8,6,74,3,860,0,35,9,"Anderson",76978,87.0378549715503,0.0481927710843374,258.515419990127,11.6916521603575,96.1313622073839,4.81927710843374
2020-09-05,961,19,936,19,25,0,1115,21,20845,269,21960,290,0,8,16,90,3,863,1,36,10,"Anderson",76978,100.02857959417,0.0566037735849057,376.731014055964,24.682376782977,116.916521603575,5.66037735849057
2020-09-06,963,2,938,2,25,0,1117,2,20901,56,22018,58,0,8,-1,89,3,866,0,36,10,"Anderson",76978,81.8415651225025,0.0482014388489209,75.3462028111928,2.59814492452389,115.617449141313,4.82014388489209
2020-09-07,966,3,941,3,25,0,1122,5,20989,88,22111,93,0,8,-8,81,11,877,0,36,10,"Anderson",76978,83.1406375847645,0.0491918482080112,120.813738990361,3.89721738678583,105.224869443218,4.91918482080112
2020-09-08,975,9,944,3,31,6,1126,4,21164,175,22290,179,1,9,4,85,4,881,0,36,10,"Anderson",76978,85.7387825092884,0.0457912457912458,232.533970744888,11.6916521603575,110.421159292265,4.57912457912458
2020-09-09,984,9,953,9,31,0,1135,9,21405,241,22540,250,0,9,-3,82,12,893,1,37,11,"Anderson",76978,87.0378549715503,0.0475514549325763,324.768115565486,11.6916521603575,106.523941905479,4.75514549325763
2020-09-10,1013,29,981,28,32,1,1165,30,21774,369,22939,399,1,10,25,107,3,896,0,37,11,"Anderson",76978,103.925796980956,0.0551771117166213,518.329912442516,37.6731014055964,139.000753462028,5.51771117166213
2020-09-11,1014,1,982,1,32,0,1167,2,21907,133,23074,135,0,10,-13,94,14,910,0,37,11,"Anderson",76978,93.53321728286,0.051994301994302,175.374782405363,1.29907246226194,122.112811452623,5.1994301994302
2020-09-12,1017,3,985,3,32,0,1172,5,22049,142,23221,147,0,10,-5,89,8,918,0,37,11,"Anderson",76978,72.7480578866689,0.0452022204599524,190.963651952506,3.89721738678583,115.617449141313,4.52022204599524
2020-09-13,1038,21,1005,20,33,1,1193,21,22293,244,23486,265,0,10,16,105,5,923,1,38,11,"Anderson",76978,97.4304346696459,0.0517711171662125,344.254202499415,27.2805217075008,136.402608537504,5.17711171662125
2020-09-14,1044,6,1010,5,34,1,1199,6,22399,106,23598,112,0,10,-7,98,13,936,1,39,11,"Anderson",76978,101.327652056432,0.0517821116341627,145.496115773338,7.79443477357167,127.309101301671,5.17821116341627
2020-09-15,1060,16,1026,16,34,0,1216,17,22639,240,23855,257,1,11,5,103,10,946,1,40,12,"Anderson",76978,110.421159292265,0.0575079872204473,333.86162280132,20.7851593961911,133.80446361298,5.75079872204473
2020-09-16,1068,8,1034,8,34,0,1228,12,22775,136,24003,148,0,11,-5,98,13,959,0,40,12,"Anderson",76978,109.122086830003,0.063568010936432,192.262724414768,10.3925796980956,127.309101301671,6.3568010936432
2020-09-17,1090,22,1054,20,36,2,1248,20,23196,421,24444,441,0,11,15,113,7,966,1,41,12,"Anderson",76978,100.02857959417,0.0551495016611296,572.890955857518,28.5795941697628,146.7951882356,5.51495016611296
2020-09-18,1109,19,1073,19,36,0,1266,18,23420,224,24686,242,0,11,6,119,13,979,0,41,12,"Anderson",76978,123.411883914885,0.0614143920595533,314.375535867391,24.682376782977,154.589623009171,6.14143920595533
2020-09-19,1124,15,1088,15,36,0,1287,21,23702,282,24989,303,0,11,9,128,6,985,1,42,12,"Anderson",76978,139.000753462028,0.0650452488687783,393.618956065369,19.4860869339292,166.281275169529,6.50452488687783
2020-09-20,1131,7,1095,7,36,0,1297,10,23854,152,25151,162,0,11,0,128,7,992,0,42,13,"Anderson",76978,120.813738990361,0.0624624624624625,210.449738886435,9.09350723583361,166.281275169529,6.24624624624625
2020-09-21,1133,2,1097,2,36,0,1299,2,23887,33,25186,35,0,11,-6,122,8,1000,0,42,13,"Anderson",76978,115.617449141313,0.0629722921914358,45.4675361791681,2.59814492452389,158.486840395957,6.29722921914358
2020-09-22,1147,14,1111,14,36,0,1316,17,24135,248,25451,265,0,11,0,122,14,1014,1,43,13,"Anderson",76978,113.019304216789,0.06265664160401,344.254202499415,18.1870144716672,158.486840395957,6.265664160401
2020-09-23,1147,0,1111,0,36,0,1316,0,24176,41,25492,41,0,11,-12,110,12,1026,0,43,13,"Anderson",76978,102.626724518694,0.0591000671591672,53.2619709527397,0,142.897970848814,5.91000671591672
2020-09-24,1160,13,1124,13,36,0,1331,15,24500,324,25831,339,1,12,0,110,12,1038,0,43,13,"Anderson",76978,90.9350723583361,0.0598413842826244,440.385564706799,16.8879420094053,142.897970848814,5.98413842826244
2020-09-25,1174,14,1137,13,37,1,1344,13,24736,236,26080,249,1,13,-2,108,15,1053,0,43,13,"Anderson",76978,84.4397100470264,0.0559540889526542,323.469043103224,18.1870144716672,140.29982592429,5.59540889526542
2020-09-26,1188,14,1151,14,37,0,1361,17,25036,300,26397,317,0,13,8,116,6,1059,0,43,13,"Anderson",76978,83.1406375847645,0.0525568181818182,411.805970537037,18.1870144716672,150.692405622386,5.25568181818182
2020-09-27,1207,19,1168,17,39,2,1377,16,25243,207,26620,223,0,13,12,128,7,1066,0,43,13,"Anderson",76978,98.7295071319078,0.0544588155207624,289.693159084414,24.682376782977,166.281275169529,5.44588155207624
2020-09-28,1210,3,1170,2,40,1,1379,2,25280,37,26659,39,0,13,-9,119,12,1078,0,43,13,"Anderson",76978,100.02857959417,0.0543109300746775,50.6638260282159,3.89721738678583,154.589623009171,5.43109300746775
2020-09-29,1221,11,1180,10,41,1,1389,10,25574,294,26963,304,0,13,-7,112,18,1096,0,43,13,"Anderson",76978,96.1313622073839,0.0482804232804233,394.918028527631,14.2897970848814,145.496115773338,4.82804232804233
2020-09-30,1233,12,1190,10,43,2,1399,10,25640,66,27039,76,0,13,3,115,9,1105,0,43,13,"Anderson",76978,111.720231754527,0.0536522301228184,98.7295071319078,15.5888695471433,149.393333160124,5.36522301228184
2020-10-01,1249,16,1204,14,45,2,1414,15,25920,280,27334,295,0,13,4,119,12,1117,0,43,13,"Anderson",76978,115.617449141313,0.0552228875582169,383.226376367274,20.7851593961911,154.589623009171,5.52228875582169
2020-10-02,1256,7,1210,6,46,1,1421,7,26002,82,27423,89,0,13,1,120,6,1123,0,43,13,"Anderson",76978,106.523941905479,0.0573343261355175,115.617449141313,9.09350723583361,155.888695471433,5.73343261355175
2020-10-03,1272,16,1226,16,46,0,1445,24,26266,264,27711,288,0,13,3,123,13,1136,0,43,13,"Anderson",76978,109.122086830003,0.0639269406392694,374.13286913144,20.7851593961911,159.785912858219,6.39269406392694
2020-10-04,1288,16,1240,14,48,2,1461,16,26603,337,28064,353,0,13,8,131,8,1144,0,43,13,"Anderson",76978,105.224869443218,0.0581717451523546,458.572579178467,20.7851593961911,170.178492556315,5.81717451523546
2020-10-05,1314,26,1265,25,49,1,1488,27,26814,211,28302,238,0,13,11,142,15,1159,1,44,13,"Anderson",76978,135.103536075242,0.0663420572124163,309.179246018343,33.7758840188106,184.468289641196,6.63420572124163
2020-10-06,1342,28,1292,27,50,1,1520,32,27151,337,28671,369,0,13,15,157,13,1172,1,45,13,"Anderson",76978,157.187767933695,0.0766978922716628,479.357738574658,36.3740289433345,203.954376575125,7.66978922716628
2020-10-07,1348,6,1298,6,50,0,1528,8,27386,235,28914,243,0,13,-3,154,9,1181,0,45,13,"Anderson",76978,149.393333160124,0.0688,315.674608329653,7.79443477357167,200.05715918834,6.88
2020-10-08,1358,10,1306,8,52,2,1537,9,27625,239,29162,248,0,13,-3,151,13,1194,1,46,13,"Anderson",76978,141.598898386552,0.0672866520787746,322.169970640962,12.9907246226195,196.159941801554,6.72866520787746
2020-10-09,1373,15,1319,13,54,2,1553,16,27798,173,29351,189,0,13,-2,149,17,1211,0,46,13,"Anderson",76978,151.991478084648,0.0684647302904564,245.524695367508,19.4860869339292,193.56179687703,6.84647302904564
2020-10-10,1389,16,1335,16,54,0,1573,20,28010,212,29583,232,0,13,3,152,13,1224,1,47,14,"Anderson",76978,151.991478084648,0.0683760683760684,301.384811244771,20.7851593961911,197.459014263816,6.83760683760684
2020-10-11,1417,28,1363,28,54,0,1604,31,28299,289,29903,320,0,13,18,170,10,1234,0,47,14,"Anderson",76978,167.580347631791,0.0777596519847743,415.703187923822,36.3740289433345,220.842318584531,7.77596519847743
2020-10-12,1433,16,1378,15,55,1,1620,16,28378,79,29998,95,0,13,-11,159,27,1261,0,47,14,"Anderson",76978,154.589623009171,0.0778301886792453,123.411883914885,20.7851593961911,206.552521499649,7.78301886792453
2020-10-13,1453,20,1396,18,57,2,1638,18,28499,121,30137,139,0,13,7,166,13,1274,0,47,14,"Anderson",76978,144.197043311076,0.0804911323328786,180.57107225441,25.9814492452389,215.646028735483,8.04911323328786
2020-10-14,1475,22,1418,22,57,0,1662,24,28799,300,30461,324,0,13,12,178,10,1284,0,47,14,"Anderson",76978,164.982202707267,0.0866192630898513,420.89947777287,28.5795941697628,231.234898282626,8.66192630898513
2020-10-15,1497,22,1434,16,63,6,1676,14,28950,151,30626,165,0,13,2,180,20,1304,1,48,14,"Anderson",76978,180.57107225441,0.0949453551912568,214.346956273221,28.5795941697628,233.83304320715,9.49453551912568
2020-10-16,1504,7,1437,3,67,4,1680,4,29049,99,30729,103,0,13,-11,169,18,1322,0,48,15,"Anderson",76978,170.178492556315,0.0921625544267054,133.80446361298,9.09350723583361,219.543246122269,9.21625544267054
2020-10-17,1532,28,1464,27,68,1,1710,30,29297,248,31007,278,0,13,14,183,14,1336,2,50,15,"Anderson",76978,185.767362103458,0.0962078651685393,361.142144508821,36.3740289433345,237.730260593936,9.62078651685393
2020-10-18,1552,20,1484,20,68,0,1733,23,29536,239,31269,262,0,13,5,188,15,1351,0,50,15,"Anderson",76978,175.374782405363,0.0944363103953148,340.35698511263,25.9814492452389,244.225622905246,9.44363103953148
2020-10-19,1556,4,1488,4,68,0,1738,5,29613,77,31351,82,0,13,-16,172,20,1371,1,51,15,"Anderson",76978,159.785912858219,0.0872135994087214,106.523941905479,5.19628984904778,223.440463509055,8.72135994087214
2020-10-20,1583,27,1515,27,68,0,1773,35,29812,199,31585,234,0,13,6,178,21,1392,0,51,15,"Anderson",76978,168.879420094053,0.093232044198895,303.982956169295,35.0749564810725,231.234898282626,9.3232044198895
2020-10-21,1600,17,1532,17,68,0,1792,19,30028,216,31820,235,0,13,8,186,9,1401,1,52,15,"Anderson",76978,162.384057782743,0.0956585724797645,305.282028631557,22.0842318584531,241.627477980722,9.56585724797645
2020-10-22,1621,21,1553,21,68,0,1817,25,30360,332,32177,357,1,14,-4,182,24,1425,0,52,15,"Anderson",76978,161.084985320481,0.0909090909090909,463.768869027514,27.2805217075008,236.431188131674,9.09090909090909
2020-10-23,1636,15,1567,14,69,1,1833,16,30635,275,32468,291,0,14,-7,175,22,1447,0,52,15,"Anderson",76978,171.477565018577,0.0879815986198965,378.030086518226,19.4860869339292,227.33768089584,8.79815986198965
2020-10-24,1667,31,1597,30,70,1,1866,33,31011,376,32877,409,0,14,19,194,12,1459,2,54,17,"Anderson",76978,175.374782405363,0.0834224598930481,531.320637065136,40.2712463301203,252.020057678817,8.34224598930481
2020-10-25,1684,17,1613,16,71,1,1885,19,31207,196,33092,215,0,14,0,194,17,1476,4,58,17,"Anderson",76978,171.477565018577,0.0833790455293472,279.300579386318,22.0842318584531,252.020057678817,8.33790455293472
2020-10-26,1700,16,1628,15,72,1,1903,18,31341,134,33244,152,-1,13,-11,183,28,1504,1,59,17,"Anderson",76978,187.06643456572,0.0871632329635499,197.459014263816,20.7851593961911,237.730260593936,8.71632329635499
2020-10-27,1729,29,1652,24,77,5,1927,24,31496,155,33423,179,1,14,10,193,18,1522,2,61,17,"Anderson",76978,189.664579490244,0.0837867247007617,232.533970744888,37.6731014055964,250.720985216555,8.37867247007617
2020-10-28,1785,56,1706,54,79,2,1986,59,31930,434,33916,493,0,14,33,226,23,1545,0,61,17,"Anderson",76978,240.32840551846,0.0925572519083969,640.442723895139,72.7480578866689,293.5903764712,9.25572519083969
2020-10-29,1814,29,1727,21,87,8,2005,19,32136,206,34141,225,0,14,6,232,23,1568,2,63,17,"Anderson",76978,250.720985216555,0.0957230142566191,292.291304008938,37.6731014055964,301.384811244771,9.57230142566191
2020-10-30,1851,37,1761,34,90,3,2043,38,32287,151,34330,189,2,16,20,252,15,1583,1,64,17,"Anderson",76978,279.300579386318,0.112781954887218,245.524695367508,48.065681103692,327.36626049001,11.2781954887218
2020-10-31,1851,0,1761,0,90,0,2043,0,32288,1,34331,1,0,16,-10,242,10,1593,0,64,19,"Anderson",76978,239.029333056198,0.121733149931224,1.29907246226194,0,314.375535867391,12.1733149931224
2020-11-01,1856,5,1766,5,90,0,2051,8,32532,244,34583,252,0,16,-10,232,15,1608,0,64,19,"Anderson",76978,223.440463509055,0.111334674714956,327.36626049001,6.49536231130973,301.384811244771,11.1334674714956
2020-11-02,1889,33,1797,31,92,2,2086,35,32799,267,34885,302,0,16,8,240,25,1633,0,64,20,"Anderson",76978,245.524695367508,0.111517367458867,392.319883603107,42.8693912546442,311.777390942867,11.1517367458867
2020-11-03,1915,26,1822,25,93,1,2111,25,32979,180,35090,205,0,16,6,246,20,1653,0,64,21,"Anderson",76978,241.627477980722,0.110377924415117,266.309854763699,33.7758840188106,319.571825716438,11.0377924415117
2020-11-04,1933,18,1837,15,96,3,2129,18,33058,79,35187,97,2,18,1,247,15,1668,1,65,21,"Anderson",76978,192.262724414768,0.112509834775767,126.010028839409,23.383304320715,320.8708981787,11.2509834775767
2020-11-05,1957,24,1855,18,102,6,2149,20,33157,99,35306,119,0,18,1,248,23,1691,0,65,22,"Anderson",76978,185.767362103458,0.123605150214592,154.589623009171,31.1777390942867,322.169970640962,12.3605150214592
2020-11-06,2006,49,1901,46,105,3,2198,49,33524,367,35722,416,0,18,24,272,25,1716,2,67,23,"Anderson",76978,201.356231650601,0.111350574712644,540.414144300969,63.6545506508353,353.347709735249,11.1350574712644
2020-11-07,2086,80,1978,77,108,3,2275,77,33971,447,36246,524,0,18,50,322,30,1746,0,67,23,"Anderson",76978,305.282028631557,0.121148825065274,680.713970225259,103.925796980956,418.301332848346,12.1148825065274
2020-11-08,2140,54,2029,51,111,3,2337,62,34581,610,36918,672,0,18,39,361,15,1761,1,68,23,"Anderson",76978,368.936579282392,0.122483940042827,872.976694640027,70.149912962145,468.965158876562,12.2483940042827
2020-11-09,2148,8,2036,7,112,1,2346,9,34655,74,37001,83,0,18,-46,315,54,1815,0,68,23,"Anderson",76978,336.459767725844,0.122873345935728,107.823014367741,10.3925796980956,409.207825612513,12.2873345935728
2020-11-10,2167,19,2054,18,113,1,2368,22,34826,171,37194,193,0,18,-16,299,35,1850,1,69,23,"Anderson",76978,327.36626049001,0.122148288973384,250.720985216555,24.682376782977,388.422666216322,12.2148288973384
2020-11-11,2206,39,2090,36,116,3,2410,42,35099,273,37509,315,1,19,13,312,25,1875,1,70,23,"Anderson",76978,354.646782197511,0.121016365202412,409.207825612513,50.6638260282159,405.310608225727,12.1016365202412
2020-11-12,2213,7,2096,6,117,1,2418,8,35297,198,37715,206,0,19,-13,299,20,1895,0,70,24,"Anderson",76978,332.562550339058,0.111664591116646,267.608927225961,9.09350723583361,388.422666216322,11.1664591116646
2020-11-13,2269,56,2149,53,120,3,2477,59,35559,262,38036,321,2,21,31,330,23,1918,2,72,24,"Anderson",76978,341.656057574892,0.12057044079516,417.002260386084,72.7480578866689,428.693912546442,12.057044079516
2020-11-14,2310,41,2189,40,121,1,2522,45,35955,396,38477,441,1,22,20,350,20,1938,1,73,25,"Anderson",76978,290.992231546676,0.110712684894666,572.890955857518,53.2619709527397,454.675361791681,11.0712684894666
2020-11-15,2408,98,2287,98,121,0,2630,108,36537,582,39167,690,1,23,79,429,18,1956,1,74,25,"Anderson",76978,348.151419886201,0.130280124499778,896.359998960742,127.309101301671,557.302086310374,13.0280124499778
2020-11-16,2457,49,2316,29,141,20,2659,29,36814,277,39473,306,0,23,-6,423,55,2011,1,75,25,"Anderson",76978,401.413390838941,0.126618122977346,397.516173452155,63.6545506508353,549.507651536803,12.6618122977346
2020-11-17,2473,16,2331,15,142,1,2675,16,37020,206,39695,222,2,25,-37,386,51,2062,1,76,26,"Anderson",76978,397.516173452155,0.122750899640144,288.394086622152,20.7851593961911,501.441970433111,12.2750899640144
2020-11-18,2503,30,2357,26,146,4,2701,26,37314,294,40015,320,0,25,-5,381,35,2097,0,76,27,"Anderson",76978,385.824521291798,0.116121308858739,415.703187923822,38.9721738678584,494.946608121801,11.6121308858739
2020-11-19,2561,58,2411,54,150,4,2763,62,37730,416,40493,478,0,25,19,400,39,2136,1,77,27,"Anderson",76978,452.077216867157,0.124190064794816,620.95663696121,75.3462028111928,519.628984904778,12.4190064794816
2020-11-20,2591,30,2438,27,153,3,2794,31,37843,113,40637,144,0,25,-10,390,40,2176,0,77,28,"Anderson",76978,418.301332848346,0.121876201460977,187.06643456572,38.9721738678584,506.638260282159,12.1876201460977
2020-11-21,2648,57,2487,49,161,8,2842,48,38187,344,41029,392,0,25,33,423,24,2200,1,78,28,"Anderson",76978,439.086492244537,0.125391849529781,509.236405206682,74.0471303489309,549.507651536803,12.5391849529781
2020-11-22,2704,56,2536,49,168,7,2899,57,38670,483,41569,540,0,25,42,465,14,2214,1,79,31,"Anderson",76978,384.525448829536,0.111990008326395,701.49912962145,72.7480578866689,604.068694951804,11.1990008326395
2020-11-23,2711,7,2542,6,169,1,2905,6,38692,22,41597,28,0,25,-64,401,71,2285,0,79,32,"Anderson",76978,329.964405414534,0.115819209039548,36.3740289433345,9.09350723583361,520.92805736704,11.5819209039548
2020-11-24,2724,13,2554,12,170,1,2917,12,38849,157,41766,169,2,27,-35,366,46,2331,0,79,32,"Anderson",76978,326.067188027748,0.116851762433607,219.543246122269,16.8879420094053,475.460521187872,11.6851762433607
2020-11-25,2752,28,2575,21,177,7,2938,21,38886,37,41824,58,1,28,-11,355,38,2369,0,79,32,"Anderson",76978,323.469043103224,0.131011608623549,75.3462028111928,36.3740289433345,461.170724102991,13.1011608623549
2020-11-26,2797,45,2617,42,180,3,2983,45,39236,350,42219,395,0,28,-30,325,75,2444,1,80,33,"Anderson",76978,306.581101093819,0.127462340672074,513.133622593468,58.4582608017875,422.198550235132,12.7462340672074
2020-11-27,2896,99,2707,90,189,9,3078,95,39662,426,42740,521,0,28,56,381,43,2487,3,83,35,"Anderson",76978,396.217100989893,0.135045173561579,676.816752838473,128.608173763933,494.946608121801,13.5045173561579
2020-11-28,2927,31,2732,25,195,6,3108,30,39805,143,42913,173,1,29,5,386,25,2512,2,85,35,"Anderson",76978,362.441216971083,0.141188959660297,224.739535971316,40.2712463301203,501.441970433111,14.1188959660297
2020-11-29,3018,91,2821,89,197,2,3204,96,40242,437,43446,533,0,29,65,451,26,2538,1,86,35,"Anderson",76978,407.908753150251,0.162493340436867,692.405622385617,118.215594065837,585.881680480137,16.2493340436867
2020-11-30,3088,70,2887,66,201,4,3277,73,40494,252,43771,325,0,29,1,452,69,2607,0,86,37,"Anderson",76978,489.750318272753,0.171113155473781,422.198550235132,90.9350723583361,587.180752942399,17.1113155473781
2020-12-01,3164,76,2953,66,211,10,3349,72,40925,431,44274,503,1,30,14,466,61,2668,6,92,38,"Anderson",76978,571.591883395256,0.172248803827751,653.433448517758,98.7295071319078,605.367767414066,17.2248803827751
2020-12-02,3179,15,2967,14,212,1,3365,16,41033,108,44398,124,0,30,-40,426,55,2723,0,92,38,"Anderson",76978,554.70394138585,0.165889665889666,161.084985320481,19.4860869339292,553.404868923589,16.5889665889666
2020-12-03,3220,41,2996,29,224,12,3398,33,41257,224,44655,257,1,31,-14,412,54,2777,1,93,39,"Anderson",76978,549.507651536803,0.170361247947455,333.86162280132,53.2619709527397,535.217854451921,17.0361247947455
2020-12-04,3287,67,3056,60,231,7,3461,63,41415,158,44876,221,1,32,-25,387,91,2868,0,93,39,"Anderson",76978,507.93733274442,0.179307116104869,287.09501415989,87.0378549715503,502.741042895373,17.9307116104869
2020-12-05,3318,31,3075,19,243,12,3479,18,41482,67,44961,85,0,32,1,388,30,2898,0,93,39,"Anderson",76978,507.93733274442,0.18115234375,110.421159292265,40.2712463301203,504.040115357635,18.115234375
2020-12-06,3354,36,3104,29,250,7,3507,28,41690,208,45197,236,0,32,12,400,24,2922,2,95,40,"Anderson",76978,436.488347320014,0.173043974871502,306.581101093819,46.76660864143,519.628984904778,17.3043974871502
2020-12-07,3494,140,3228,124,266,16,3643,136,42283,593,45926,729,2,34,28,428,110,3032,4,99,41,"Anderson",76978,527.42341967835,0.169837587006961,947.023824988958,181.870144716672,556.003013848112,16.9837587006961
2020-12-08,3565,71,3277,49,288,22,3695,52,42581,298,46276,350,1,35,-8,420,78,3110,2,101,43,"Anderson",76978,520.92805736704,0.172827172827173,454.675361791681,92.2341448205981,545.610434150017,17.2827172827173
2020-12-09,3670,105,3368,91,302,14,3799,104,42842,261,46641,365,0,35,46,466,59,3169,3,104,44,"Anderson",76978,637.844578970615,0.193490860454748,474.16144872561,136.402608537504,605.367767414066,19.3490860454748
2020-12-10,3764,94,3446,78,318,16,3886,87,43374,532,47260,619,3,38,81,547,10,3179,3,107,45,"Anderson",76978,706.695419470498,0.187332053742802,804.125854140144,122.112811452623,710.592636857284,18.7332053742802
2020-12-11,3837,73,3499,53,338,20,3937,51,43540,166,47477,217,1,39,30,577,42,3221,2,109,45,"Anderson",76978,714.48985424407,0.183006535947712,281.898724310842,94.832289745122,749.564810725142,18.3006535947712
2020-12-12,3925,88,3560,61,365,27,4002,65,44053,513,48055,578,0,39,55,632,33,3254,2,111,45,"Anderson",76978,788.536984593001,0.169036845507434,750.863883187404,114.318376679051,821.013796149549,16.9036845507434
2020-12-13,4157,232,3743,183,414,49,4206,204,44925,872,49131,1076,1,40,188,820,43,3297,0,111,47,"Anderson",76978,1043.15518719634,0.177681748856126,1397.80196939385,301.384811244771,1065.23941905479,17.7681748856126
2020-12-14,4272,115,3829,86,443,29,4305,99,45216,291,49521,390,0,40,-37,783,152,3449,1,112,48,"Anderson",76978,1010.67837563979,0.184144645340751,506.638260282159,149.393333160124,1017.1737379511,18.4144645340751
2020-12-15,4407,135,3914,85,493,50,4401,96,45743,527,50144,623,1,41,42,825,92,3541,6,118,51,"Anderson",76978,1093.81901322456,0.182523267838676,809.322143989192,175.374782405363,1071.7347813661,18.2523267838676
2020-12-16,4476,69,3944,30,532,39,4437,36,46066,323,50503,359,2,43,-17,808,84,3625,4,122,52,"Anderson",76978,1047.05240458313,0.165199378560331,466.367013952038,89.6359998960742,1049.65054950765,16.5199378560331
2020-12-17,4677,201,4118,174,559,27,4631,194,46594,528,51225,722,2,45,114,922,85,3710,2,124,54,"Anderson",76978,1186.05315804516,0.187894073139975,937.930317753124,261.113564914651,1197.74481020551,18.7894073139975
2020-12-18,4775,98,4194,76,581,22,4718,87,46960,366,51678,453,1,46,23,945,74,3784,2,126,54,"Anderson",76978,1218.5299696017,0.185908117114973,588.479825404661,127.309101301671,1227.62347683754,18.5908117114973
2020-12-19,4880,105,4275,81,605,24,4805,87,47218,258,52023,345,0,46,74,1019,31,3815,1,127,55,"Anderson",76978,1240.61420146016,0.202368951612903,448.179999480371,136.402608537504,1323.75483904492,20.2368951612903
2020-12-20,5020,140,4397,122,623,18,4942,137,47682,464,52624,601,2,48,84,1103,54,3869,3,130,56,"Anderson",76978,1121.09953493206,0.2107071285428,780.742549819429,181.870144716672,1432.87692587493,21.07071285428
2020-12-21,5068,48,4415,18,653,30,4965,23,47902,220,52867,243,3,51,-83,1020,128,3997,2,132,59,"Anderson",76978,1034.06167996051,0.197250448296473,315.674608329653,62.3554781885734,1325.05391150718,19.7250448296473
2020-12-22,5138,70,4459,44,679,26,5012,47,48008,106,53020,153,1,52,-31,989,100,4097,2,134,64,"Anderson",76978,949.621969913482,0.212447844228095,198.758086726078,90.9350723583361,1284.78266517706,21.2447844228095
2020-12-23,5212,74,4501,42,711,32,5055,43,48324,316,53379,359,2,54,-8,981,80,4177,2,136,66,"Anderson",76978,956.117332224792,0.214881780250348,466.367013952038,96.1313622073839,1274.39008547897,21.4881780250348
2020-12-24,5270,58,4525,24,745,34,5082,27,48476,152,53558,179,1,55,-47,934,104,4281,1,137,71,"Anderson",76978,770.349970121333,0.193313330475782,232.533970744888,75.3462028111928,1213.33367975266,19.3313330475782
2020-12-25,5363,93,4602,77,761,16,5174,92,48885,409,54059,501,0,55,-16,918,109,4390,1,138,72,"Anderson",76978,763.854607810024,0.191516169676606,650.835303593234,120.813738990361,1192.54852035647,19.1516169676606
2020-12-26,5419,56,4631,29,788,27,5202,28,49004,119,54206,147,0,55,6,924,50,4440,3,141,74,"Anderson",76978,700.200057159188,0.181859825927623,190.963651952506,72.7480578866689,1200.34295513004,18.1859825927623
2020-12-27,5479,60,4668,37,811,23,5238,36,49140,136,54378,172,1,56,30,954,29,4469,6,147,75,"Anderson",76978,596.274260178233,0.168757126567845,223.440463509055,77.9443477357167,1239.3151289979,16.8757126567845
2020-12-28,5526,47,4689,21,837,26,5258,20,49209,69,54467,89,2,58,-85,869,130,4599,4,151,82,"Anderson",76978,594.975187715971,0.183125,115.617449141313,61.0564057263114,1128.89396970563,18.3125
2020-12-29,5622,96,4741,52,881,44,5306,48,49304,95,54610,143,2,60,-34,835,128,4727,5,156,85,"Anderson",76978,628.751071734781,0.184905660377358,185.767362103458,124.710956377147,1084.72550598872,18.4905660377358
2020-12-30,5657,35,4759,18,898,17,5323,17,49432,128,54755,145,6,66,-89,746,118,4845,1,157,88,"Anderson",76978,578.087245706566,0.194767441860465,188.365507027982,45.4675361791681,969.108056847411,19.4767441860465
2020-12-31,5820,163,4859,100,961,63,5425,102,49736,304,55161,406,6,72,63,809,94,4939,1,158,93,"Anderson",76978,714.48985424407,0.213973799126638,527.42341967835,211.748811348697,1050.94962196991,21.3973799126638
2021-01-01,5885,65,4901,42,984,23,5480,55,50012,276,55492,331,0,72,-25,784,90,5029,2,160,94,"Anderson",76978,678.115825300735,0.213538032100488,429.992985008704,84.4397100470264,1018.47281041336,21.3538032100488
2021-01-02,5978,93,4942,41,1036,52,5521,41,50297,285,55818,326,0,72,49,833,44,5073,2,162,96,"Anderson",76978,726.181506404427,0.197890818858561,423.497622697394,120.813738990361,1082.1273610642,19.7890818858561
2021-01-03,6003,25,4954,12,1049,13,5537,16,50349,52,55886,68,0,72,-9,824,34,5107,1,163,98,"Anderson",76978,680.713970225259,0.198275862068966,88.3369274338123,32.4768115565486,1070.43570890384,19.8275862068966
2021-01-04,6040,37,4978,24,1062,13,5568,31,50456,107,56024,138,1,73,-57,767,93,5200,0,163,103,"Anderson",76978,667.72324560264,0.199100834938985,179.271999792148,48.065681103692,996.388578554912,19.9100834938985
2021-01-05,6112,72,5009,31,1103,41,5599,31,50574,118,56173,149,2,75,-47,720,117,5317,2,165,106,"Anderson",76978,636.545506508353,0.187460012795905,193.56179687703,93.53321728286,935.3321728286,18.7460012795905
2021-01-06,6186,74,5049,40,1137,34,5642,43,50735,161,56377,204,5,80,-12,708,81,5398,2,167,108,"Anderson",76978,687.209332536569,0.196670776818742,265.010782301437,96.1313622073839,919.743303281457,19.6670776818742
2021-01-07,6291,105,5129,80,1162,25,5734,92,50956,221,56690,313,1,81,65,773,39,5437,1,168,111,"Anderson",76978,611.863129725376,0.202092871157619,406.609680687989,136.402608537504,1004.18301332848,20.2092871157619
2021-01-08,6373,82,5179,50,1194,32,5786,52,51155,199,56941,251,5,86,61,834,16,5453,2,170,114,"Anderson",76978,633.947361583829,0.211180124223602,326.067188027748,106.523941905479,1083.42643352646,21.1180124223602
2021-01-09,6483,110,5248,69,1235,41,5861,75,51586,431,57447,506,2,88,44,878,64,5517,0,170,116,"Anderson",76978,656.031593442282,0.208717004297115,657.330665904544,142.897970848814,1140.58562186599,20.8717004297115
2021-01-10,6543,60,5273,25,1270,35,5886,25,51680,94,57566,119,2,90,28,906,30,5547,3,173,117,"Anderson",76978,701.49912962145,0.207738095238095,154.589623009171,77.9443477357167,1176.95965080932,20.7738095238095
2021-01-11,6576,33,5283,10,1293,23,5899,13,51751,71,57650,84,1,91,-93,813,125,5672,1,174,119,"Anderson",76978,696.302839772403,0.203567035670357,109.122086830003,42.8693912546442,1056.14591181896,20.3567035670357
2021-01-12,6629,53,5317,34,1312,19,5937,38,51923,172,57860,210,2,93,-100,713,151,5823,1,175,119,"Anderson",76978,671.620462989426,0.200355660936574,272.805217075008,68.8508404998831,926.238665592767,20.0355660936574
2021-01-13,6655,26,5334,17,1321,9,5956,19,52013,90,57969,109,3,96,-44,669,67,5890,0,175,120,"Anderson",76978,609.264984800852,0.197236180904523,141.598898386552,33.7758840188106,869.079477253241,19.7236180904523
2021-01-14,6752,97,5396,62,1356,35,6030,74,52420,407,58450,481,5,101,9,678,83,5973,2,177,122,"Anderson",76978,598.872405102757,0.168181818181818,624.853854347995,126.010028839409,880.771129413599,16.8181818181818
2021-01-15,6786,34,5416,20,1370,14,6054,24,52575,155,58629,179,0,101,-16,662,50,6023,1,178,125,"Anderson",76978,536.516926914183,0.158767772511848,232.533970744888,44.1684637169061,859.985970017408,15.8767772511848
2021-01-16,6850,64,5446,30,1404,34,6087,33,52819,244,58906,277,1,102,2,664,61,6084,1,179,128,"Anderson",76978,476.759593650134,0.154900616860864,359.843072046559,83.1406375847645,862.584114941931,15.4900616860864
2021-01-17,6887,37,5466,20,1421,17,6110,23,52923,104,59033,127,0,102,-6,658,43,6127,0,179,130,"Anderson",76978,446.880927018109,0.152692569870484,164.982202707267,48.065681103692,854.78968016836,15.2692569870484
2021-01-18,6906,19,5474,8,1432,11,6120,10,53019,96,59139,106,1,103,-68,590,86,6213,0,179,131,"Anderson",76978,428.693912546442,0.148421759570181,137.701680999766,24.682376782977,766.452752734548,14.8421759570181
2021-01-19,6948,42,5491,17,1457,25,6140,20,53131,112,59271,132,1,104,-78,512,119,6332,0,179,133,"Anderson",76978,414.40411546156,0.143869596031184,171.477565018577,54.5610434150017,665.125100678116,14.3869596031184
2021-01-20,6976,28,5507,16,1469,12,6159,19,53283,152,59442,171,3,107,-29,483,54,6386,0,179,136,"Anderson",76978,417.002260386084,0.137813985064494,222.141391046793,36.3740289433345,627.451999272519,13.7813985064494
2021-01-21,7032,56,5547,40,1485,16,6198,39,53524,241,59722,280,5,112,-43,440,94,6480,2,181,137,"Anderson",76978,363.740289433345,0.132075471698113,363.740289433345,72.7480578866689,571.591883395256,13.2075471698113
2021-01-22,7070,38,5565,18,1505,20,6220,22,53669,145,59889,167,2,114,-16,424,52,6532,0,181,140,"Anderson",76978,368.936579282392,0.131746031746032,216.945101197745,49.3647535659539,550.806723999065,13.1746031746032
2021-01-23,7108,38,5579,14,1529,24,6233,13,53929,260,60162,273,0,114,8,432,30,6562,1,182,140,"Anderson",76978,335.160695263582,0.116242038216561,354.646782197511,49.3647535659539,561.19930369716,11.6242038216561
2021-01-24,7121,13,5591,12,1530,1,6247,14,53996,67,60243,81,0,114,-21,411,34,6596,0,182,142,"Anderson",76978,303.982956169295,0.113223140495868,105.224869443218,16.8879420094053,533.918781989659,11.3223140495868
2021-01-25,7138,17,5602,11,1536,6,6258,11,54056,60,60314,71,2,116,-47,364,62,6658,1,183,144,"Anderson",76978,301.384811244771,0.117446808510638,92.2341448205981,22.0842318584531,472.862376263348,11.7446808510638
2021-01-26,7165,27,5623,21,1542,6,6283,25,54219,163,60502,188,0,116,-36,328,63,6721,1,184,147,"Anderson",76978,281.898724310842,0.116165718927701,244.225622905246,35.0749564810725,426.095767621918,11.6165718927701
2021-01-27,7182,17,5631,8,1551,9,6292,9,54305,86,60597,95,4,120,-17,311,30,6751,0,184,149,"Anderson",76978,267.608927225961,0.115151515151515,123.411883914885,22.0842318584531,404.011535763465,11.5151515151515
2021-01-28,7269,87,5671,40,1598,47,6339,47,54531,226,60870,273,4,124,24,335,59,6810,0,184,150,"Anderson",76978,307.880173556081,0.122822299651568,354.646782197511,113.019304216789,435.189274857752,12.2822299651568
2021-01-29,7282,13,5675,4,1607,9,6344,5,54576,45,60920,50,1,125,-34,301,46,6856,1,185,150,"Anderson",76978,275.403361999532,0.120271580989331,64.9536231130973,16.8879420094053,391.020811140845,12.0271580989331
2021-01-30,7322,40,5710,35,1612,5,6380,36,54835,259,61215,295,2,127,1,302,37,6893,2,187,151,"Anderson",76978,278.001506924056,0.13960113960114,383.226376367274,51.9628984904778,392.319883603107,13.960113960114
2021-01-31,7338,16,5717,7,1621,9,6391,11,55004,169,61395,180,1,128,-4,298,19,6912,0,187,153,"Anderson",76978,281.898724310842,0.125,233.83304320715,20.7851593961911,387.12359375406,12.5
2021-02-01,7358,20,5729,12,1629,8,6404,13,55057,53,61461,66,1,129,-26,272,45,6957,1,188,155,"Anderson",76978,285.795941697628,0.127288578901482,85.7387825092884,25.9814492452389,353.347709735249,12.7288578901482
2021-02-02,7365,7,5735,6,1630,1,6410,6,55126,69,61536,75,5,134,-45,227,47,7004,0,188,156,"Anderson",76978,259.814492452389,0.122823984526112,97.4304346696459,9.09350723583361,294.889448933461,12.2823984526112
2021-02-03,7387,22,5741,6,1646,16,6420,10,55318,192,61738,202,4,138,1,228,17,7021,0,188,157,"Anderson",76978,266.309854763699,0.112182296231376,262.412637376913,28.5795941697628,296.188521395723,11.2182296231376
2021-02-04,7417,30,5755,14,1662,16,6437,17,55642,324,62079,341,2,140,-5,223,33,7054,0,188,157,"Anderson",76978,192.262724414768,0.0810587262200165,442.983709631323,38.9721738678584,289.693159084414,8.10587262200166
2021-02-05,7435,18,5766,11,1669,7,6454,17,55799,157,62253,174,2,142,-13,210,29,7083,0,188,158,"Anderson",76978,198.758086726078,0.0825206301575394,226.038608433578,23.383304320715,272.805217075008,8.25206301575394
2021-02-06,7461,26,5782,16,1679,10,6474,20,56021,222,62495,242,1,143,8,218,17,7100,1,189,158,"Anderson",76978,180.57107225441,0.0734375,314.375535867391,33.7758840188106,283.197796773104,7.34375
2021-02-07,7474,13,5789,7,1685,6,6482,8,56128,107,62610,115,0,143,-10,208,23,7123,0,189,158,"Anderson",76978,176.673854867625,0.0748971193415638,149.393333160124,16.8879420094053,270.207072150485,7.48971193415638
2021-02-08,7499,25,5795,6,1704,19,6487,5,56150,22,62637,27,2,145,-12,196,35,7158,0,189,158,"Anderson",76978,183.169217178934,0.070578231292517,35.0749564810725,32.4768115565486,254.618202603341,7.0578231292517
2021-02-09,7523,24,5805,10,1718,14,6498,11,56319,169,62817,180,2,147,-24,172,46,7204,2,191,158,"Anderson",76978,205.253449037387,0.068696330991413,233.83304320715,31.1777390942867,223.440463509055,6.8696330991413
2021-02-10,7548,25,5820,15,1728,10,6517,19,56514,195,63031,214,1,148,8,180,16,7220,1,192,158,"Anderson",76978,209.150666424173,0.0750193348801237,278.001506924056,32.4768115565486,233.83304320715,7.50193348801237
2021-02-11,7561,13,5828,8,1733,5,6529,12,56694,180,63223,192,-1,147,-16,164,30,7250,0,192,159,"Anderson",76978,187.06643456572,0.0804195804195804,249.421912754293,16.8879420094053,213.047883810959,8.04195804195804
2021-02-12,7588,27,5843,15,1745,12,6544,15,56888,194,63432,209,0,147,13,177,14,7264,0,192,159,"Anderson",76978,198.758086726078,0.0763358778625954,271.506144612746,35.0749564810725,229.935825820364,7.63358778625954
2021-02-13,7614,26,5853,10,1761,16,6554,10,57077,189,63631,199,0,147,11,188,15,7279,0,192,159,"Anderson",76978,198.758086726078,0.0704225352112676,258.515419990127,33.7758840188106,244.225622905246,7.04225352112676
2021-02-14,7628,14,5863,10,1765,4,6565,11,57138,61,63703,72,2,149,1,189,11,7290,0,192,159,"Anderson",76978,200.05715918834,0.0759377859103385,93.53321728286,18.1870144716672,245.524695367508,7.59377859103385
2021-02-15,7644,16,5871,8,1773,8,6574,9,57211,73,63785,82,0,149,-6,183,22,7312,1,193,160,"Anderson",76978,188.365507027982,0.0757839721254355,106.523941905479,20.7851593961911,237.730260593936,7.57839721254355
2021-02-16,7673,29,5885,14,1788,15,6591,17,57295,84,63886,101,0,149,11,194,18,7330,0,193,160,"Anderson",76978,194.860869339292,0.0869971936389149,131.206318688456,37.6731014055964,252.020057678817,8.69971936389149
2021-02-17,7692,19,5897,12,1795,7,6603,12,57403,108,64006,120,0,149,-8,186,27,7357,0,193,162,"Anderson",76978,187.06643456572,0.0882051282051282,155.888695471433,24.682376782977,241.627477980722,8.82051282051282
2021-02-18,7716,24,5919,22,1797,2,6629,26,57559,156,64188,182,0,149,9,195,15,7372,0,193,162,"Anderson",76978,201.356231650601,0.103626943005181,236.431188131674,31.1777390942867,253.319130141079,10.3626943005181
2021-02-19,7729,13,5930,11,1799,2,6644,15,57605,46,64249,61,0,149,0,195,13,7385,0,193,163,"Anderson",76978,183.169217178934,0.122399020807834,79.2434201979787,16.8879420094053,253.319130141079,12.2399020807834
2021-02-20,7748,19,5937,7,1811,12,6653,9,57727,122,64380,131,1,150,3,198,15,7400,0,193,164,"Anderson",76978,174.075709943101,0.132176234979973,170.178492556315,24.682376782977,257.216347527865,13.2176234979973
2021-02-21,7760,12,5944,7,1816,5,6660,7,57791,64,64451,71,2,152,-1,197,11,7411,1,194,164,"Anderson",76978,171.477565018577,0.127005347593583,92.2341448205981,15.5888695471433,255.917275065603,12.7005347593583
2021-02-22,7765,5,5946,2,1819,3,6666,6,57828,37,64494,43,1,153,-17,180,21,7432,0,194,165,"Anderson",76978,157.187767933695,0.129760225669958,55.8601158772636,6.49536231130973,233.83304320715,12.9760225669958
2021-02-23,7789,24,5955,9,1834,15,6674,8,57971,143,64645,151,2,155,-2,178,24,7456,0,194,167,"Anderson",76978,150.692405622386,0.10935441370224,196.159941801554,31.1777390942867,231.234898282626,10.935441370224
2021-02-24,7821,32,5974,19,1847,13,6697,23,58145,174,64842,197,0,155,15,193,17,7473,0,194,167,"Anderson",76978,167.580347631791,0.11244019138756,255.917275065603,41.5703187923822,250.720985216555,11.244019138756
2021-02-25,7838,17,5982,8,1856,9,6708,11,58272,127,64980,138,1,156,-3,190,19,7492,0,194,167,"Anderson",76978,158.486840395957,0.0997474747474748,179.271999792148,22.0842318584531,246.82376782977,9.97474747474748
2021-02-26,7850,12,5990,8,1860,4,6717,9,58371,99,65088,108,0,156,-17,173,29,7521,0,194,167,"Anderson",76978,157.187767933695,0.0870083432657926,140.29982592429,15.5888695471433,224.739535971316,8.70083432657926
2021-02-27,7859,9,5997,7,1862,2,6723,6,58463,92,65186,98,0,156,-6,167,15,7536,0,194,167,"Anderson",76978,144.197043311076,0.086848635235732,127.309101301671,11.6916521603575,216.945101197745,8.6848635235732
2021-02-28,7873,14,6007,10,1866,4,6734,11,58534,71,65268,82,0,156,0,167,14,7550,0,194,167,"Anderson",76978,146.7951882356,0.0905752753977968,106.523941905479,18.1870144716672,216.945101197745,9.05752753977968
2021-03-01,7881,8,6012,5,1869,3,6741,7,58569,35,65310,42,0,156,-11,156,19,7569,0,194,168,"Anderson",76978,150.692405622386,0.0919117647058824,54.5610434150017,10.3925796980956,202.655304112863,9.19117647058824
2021-03-02,7904,23,6023,11,1881,12,6751,10,58685,116,65436,126,1,157,-2,154,24,7593,1,195,168,"Anderson",76978,149.393333160124,0.0973451327433628,163.683130245005,29.8786666320247,200.05715918834,9.73451327433628
2021-03-03,7937,33,6044,21,1893,12,6776,25,58801,116,65577,141,1,158,13,167,19,7612,0,195,169,"Anderson",76978,150.692405622386,0.107482993197279,183.169217178934,42.8693912546442,216.945101197745,10.7482993197279
2021-03-04,7962,25,6057,13,1905,12,6793,17,58964,163,65757,180,0,158,13,180,12,7624,0,195,169,"Anderson",76978,161.084985320481,0.109395109395109,233.83304320715,32.4768115565486,233.83304320715,10.9395109395109
2021-03-05,7995,33,6074,17,1921,16,6815,22,59098,134,65913,156,0,158,18,198,15,7639,2,197,169,"Anderson",76978,188.365507027982,0.118787878787879,202.655304112863,42.8693912546442,257.216347527865,11.8787878787879
2021-03-06,8005,10,6079,5,1926,5,6823,8,59187,89,66010,97,0,158,-1,197,11,7650,0,197,169,"Anderson",76978,189.664579490244,0.121359223300971,126.010028839409,12.9907246226195,255.917275065603,12.1359223300971
2021-03-07,8011,6,6082,3,1929,3,6826,3,59226,39,66052,42,0,158,-10,187,16,7666,0,197,169,"Anderson",76978,179.271999792148,0.11734693877551,54.5610434150017,7.79443477357167,242.926550442984,11.734693877551
2021-03-08,8027,16,6089,7,1938,9,6835,9,59303,77,66138,86,1,159,-4,183,19,7685,0,197,169,"Anderson",76978,189.664579490244,0.113526570048309,111.720231754527,20.7851593961911,237.730260593936,11.3526570048309
2021-03-09,8048,21,6097,8,1951,13,6843,8,59368,65,66211,73,0,159,3,186,18,7703,3,200,170,"Anderson",76978,187.06643456572,0.118709677419355,94.832289745122,27.2805217075008,241.627477980722,11.8709677419355
2021-03-10,8070,22,6110,13,1960,9,6859,16,59525,157,66384,173,0,159,11,197,11,7714,1,201,170,"Anderson",76978,172.776637480839,0.102850061957869,224.739535971316,28.5795941697628,255.917275065603,10.2850061957869
2021-03-11,8093,23,6120,10,1973,13,6869,10,59622,97,66491,107,0,159,1,198,22,7736,1,202,171,"Anderson",76978,170.178492556315,0.103542234332425,139.000753462028,29.8786666320247,257.216347527865,10.3542234332425
2021-03-12,8113,20,6137,17,1976,3,6889,20,59728,106,66617,126,0,159,8,206,12,7748,0,202,171,"Anderson",76978,153.29055054691,0.105113636363636,163.683130245005,25.9814492452389,267.608927225961,10.5113636363636
2021-03-13,8124,11,6141,4,1983,7,6893,4,59804,76,66697,80,0,159,2,208,9,7757,1,203,171,"Anderson",76978,154.589623009171,0.101892285298399,103.925796980956,14.2897970848814,270.207072150485,10.1892285298399
2021-03-14,8130,6,6145,4,1985,2,6899,6,59840,36,66739,42,0,159,-13,195,19,7776,1,204,171,"Anderson",76978,154.589623009171,0.106259097525473,54.5610434150017,7.79443477357167,253.319130141079,10.6259097525473
2021-03-15,8148,18,6151,6,1997,12,6905,6,59873,33,66778,39,0,159,-9,186,27,7803,1,205,171,"Anderson",76978,157.187767933695,0.109375,50.6638260282159,23.383304320715,241.627477980722,10.9375
2021-03-16,8181,33,6164,13,2017,20,6920,15,59966,93,66886,108,0,159,-2,184,35,7838,2,207,171,"Anderson",76978,172.776637480839,0.114074074074074,140.29982592429,42.8693912546442,239.029333056198,11.4074074074074
2021-03-17,8198,17,6175,11,2023,6,6933,13,60053,87,66986,100,0,159,-5,179,22,7860,0,207,172,"Anderson",76978,166.281275169529,0.122923588039867,129.907246226195,22.0842318584531,232.533970744888,12.2923588039867
2021-03-18,8214,16,6187,12,2027,4,6948,15,60134,81,67082,96,1,160,-1,178,16,7876,0,207,172,"Anderson",76978,157.187767933695,0.133671742808799,124.710956377147,20.7851593961911,231.234898282626,13.3671742808799
2021-03-19,8238,24,6201,14,2037,10,6961,13,60253,119,67214,132,0,160,13,191,11,7887,1,208,172,"Anderson",76978,162.384057782743,0.120603015075377,171.477565018577,31.1777390942867,248.122840292031,12.0603015075377
2021-03-20,8250,12,6207,6,2043,6,6969,8,60292,39,67261,47,0,160,3,194,9,7896,1,209,172,"Anderson",76978,163.683130245005,0.134751773049645,61.0564057263114,15.5888695471433,252.020057678817,13.4751773049645
2021-03-21,8260,10,6213,6,2047,4,6976,7,60354,62,67330,69,-1,159,-5,189,16,7912,0,209,172,"Anderson",76978,168.879420094053,0.130287648054146,89.6359998960742,12.9907246226195,245.524695367508,13.0287648054146
2021-03-22,8266,6,6214,1,2052,5,6977,1,60420,66,67397,67,0,159,-9,180,15,7927,1,210,172,"Anderson",76978,153.29055054691,0.116316639741519,87.0378549715503,7.79443477357167,233.83304320715,11.6316639741519
2021-03-23,8272,6,6215,1,2057,5,6978,1,60463,43,67441,44,0,159,-15,165,21,7948,0,210,173,"Anderson",76978,118.215594065837,0.104504504504505,57.1591883395256,7.79443477357167,214.346956273221,10.4504504504505
2021-03-24,8280,8,6222,7,2058,1,6985,7,60584,121,67569,128,1,160,-11,154,18,7966,0,210,173,"Anderson",76978,106.523941905479,0.0891938250428816,166.281275169529,10.3925796980956,200.05715918834,8.91938250428817
2021-03-25,8290,10,6227,5,2063,5,6991,6,60685,101,67676,107,0,160,-10,144,20,7986,0,210,173,"Anderson",76978,98.7295071319078,0.0723905723905724,139.000753462028,12.9907246226195,187.06643456572,7.23905723905724
2021-03-26,8307,17,6239,12,2068,5,7002,11,60751,66,67753,77,0,160,2,146,15,8001,0,210,174,"Anderson",76978,89.6359998960742,0.0760667903525046,100.02857959417,22.0842318584531,189.664579490244,7.60667903525046
2021-03-27,8311,4,6243,4,2068,0,7008,6,60815,64,67823,70,1,161,-12,134,15,8016,2,212,174,"Anderson",76978,79.2434201979786,0.0693950177935943,90.9350723583361,5.19628984904778,174.075709943101,6.93950177935943
2021-03-28,8314,3,6243,0,2071,3,7008,0,60844,29,67852,29,1,162,-12,122,14,8030,0,212,175,"Anderson",76978,70.149912962145,0.0613026819923372,37.6731014055964,3.89721738678583,158.486840395957,6.13026819923372
2021-03-29,8329,15,6247,4,2082,11,7012,4,60930,86,67942,90,1,163,-16,106,30,8060,0,212,176,"Anderson",76978,81.8415651225025,0.0642201834862385,116.916521603575,19.4860869339292,137.701680999766,6.42201834862385
2021-03-30,8334,5,6250,3,2084,2,7015,3,60988,58,68003,61,1,164,-12,94,16,8076,0,212,176,"Anderson",76978,80.5424926602406,0.0658362989323843,79.2434201979787,6.49536231130973,122.112811452623,6.58362989323843
2021-03-31,8357,23,6264,14,2093,9,7031,16,61152,164,68183,180,1,165,10,104,12,8088,1,213,176,"Anderson",76978,100.02857959417,0.0749185667752443,233.83304320715,29.8786666320247,135.103536075242,7.49185667752443
2021-04-01,8366,9,6268,4,2098,5,7035,4,61209,57,68244,61,0,165,-8,96,17,8105,0,213,176,"Anderson",76978,98.7295071319078,0.0774647887323944,79.2434201979787,11.6916521603575,124.710956377147,7.74647887323944
2021-04-02,8375,9,6275,7,2100,2,7042,7,61279,70,68321,77,0,165,-1,95,10,8115,0,213,176,"Anderson",76978,88.3369274338123,0.0704225352112676,100.02857959417,11.6916521603575,123.411883914885,7.04225352112676
2021-04-03,8381,6,6280,5,2101,1,7048,6,61329,50,68377,56,0,165,-8,87,14,8129,0,213,176,"Anderson",76978,90.9350723583361,0.0722021660649819,72.7480578866689,7.79443477357167,113.019304216789,7.22021660649819
2021-04-04,8383,2,6282,2,2101,0,7050,2,61367,38,68417,40,0,165,-5,82,7,8136,0,213,176,"Anderson",76978,89.6359998960742,0.0743362831858407,51.9628984904778,2.59814492452389,106.523941905479,7.43362831858407
2021-04-05,8397,14,6285,3,2112,11,7052,2,61425,58,68477,60,0,165,4,86,10,8146,2,215,176,"Anderson",76978,88.3369274338123,0.0747663551401869,77.9443477357167,18.1870144716672,111.720231754527,7.47663551401869
2021-04-06,8402,5,6289,4,2113,1,7058,6,61467,42,68525,48,0,165,3,89,2,8148,0,215,176,"Anderson",76978,88.3369274338123,0.0823754789272031,62.3554781885734,6.49536231130973,115.617449141313,8.23754789272031
2021-04-07,8422,20,6302,13,2120,7,7072,14,61626,159,68698,173,0,165,10,99,10,8158,2,217,176,"Anderson",76978,84.4397100470264,0.0796116504854369,224.739535971316,25.9814492452389,128.608173763933,7.96116504854369
2021-04-08,8425,3,6304,2,2121,1,7075,3,61717,91,68792,94,5,170,-17,82,15,8173,1,218,176,"Anderson",76978,76.6452752734548,0.072992700729927,122.112811452623,3.89721738678583,106.523941905479,7.2992700729927
2021-04-09,8433,8,6310,6,2123,2,7084,9,61804,87,68888,96,-4,166,8,90,4,8177,0,218,176,"Anderson",76978,75.3462028111928,0.0740740740740741,124.710956377147,10.3925796980956,116.916521603575,7.40740740740741
2021-04-10,8438,5,6315,5,2123,0,7089,5,61875,71,68964,76,0,166,-6,84,11,8188,0,218,176,"Anderson",76978,74.0471303489309,0.0698466780238501,98.7295071319078,6.49536231130973,109.122086830003,6.98466780238501
2021-04-11,8445,7,6320,5,2125,2,7094,5,61919,44,69013,49,-1,165,0,84,8,8196,0,218,176,"Anderson",76978,80.5424926602406,0.0738255033557047,63.6545506508353,9.09350723583361,109.122086830003,7.38255033557047
2021-04-12,8448,3,6323,3,2125,0,7097,3,61988,69,69085,72,0,165,-7,77,10,8206,0,218,176,"Anderson",76978,66.2526955753592,0.0740131578947368,93.53321728286,3.89721738678583,100.02857959417,7.40131578947368
2021-04-13,8458,10,6328,5,2130,5,7103,6,62049,61,69152,67,5,170,-7,70,12,8218,0,218,176,"Anderson",76978,72.7480578866689,0.0717703349282297,87.0378549715503,12.9907246226195,90.9350723583361,7.17703349282297
2021-04-14,8472,14,6337,9,2135,5,7114,11,62187,138,69301,149,0,170,7,77,7,8225,0,218,176,"Anderson",76978,64.9536231130973,0.0696517412935323,193.56179687703,18.1870144716672,100.02857959417,6.96517412935323
2021-04-15,8481,9,6342,5,2139,4,7119,5,62268,81,69387,86,0,170,6,83,3,8228,0,218,176,"Anderson",76978,72.7480578866689,0.0739495798319328,111.720231754527,11.6916521603575,107.823014367741,7.39495798319328
2021-04-16,8494,13,6353,11,2141,2,7132,13,62421,153,69553,166,0,170,6,89,7,8235,0,218,176,"Anderson",76978,79.2434201979786,0.0721804511278196,215.646028735483,16.8879420094053,115.617449141313,7.21804511278196
2021-04-17,8499,5,6356,3,2143,2,7136,4,62486,65,69622,69,0,170,0,89,5,8240,0,218,176,"Anderson",76978,79.2434201979786,0.0714285714285714,89.6359998960742,6.49536231130973,115.617449141313,7.14285714285714
2021-04-18,8506,7,6362,6,2144,1,7142,6,62531,45,69673,51,0,170,0,89,7,8247,0,218,176,"Anderson",76978,79.2434201979786,0.0727272727272727,66.2526955753592,9.09350723583361,115.617449141313,7.27272727272727
2021-04-19,8512,6,6365,3,2147,3,7145,3,62554,23,69699,26,0,170,-6,83,12,8259,0,218,177,"Anderson",76978,83.1406375847645,0.0781758957654723,33.7758840188106,7.79443477357167,107.823014367741,7.81758957654723
2021-04-20,8518,6,6368,3,2150,3,7148,3,62653,99,69801,102,0,170,-1,82,7,8266,0,218,177,"Anderson",76978,77.9443477357167,0.0693374422187981,132.505391150718,7.79443477357167,106.523941905479,6.93374422187981
2021-04-21,8530,12,6374,6,2156,6,7154,6,62808,155,69962,161,1,171,-2,80,13,8279,0,218,177,"Anderson",76978,75.3462028111928,0.0605143721633888,209.150666424173,15.5888695471433,103.925796980956,6.05143721633888
2021-04-22,8548,18,6380,6,2168,12,7161,7,62952,144,70113,151,0,171,12,92,6,8285,0,218,177,"Anderson",76978,87.0378549715503,0.0578512396694215,196.159941801554,23.383304320715,119.514666528099,5.78512396694215
2021-04-23,8558,10,6385,5,2173,5,7167,6,63118,166,70285,172,0,171,8,100,2,8287,0,218,177,"Anderson",76978,83.1406375847645,0.0478142076502732,223.440463509055,12.9907246226195,129.907246226195,4.78142076502732
2021-04-24,8570,12,6391,6,2179,6,7174,7,63185,67,70359,74,0,171,8,108,4,8291,1,219,177,"Anderson",76978,92.2341448205981,0.0515603799185889,96.1313622073839,15.5888695471433,140.29982592429,5.15603799185889
2021-04-25,8574,4,6393,2,2181,2,7176,2,63225,40,70401,42,0,171,0,108,4,8295,0,219,177,"Anderson",76978,88.3369274338123,0.0467032967032967,54.5610434150017,5.19628984904778,140.29982592429,4.67032967032967
2021-04-26,8583,9,6397,4,2186,5,7180,4,63300,75,70480,79,0,171,2,110,7,8302,0,219,178,"Anderson",76978,92.2341448205981,0.0448143405889885,102.626724518694,11.6916521603575,142.897970848814,4.48143405889885
2021-04-27,8593,10,6403,6,2190,4,7186,6,63368,68,70554,74,0,171,-3,107,13,8315,0,219,178,"Anderson",76978,97.4304346696459,0.050464807436919,96.1313622073839,12.9907246226195,139.000753462028,5.0464807436919
2021-04-28,8610,17,6415,12,2195,5,7199,13,63506,138,70705,151,0,171,1,108,16,8331,1,220,179,"Anderson",76978,103.925796980956,0.0605652759084791,196.159941801554,22.0842318584531,140.29982592429,6.05652759084791
2021-04-29,8616,6,6417,2,2199,4,7202,3,63655,149,70857,152,0,171,-1,107,7,8338,0,220,179,"Anderson",76978,88.3369274338123,0.0551075268817204,197.459014263816,7.79443477357167,139.000753462028,5.51075268817204
2021-04-30,8623,7,6420,3,2203,4,7206,4,63777,122,70983,126,0,171,-2,105,9,8347,0,220,179,"Anderson",76978,84.4397100470264,0.0558739255014327,163.683130245005,9.09350723583361,136.402608537504,5.58739255014327
2021-05-01,8628,5,6423,3,2205,2,7209,3,63840,63,71049,66,0,171,-1,104,6,8353,1,221,179,"Anderson",76978,75.3462028111928,0.0507246376811594,85.7387825092884,6.49536231130973,135.103536075242,5.07246376811594
2021-05-02,8631,3,6424,1,2207,2,7210,1,63891,51,71101,52,0,171,-7,97,10,8363,0,221,179,"Anderson",76978,74.0471303489309,0.0485714285714286,67.5517680376211,3.89721738678583,126.010028839409,4.85714285714286
2021-05-03,8641,10,6429,5,2212,5,7215,5,63997,106,71212,111,0,171,-3,94,13,8376,0,221,179,"Anderson",76978,75.3462028111928,0.0478142076502732,144.197043311076,12.9907246226195,122.112811452623,4.78142076502732
2021-05-04,8643,2,6429,0,2214,2,7216,1,64073,76,71289,77,0,171,-11,83,13,8389,0,221,179,"Anderson",76978,64.9536231130973,0.0408163265306122,100.02857959417,2.59814492452389,107.823014367741,4.08163265306122
2021-05-05,8651,8,6433,4,2218,4,7219,3,64190,117,71409,120,0,171,-3,80,11,8400,0,221,179,"Anderson",76978,53.2619709527397,0.0284090909090909,155.888695471433,10.3925796980956,103.925796980956,2.84090909090909
2021-05-06,8656,5,6436,3,2220,2,7225,6,64242,52,71467,58,0,171,-4,76,9,8409,1,222,179,"Anderson",76978,51.9628984904778,0.0377049180327869,75.3462028111928,6.49536231130973,98.7295071319078,3.77049180327869
2021-05-07,8661,5,6438,2,2223,3,7228,3,64363,121,71591,124,0,171,-4,72,9,8418,0,222,179,"Anderson",76978,49.3647535659539,0.0361842105263158,161.084985320481,6.49536231130973,93.53321728286,3.61842105263158
2021-05-08,8667,6,6441,3,2226,3,7230,2,64432,69,71662,71,0,171,-6,66,12,8430,1,223,180,"Anderson",76978,50.6638260282159,0.034257748776509,92.2341448205981,7.79443477357167,85.7387825092884,3.4257748776509
2021-05-09,8668,1,6441,0,2227,1,7231,1,64460,28,71691,29,0,171,-4,62,5,8435,0,223,180,"Anderson",76978,48.065681103692,0.0355932203389831,37.6731014055964,1.29907246226194,80.5424926602406,3.55932203389831
2021-05-10,8673,5,6441,0,2232,5,7231,0,64548,88,71779,88,0,171,-5,57,10,8445,0,223,180,"Anderson",76978,41.5703187923822,0.0282186948853616,114.318376679051,6.49536231130973,74.0471303489309,2.82186948853616
2021-05-11,8681,8,6442,1,2239,7,7233,2,64590,42,71823,44,0,171,3,60,5,8450,0,223,181,"Anderson",76978,49.3647535659539,0.0318352059925094,57.1591883395256,10.3925796980956,77.9443477357167,3.18352059925094
2021-05-12,8694,13,6449,7,2245,6,7239,6,64694,104,71933,110,0,171,8,68,5,8455,2,225,181,"Anderson",76978,55.8601158772636,0.0381679389312977,142.897970848814,16.8879420094053,88.3369274338123,3.81679389312977
2021-05-13,8698,4,6451,2,2247,2,7241,2,64797,103,72038,105,0,171,-3,65,7,8462,2,227,181,"Anderson",76978,54.5610434150017,0.0280210157618214,136.402608537504,5.19628984904778,84.4397100470264,2.80210157618214
2021-05-14,8706,8,6454,3,2252,5,7246,5,64884,87,72130,92,0,171,2,67,6,8468,0,227,181,"Anderson",76978,58.4582608017875,0.0333951762523191,119.514666528099,10.3925796980956,87.0378549715503,3.33951762523191
2021-05-15,8711,5,6456,2,2255,3,7248,2,64949,65,72197,67,0,171,1,68,4,8472,0,227,181,"Anderson",76978,57.1591883395256,0.0336448598130841,87.0378549715503,6.49536231130973,88.3369274338123,3.36448598130841
2021-05-16,8713,2,6457,1,2256,1,7249,1,64985,36,72234,37,0,171,-5,63,7,8479,0,227,181,"Anderson",76978,58.4582608017875,0.0331491712707182,48.065681103692,2.59814492452389,81.8415651225025,3.31491712707182
2021-05-17,8719,6,6462,5,2257,1,7254,5,65044,59,72298,64,1,172,0,63,5,8484,0,227,181,"Anderson",76978,59.7573332640495,0.0443159922928709,83.1406375847645,7.79443477357167,81.8415651225025,4.43159922928709
2021-05-18,8723,4,6462,0,2261,4,7254,0,65135,91,72389,91,0,172,0,63,4,8488,1,228,181,"Anderson",76978,54.5610434150017,0.0371024734982332,118.215594065837,5.19628984904778,81.8415651225025,3.71024734982332
2021-05-19,8730,7,6467,5,2263,2,7260,6,65254,119,72514,125,0,172,5,68,2,8490,0,228,181,"Anderson",76978,46.76660864143,0.036144578313253,162.384057782743,9.09350723583361,88.3369274338123,3.6144578313253
2021-05-20,8732,2,6469,2,2263,0,7262,2,65373,119,72635,121,0,172,-1,67,3,8493,0,228,181,"Anderson",76978,44.1684637169061,0.0351758793969849,157.187767933695,2.59814492452389,87.0378549715503,3.51758793969849
2021-05-21,8734,2,6469,0,2265,2,7262,0,65443,70,72705,70,0,172,-7,60,9,8502,0,228,181,"Anderson",76978,36.3740289433345,0.0278260869565217,90.9350723583361,2.59814492452389,77.9443477357167,2.78260869565217
2021-05-22,8739,5,6471,2,2268,3,7264,2,65483,40,72747,42,0,172,-3,57,8,8510,0,228,181,"Anderson",76978,36.3740289433345,0.0290909090909091,54.5610434150017,6.49536231130973,74.0471303489309,2.90909090909091
2021-05-23,8739,0,6471,0,2268,0,7264,0,65512,29,72776,29,0,172,-3,54,3,8513,0,228,181,"Anderson",76978,33.7758840188106,0.0276752767527675,37.6731014055964,0,70.149912962145,2.76752767527675
2021-05-24,8747,8,6475,4,2272,4,7267,3,65571,59,72838,62,0,172,1,55,7,8520,0,228,181,"Anderson",76978,36.3740289433345,0.0240740740740741,80.5424926602406,10.3925796980956,71.448985424407,2.40740740740741
2021-05-25,8749,2,6475,0,2274,2,7268,1,65616,45,72884,46,0,172,-10,45,12,8532,0,228,181,"Anderson",76978,33.7758840188106,0.0282828282828283,59.7573332640495,2.59814492452389,58.4582608017875,2.82828282828283
2021-05-26,8756,7,6480,5,2276,2,7274,6,65716,100,72990,106,0,172,0,45,7,8539,0,228,181,"Anderson",76978,33.7758840188106,0.0294117647058824,137.701680999766,9.09350723583361,58.4582608017875,2.94117647058824
2021-05-27,8758,2,6481,1,2277,1,7275,1,65766,50,73041,51,0,172,-1,44,3,8542,1,229,181,"Anderson",76978,33.7758840188106,0.0320197044334975,66.2526955753592,2.59814492452389,57.1591883395256,3.20197044334975
2021-05-28,8763,5,6485,4,2278,1,7280,5,65849,83,73129,88,0,172,0,44,5,8547,0,229,181,"Anderson",76978,37.6731014055964,0.0424528301886792,114.318376679051,6.49536231130973,57.1591883395256,4.24528301886792
2021-05-29,8764,1,6485,0,2279,1,7280,0,65886,37,73166,37,0,172,-5,39,6,8553,0,229,181,"Anderson",76978,32.4768115565486,0.0381861575178998,48.065681103692,1.29907246226194,50.6638260282159,3.81861575178998
2021-05-30,8767,3,6486,1,2281,2,7281,1,65936,50,73217,51,0,172,0,39,3,8556,0,229,181,"Anderson",76978,36.3740289433345,0.0385487528344671,66.2526955753592,3.89721738678583,50.6638260282159,3.85487528344671
2021-05-31,8771,4,6489,3,2282,1,7284,3,65987,51,73271,54,0,172,1,40,3,8559,0,229,181,"Anderson",76978,31.1777390942867,0.0392609699769053,70.149912962145,5.19628984904778,51.9628984904778,3.92609699769053
2021-06-01,8774,3,6491,2,2283,1,7285,1,66035,48,73320,49,0,172,1,41,2,8561,1,230,181,"Anderson",76978,32.4768115565486,0.0389908256880734,63.6545506508353,3.89721738678583,53.2619709527397,3.89908256880734
2021-06-02,8778,4,6492,1,2286,3,7287,2,66076,41,73363,43,0,172,-2,39,6,8567,0,230,181,"Anderson",76978,28.5795941697628,0.0348525469168901,55.8601158772636,5.19628984904778,50.6638260282159,3.48525469168901
2021-06-03,8779,1,6492,0,2287,1,7290,3,66166,90,73456,93,1,173,-3,36,3,8570,0,230,182,"Anderson",76978,27.2805217075008,0.036144578313253,120.813738990361,1.29907246226194,46.76660864143,3.6144578313253
2021-06-04,8780,1,6493,1,2287,0,7292,2,66219,53,73511,55,-1,172,-2,34,4,8574,0,230,182,"Anderson",76978,22.0842318584531,0.031413612565445,71.448985424407,1.29907246226194,44.1684637169061,3.1413612565445
2021-06-05,8781,1,6494,1,2287,0,7293,1,66276,57,73569,58,0,172,-3,31,4,8578,0,230,182,"Anderson",76978,22.0842318584531,0.032258064516129,75.3462028111928,1.29907246226194,40.2712463301203,3.2258064516129
2021-06-06,8781,0,6494,0,2287,0,7293,0,66301,25,73594,25,0,172,-4,27,4,8582,0,230,182,"Anderson",76978,18.1870144716672,0.0318302387267905,32.4768115565486,0,35.0749564810725,3.18302387267904
2021-06-07,8782,1,6494,0,2288,1,7293,0,66365,64,73658,64,0,172,-1,26,2,8584,0,230,182,"Anderson",76978,14.2897970848814,0.0232558139534884,83.1406375847645,1.29907246226194,33.7758840188106,2.32558139534884
2021-06-08,8783,1,6494,0,2289,1,7293,0,66402,37,73695,37,0,172,-1,25,2,8586,1,231,183,"Anderson",76978,11.6916521603575,0.0213333333333333,48.065681103692,1.29907246226194,32.4768115565486,2.13333333333333
2021-06-09,8783,0,6494,0,2289,0,7293,0,66484,82,73777,82,0,172,-4,21,4,8590,0,231,183,"Anderson",76978,6.49536231130972,0.0144927536231884,106.523941905479,0,27.2805217075008,1.44927536231884
2021-06-10,8787,4,6495,1,2292,3,7294,1,66541,57,73835,58,0,172,4,25,0,8590,0,231,183,"Anderson",76978,10.3925796980956,0.0105540897097625,75.3462028111928,5.19628984904778,32.4768115565486,1.05540897097625
2021-06-11,8788,1,6495,0,2293,1,7295,1,66596,55,73891,56,1,173,-3,22,3,8593,0,231,183,"Anderson",76978,10.3925796980956,0.00789473684210526,72.7480578866689,1.29907246226194,28.5795941697628,0.789473684210526
2021-06-12,8789,1,6495,0,2294,1,7296,1,66651,55,73947,56,2,175,-4,18,3,8596,0,231,183,"Anderson",76978,10.3925796980956,0.00793650793650794,72.7480578866689,1.29907246226194,23.383304320715,0.793650793650794
2021-06-13,8790,1,6495,0,2295,1,7297,1,66689,38,73986,39,0,175,-3,15,4,8600,0,231,183,"Anderson",76978,11.6916521603575,0.0102040816326531,50.6638260282159,1.29907246226194,19.4860869339292,1.02040816326531
2021-06-14,8792,2,6497,2,2295,0,7299,2,66775,86,74074,88,0,175,1,16,1,8601,0,231,183,"Anderson",76978,12.9907246226194,0.0144230769230769,114.318376679051,2.59814492452389,20.7851593961911,1.44230769230769
2021-06-15,8792,0,6497,0,2295,0,7300,1,66806,31,74106,32,0,175,-2,14,2,8603,0,231,183,"Anderson",76978,11.6916521603575,0.0170316301703163,41.5703187923822,0,18.1870144716672,1.70316301703163
2021-06-16,8793,1,6498,1,2295,0,7301,1,66850,44,74151,45,0,175,0,14,1,8604,0,231,183,"Anderson",76978,12.9907246226194,0.0213903743315508,58.4582608017875,1.29907246226194,18.1870144716672,2.13903743315508
2021-06-17,8793,0,6498,0,2295,0,7301,0,66936,86,74237,86,0,175,-1,13,1,8605,0,231,183,"Anderson",76978,7.79443477357167,0.0174129353233831,111.720231754527,0,16.8879420094053,1.74129353233831
2021-06-18,8795,2,6499,1,2296,1,7305,4,66986,50,74291,54,0,175,1,14,1,8606,0,231,183,"Anderson",76978,9.09350723583361,0.025,70.149912962145,2.59814492452389,18.1870144716672,2.5
2021-06-19,8795,0,6499,0,2296,0,7305,0,67034,48,74339,48,0,175,-1,13,1,8607,0,231,183,"Anderson",76978,7.79443477357167,0.0229591836734694,62.3554781885734,0,16.8879420094053,2.29591836734694
2021-06-20,8795,0,6499,0,2296,0,7306,1,67057,23,74363,24,0,175,-2,11,2,8609,0,231,183,"Anderson",76978,6.49536231130972,0.0238726790450928,31.1777390942867,0,14.2897970848814,2.38726790450928
2021-06-21,8796,1,6499,0,2297,1,7306,0,67097,40,74403,40,0,175,0,11,1,8610,0,231,183,"Anderson",76978,5.19628984904778,0.0212765957446809,51.9628984904778,1.29907246226194,14.2897970848814,2.12765957446809
2021-06-22,8800,4,6500,1,2300,3,7306,0,67139,42,74445,42,0,175,2,13,2,8612,1,232,183,"Anderson",76978,10.3925796980956,0.0176991150442478,54.5610434150017,5.19628984904778,16.8879420094053,1.76991150442478
2021-06-23,8801,1,6501,1,2300,0,7307,1,67187,48,74494,49,0,175,1,14,0,8612,0,232,183,"Anderson",76978,10.3925796980956,0.0174927113702624,63.6545506508353,1.29907246226194,18.1870144716672,1.74927113702624
2021-06-24,8801,0,6501,0,2300,0,7308,1,67232,45,74540,46,0,175,-3,11,3,8615,0,232,183,"Anderson",76978,10.3925796980956,0.0231023102310231,59.7573332640495,0,14.2897970848814,2.31023102310231
2021-06-25,8802,1,6502,1,2300,0,7309,1,67268,36,74577,37,0,175,1,12,0,8615,0,232,183,"Anderson",76978,9.09350723583361,0.013986013986014,48.065681103692,1.29907246226194,15.5888695471433,1.3986013986014
2021-06-26,8803,1,6503,1,2300,0,7310,1,67301,33,74611,34,0,175,0,12,1,8616,0,232,183,"Anderson",76978,10.3925796980956,0.0183823529411765,44.1684637169061,1.29907246226194,15.5888695471433,1.83823529411765
2021-06-27,8803,0,6503,0,2300,0,7310,0,67333,32,74643,32,0,175,0,12,0,8616,0,232,183,"Anderson",76978,10.3925796980956,0.0142857142857143,41.5703187923822,0,15.5888695471433,1.42857142857143
2021-06-28,8804,1,6503,0,2301,1,7311,1,67349,16,74660,17,0,175,1,13,0,8616,0,232,183,"Anderson",76978,10.3925796980956,0.0194552529182879,22.0842318584531,1.29907246226194,16.8879420094053,1.94552529182879
2021-06-29,8807,3,6506,3,2301,0,7314,3,67408,59,74722,62,0,175,2,15,1,8617,0,232,183,"Anderson",76978,9.09350723583361,0.0288808664259928,80.5424926602406,3.89721738678583,19.4860869339292,2.88808664259928
2021-06-30,8807,0,6506,0,2301,0,7314,0,67454,46,74768,46,0,175,-1,14,1,8618,0,232,183,"Anderson",76978,7.79443477357167,0.0255474452554745,59.7573332640495,0,18.1870144716672,2.55474452554745
2021-07-01,8808,1,6507,1,2301,0,7315,1,67491,37,74806,38,0,175,1,15,0,8618,0,232,183,"Anderson",76978,9.09350723583361,0.0263157894736842,49.3647535659539,1.29907246226194,19.4860869339292,2.63157894736842
2021-07-02,8808,0,6507,0,2301,0,7315,0,67534,43,74849,43,0,175,0,15,0,8618,0,232,183,"Anderson",76978,7.79443477357167,0.0220588235294118,55.8601158772636,0,19.4860869339292,2.20588235294118
2021-07-03,8808,0,6507,0,2301,0,7315,0,67555,21,74870,21,0,175,-1,14,1,8619,0,232,183,"Anderson",76978,6.49536231130972,0.0193050193050193,27.2805217075008,0,18.1870144716672,1.93050193050193
2021-07-04,8809,1,6507,0,2302,1,7316,1,67580,25,74896,26,0,175,0,14,1,8620,0,232,183,"Anderson",76978,7.79443477357167,0.0237154150197628,33.7758840188106,1.29907246226194,18.1870144716672,2.37154150197628
2021-07-05,8809,0,6507,0,2302,0,7317,1,67595,15,74912,16,0,175,-1,13,1,8621,0,232,183,"Anderson",76978,6.49536231130972,0.0238095238095238,20.7851593961911,0,16.8879420094053,2.38095238095238
2021-07-06,8810,1,6507,0,2303,1,7317,0,67625,30,74942,30,1,176,-3,10,3,8624,0,232,183,"Anderson",76978,3.89721738678583,0.0136363636363636,38.9721738678584,1.29907246226194,12.9907246226195,1.36363636363636
2021-07-07,8811,1,6507,0,2304,1,7317,0,67671,46,74988,46,0,176,-2,8,3,8627,0,232,183,"Anderson",76978,5.19628984904778,0.0136363636363636,59.7573332640495,1.29907246226194,10.3925796980956,1.36363636363636
2021-07-08,8812,1,6508,1,2304,0,7318,1,67712,41,75030,42,0,176,-1,7,2,8629,0,232,183,"Anderson",76978,5.19628984904778,0.0133928571428571,54.5610434150017,1.29907246226194,9.09350723583361,1.33928571428571
2021-07-09,8814,2,6509,1,2305,1,7319,1,67756,44,75075,45,0,176,1,8,1,8630,0,232,183,"Anderson",76978,7.79443477357167,0.0176991150442478,58.4582608017875,2.59814492452389,10.3925796980956,1.76991150442478
2021-07-10,8816,2,6510,1,2306,1,7320,1,67778,22,75098,23,0,176,2,10,0,8630,1,233,183,"Anderson",76978,10.3925796980956,0.0219298245614035,29.8786666320247,2.59814492452389,12.9907246226195,2.19298245614035
2021-07-11,8816,0,6510,0,2306,0,7320,0,67793,15,75113,15,0,176,0,10,0,8630,0,233,183,"Anderson",76978,9.09350723583361,0.0184331797235023,19.4860869339292,0,12.9907246226195,1.84331797235023
2021-07-12,8824,8,6514,4,2310,4,7324,4,67829,36,75153,40,0,176,7,17,1,8631,1,234,183,"Anderson",76978,19.4860869339292,0.029045643153527,51.9628984904778,10.3925796980956,22.0842318584531,2.9045643153527
2021-07-13,8825,1,6514,0,2311,1,7324,0,67850,21,75174,21,0,176,0,17,1,8632,0,234,185,"Anderson",76978,19.4860869339292,0.0301724137931034,27.2805217075008,1.29907246226194,22.0842318584531,3.01724137931034
2021-07-14,8830,5,6519,5,2311,0,7329,5,67904,54,75233,59,0,176,5,22,0,8632,1,235,185,"Anderson",76978,24.682376782977,0.0489795918367347,76.6452752734548,6.49536231130973,28.5795941697628,4.89795918367347
2021-07-15,8833,3,6522,3,2311,0,7331,2,67937,33,75268,35,0,176,3,25,0,8632,0,235,185,"Anderson",76978,27.2805217075008,0.0546218487394958,45.4675361791681,3.89721738678583,32.4768115565486,5.46218487394958
2021-07-16,8843,10,6524,2,2319,8,7332,1,67965,28,75297,29,0,176,10,35,0,8632,0,235,185,"Anderson",76978,37.6731014055964,0.0585585585585586,37.6731014055964,12.9907246226195,45.4675361791681,5.85585585585586
2021-07-17,8848,5,6525,1,2323,4,7333,1,68001,36,75334,37,0,176,4,39,1,8633,0,235,185,"Anderson",76978,41.5703187923822,0.0550847457627119,48.065681103692,6.49536231130973,50.6638260282159,5.50847457627119
2021-07-18,8851,3,6527,2,2324,1,7335,2,68021,20,75356,22,0,176,-1,38,4,8637,0,235,185,"Anderson",76978,45.4675361791681,0.0617283950617284,28.5795941697628,3.89721738678583,49.3647535659539,6.17283950617284
2021-07-19,8856,5,6531,4,2325,1,7339,4,68055,34,75394,38,1,177,2,40,2,8639,0,235,185,"Anderson",76978,41.5703187923822,0.0622406639004149,49.3647535659539,6.49536231130973,51.9628984904778,6.22406639004149
2021-07-20,8871,15,6542,11,2329,4,7350,11,68090,35,75440,46,0,177,10,50,5,8644,1,236,185,"Anderson",76978,59.7573332640495,0.0977443609022556,59.7573332640495,19.4860869339292,64.9536231130973,9.77443609022556
2021-07-21,8878,7,6546,4,2332,3,7355,5,68175,85,75530,90,0,177,6,56,1,8645,0,236,186,"Anderson",76978,62.3554781885734,0.0875420875420875,116.916521603575,9.09350723583361,72.7480578866689,8.75420875420875
2021-07-22,8888,10,6551,5,2337,5,7359,4,68231,56,75590,60,0,177,9,65,1,8646,0,236,186,"Anderson",76978,71.448985424407,0.0869565217391304,77.9443477357167,12.9907246226195,84.4397100470264,8.69565217391304
2021-07-23,8898,10,6555,4,2343,6,7364,5,68302,71,75666,76,0,177,10,75,0,8646,0,236,186,"Anderson",76978,71.448985424407,0.0867208672086721,98.7295071319078,12.9907246226195,97.4304346696459,8.67208672086721
2021-07-24,8906,8,6559,4,2347,4,7368,4,68356,54,75724,58,0,177,7,82,1,8647,0,236,187,"Anderson",76978,75.3462028111928,0.0897435897435897,75.3462028111928,10.3925796980956,106.523941905479,8.97435897435897
2021-07-25,8911,5,6562,3,2349,2,7369,1,68378,22,75747,23,0,177,2,84,3,8650,0,236,187,"Anderson",76978,77.9443477357167,0.0869565217391304,29.8786666320247,6.49536231130973,109.122086830003,8.69565217391304
2021-07-26,8934,23,6571,9,2363,14,7377,8,68428,50,75805,58,2,179,13,97,8,8658,0,236,187,"Anderson",76978,101.327652056432,0.0924574209245742,75.3462028111928,29.8786666320247,126.010028839409,9.24574209245742
2021-07-27,8949,15,6576,5,2373,10,7382,5,68481,53,75863,58,0,179,12,109,3,8661,0,236,187,"Anderson",76978,101.327652056432,0.0756501182033097,75.3462028111928,19.4860869339292,141.598898386552,7.56501182033097
2021-07-28,8969,20,6584,8,2385,12,7394,12,68564,83,75958,95,0,179,14,123,6,8667,0,236,187,"Anderson",76978,118.215594065837,0.0911214953271028,123.411883914885,25.9814492452389,159.785912858219,9.11214953271028
2021-07-29,8981,12,6594,10,2387,2,7406,12,68613,49,76019,61,0,179,8,131,4,8671,0,236,187,"Anderson",76978,120.813738990361,0.10955710955711,79.2434201979787,15.5888695471433,170.178492556315,10.955710955711
2021-07-30,9012,31,6615,21,2397,10,7429,23,68662,49,76091,72,0,179,19,150,12,8683,1,237,187,"Anderson",76978,148.094260697862,0.152941176470588,93.53321728286,40.2712463301203,194.860869339292,15.2941176470588
2021-07-31,9025,13,6621,6,2404,7,7435,6,68704,42,76139,48,0,179,8,158,5,8688,0,237,187,"Anderson",76978,154.589623009171,0.16144578313253,62.3554781885734,16.8879420094053,205.253449037387,16.144578313253
2021-08-01,9044,19,6632,11,2412,8,7450,15,68743,39,76193,54,0,179,14,172,5,8693,0,237,187,"Anderson",76978,172.776637480839,0.181614349775785,70.149912962145,24.682376782977,223.440463509055,18.1614349775785
2021-08-02,9055,11,6637,5,2418,6,7455,5,68822,79,76277,84,0,179,3,175,8,8701,0,237,187,"Anderson",76978,157.187767933695,0.165254237288136,109.122086830003,14.2897970848814,227.33768089584,16.5254237288136
2021-08-03,9078,23,6648,11,2430,12,7468,13,68894,72,76362,85,0,179,14,189,9,8710,1,238,187,"Anderson",76978,167.580347631791,0.172344689378758,110.421159292265,29.8786666320247,245.524695367508,17.2344689378758
2021-08-04,9104,26,6670,22,2434,4,7489,21,68996,102,76485,123,0,179,24,213,2,8712,0,238,187,"Anderson",76978,175.374782405363,0.180265654648956,159.785912858219,33.7758840188106,276.702434461794,18.0265654648956
2021-08-05,9134,30,6686,16,2448,14,7505,16,69094,98,76599,114,0,179,13,226,17,8729,1,239,187,"Anderson",76978,198.758086726078,0.170689655172414,148.094260697862,38.9721738678584,293.5903764712,17.0689655172414
2021-08-06,9159,25,6702,16,2457,9,7523,18,69237,143,76760,161,0,179,17,243,8,8737,1,240,187,"Anderson",76978,190.963651952506,0.14050822122571,209.150666424173,32.4768115565486,315.674608329653,14.050822122571
2021-08-07,9172,13,6708,6,2464,7,7530,7,69312,75,76842,82,0,179,5,248,8,8745,0,240,187,"Anderson",76978,190.963651952506,0.135135135135135,106.523941905479,16.8879420094053,322.169970640962,13.5135135135135
2021-08-08,9186,14,6716,8,2470,6,7540,10,69364,52,76904,62,0,179,6,254,8,8753,0,240,187,"Anderson",76978,184.468289641196,0.126582278481013,80.5424926602406,18.1870144716672,329.964405414534,12.6582278481013
2021-08-09,9222,36,6736,20,2486,16,7559,19,69463,99,77022,118,0,179,16,270,20,8773,0,240,187,"Anderson",76978,216.945101197745,0.139597315436242,153.29055054691,46.76660864143,350.749564810725,13.9597315436242
2021-08-10,9261,39,6756,20,2505,19,7579,20,69563,100,77142,120,0,179,20,290,19,8792,2,242,187,"Anderson",76978,237.730260593936,0.142307692307692,155.888695471433,50.6638260282159,376.731014055964,14.2307692307692
2021-08-11,9315,54,6780,24,2535,30,7608,29,69695,132,77303,161,0,179,30,320,24,8816,1,243,187,"Anderson",76978,274.10428953727,0.145476772616137,209.150666424173,70.149912962145,415.703187923822,14.5476772616137
2021-08-12,9363,48,6816,36,2547,12,7645,37,69863,168,77508,205,0,179,27,347,21,8837,0,243,189,"Anderson",76978,297.487593857985,0.154015401540154,266.309854763699,62.3554781885734,450.778144404895,15.4015401540154
2021-08-13,9426,63,6851,35,2575,28,7683,38,69977,114,77660,152,2,181,45,392,16,8853,1,244,190,"Anderson",76978,346.852347423939,0.177777777777778,197.459014263816,81.8415651225025,509.236405206682,17.7777777777778
2021-08-14,9476,50,6886,35,2590,15,7715,32,70163,186,77878,218,0,181,29,421,21,8874,0,244,190,"Anderson",76978,394.918028527631,0.178571428571429,283.197796773104,64.9536231130973,546.909506612279,17.8571428571429
2021-08-15,9499,23,6899,13,2600,10,7730,15,70252,89,77982,104,0,181,16,437,7,8881,0,244,190,"Anderson",76978,406.609680687989,0.176252319109462,135.103536075242,29.8786666320247,567.69466600847,17.6252319109462
2021-08-16,9537,38,6923,24,2614,14,7754,24,70341,89,78095,113,0,181,11,448,27,8908,0,244,191,"Anderson",76978,409.207825612513,0.181733457595527,146.7951882356,49.3647535659539,581.984463093351,18.1733457595527
2021-08-17,9580,43,6944,21,2636,22,7778,24,70449,108,78227,132,1,182,14,462,28,8936,0,244,191,"Anderson",76978,414.40411546156,0.183410138248848,171.477565018577,55.8601158772636,600.171477565019,18.3410138248848
2021-08-18,9632,52,6971,27,2661,25,7809,31,70561,112,78370,143,0,182,16,478,36,8972,0,244,191,"Anderson",76978,411.805970537037,0.188378631677601,185.767362103458,67.5517680376211,620.95663696121,18.8378631677601
2021-08-19,9706,74,7004,33,2702,41,7844,35,70713,152,78557,187,0,182,48,526,26,8998,0,244,191,"Anderson",76978,445.581854555847,0.189704480457579,242.926550442984,96.1313622073839,683.312115149783,18.9704480457579
2021-08-20,9766,60,7046,42,2720,18,7888,44,70907,194,78795,238,0,182,27,553,33,9031,2,246,191,"Anderson",76978,441.684637169061,0.180616740088106,309.179246018343,77.9443477357167,718.387071630856,18.0616740088106
2021-08-21,9847,81,7079,33,2768,48,7922,34,71181,274,79103,308,0,182,60,613,21,9052,1,247,191,"Anderson",76978,481.955883499182,0.168979591836735,400.114318376679,105.224869443218,796.331419366572,16.8979591836735
2021-08-22,9870,23,7101,22,2769,1,7950,28,71337,156,79287,184,0,182,-2,611,25,9077,0,247,191,"Anderson",76978,481.955883499182,0.168582375478927,239.029333056198,29.8786666320247,793.733274442048,16.8582375478927
2021-08-23,9918,48,7115,14,2803,34,7967,17,71472,135,79439,152,0,182,-4,607,52,9129,2,249,192,"Anderson",76978,494.946608121801,0.158482142857143,197.459014263816,62.3554781885734,788.536984593001,15.8482142857143
2021-08-24,9962,44,7142,27,2820,17,7991,24,71558,86,79549,110,1,183,-23,584,66,9195,0,249,193,"Anderson",76978,496.245680584063,0.161119515885023,142.897970848814,57.1591883395256,758.658317960976,16.1119515885023
2021-08-25,10033,71,7168,26,2865,45,8013,22,71602,44,79615,66,0,183,15,599,56,9251,1,250,193,"Anderson",76978,520.92805736704,0.163855421686747,85.7387825092884,92.2341448205981,778.144404894905,16.3855421686747
2021-08-26,10101,68,7204,36,2897,32,8057,44,71774,172,79831,216,1,184,15,614,52,9303,2,252,194,"Anderson",76978,513.133622593468,0.167189952904239,280.59965184858,88.3369274338123,797.630491828834,16.7189952904239
2021-08-27,10176,75,7259,55,2917,20,8118,61,71951,177,80069,238,0,184,30,644,45,9348,0,252,194,"Anderson",76978,532.619709527397,0.180533751962323,309.179246018343,97.4304346696459,836.602665696693,18.0533751962323
2021-08-28,10235,59,7291,32,2944,27,8158,40,72155,204,80313,244,0,184,31,675,28,9376,0,252,194,"Anderson",76978,504.040115357635,0.19504132231405,316.973680791915,76.6452752734548,876.873912026813,19.504132231405
2021-08-29,10299,64,7340,49,2959,15,8212,54,72366,211,80578,265,0,184,40,715,24,9400,1,253,195,"Anderson",76978,557.302086310374,0.20294345468629,344.254202499415,83.1406375847645,928.836810517291,20.294345468629
2021-08-30,10370,71,7386,46,2984,25,8260,48,72592,226,80852,274,0,184,3,718,68,9468,3,256,195,"Anderson",76978,587.180752942399,0.207360226468507,355.945854659773,92.2341448205981,932.734027904076,20.7360226468507
2021-08-31,10504,134,7468,82,3036,52,8347,87,72849,257,81196,344,0,184,48,766,86,9554,0,256,196,"Anderson",76978,704.097274545974,0.216150576806314,446.880927018109,174.075709943101,995.08950609265,21.6150576806314
2021-09-01,10535,31,7490,22,3045,9,8371,24,72940,91,81311,115,0,184,-17,749,48,9602,0,256,197,"Anderson",76978,652.134376055496,0.211084905660377,149.393333160124,40.2712463301203,973.005274234197,21.1084905660377
2021-09-02,10594,59,7516,26,3078,33,8400,29,73041,101,81441,130,1,185,-9,740,67,9669,0,256,197,"Anderson",76978,640.442723895139,0.21304347826087,168.879420094053,76.6452752734548,961.313622073839,21.304347826087
2021-09-03,10623,29,7534,18,3089,11,8418,18,73114,73,81532,91,0,185,-38,702,67,9736,0,256,197,"Anderson",76978,580.685390631089,0.205058099794942,118.215594065837,37.6731014055964,911.948868507885,20.5058099794942
2021-09-04,10730,107,7604,70,3126,37,8494,76,73435,321,81929,397,0,185,77,779,30,9766,1,257,197,"Anderson",76978,643.040868819663,0.207920792079208,515.731767517992,139.000753462028,1011.97744810206,20.7920792079208
2021-09-05,10842,112,7678,74,3164,38,8570,76,73739,304,82309,380,0,185,76,855,36,9802,1,258,198,"Anderson",76978,705.396347008236,0.20681686886193,493.647535659539,145.496115773338,1110.70695523396,20.681686886193
2021-09-06,10957,115,7755,77,3202,38,8657,87,74146,407,82803,494,0,185,-5,850,120,9922,3,261,199,"Anderson",76978,762.555535347762,0.203485392106612,641.741796357401,149.393333160124,1104.21159292265,20.3485392106612
2021-09-07,10994,37,7775,20,3219,17,8675,18,74245,99,82920,117,0,185,-73,777,110,10032,0,261,199,"Anderson",76978,636.545506508353,0.190255220417633,151.991478084648,48.065681103692,1009.37930317753,19.0255220417633
2021-09-08,11035,41,7806,31,3229,10,8707,32,74352,107,83059,139,0,185,-57,720,98,10130,2,263,202,"Anderson",76978,649.536231130973,0.192219679633867,180.57107225441,53.2619709527397,935.3321728286,19.2219679633867
2021-09-09,11093,58,7827,21,3266,37,8725,18,74558,206,83283,224,0,185,-41,679,99,10229,1,264,205,"Anderson",76978,648.237158668711,0.176438653637351,290.992231546676,75.3462028111928,882.070201875861,17.6438653637351
2021-09-10,11245,152,7900,73,3345,79,8806,81,74851,293,83657,374,1,186,65,744,86,10315,2,266,206,"Anderson",76978,808.02307152693,0.182588235294118,485.853100885967,197.459014263816,966.509911922887,18.2588235294118
2021-09-11,11360,115,7962,62,3398,53,8875,69,75197,346,84072,415,0,186,82,826,33,10348,1,267,206,"Anderson",76978,818.415651225025,0.177788147456836,539.115071838707,149.393333160124,1073.03385382837,17.7788147456836
2021-09-12,11398,38,7994,32,3404,6,8910,35,75340,143,84250,178,0,186,5,831,33,10381,4,271,207,"Anderson",76978,722.284289017641,0.175167439464194,231.234898282626,49.3647535659539,1079.52921613968,17.5167439464194
2021-09-13,11486,88,8028,34,3458,54,8944,34,75470,130,84414,164,4,190,-47,784,131,10512,3,274,207,"Anderson",76978,687.209332536569,0.178150217256363,213.047883810959,114.318376679051,1018.47281041336,17.8150217256363
2021-09-14,11546,60,8058,30,3488,30,8979,35,75629,159,84608,194,1,191,-47,737,106,10618,1,275,207,"Anderson",76978,717.087999168594,0.180094786729858,252.020057678817,77.9443477357167,957.416404687054,18.0094786729858
2021-09-15,11586,40,8074,16,3512,24,8993,14,75690,61,84683,75,0,191,-42,695,82,10700,1,276,208,"Anderson",76978,715.788926706332,0.176108374384236,97.4304346696459,51.9628984904778,902.855361272052,17.6108374384236
2021-09-16,11672,86,8128,54,3544,32,9049,56,75912,222,84961,278,0,191,26,721,60,10760,1,277,208,"Anderson",76978,752.162955649666,0.193087008343266,361.142144508821,111.720231754527,936.631245290862,19.3087008343266
2021-09-17,11745,73,8170,42,3575,31,9086,37,76075,163,85161,200,0,191,15,736,58,10818,1,278,212,"Anderson",76978,649.536231130973,0.186170212765957,259.814492452389,94.832289745122,956.117332224792,18.6170212765957
2021-09-18,11797,52,8200,30,3597,22,9119,33,76229,154,85348,187,0,191,7,743,45,10863,1,279,213,"Anderson",76978,567.69466600847,0.191222570532915,242.926550442984,67.5517680376211,965.210839460625,19.1222570532915
2021-09-19,11820,23,8209,9,3611,14,9129,10,76297,68,85426,78,0,191,-17,726,40,10903,0,279,213,"Anderson",76978,548.208579074541,0.186224489795918,101.327652056432,29.8786666320247,943.126607602172,18.6224489795918
2021-09-20,11883,63,8244,35,3639,28,9165,36,76483,186,85648,222,0,191,25,751,38,10941,3,282,213,"Anderson",76978,515.731767517992,0.179092382495948,288.394086622152,81.8415651225025,975.603419158721,17.9092382495948
2021-09-21,11937,54,8270,26,3667,28,9189,24,76601,118,85790,142,0,191,-55,696,109,11050,1,283,214,"Anderson",76978,507.93733274442,0.177664974619289,184.468289641196,70.149912962145,904.154433734314,17.7664974619289
2021-09-22,11988,51,8304,34,3684,17,9229,40,76873,272,86102,312,0,191,-38,658,89,11139,0,283,216,"Anderson",76978,522.227129829302,0.16631430584919,405.310608225727,66.2526955753592,854.78968016836,16.631430584919
2021-09-23,12063,75,8352,48,3711,27,9280,51,77081,208,86361,259,2,193,-11,647,84,11223,1,284,216,"Anderson",76978,507.93733274442,0.165,336.459767725844,97.4304346696459,840.499883083478,16.5
2021-09-24,12104,41,8374,22,3730,19,9305,25,77221,140,86526,165,2,195,-18,629,57,11280,1,285,218,"Anderson",76978,466.367013952038,0.16043956043956,214.346956273221,53.2619709527397,817.116578762763,16.043956043956
2021-09-25,12114,10,8378,4,3736,6,9311,6,77316,95,86627,101,0,195,-35,594,45,11325,0,285,218,"Anderson",76978,411.805970537037,0.150117279124316,131.206318688456,12.9907246226195,771.649042583595,15.0117279124316
2021-09-26,12132,18,8393,15,3739,3,9329,18,77453,137,86782,155,1,196,-12,582,29,11354,0,285,218,"Anderson",76978,405.310608225727,0.147492625368732,201.356231650601,23.383304320715,756.060173036452,14.7492625368732
2021-09-27,12182,50,8414,21,3768,29,9351,22,77539,86,86890,108,1,197,-43,539,92,11446,1,286,219,"Anderson",76978,388.422666216322,0.14975845410628,140.29982592429,64.9536231130973,700.200057159188,14.975845410628
2021-09-28,12231,49,8438,24,3793,25,9378,27,77634,95,87012,122,0,197,-29,510,78,11524,1,287,219,"Anderson",76978,381.927303905012,0.154664484451718,158.486840395957,63.6545506508353,662.526955753592,15.4664484451718
2021-09-29,12267,36,8454,16,3813,20,9395,17,77825,191,87220,208,2,199,-37,473,71,11595,0,287,221,"Anderson",76978,362.441216971083,0.148479427549195,270.207072150485,46.76660864143,614.4612746499,14.8479427549195
2021-09-30,12329,62,8492,38,3837,24,9435,40,77997,172,87432,212,0,199,2,475,60,11655,1,288,222,"Anderson",76978,345.553274961677,0.144724556489262,275.403361999532,80.5424926602406,617.059419574424,14.4724556489262
2021-10-01,12380,51,8519,27,3861,24,9464,29,78148,151,87612,180,0,199,-10,465,61,11716,1,289,223,"Anderson",76978,358.543999584297,0.146408839779006,233.83304320715,66.2526955753592,604.068694951804,14.6408839779006
2021-10-02,12397,17,8526,7,3871,10,9470,6,78228,80,87698,86,1,200,-10,455,26,11742,0,289,225,"Anderson",76978,367.63750682013,0.148459383753501,111.720231754527,22.0842318584531,591.077970329185,14.8459383753501
2021-10-03,12410,13,8535,9,3875,4,9479,9,78326,98,87805,107,4,204,-10,445,19,11761,0,289,225,"Anderson",76978,361.142144508821,0.146627565982405,139.000753462028,16.8879420094053,578.087245706565,14.6627565982405
2021-10-04,12454,44,8558,23,3896,21,9505,26,78446,120,87951,146,1,205,-22,423,65,11826,0,289,227,"Anderson",76978,353.347709735249,0.145146088595664,189.664579490244,57.1591883395256,549.507651536803,14.5146088595664
2021-10-05,12507,53,8587,29,3920,24,9535,30,78574,128,88109,158,2,207,-15,408,66,11892,0,289,228,"Anderson",76978,358.543999584297,0.143117593436645,205.253449037387,68.8508404998831,530.021564602874,14.3117593436645
2021-10-06,12537,30,8610,23,3927,7,9561,26,78739,165,88300,191,1,208,-5,403,34,11926,0,289,229,"Anderson",76978,350.749564810725,0.153703703703704,248.122840292031,38.9721738678584,523.526202291564,15.3703703703704
2021-10-07,12569,32,8632,22,3937,10,9586,25,78878,139,88464,164,0,208,-10,393,42,11968,0,289,231,"Anderson",76978,311.777390942867,0.146317829457364,213.047883810959,41.5703187923822,510.535477668944,14.6317829457364
2021-10-08,12586,17,8637,5,3949,12,9596,10,79008,130,88604,140,1,209,-13,380,29,11997,1,290,231,"Anderson",76978,267.608927225961,0.133064516129032,181.870144716672,22.0842318584531,493.647535659539,13.3064516129032
2021-10-09,12601,15,8640,3,3961,12,9603,7,79070,62,88673,69,0,209,-12,368,27,12024,0,290,232,"Anderson",76978,265.010782301437,0.136410256410256,89.6359998960742,19.4860869339292,478.058666112396,13.6410256410256
2021-10-10,12611,10,8648,8,3963,2,9612,9,79157,87,88769,96,0,209,-15,353,25,12049,0,290,232,"Anderson",76978,261.113564914651,0.137966804979253,124.710956377147,12.9907246226195,458.572579178467,13.7966804979253
2021-10-11,12652,41,8662,14,3990,27,9625,13,79258,101,88883,114,0,209,-11,342,52,12101,1,291,232,"Anderson",76978,257.216347527865,0.128755364806867,148.094260697862,53.2619709527397,444.282782093585,12.8755364806867
2021-10-12,12687,35,8686,24,4001,11,9647,22,79357,99,89004,121,2,211,-9,333,42,12143,3,294,232,"Anderson",76978,233.83304320715,0.125139664804469,157.187767933695,45.4675361791681,432.591129933228,12.5139664804469
2021-10-13,12713,26,8700,14,4013,12,9665,18,79469,112,89134,130,0,211,-15,318,41,12184,1,295,235,"Anderson",76978,228.636753358102,0.124700239808153,168.879420094053,33.7758840188106,413.105042999298,12.4700239808153
2021-10-14,12732,19,8710,10,4022,9,9679,14,79572,103,89251,117,1,212,-21,297,39,12223,0,295,235,"Anderson",76978,211.748811348697,0.118170266836086,151.991478084648,24.682376782977,385.824521291798,11.8170266836086
2021-10-15,12755,23,8722,12,4033,11,9692,13,79694,122,89386,135,0,212,-15,282,38,12261,1,296,235,"Anderson",76978,219.543246122269,0.122762148337596,175.374782405363,29.8786666320247,366.338434357868,12.2762148337596
2021-10-16,12763,8,8727,5,4036,3,9699,7,79749,55,89448,62,0,212,-15,267,23,12284,1,297,235,"Anderson",76978,210.449738886435,0.123870967741935,80.5424926602406,10.3925796980956,346.852347423939,12.3870967741935
2021-10-17,12765,2,8728,1,4037,1,9700,1,79800,51,89500,52,0,212,-11,256,13,12297,0,297,235,"Anderson",76978,200.05715918834,0.120383036935705,67.5517680376211,2.59814492452389,332.562550339058,12.0383036935705
2021-10-18,12789,24,8738,10,4051,14,9711,11,79868,68,89579,79,1,213,-26,230,49,12346,1,298,235,"Anderson",76978,177.972927329886,0.123563218390805,102.626724518694,31.1777390942867,298.786666320247,12.3563218390805
2021-10-19,12818,29,8751,13,4067,16,9722,11,79979,111,89701,122,2,215,-17,213,44,12390,0,298,235,"Anderson",76978,170.178492556315,0.107604017216643,158.486840395957,37.6731014055964,276.702434461794,10.7604017216643
2021-10-20,12853,35,8777,26,4076,9,9751,29,80090,111,89841,140,0,215,12,225,23,12413,1,299,236,"Anderson",76978,181.870144716672,0.121640735502122,181.870144716672,45.4675361791681,292.291304008938,12.1640735502122
2021-10-21,12885,32,8795,18,4090,14,9769,18,80183,93,89952,111,0,215,11,236,21,12434,1,300,237,"Anderson",76978,198.758086726078,0.128388017118402,144.197043311076,41.5703187923822,306.581101093819,12.8388017118402
2021-10-22,12894,9,8801,6,4093,3,9777,8,80259,76,90036,84,0,215,-23,213,32,12466,1,301,237,"Anderson",76978,180.57107225441,0.130769230769231,109.122086830003,11.6916521603575,276.702434461794,13.0769230769231
2021-10-23,12911,17,8805,4,4106,13,9781,4,80312,53,90093,57,0,215,3,216,14,12480,1,302,237,"Anderson",76978,192.262724414768,0.127131782945736,74.0471303489309,22.0842318584531,280.59965184858,12.7131782945736
2021-10-24,12917,6,8810,5,4107,1,9788,7,80364,52,90152,59,0,215,-10,206,16,12496,0,302,238,"Anderson",76978,197.459014263816,0.134969325153374,76.6452752734548,7.79443477357167,267.608927225961,13.4969325153374
2021-10-25,12941,24,8823,13,4118,11,9802,14,80435,71,90237,85,1,216,-8,198,31,12527,2,304,238,"Anderson",76978,197.459014263816,0.138297872340426,110.421159292265,31.1777390942867,257.216347527865,13.8297872340426
2021-10-26,12953,12,8829,6,4124,6,9808,6,80499,64,90307,70,0,216,-9,189,21,12548,0,304,239,"Anderson",76978,175.374782405363,0.141914191419142,90.9350723583361,15.5888695471433,245.524695367508,14.1914191419142
2021-10-27,12971,18,8839,10,4132,8,9821,13,80620,121,90441,134,1,217,-4,185,21,12569,2,306,241,"Anderson",76978,153.29055054691,0.116666666666667,174.075709943101,23.383304320715,240.32840551846,11.6666666666667
2021-10-28,12993,22,8853,14,4140,8,9838,17,80702,82,90540,99,1,218,7,192,14,12583,0,306,242,"Anderson",76978,140.29982592429,0.11734693877551,128.608173763933,28.5795941697628,249.421912754293,11.734693877551
2021-10-29,13014,21,8864,11,4150,10,9850,12,80816,114,90666,126,0,218,7,199,14,12597,1,307,242,"Anderson",76978,155.888695471433,0.115873015873016,163.683130245005,27.2805217075008,258.515419990127,11.5873015873016
2021-10-30,13026,12,8868,4,4158,8,9855,5,80903,87,90758,92,0,218,0,199,12,12609,1,308,242,"Anderson",76978,149.393333160124,0.111278195488722,119.514666528099,15.5888695471433,258.515419990127,11.1278195488722
2021-10-31,13029,3,8870,2,4159,1,9858,3,80942,39,90800,42,0,218,-8,191,11,12620,0,308,242,"Anderson",76978,145.496115773338,0.108024691358025,54.5610434150017,3.89721738678583,248.122840292031,10.8024691358025
2021-11-01,13056,27,8875,5,4181,22,9862,4,81030,88,90892,92,1,219,-15,176,41,12661,1,309,243,"Anderson",76978,149.393333160124,0.0916030534351145,119.514666528099,35.0749564810725,228.636753358102,9.16030534351145
2021-11-02,13076,20,8880,5,4196,15,9867,5,81106,76,90973,81,2,221,-6,170,24,12685,1,310,243,"Anderson",76978,159.785912858219,0.0885885885885886,105.224869443218,25.9814492452389,220.842318584531,8.85885885885886
2021-11-03,13105,29,8897,17,4208,12,9884,17,81306,200,91190,217,1,222,10,180,18,12703,0,310,243,"Anderson",76978,174.075709943101,0.0841121495327103,281.898724310842,37.6731014055964,233.83304320715,8.41121495327103
2021-11-04,13127,22,8912,15,4215,7,9900,16,81439,133,91339,149,0,222,6,186,16,12719,0,310,243,"Anderson",76978,174.075709943101,0.0775969962453066,193.56179687703,28.5795941697628,241.627477980722,7.75969962453066
2021-11-05,13137,10,8915,3,4222,7,9901,1,81561,122,91462,123,0,222,3,189,7,12726,0,310,243,"Anderson",76978,159.785912858219,0.064070351758794,159.785912858219,12.9907246226195,245.524695367508,6.4070351758794
2021-11-06,13146,9,8919,4,4227,5,9906,5,81648,87,91554,92,0,222,-4,185,13,12739,3,313,244,"Anderson",76978,155.888695471433,0.064070351758794,119.514666528099,11.6916521603575,240.32840551846,6.4070351758794
2021-11-07,13152,6,8924,5,4228,1,9912,6,81696,48,91608,54,0,222,-4,181,10,12749,0,313,244,"Anderson",76978,159.785912858219,0.0668316831683168,70.149912962145,7.79443477357167,235.132115669412,6.68316831683168
2021-11-08,13177,25,8935,11,4242,14,9925,13,81784,88,91709,101,1,223,-1,180,25,12774,0,313,244,"Anderson",76978,157.187767933695,0.0771113831089351,131.206318688456,32.4768115565486,233.83304320715,7.71113831089351
2021-11-09,13200,23,8942,7,4258,16,9931,6,81942,158,91873,164,1,224,6,186,16,12790,0,313,245,"Anderson",76978,161.084985320481,0.0711111111111111,213.047883810959,29.8786666320247,241.627477980722,7.11111111111111
2021-11-10,13219,19,8954,12,4265,7,9944,13,82058,116,92002,129,0,224,4,190,15,12805,1,314,247,"Anderson",76978,148.094260697862,0.0738916256157636,167.580347631791,24.682376782977,246.82376782977,7.38916256157635
2021-11-11,13241,22,8971,17,4270,5,9961,17,82248,190,92209,207,0,224,1,191,21,12826,0,314,248,"Anderson",76978,148.094260697862,0.0701149425287356,268.907999688223,28.5795941697628,248.122840292031,7.01149425287356
2021-11-12,13254,13,8979,8,4275,5,9969,8,82381,133,92350,141,0,224,1,192,12,12838,1,315,248,"Anderson",76978,151.991478084648,0.0765765765765766,183.169217178934,16.8879420094053,249.421912754293,7.65765765765766
2021-11-13,13261,7,8983,4,4278,3,9973,4,82432,51,92405,55,3,227,-10,182,14,12852,1,316,249,"Anderson",76978,149.393333160124,0.0787309048178613,71.448985424407,9.09350723583361,236.431188131674,7.87309048178613
2021-11-14,13263,2,8985,2,4278,0,9976,3,82511,79,92487,82,0,227,-4,178,6,12858,0,316,249,"Anderson",76978,144.197043311076,0.0728100113765643,106.523941905479,2.59814492452389,231.234898282626,7.28100113765643
2021-11-15,13295,32,8999,14,4296,18,9990,14,82596,85,92586,99,0,227,5,183,27,12885,0,316,250,"Anderson",76978,153.29055054691,0.0741163055872292,128.608173763933,41.5703187923822,237.730260593936,7.41163055872292
2021-11-16,13320,25,9012,13,4308,12,10003,13,82722,126,92725,139,1,228,-2,181,26,12911,0,316,251,"Anderson",76978,155.888695471433,0.0845070422535211,180.57107225441,32.4768115565486,235.132115669412,8.45070422535211
2021-11-17,13337,17,9021,9,4316,8,10012,9,82836,114,92848,123,0,228,-2,179,19,12930,2,318,253,"Anderson",76978,153.29055054691,0.0803782505910166,159.785912858219,22.0842318584531,232.533970744888,8.03782505910165
2021-11-18,13360,23,9035,14,4325,9,10030,18,82971,135,93001,153,4,232,4,183,15,12945,0,318,255,"Anderson",76978,154.589623009171,0.0871212121212121,198.758086726078,29.8786666320247,237.730260593936,8.71212121212121
2021-11-19,13374,14,9041,6,4333,8,10037,7,83080,109,93117,116,1,233,2,185,11,12956,0,318,255,"Anderson",76978,155.888695471433,0.0886571056062582,150.692405622386,18.1870144716672,240.32840551846,8.86571056062582
2021-11-20,13383,9,9046,5,4337,4,10042,5,83173,93,93215,98,0,233,-9,176,18,12974,0,318,256,"Anderson",76978,158.486840395957,0.0851851851851852,127.309101301671,11.6916521603575,228.636753358102,8.51851851851852
2021-11-21,13395,12,9052,6,4343,6,10048,6,83213,40,93261,46,0,233,4,180,8,12982,0,318,256,"Anderson",76978,171.477565018577,0.0930232558139535,59.7573332640495,15.5888695471433,233.83304320715,9.30232558139535
2021-11-22,13423,28,9069,17,4354,11,10066,18,83335,122,93401,140,1,234,6,186,21,13003,0,318,256,"Anderson",76978,166.281275169529,0.0932515337423313,181.870144716672,36.3740289433345,241.627477980722,9.32515337423313
2021-11-23,13440,17,9075,6,4365,11,10071,5,83432,97,93503,102,0,234,-5,181,22,13025,1,319,257,"Anderson",76978,155.888695471433,0.0874035989717224,132.505391150718,22.0842318584531,235.132115669412,8.74035989717224
2021-11-24,13465,25,9091,16,4374,9,10083,12,83542,110,93625,122,1,235,6,187,18,13043,1,320,257,"Anderson",76978,166.281275169529,0.0913770913770914,158.486840395957,32.4768115565486,242.926550442984,9.13770913770914
2021-11-25,13470,5,9093,2,4377,3,10084,1,83587,45,93671,46,0,235,-12,175,17,13060,2,322,257,"Anderson",76978,142.897970848814,0.0805970149253731,59.7573332640495,6.49536231130973,227.33768089584,8.05970149253731
2021-11-26,13477,7,9099,6,4378,1,10093,9,83630,43,93723,52,0,235,-7,168,14,13074,0,322,258,"Anderson",76978,133.80446361298,0.0924092409240924,67.5517680376211,9.09350723583361,218.244173660007,9.24092409240924
2021-11-27,13482,5,9101,2,4381,3,10095,2,83666,36,93761,38,0,235,-8,160,13,13087,0,322,258,"Anderson",76978,128.608173763933,0.0970695970695971,49.3647535659539,6.49536231130973,207.851593961911,9.70695970695971
2021-11-28,13492,10,9102,1,4390,9,10096,1,83704,38,93800,39,0,235,-10,150,20,13107,0,322,258,"Anderson",76978,126.010028839409,0.0890538033395176,50.6638260282159,12.9907246226195,194.860869339292,8.90538033395176
2021-11-29,13519,27,9117,15,4402,12,10112,16,83783,79,93895,95,0,235,13,163,14,13121,0,322,258,"Anderson",76978,124.710956377147,0.0931174089068826,123.411883914885,35.0749564810725,211.748811348697,9.31174089068826
2021-11-30,13546,27,9131,14,4415,13,10124,12,83885,102,94009,114,0,235,14,177,13,13134,1,323,258,"Anderson",76978,137.701680999766,0.104743083003953,148.094260697862,35.0749564810725,229.935825820364,10.4743083003953
2021-12-01,13577,31,9149,18,4428,13,10142,18,83992,107,94134,125,0,235,15,192,16,13150,2,325,258,"Anderson",76978,145.496115773338,0.115913555992141,162.384057782743,40.2712463301203,249.421912754293,11.5913555992141
2021-12-02,13619,42,9173,24,4446,18,10168,26,84130,138,94298,164,0,235,23,215,19,13169,0,325,261,"Anderson",76978,193.56179687703,0.133971291866029,213.047883810959,54.5610434150017,279.300579386318,13.3971291866029
2021-12-03,13650,31,9191,18,4459,13,10187,19,84317,187,94504,206,1,236,18,233,12,13181,1,326,261,"Anderson",76978,224.739535971316,0.120358514724712,267.608927225961,40.2712463301203,302.683883707033,12.0358514724712
2021-12-04,13670,20,9204,13,4466,7,10201,14,84386,69,94587,83,0,236,8,241,12,13193,0,326,261,"Anderson",76978,244.225622905246,0.128329297820823,107.823014367741,25.9814492452389,313.076463405129,12.8329297820823
2021-12-05,13683,13,9206,2,4477,11,10203,2,84428,42,94631,44,0,236,0,241,13,13206,0,326,261,"Anderson",76978,248.122840292031,0.128760529482551,57.1591883395256,16.8879420094053,313.076463405129,12.8760529482551
2021-12-06,13718,35,9226,20,4492,15,10225,22,84530,102,94755,124,2,238,7,248,26,13232,1,327,261,"Anderson",76978,258.515419990127,0.131395348837209,161.084985320481,45.4675361791681,322.169970640962,13.1395348837209
2021-12-07,13747,29,9241,15,4506,14,10241,16,84625,95,94866,111,0,238,19,267,10,13242,0,327,261,"Anderson",76978,261.113564914651,0.136522753792299,144.197043311076,37.6731014055964,346.852347423939,13.6522753792299
2021-12-08,13774,27,9262,21,4512,6,10261,20,84746,121,95007,141,0,238,17,284,10,13252,1,328,261,"Anderson",76978,255.917275065603,0.13631156930126,183.169217178934,35.0749564810725,368.936579282392,13.631156930126
2021-12-09,13802,28,9278,16,4524,12,10278,17,84956,210,95234,227,0,238,13,297,15,13267,1,329,261,"Anderson",76978,237.730260593936,0.117521367521368,294.889448933461,36.3740289433345,385.824521291798,11.7521367521368
2021-12-10,13831,29,9295,17,4536,12,10295,17,85109,153,95404,170,0,238,9,306,20,13287,1,330,261,"Anderson",76978,235.132115669412,0.12,220.842318584531,37.6731014055964,397.516173452155,12
2021-12-11,13841,10,9300,5,4541,5,10301,6,85184,75,95485,81,0,238,-2,304,12,13299,0,330,262,"Anderson",76978,222.141391046793,0.111358574610245,105.224869443218,12.9907246226195,394.918028527631,11.1358574610245
2021-12-12,13861,20,9311,11,4550,9,10313,12,85254,70,95567,82,0,238,3,307,17,13316,0,330,262,"Anderson",76978,231.234898282626,0.117521367521368,106.523941905479,25.9814492452389,398.815245914417,11.7521367521368
2021-12-13,13891,30,9317,6,4574,24,10320,7,85329,75,95649,82,0,238,-9,298,39,13355,0,330,265,"Anderson",76978,224.739535971316,0.106263982102908,106.523941905479,38.9721738678584,387.12359375406,10.6263982102908
2021-12-14,13905,14,9322,5,4583,9,10326,6,85408,79,95734,85,3,241,-10,288,21,13376,1,331,265,"Anderson",76978,205.253449037387,0.097926267281106,110.421159292265,18.1870144716672,374.13286913144,9.7926267281106
2021-12-15,13931,26,9336,14,4595,12,10341,15,85537,129,95878,144,0,241,-1,287,27,13403,0,331,266,"Anderson",76978,203.954376575125,0.0918484500574053,187.06643456572,33.7758840188106,372.833796669178,9.18484500574053
2021-12-16,13959,28,9346,10,4613,18,10356,15,85632,95,95988,110,0,241,7,294,21,13424,2,333,266,"Anderson",76978,203.954376575125,0.103448275862069,142.897970848814,36.3740289433345,381.927303905012,10.3448275862069
2021-12-17,13990,31,9369,23,4621,8,10378,22,85787,155,96165,177,1,242,0,294,30,13454,0,333,267,"Anderson",76978,206.552521499649,0.109067017082786,229.935825820364,40.2712463301203,381.927303905012,10.9067017082786
2021-12-18,14002,12,9379,10,4623,2,10388,10,85869,82,96257,92,0,242,2,296,10,13464,0,333,267,"Anderson",76978,209.150666424173,0.112694300518135,119.514666528099,15.5888695471433,384.525448829536,11.2694300518135
2021-12-19,14016,14,9387,8,4629,6,10399,11,85949,80,96348,91,0,242,-8,288,22,13486,0,333,267,"Anderson",76978,201.356231650601,0.1101152368758,118.215594065837,18.1870144716672,374.13286913144,11.01152368758
2021-12-20,14040,24,9403,16,4637,8,10413,14,86035,86,96448,100,0,242,-4,284,28,13514,0,333,268,"Anderson",76978,193.56179687703,0.11639549436796,129.907246226195,31.1777390942867,368.936579282392,11.639549436796
2021-12-21,14068,28,9411,8,4657,20,10424,11,86116,81,96540,92,0,242,3,287,25,13539,0,333,268,"Anderson",76978,211.748811348697,0.121588089330025,119.514666528099,36.3740289433345,372.833796669178,12.1588089330025
2021-12-22,14116,48,9425,14,4691,34,10435,11,86231,115,96666,126,19,261,1,288,28,13567,0,333,269,"Anderson",76978,240.32840551846,0.119289340101523,163.683130245005,62.3554781885734,374.13286913144,11.9289340101523
2021-12-23,14143,27,9440,15,4703,12,10452,17,86331,100,96783,117,-1,260,7,295,21,13588,1,334,270,"Anderson",76978,239.029333056198,0.120754716981132,151.991478084648,35.0749564810725,383.226376367274,12.0754716981132
2021-12-24,14169,26,9455,15,4714,11,10469,17,86418,87,96887,104,0,260,6,301,20,13608,1,335,270,"Anderson",76978,232.533970744888,0.126038781163435,135.103536075242,33.7758840188106,391.020811140845,12.6038781163435
2021-12-25,14183,14,9462,7,4721,7,10479,10,86476,58,96955,68,1,261,2,303,11,13619,0,335,271,"Anderson",76978,235.132115669412,0.130372492836676,88.3369274338123,18.1870144716672,393.618956065369,13.0372492836676
2021-12-26,14194,11,9466,4,4728,7,10485,6,86520,44,97005,50,1,262,-7,296,17,13636,0,335,271,"Anderson",76978,231.234898282626,0.13089802130898,64.9536231130973,14.2897970848814,384.525448829536,13.089802130898
2021-12-27,14241,47,9485,19,4756,28,10505,20,86624,104,97129,124,1,263,14,310,32,13668,1,336,272,"Anderson",76978,261.113564914651,0.135095447870778,161.084985320481,61.0564057263114,402.712463301203,13.5095447870778
2021-12-28,14328,87,9521,36,4807,51,10541,36,86733,109,97274,145,0,263,70,380,17,13685,0,336,272,"Anderson",76978,337.758840188106,0.159400544959128,188.365507027982,113.019304216789,493.647535659539,15.9400544959128
2021-12-29,14409,81,9565,44,4844,37,10588,47,86891,158,97479,205,2,265,49,429,30,13715,0,336,272,"Anderson",76978,380.62823144275,0.188191881918819,266.309854763699,105.224869443218,557.302086310374,18.8191881918819
2021-12-30,14501,92,9607,42,4894,50,10626,38,87010,119,97636,157,1,266,70,499,21,13736,0,336,272,"Anderson",76978,465.067941489776,0.203985932004689,203.954376575125,119.514666528099,648.237158668711,20.3985932004689
2021-12-31,14567,66,9647,40,4920,26,10670,44,87127,117,97797,161,0,266,49,548,17,13753,0,336,273,"Anderson",76978,517.030839980254,0.220879120879121,209.150666424173,85.7387825092884,711.891709319546,22.0879120879121
2022-01-01,14628,61,9681,34,4947,27,10707,37,87226,99,97933,136,0,266,48,596,13,13766,0,336,273,"Anderson",76978,578.087245706566,0.233128834355828,176.673854867625,79.2434201979787,774.247187508119,23.3128834355828
2022-01-02,14660,32,9704,23,4956,9,10740,33,87342,116,98082,149,0,266,16,612,16,13782,0,336,274,"Anderson",76978,605.367767414066,0.236768802228412,193.56179687703,41.5703187923822,795.03234690431,23.6768802228412
2022-01-03,14721,61,9725,21,4996,40,10763,23,87418,76,98181,99,1,267,31,643,29,13811,0,336,274,"Anderson",76978,623.554781885734,0.245247148288973,128.608173763933,79.2434201979787,835.303593234431,24.5247148288973
2022-01-04,14848,127,9790,65,5058,62,10826,63,87592,174,98418,237,1,268,73,716,53,13864,0,336,275,"Anderson",76978,675.517680376211,0.249125874125874,307.880173556081,164.982202707267,930.135882979553,24.9125874125874
2022-01-05,15015,167,9876,86,5139,81,10912,86,87738,146,98650,232,1,269,133,849,33,13897,0,336,276,"Anderson",76978,787.237912130739,0.27668659265585,301.384811244771,216.945101197745,1102.91252046039,27.668659265585
2022-01-06,15157,142,9948,72,5209,70,10983,71,87858,120,98841,191,1,270,114,963,27,13924,1,337,276,"Anderson",76978,852.191535243836,0.296265560165975,248.122840292031,184.468289641196,1251.00678115825,29.6265560165975
2022-01-07,15296,139,10018,70,5278,69,11059,76,87998,140,99057,216,0,270,125,1088,14,13938,1,338,276,"Anderson",76978,947.023824988958,0.308730158730159,280.59965184858,180.57107225441,1413.390838941,30.8730158730159
2022-01-08,15399,103,10060,42,5339,61,11104,45,88073,75,99177,120,0,270,97,1185,6,13944,1,339,279,"Anderson",76978,1001.58486840396,0.319131832797428,155.888695471433,133.80446361298,1539.4008677804,31.9131832797428
2022-01-09,15484,85,10115,55,5369,30,11166,62,88216,143,99382,205,0,270,53,1238,32,13976,0,339,279,"Anderson",76978,1070.43570890384,0.327692307692308,266.309854763699,110.421159292265,1608.25170828029,32.7692307692308
2022-01-10,15640,156,10190,75,5450,81,11245,79,88329,113,99574,192,1,271,68,1306,87,14063,3,342,281,"Anderson",76978,1193.84759281873,0.346015793251974,249.421912754293,202.655304112863,1696.5886357141,34.6015793251974
2022-01-11,15814,174,10299,109,5515,65,11347,102,88470,141,99817,243,0,271,55,1361,119,14182,0,342,282,"Anderson",76978,1254.90399854504,0.37240886347391,315.674608329653,226.038608433578,1768.03762113851,37.240886347391
2022-01-12,16068,254,10461,162,5607,92,11510,163,88661,191,100171,354,0,271,170,1531,84,14266,0,342,282,"Anderson",76978,1367.92330276183,0.393162393162393,459.871651640728,329.964405414534,1988.87993972304,39.3162393162393
2022-01-13,16299,231,10613,152,5686,79,11665,155,88893,232,100558,387,4,275,111,1642,116,14382,0,342,282,"Anderson",76978,1483.54075190314,0.397204426324985,502.741042895373,300.085738782509,2133.07698303411,39.7204426324985
2022-01-14,16557,258,10758,145,5799,113,11814,149,89049,156,100863,305,2,277,208,1850,48,14430,2,344,282,"Anderson",76978,1638.13037491231,0.418050941306755,396.217100989893,335.160695263582,2403.2840551846,41.8050941306755
2022-01-15,16653,96,10816,58,5837,38,11875,61,89167,118,101042,179,1,278,71,1921,24,14454,1,345,282,"Anderson",76978,1629.03686767648,0.413404825737265,232.533970744888,124.710956377147,2495.5182000052,41.3404825737265
2022-01-16,16805,152,10943,127,5862,25,12008,133,89364,197,101372,330,0,278,101,2022,51,14505,0,345,282,"Anderson",76978,1716.07472264803,0.423115577889447,428.693912546442,197.459014263816,2626.72451869365,42.3115577889447
2022-01-17,16986,181,11054,111,5932,70,12124,116,89483,119,101607,235,0,278,26,2048,155,14660,1,346,282,"Anderson",76978,1748.55153420458,0.432365961633055,305.282028631557,235.132115669412,2660.50040271246,43.2365961633055
2022-01-18,17200,214,11194,140,6006,74,12266,142,89620,137,101886,279,0,278,16,2064,198,14858,0,346,284,"Anderson",76978,1800.51443269506,0.44417593040116,362.441216971083,278.001506924056,2681.28556210865,44.417593040116
2022-01-19,17501,301,11403,209,6098,92,12480,214,89840,220,102320,434,3,281,121,2185,177,15035,0,346,284,"Anderson",76978,1861.57083842137,0.451372731503025,563.797448621684,391.020811140845,2838.47333004235,45.1372731503025
2022-01-20,17797,296,11644,241,6153,55,12740,260,89997,157,102737,417,1,282,186,2371,109,15144,1,347,285,"Anderson",76978,1946.01054846839,0.493345571363011,541.713216763231,384.525448829536,3080.10080802307,49.3345571363011
2022-01-21,18043,246,11859,215,6184,31,12965,225,90216,219,103181,444,2,284,111,2482,133,15277,0,347,287,"Anderson",76978,1930.42167892125,0.496548748921484,576.788173244304,319.571825716438,3224.29785133415,49.6548748921484
2022-01-22,18171,128,11951,92,6220,36,13069,104,90335,119,103404,223,0,284,40,2522,88,15365,0,347,287,"Anderson",76978,1971.99199771363,0.505503810330229,289.693159084414,166.281275169529,3276.26074982462,50.5503810330229
2022-01-23,18298,127,12061,110,6237,17,13182,113,90442,107,103624,220,0,284,67,2589,60,15425,0,347,288,"Anderson",76978,1939.51518615708,0.521314387211368,285.795941697628,164.982202707267,3363.29860479618,52.1314387211368
2022-01-24,18566,268,12210,149,6356,119,13343,161,90620,178,103963,339,1,285,1,2590,266,15691,0,347,289,"Anderson",76978,2052.53449037387,0.517402376910017,440.385564706799,348.151419886201,3364.59767725844,51.7402376910017
2022-01-25,18749,183,12343,133,6406,50,13488,145,90740,120,104228,265,1,286,-69,2521,251,15942,0,347,289,"Anderson",76978,2012.26324404375,0.521776259607173,344.254202499415,237.730260593936,3274.96167736236,52.1776259607173
2022-01-26,18955,206,12497,154,6458,52,13654,166,90892,152,104546,318,2,288,-24,2497,228,16170,0,347,290,"Anderson",76978,1888.85136012887,0.527403414195867,413.105042999298,267.608927225961,3243.78393826808,52.7403414195867
2022-01-27,19173,218,12668,171,6505,47,13831,177,91112,220,104943,397,0,288,-38,2459,256,16426,0,347,290,"Anderson",76978,1787.52370807244,0.49456029011786,515.731767517992,283.197796773104,3194.41918470212,49.456029011786
2022-01-28,19361,188,12804,136,6557,52,13975,144,91275,163,105250,307,1,289,-97,2362,284,16710,0,347,290,"Anderson",76978,1712.17750526124,0.488158530691155,398.815245914417,244.225622905246,3068.40915586271,48.8158530691155
2022-01-29,19504,143,12903,99,6601,44,14080,105,91392,117,105472,222,0,289,15,2377,128,16838,0,347,292,"Anderson",76978,1731.66359219517,0.488878143133462,288.394086622152,185.767362103458,3087.89524279664,48.8878143133462
2020-03-12,1,1,1,1,0,0,1,1,11,11,12,12,NA,NA,NA,NA,0,0,0,0,0,"East TN",2455501,NA,NA,0.488698640318208,0.040724886693184,NA,NA
2020-03-13,1,0,1,0,0,0,1,0,23,12,24,12,NA,NA,NA,NA,0,0,0,0,0,"East TN",2455501,NA,NA,0.488698640318208,0,NA,NA
2020-03-14,3,2,3,2,0,0,3,2,50,27,53,29,NA,NA,NA,NA,0,0,0,0,0,"East TN",2455501,NA,NA,1.18102171410234,0.081449773386368,NA,NA
2020-03-15,3,0,3,0,0,0,3,0,53,3,56,3,NA,NA,NA,NA,0,0,0,0,0,"East TN",2455501,NA,NA,0.122174660079552,0,NA,NA
2020-03-16,5,2,5,2,0,0,5,2,89,36,94,38,NA,NA,NA,NA,0,0,0,0,0,"East TN",2455501,NA,NA,1.54754569434099,0.081449773386368,NA,NA
2020-03-17,6,1,6,1,0,0,5,0,130,41,135,41,NA,NA,NA,NA,0,0,0,0,0,"East TN",2455501,NA,NA,1.66972035442054,0.040724886693184,NA,NA
2020-03-18,8,2,8,2,0,0,7,2,171,41,178,43,NA,NA,NA,NA,0,0,0,0,0,"East TN",2455501,0.325799093545472,0.0393258426966292,1.75117012780691,0.081449773386368,NA,3.93258426966292
2020-03-19,11,3,11,3,0,0,11,4,238,67,249,71,NA,NA,NA,NA,0,0,0,0,0,"East TN",2455501,0.40724886693184,0.0421940928270042,2.89146695521606,0.122174660079552,NA,4.21940928270042
2020-03-20,29,18,29,18,0,0,27,16,382,144,409,160,NA,NA,NA,NA,3,3,2,2,0,"East TN",2455501,1.14029682740915,0.0675324675324675,6.51598187090944,0.733047960477312,NA,6.75324675324675
2020-03-21,38,9,38,9,0,0,38,11,610,228,648,239,NA,NA,NA,NA,3,6,1,3,1,"East TN",2455501,1.42537103426144,0.0588235294117647,9.73324791967098,0.366523980238656,NA,5.88235294117647
2020-03-22,48,10,47,9,1,1,43,5,713,103,756,108,NA,NA,NA,NA,2,8,4,7,2,"East TN",2455501,1.83261990119328,0.0571428571428571,4.39828776286387,0.40724886693184,NA,5.71428571428571
2020-03-23,64,16,63,16,1,0,56,13,846,133,902,146,NA,NA,NA,NA,7,15,4,11,2,"East TN",2455501,2.40276831489786,0.0631188118811881,5.94583345720486,0.651598187090944,NA,6.31188118811881
2020-03-24,83,19,82,19,1,0,70,14,987,141,1057,155,NA,NA,NA,NA,7,22,5,16,2,"East TN",2455501,3.13581627537517,0.0704989154013015,6.31235743744352,0.773772847170496,NA,7.04989154013015
2020-03-25,116,33,115,33,1,0,99,29,1288,301,1387,330,NA,NA,NA,NA,15,37,12,28,3,"East TN",2455501,4.39828776286387,0.076095947063689,13.4392126087507,1.34392126087507,NA,7.6095947063689
2020-03-26,144,28,143,28,1,0,130,31,1774,486,1904,517,NA,NA,NA,NA,15,52,5,33,4,"East TN",2455501,5.41640993019347,0.0719033232628399,21.0547664203761,1.14029682740915,NA,7.19033232628399
2020-03-27,166,22,165,22,1,0,147,17,2171,397,2318,414,NA,NA,NA,NA,17,69,6,39,4,"East TN",2455501,5.57930947696621,0.0628601361969618,16.8601030909782,0.895947507250048,NA,6.28601361969618
2020-03-28,197,31,196,31,1,0,180,33,2608,437,2788,470,NA,NA,NA,NA,12,81,8,47,4,"East TN",2455501,6.47525698421626,0.0663551401869159,19.1406967457965,1.2624714874887,NA,6.63551401869159
2020-03-29,213,16,212,16,1,0,196,16,2795,187,2991,203,NA,NA,NA,NA,27,108,3,50,7,"East TN",2455501,6.71960630437536,0.0684563758389262,8.26715199871635,0.651598187090944,NA,6.84563758389262
2020-03-30,246,33,245,33,1,0,226,30,3345,550,3571,580,NA,NA,NA,NA,33,141,8,58,9,"East TN",2455501,7.41192937815949,0.0636942675159236,23.6204342820467,1.34392126087507,NA,6.36942675159236
2020-03-31,295,49,294,49,1,0,278,52,3645,300,3923,352,NA,NA,NA,NA,39,180,12,70,10,"East TN",2455501,8.63367597895501,0.0725750174459177,14.3351601160008,1.99551944796602,NA,7.25750174459177
2020-04-01,346,51,345,51,1,0,336,58,4243,598,4579,656,NA,NA,NA,NA,36,216,9,79,12,"East TN",2455501,9.36672393943232,0.0742481203007519,26.7155256707287,2.07696922135238,NA,7.42481203007519
2020-04-02,391,45,390,45,1,0,383,47,4839,596,5222,643,2,7,NA,134,34,250,5,84,14,"East TN",2455501,10.0590470132164,0.0762507534659433,26.1861021437173,1.83261990119328,5.45713481688666,7.62507534659433
2020-04-03,412,21,411,21,1,0,401,18,5124,285,5525,303,1,8,-13,121,33,283,2,86,17,"East TN",2455501,10.0183221265233,0.0792017461802308,12.3396406680348,0.855222620556864,4.92771128987526,7.92017461802307
2020-04-04,447,35,446,35,1,0,431,30,5716,592,6147,622,3,11,0,121,32,315,5,91,19,"East TN",2455501,10.181221673296,0.0747246204227449,25.3308795231604,1.42537103426144,4.92771128987526,7.47246204227449
2020-04-05,473,26,472,26,1,0,464,33,6093,377,6557,410,-1,10,1,122,26,341,2,93,20,"East TN",2455501,10.5884705402278,0.0751542344363432,16.6972035442054,1.05884705402278,4.96843617656845,7.51542344363432
2020-04-06,514,41,513,41,1,0,514,50,6626,533,7140,583,8,18,0,122,33,374,5,98,20,"East TN",2455501,10.9142696337733,0.080694872513309,23.7426089421263,1.66972035442054,4.96843617656845,8.06948725133091
2020-04-07,570,56,569,56,1,0,592,78,7755,1129,8347,1207,0,18,19,141,37,411,7,105,21,"East TN",2455501,11.1993438406256,0.0709764918625678,49.1549382386731,2.2805936548183,5.74220902373894,7.09764918625678
2020-04-08,607,37,606,37,1,0,632,40,8162,407,8794,447,1,19,4,145,32,443,8,113,25,"East TN",2455501,10.629195426921,0.0702253855278766,18.2040243518532,1.50682080764781,5.90510857051168,7.02253855278766
2020-04-09,633,26,632,26,1,0,662,30,8613,451,9275,481,3,22,3,148,20,463,2,115,25,"East TN",2455501,9.85542257975053,0.0688378978534419,19.5886704994215,1.05884705402278,6.02728323059123,6.88378978534419
2020-04-10,655,22,654,22,1,0,682,20,8941,328,9623,348,0,22,-7,141,29,492,4,119,25,"East TN",2455501,9.89614746644371,0.0685700341630063,14.172260569228,0.895947507250048,5.74220902373894,6.85700341630063
2020-04-11,679,24,678,24,1,0,728,46,10022,1081,10750,1127,2,24,-5,136,27,519,5,124,27,"East TN",2455501,9.44817371281869,0.0645231370845101,45.8969473032184,0.977397280636416,5.53858459027302,6.45231370845101
2020-04-12,709,30,708,30,1,0,761,33,11472,1450,12233,1483,0,24,18,154,12,531,1,125,28,"East TN",2455501,9.61107325959142,0.0523255813953488,60.3950069659919,1.22174660079552,6.27163255075034,5.23255813953488
2020-04-13,738,29,737,29,1,0,803,42,12435,963,13238,1005,0,24,-2,152,31,562,7,132,32,"East TN",2455501,9.12237461927321,0.0473925877336832,40.9285111266499,1.18102171410234,6.19018277736397,4.73925877336832
2020-04-14,749,11,748,11,1,0,823,20,12720,285,13543,305,4,28,-18,134,25,587,1,133,33,"East TN",2455501,7.28975471807994,0.0444572748267898,12.4210904414211,0.447973753625024,5.45713481688666,4.44572748267898
2020-04-15,773,24,772,24,1,0,850,27,13132,412,13982,439,2,30,-6,128,28,615,4,137,34,"East TN",2455501,6.76033119106854,0.0420200462606014,17.8782252583078,0.977397280636416,5.21278549672755,4.20200462606014
2020-04-16,801,28,800,28,1,0,886,36,13809,677,14695,713,1,31,1,129,26,641,6,143,34,"East TN",2455501,6.84178096445491,0.0413284132841328,29.0368442122402,1.14029682740915,5.25351038342074,4.13284132841328
2020-04-17,823,22,821,21,2,1,916,30,14138,329,15054,359,0,31,-1,128,23,664,4,147,35,"East TN",2455501,6.84178096445491,0.0430859878475419,14.6202343228531,0.895947507250048,5.21278549672755,4.30859878475419
2020-04-18,835,12,833,12,2,0,935,19,14919,781,15854,800,0,31,-11,117,23,687,0,147,35,"East TN",2455501,6.3530823241367,0.0405564263322884,32.5799093545472,0.488698640318208,4.76481174310253,4.05564263322884
2020-04-19,914,79,912,79,2,0,1016,81,15605,686,16621,767,1,32,66,183,12,699,1,148,35,"East TN",2455501,8.34860177210272,0.0581130355515041,31.2359880936721,3.21726604876154,7.45265426485267,5.81130355515041
2020-04-20,939,25,931,19,8,6,1033,17,16568,963,17601,980,0,32,10,193,15,714,2,150,35,"East TN",2455501,8.18570222532998,0.0527160210864084,39.9103889593203,1.0181221673296,7.85990313178451,5.27160210864084
2020-04-21,1045,106,1037,106,8,0,1154,121,19274,2706,20428,2827,0,32,83,276,23,737,6,156,36,"East TN",2455501,12.0545664611825,0.0480755265068991,115.129254681631,4.3168379894775,11.2400687273188,4.80755265068991
2020-04-22,1247,202,1237,200,10,2,1354,200,21826,2552,23180,2752,2,34,177,453,23,760,2,158,36,"East TN",2455501,19.3035962925692,0.0547945205479452,112.074888179642,8.22642711202317,18.4483736720124,5.47945205479452
2020-04-23,1492,245,1480,243,12,2,1601,247,22933,1107,24534,1354,0,34,236,689,9,769,3,161,36,"East TN",2455501,28.1408967049901,0.0726699867872751,55.1414965825711,9.97759723983008,28.0594469316038,7.26699867872751
2020-04-24,1540,48,1527,47,13,1,1655,54,25622,2689,27277,2743,0,34,22,711,26,795,4,165,36,"East TN",2455501,29.1997437590129,0.0604597889225231,111.708364199404,1.95479456127283,28.9553944388538,6.04597889225231
2020-04-25,1563,23,1546,19,17,4,1674,19,26397,775,28071,794,0,34,10,721,13,808,3,168,37,"East TN",2455501,29.6477175126379,0.0604894818695261,32.3355600343881,0.936672393943232,29.3626433057857,6.04894818695261
2020-04-26,1583,20,1565,19,18,1,1700,26,27514,1117,29214,1143,0,34,-1,720,21,829,0,168,38,"East TN",2455501,27.2449491977401,0.0543158897800365,46.5485454903093,0.81449773386368,29.3219184190925,5.43158897800365
2020-04-27,1652,69,1633,68,19,1,1772,72,28429,915,30201,987,0,34,50,770,19,848,8,176,39,"East TN",2455501,29.0368442122402,0.0586507936507936,40.1954631661726,2.8100171818297,31.3581627537517,5.86507936507936
2020-04-28,1689,37,1667,34,22,3,1812,40,30603,2174,32415,2214,2,36,19,789,16,864,1,177,40,"East TN",2455501,26.2268270304105,0.0548928005339117,90.1648991387094,1.50682080764781,32.1319356009222,5.48928005339117
2020-04-29,1752,63,1729,62,23,1,1878,66,33352,2749,35230,2815,1,37,39,828,23,887,6,183,41,"East TN",2455501,20.5660677800579,0.0434854771784232,114.640556041313,2.56566786167059,33.7202061819563,4.34854771784232
2020-04-30,1774,22,1750,21,24,1,1900,22,33901,549,35801,571,0,37,-1,827,23,910,1,184,41,"East TN",2455501,11.4844180474779,0.0265376764001065,23.2539103018081,0.895947507250048,33.6794812952632,2.65376764001065
2020-05-01,1814,40,1786,36,28,4,1929,29,35563,1662,37492,1691,0,37,-16,811,56,966,0,184,41,"East TN",2455501,11.1586189539324,0.0268232990699951,68.8657833981741,1.62899546772736,33.0278831081722,2.68232990699951
2020-05-02,1835,21,1807,21,28,0,1966,37,37440,1877,39406,1914,0,37,-107,704,128,1094,3,187,41,"East TN",2455501,11.077169180546,0.0257609175121306,77.9474331307542,0.855222620556864,28.6703202320015,2.57609175121306
2020-05-03,1873,38,1840,33,33,5,2003,37,39560,2120,41563,2157,0,37,-20,684,58,1152,3,190,43,"East TN",2455501,11.8102171410234,0.0245363997084784,87.8435805971979,1.54754569434099,27.8558224981379,2.45363997084784
2020-05-04,1920,47,1884,44,36,3,2060,57,41506,1946,43566,2003,0,37,-312,372,359,1511,1,191,43,"East TN",2455501,10.9142696337733,0.0215488215488215,81.5719480464475,1.91406967457965,15.1496578498644,2.15488215488215
2020-05-05,1948,28,1911,27,37,1,2092,32,44416,2910,46508,2942,2,39,-45,327,71,1582,1,192,43,"East TN",2455501,10.5477456535347,0.0198680195841907,119.812616651347,1.14029682740915,13.3170379486712,1.98680195841907
2020-05-06,1985,37,1948,37,37,0,2135,43,45460,1044,47595,1087,1,40,7,334,29,1611,0,192,43,"East TN",2455501,9.48889859951187,0.0207844723008492,44.267951835491,1.50682080764781,13.6021121555235,2.07844723008492
2020-05-07,2028,43,1989,41,39,2,2183,48,46851,1391,49034,1439,0,40,19,353,24,1635,4,196,47,"East TN",2455501,10.3441212200687,0.0213859291166024,58.6031119514918,1.75117012780691,14.375885002694,2.13859291166024
2020-05-08,2047,19,2008,19,39,0,2219,36,48521,1670,50740,1706,1,41,-15,338,33,1668,0,196,48,"East TN",2455501,9.48889859951187,0.0218900966183575,69.4766566985719,0.773772847170496,13.7650117022962,2.18900966183575
2020-05-09,2063,16,2022,14,41,2,2237,18,51339,2818,53576,2836,0,41,-32,306,48,1716,1,197,49,"East TN",2455501,9.28527416604595,0.0191249117854622,115.49577866187,0.651598187090944,12.4618153281143,1.91249117854622
2020-05-10,2079,16,2037,15,42,1,2256,19,53903,2564,56159,2583,1,42,-27,279,42,1758,3,200,49,"East TN",2455501,8.3893266587959,0.0173335160317895,105.192382328494,0.651598187090944,11.3622433873983,1.73335160317895
2020-05-11,2140,61,2097,60,43,1,2307,51,55474,1571,57781,1622,3,45,13,292,45,1803,5,205,51,"East TN",2455501,8.95947507250048,0.0173760112557158,66.0557662163444,2.48421808828422,11.8916669144097,1.73760112557158
2020-05-12,2193,53,2150,53,43,0,2373,66,59029,3555,61402,3621,3,48,30,322,20,1823,3,208,51,"East TN",2455501,9.97759723983008,0.0188666577145159,147.464814716019,2.15841899473875,13.1134135152052,1.88666577145159
2020-05-13,2247,54,2201,51,46,3,2425,52,60654,1625,63079,1677,0,48,18,340,36,1859,7,215,53,"East TN",2455501,10.6699203136142,0.0187290105915784,68.2956349844696,2.19914388143194,13.8464614756826,1.87290105915784
2020-05-14,2278,31,2232,31,46,0,2470,45,62362,1708,64832,1753,1,49,-2,338,32,1891,2,217,54,"East TN",2455501,10.181221673296,0.018166856564122,71.3907263731516,1.2624714874887,13.7650117022962,1.8166856564122
2020-05-15,2306,28,2260,28,46,0,2507,37,64681,2319,67188,2356,1,50,-21,317,48,1939,4,221,54,"East TN",2455501,10.5477456535347,0.0175097276264591,95.9478330491415,1.14029682740915,12.9097890817393,1.75097276264591
2020-05-16,2316,10,2270,10,46,0,2525,18,67450,2769,69975,2787,1,51,-28,289,37,1976,1,222,54,"East TN",2455501,10.3033963333756,0.0175620464662479,113.500259213904,0.40724886693184,11.7694922543302,1.75620464662479
2020-05-17,2396,80,2350,80,46,0,2604,79,69677,2227,72281,2306,0,51,59,348,21,1997,4,226,56,"East TN",2455501,12.9097890817393,0.0215854112393003,93.9115887144823,3.25799093545472,14.172260569228,2.15854112393003
2020-05-18,2445,49,2398,48,47,1,2665,61,71555,1878,74220,1939,0,51,8,356,41,2038,3,229,56,"East TN",2455501,12.4210904414211,0.0217774803820184,78.9655552980838,1.99551944796602,14.4980596627735,2.17774803820184
2020-05-19,2486,41,2438,40,48,1,2705,40,72679,1124,75384,1164,1,52,-6,350,46,2084,3,232,56,"East TN",2455501,11.9323918011029,0.0237448147618366,47.4037681108662,1.66972035442054,14.2537103426144,2.37448147618366
2020-05-20,2528,42,2480,42,48,0,2750,45,74419,1740,77169,1785,0,52,13,363,29,2113,3,235,56,"East TN",2455501,11.4436931607847,0.0230660042583392,72.6939227473334,1.71044524111373,14.7831338696258,2.30660042583392
2020-05-21,2769,241,2720,240,49,1,2988,238,75881,1462,78869,1700,0,52,211,574,30,2143,4,239,57,"East TN",2455501,19.9959193663533,0.0369024720381848,69.2323073784128,9.81469769305734,23.3760849618876,3.69024720381848
2020-05-22,2860,91,2808,88,52,3,3066,78,77405,1524,80471,1602,0,52,40,614,51,2194,7,246,57,"East TN",2455501,22.5615872280239,0.0420838665964014,65.2412684824808,3.70596468907974,25.005080429615,4.20838665964014
2020-05-23,2926,66,2870,62,56,4,3157,91,79620,2215,82777,2306,2,54,36,650,28,2222,7,253,58,"East TN",2455501,24.8421808828422,0.049367286361506,93.9115887144823,2.68784252175014,26.4711763505696,4.9367286361506
2020-05-24,2978,52,2922,52,56,0,3227,70,81740,2120,84967,2190,0,54,26,676,26,2248,0,253,59,"East TN",2455501,23.7018840554331,0.0491092542960744,89.187501858073,2.11769410804557,27.5300234045924,4.91092542960744
2020-05-25,3062,84,3005,83,57,1,3321,94,84390,2650,87711,2744,1,55,42,718,41,2289,2,255,59,"East TN",2455501,25.1272550896945,0.0486250092654362,111.749089086097,3.42089048222746,29.2404686457061,4.86250092654362
2020-05-26,3123,61,3057,52,66,9,3377,56,86776,2386,90153,2442,1,56,15,733,45,2334,3,258,59,"East TN",2455501,25.9417528235582,0.0455007109486086,99.4501733047553,2.48421808828422,29.8513419461039,4.55007109486086
2020-05-27,3199,76,3130,73,69,3,3444,67,88643,1867,92087,1934,0,56,40,773,36,2370,9,267,59,"East TN",2455501,27.3263989711265,0.0465209813647942,78.7619308646179,3.09509138868198,31.4803374138312,4.65209813647942
2020-05-28,3273,74,3204,74,69,0,3511,67,90042,1399,93553,1466,0,56,14,787,60,2430,1,268,59,"East TN",2455501,20.5253428933647,0.0356169980931626,59.7026838922077,3.01364161529562,32.0504858275358,3.56169980931626
2020-05-29,3348,75,3278,74,70,1,3594,83,91320,1278,94914,1361,0,56,10,797,65,2495,4,272,59,"East TN",2455501,19.8737447062738,0.0365575019040366,55.4265707894234,3.0543665019888,32.4577346944676,3.65575019040366
2020-05-30,3421,73,3350,72,71,1,3675,81,93565,2245,97240,2326,0,56,-1,796,74,2569,5,277,60,"East TN",2455501,20.1588189131261,0.0358155292816152,94.726086448346,2.97291672860243,32.4170098077745,3.58155292816152
2020-05-31,3533,112,3460,110,73,2,3769,94,96348,2783,100117,2877,0,56,71,867,41,2610,1,278,61,"East TN",2455501,22.6023121147171,0.0357755775577558,117.16549901629,4.56118730963661,35.3084767629905,3.57755775577558
2020-06-01,3629,96,3553,93,76,3,3903,134,100180,3832,104083,3966,0,56,-169,698,265,2875,5,283,61,"East TN",2455501,23.0910107550353,0.0355484974346445,161.514900625168,3.90958912254566,28.4259709118424,3.55484974346445
2020-06-02,3736,107,3658,105,78,2,4018,115,104239,4059,108257,4174,1,57,16,714,90,2965,3,286,65,"East TN",2455501,24.9643555429218,0.0354065399911622,169.98567705735,4.35756287617069,29.0775690989334,3.54065399911622
2020-06-03,3786,50,3708,50,78,0,4068,50,106169,1930,110237,1980,0,57,-65,649,115,3080,4,290,66,"East TN",2455501,23.905508488899,0.0343801652892562,80.6352756525043,2.0362443346592,26.4304514638764,3.43801652892562
2020-06-04,3837,51,3757,49,80,2,4129,61,107717,1548,111846,1609,6,63,-37,612,82,3162,5,295,67,"East TN",2455501,22.9688360949558,0.0337834144208167,65.526342689333,2.07696922135238,24.9236306562286,3.37834144208167
2020-06-05,3936,99,3852,95,84,4,4211,82,109873,2156,114084,2238,1,64,-43,569,141,3303,4,299,68,"East TN",2455501,23.9462333755922,0.0321857068335942,91.1422964193458,4.03176378262522,23.1724605284217,3.21857068335942
2020-06-06,3989,53,3902,50,87,3,4286,75,112978,3105,117264,3180,1,65,-14,555,66,3369,4,303,68,"East TN",2455501,23.1317356417285,0.0305133839392729,129.505139684325,2.15841899473875,22.6023121147171,3.05133839392729
2020-06-07,4047,58,3958,56,89,2,4367,81,116938,3960,121305,4041,0,65,-8,547,66,3435,6,309,69,"East TN",2455501,20.9325917602966,0.0282235227487257,164.569267127157,2.36204342820467,22.2765130211716,2.82235227487257
2020-06-08,4207,160,4114,156,93,4,4524,157,119889,2951,124413,3108,0,65,75,622,85,3520,6,315,69,"East TN",2455501,23.5389845086604,0.0305459911460895,126.572947842416,6.51598187090944,25.3308795231604,3.05459911460895
2020-06-09,4315,108,4221,107,94,1,4642,118,122216,2327,126858,2445,1,66,-35,587,142,3662,7,322,70,"East TN",2455501,23.5797093953535,0.0335465835170152,99.5723479648349,4.39828776286387,23.905508488899,3.35465835170152
2020-06-10,4392,77,4295,74,97,3,4716,74,125054,2838,129770,2912,0,66,-63,524,140,3802,6,328,70,"East TN",2455501,24.6792813360695,0.0331746275533712,118.590870050552,3.13581627537517,21.3398406272284,3.31746275533712
2020-06-11,4656,264,4557,262,99,2,4996,280,127345,2291,132341,2571,1,67,149,673,114,3916,8,336,70,"East TN",2455501,33.3536822017177,0.0423030007318858,104.703683688176,10.7513700870006,27.4078487445128,4.23030007318858
2020-06-12,4827,171,4727,170,100,1,5168,172,129973,2628,135141,2800,2,69,24,697,145,4061,3,339,71,"East TN",2455501,36.2858740436269,0.0454480695255734,114.029682740915,6.96395562453446,28.3852460251492,4.54480695255734
2020-06-13,4975,148,4871,144,104,4,5336,168,132164,2191,137500,2359,0,69,50,747,98,4159,4,343,72,"East TN",2455501,40.1547382794794,0.0518877248468077,96.0700077092211,6.02728323059123,30.4214903598084,5.18877248468077
2020-06-14,5091,116,4986,115,105,1,5471,135,136034,3870,141505,4005,0,69,30,777,86,4245,4,347,73,"East TN",2455501,42.5167817076841,0.0546534653465347,163.103171206202,4.72408685640934,31.643236960604,5.46534653465347
2020-06-15,5274,183,5158,172,116,11,5650,179,139208,3174,144858,3353,0,69,59,836,124,4369,9,356,78,"East TN",2455501,43.4534541016273,0.0550745903643923,136.550545082246,7.45265426485267,34.0460052755018,5.50745903643923
2020-06-16,5428,154,5310,152,118,2,5808,158,141008,1800,146816,1958,3,72,64,900,87,4456,4,360,81,"East TN",2455501,45.3267988895138,0.0584226876440525,79.7393281452543,6.27163255075034,36.6523980238656,5.84226876440525
2020-06-17,5561,133,5440,130,121,3,5930,122,142448,1440,148378,1562,3,75,-6,894,136,4592,6,366,83,"East TN",2455501,47.6073925443321,0.0652407566638005,63.6122730147534,5.41640993019347,36.4080487037065,6.52407566638005
2020-06-18,5739,178,5617,177,122,1,6136,206,146039,3591,152175,3797,1,76,42,936,135,4727,12,378,83,"East TN",2455501,44.1050522887183,0.0574770595946355,154.63239477402,7.24902983138675,38.1184939448202,5.74770595946355
2020-06-19,5874,135,5748,131,126,4,6254,118,147503,1464,153757,1582,4,80,22,958,109,4836,13,391,84,"East TN",2455501,42.6389563677636,0.0583369144821659,64.4267707486171,5.49785970357984,39.0144414520703,5.83369144821659
2020-06-20,5940,66,5813,65,127,1,6349,95,149678,2175,156027,2270,0,80,-44,914,110,4946,7,398,84,"East TN",2455501,39.2995156589226,0.0546769579532574,92.4454927935277,2.68784252175014,37.2225464375702,5.46769579532574
2020-06-21,6028,88,5900,87,128,1,6468,119,153028,3350,159496,3469,1,81,0,914,87,5033,3,401,87,"East TN",2455501,38.1592188315134,0.0554165971874826,141.274631938655,3.58379002900019,37.2225464375702,5.54165971874826
2020-06-22,6224,196,6089,189,135,7,6666,198,156439,3411,163105,3609,1,82,43,957,152,5185,7,408,88,"East TN",2455501,38.6886423585248,0.0556803858168466,146.976116075701,7.98207779186406,38.9737165653771,5.56803858168466
2020-06-23,6414,190,6273,184,141,6,6850,184,158244,1805,165094,1989,4,86,57,1014,129,5314,15,423,88,"East TN",2455501,40.1547382794794,0.0570084254294781,81.001799632743,7.73772847170496,41.2950351068886,5.70084254294781
2020-06-24,6592,178,6449,176,143,2,7033,183,159875,1631,166908,1814,2,88,37,1051,139,5453,9,432,88,"East TN",2455501,41.9873581806727,0.0595250944414463,73.8749444614358,7.24902983138675,42.8018559145364,5.95250944414463
2020-06-25,6761,169,6609,160,152,9,7217,184,163049,3174,170266,3358,0,88,22,1073,147,5600,8,440,88,"East TN",2455501,41.620834200434,0.0597534685755348,136.754169515712,6.8825058511481,43.6978034217864,5.97534685755348
2020-06-26,6975,214,6813,204,162,10,7389,172,164638,1589,172027,1761,1,89,67,1140,146,5746,16,456,88,"East TN",2455501,44.8381002491956,0.0621237000547345,71.716525466697,8.71512575234138,46.4263708302298,6.21237000547345
2020-06-27,7049,74,6882,69,167,5,7435,46,164847,209,172282,255,-1,88,-52,1088,127,5873,5,461,90,"East TN",2455501,45.1638993427411,0.066810212242387,10.3848461067619,3.01364161529562,44.3086767221842,6.6810212242387
2020-06-28,7176,127,7007,125,169,2,7606,171,167935,3088,175541,3259,0,88,30,1118,97,5970,5,466,91,"East TN",2455501,46.7521699237752,0.0709255219694609,132.722405733087,5.17206061003437,45.5304233229797,7.09255219694609
2020-06-29,7519,343,7348,341,171,2,7946,340,173203,5268,181149,5608,1,89,147,1265,195,6165,22,488,92,"East TN",2455501,52.7387282676733,0.0709377078253159,228.385164575376,13.9686361357621,51.5169816668778,7.09377078253159
2020-06-30,7789,270,7614,266,175,4,8394,448,179489,6286,187883,6734,0,89,100,1365,170,6335,22,510,93,"East TN",2455501,55.996719203128,0.0677519856070911,274.241386991901,10.9957194071597,55.5894703361962,6.77519856070911
2020-07-01,8064,275,7886,272,178,3,8728,334,182693,3204,191421,3538,0,89,66,1431,209,6544,17,527,96,"East TN",2455501,59.9470332123668,0.0691469832333864,144.084649120485,11.1993438406256,58.2773128579463,6.91469832333864
2020-07-02,8544,480,8361,475,183,5,9334,606,189076,6383,198410,6989,2,91,314,1745,164,6708,25,552,99,"East TN",2455501,72.6124729739471,0.0752202956225128,284.626233098663,19.5479456127283,71.0649272796061,7.52202956225128
2020-07-03,8770,226,8581,220,189,6,9562,228,192432,3356,201994,3584,5,96,24,1769,197,6905,14,566,100,"East TN",2455501,73.1011716142653,0.0725130977408483,145.957993908371,9.20382439265958,72.0423245602425,7.25130977408483
2020-07-04,8990,220,8799,218,191,2,9842,280,197196,4764,207038,5044,2,98,77,1846,141,7046,15,581,106,"East TN",2455501,79.0470050714701,0.0692542294855565,205.41632848042,8.95947507250048,75.1781408356177,6.92542294855565
2020-07-05,9310,320,9118,319,192,1,10210,368,201043,3847,211253,4215,2,100,163,2009,155,7201,12,593,109,"East TN",2455501,86.9069082032546,0.0729166666666667,171.655397411771,13.0319637418189,81.8162973666066,7.29166666666667
2020-07-06,9544,234,9341,223,203,11,10420,210,202674,1631,213094,1841,4,104,-51,1958,281,7482,26,619,109,"East TN",2455501,82.4678955536976,0.0774456096415714,74.9745164021517,9.52962348620506,79.7393281452543,7.74456096415715
2020-07-07,9992,448,9780,439,212,9,10986,566,208952,6278,219938,6844,0,104,159,2117,289,7771,32,651,110,"East TN",2455501,89.7169253850844,0.0808610201216659,278.721124528151,18.2447492385464,86.2145851294705,8.08610201216659
2020-07-08,10373,381,10151,371,222,10,11420,434,213123,4171,224543,4605,1,105,61,2178,319,8090,20,671,110,"East TN",2455501,94.0337633745619,0.0812752853088582,187.538103222112,15.5161818301031,88.6988032177547,8.12752853088582
2020-07-09,10822,449,10586,435,236,14,11892,472,219072,5949,230964,6421,1,106,149,2327,299,8389,24,695,114,"East TN",2455501,92.7712918870731,0.0785771333783867,261.494497456934,18.2854741252396,94.7668113350392,7.85771333783867
2020-07-10,11289,467,11041,455,248,12,12345,453,222356,3284,234701,3737,0,106,141,2468,326,8715,29,724,116,"East TN",2455501,102.58598958013,0.0850888189072676,152.188901572429,19.0185220857169,100.509020358778,8.50888189072676
2020-07-11,11595,306,11340,299,255,7,12767,422,226834,4478,239601,4900,5,111,44,2512,257,8972,23,747,121,"East TN",2455501,106.088329835744,0.0898258759942266,199.551944796602,12.4618153281143,102.300915373278,8.98258759942266
2020-07-12,12065,470,11802,462,263,8,13400,633,232764,5930,246164,6563,1,112,222,2734,247,9219,25,772,126,"East TN",2455501,112.197062839722,0.091375211251468,267.277431367367,19.1406967457965,111.341840219165,9.1375211251468
2020-07-13,12419,354,12143,341,276,13,13743,343,236198,3434,249941,3777,3,115,-119,2615,470,9689,20,792,130,"East TN",2455501,117.084049242904,0.0901837327326512,153.817897040156,14.4166098893871,106.495578702676,9.01837327326512
2020-07-14,12934,515,12653,510,281,5,14327,584,240686,4488,255013,5072,4,119,77,2692,434,10123,34,826,134,"East TN",2455501,119.812616651347,0.0952530292230934,206.556625307829,20.9733166469898,109.631394978051,9.52530292230934
2020-07-15,13314,380,13027,374,287,6,14710,383,243783,3097,258493,3480,6,125,-106,2586,480,10603,24,850,141,"East TN",2455501,119.771891764654,0.0969072164948454,141.72260569228,15.4754569434099,105.314556988574,9.69072164948454
2020-07-16,14141,827,13839,812,302,15,15807,1097,253617,9834,269424,10931,6,131,349,2935,472,11075,44,894,143,"East TN",2455501,135.165898934678,0.101794071762871,445.163736443194,33.6794812952632,119.527542444495,10.1794071762871
2020-07-17,14609,468,14293,454,316,14,16318,511,257936,4319,274254,4830,3,134,95,3030,370,11445,24,918,148,"East TN",2455501,135.206623821371,0.100447500821682,196.701202728079,19.0592469724101,123.396406680348,10.0447500821682
2020-07-18,15118,509,14787,494,331,15,16986,668,266027,8091,283013,8759,6,140,185,3215,318,11763,27,945,151,"East TN",2455501,143.473775820087,0.0971851101078043,356.709282545599,20.7289673268307,130.930510718587,9.71851101078043
2020-07-19,15599,481,15249,462,350,19,17546,560,270881,4854,288427,5414,0,140,76,3291,405,12168,26,971,155,"East TN",2455501,143.921749573712,0.0980999929015924,220.484536556898,19.5886704994215,134.025602107269,9.80999929015924
2020-07-20,16035,436,15670,421,365,15,17957,411,273338,2457,291295,2868,2,142,-270,3021,704,12872,29,1000,159,"East TN",2455501,147.261190282553,0.10190066257194,116.798975036052,17.7560505982282,123.029882700109,10.190066257194
2020-07-21,17036,1001,16654,984,382,17,19169,1212,281716,8378,300885,9590,1,143,381,3402,619,13491,61,1061,162,"East TN",2455501,167.053485215441,0.105554586675968,390.551663387635,40.7656115798772,138.546064530212,10.5554586675968
2020-07-22,17620,584,17222,568,398,16,19823,654,285016,3300,304839,3954,4,147,-79,3323,659,14150,29,1090,167,"East TN",2455501,175.36136210085,0.110322357916541,161.02620198485,23.7833338288195,135.32879848145,11.0322357916541
2020-07-23,18415,795,17995,773,420,22,20822,999,295220,10204,316042,11203,4,151,242,3565,549,14699,50,1140,173,"East TN",2455501,174.058165726668,0.107576472607147,456.24090562374,32.3762849210813,145.184221061201,10.7576472607147
2020-07-24,19018,603,18585,590,433,13,21506,684,301030,5810,322536,6494,2,153,7,3572,594,15293,34,1174,180,"East TN",2455501,179.556025430248,0.10745205252475,264.467414185537,24.55710667599,145.469295268053,10.745205252475
2020-07-25,19996,978,19551,966,445,12,22708,1202,310645,9615,333353,10817,10,163,550,4122,418,15711,29,1203,188,"East TN",2455501,198.655997289352,0.113667063965038,440.521099360171,39.8289391859339,167.867982949304,11.3667063965038
2020-07-26,20771,775,20311,760,460,15,23605,897,318168,7523,341773,8420,1,164,391,4513,383,16094,21,1224,195,"East TN",2455501,210.629113977148,0.113579274922206,342.903545956609,31.5617871872176,183.791413646339,11.3579274922206
2020-07-27,21417,646,20935,624,482,22,24311,706,322634,4466,346945,5172,6,170,-78,4435,718,16812,38,1262,199,"East TN",2455501,219.181340182716,0.114177897574124,210.629113977148,26.3082768037969,180.614872484271,11.4177897574124
2020-07-28,22232,815,21727,792,505,23,25283,972,330855,8221,356138,9193,7,177,170,4605,638,17450,50,1312,204,"East TN",2455501,211.606511257784,0.11065462508823,374.38388337044,33.190782654945,187.538103222112,11.065462508823
2020-07-29,22575,343,22059,332,516,11,25599,316,332425,1570,358024,1886,5,182,-337,4268,675,18125,24,1336,213,"East TN",2455501,201.791813564727,0.108602049450033,76.807136303345,13.9686361357621,173.813816406509,10.8602049450033
2020-07-30,23763,1188,23232,1173,531,15,26980,1381,344959,12534,371939,13915,5,187,674,4942,509,18634,46,1382,220,"East TN",2455501,217.796694035148,0.110166914145661,566.686798335655,48.3811653915026,201.262390037715,11.0166914145661
2020-07-31,24385,622,23838,606,547,16,27634,654,348927,3968,376561,4622,6,193,80,5022,536,19170,27,1409,229,"East TN",2455501,218.570466882319,0.113428968070338,188.230426295896,25.3308795231604,204.52038097317,11.3428968070338
2020-08-01,24944,559,24380,542,564,17,28270,636,355902,6975,384172,7611,1,194,152,5174,406,19576,16,1425,232,"East TN",2455501,201.506739357874,0.109447253979811,309.957112621823,22.7652116614899,210.710563750534,10.9447253979811
2020-08-02,25375,431,24800,420,575,11,28754,484,359700,3798,388454,4282,4,198,49,5223,378,19954,21,1446,237,"East TN",2455501,187.497378335419,0.110301835864699,174.383964820214,17.5524261647623,212.7060831985,11.0301835864699
2020-08-03,26001,626,25408,608,593,18,29462,708,363844,4144,393306,4852,3,201,-43,5180,666,20620,39,1485,245,"East TN",2455501,186.682880601555,0.111106317810228,197.597150235329,25.4937790699332,210.954913070693,11.1106317810228
2020-08-04,26487,486,25874,466,613,20,29988,526,369215,5371,399203,5897,6,207,-218,4962,698,21318,34,1519,254,"East TN",2455501,173.284392879498,0.10925345408104,240.154656829706,19.7922949328874,202.076887771579,10.925345408104
2020-08-05,26955,468,26334,460,621,8,30509,521,373428,4213,403937,4734,9,216,-222,4740,681,21999,20,1539,260,"East TN",2455501,178.375003716146,0.106941389149043,192.791613605533,19.0592469724101,193.035962925692,10.6941389149043
2020-08-06,27686,731,27027,693,659,38,31361,852,380497,7069,411858,7921,7,223,202,4942,522,22521,37,1576,266,"East TN",2455501,159.763730497361,0.109747238157268,322.58182749671,29.7698921727175,201.262390037715,10.9747238157268
2020-08-07,28241,555,27568,541,673,14,31980,619,384467,3970,416447,4589,6,229,40,4982,509,23030,34,1610,279,"East TN",2455501,157.035163088917,0.108960537531966,186.886505035021,22.6023121147171,202.891385505443,10.8960537531966
2020-08-08,28916,675,28231,663,685,12,32780,800,394544,10077,427324,10877,8,237,290,5272,377,23407,24,1634,290,"East TN",2455501,161.759249945327,0.104514275120504,442.964592561762,27.4892985178992,214.701602646466,10.4514275120504
2020-08-09,29444,528,28747,516,697,12,33414,634,398845,4301,432259,4935,2,239,115,5387,411,23818,20,1654,297,"East TN",2455501,165.709563954566,0.106380550165506,200.977315830863,21.5027401740012,219.384964616182,10.6380550165506
2020-08-10,29747,303,29039,292,708,11,33742,328,401134,2289,434876,2617,3,242,-477,4910,777,24595,26,1680,301,"East TN",2455501,152.555425552667,0.102958864565793,106.577028476063,12.3396406680348,199.959193663533,10.2958864565793
2020-08-11,30359,612,29634,595,725,17,34427,685,407234,6100,441661,6785,17,259,-7,4903,602,25197,28,1708,306,"East TN",2455501,157.686761276008,0.104550379198267,276.318356213253,24.9236306562286,199.674119456681,10.4550379198267
2020-08-12,30804,445,30058,424,746,21,34901,474,410983,3749,445884,4223,6,265,-251,4652,690,25887,25,1733,311,"East TN",2455501,156.750088882065,0.104703554485422,171.981196505316,18.1225745784669,189.452172896692,10.4703554485422
2020-08-13,31621,817,30862,804,759,13,36018,1117,419546,8563,455564,9680,6,271,202,4854,609,26496,44,1777,319,"East TN",2455501,160.252429137679,0.106552876035327,394.216903190021,33.2722324283313,197.678600008715,10.6552876035327
2020-08-14,32082,461,31294,432,788,29,36552,534,424202,4656,460754,5190,4,275,-142,4712,599,27095,18,1795,326,"East TN",2455501,156.42428978852,0.10318911232988,211.362161937625,18.7741727655578,191.895666098283,10.318911232988
2020-08-15,32732,650,31932,638,800,12,37429,877,431135,6933,468564,7810,4,279,216,4928,430,27525,17,1812,335,"East TN",2455501,155.40616762119,0.112730358874879,318.061365073767,26.4711763505696,200.692241624011,11.2730358874879
2020-08-16,33206,474,32395,463,811,11,38022,593,436600,5465,474622,6058,2,281,110,5038,362,27887,10,1822,344,"East TN",2455501,153.207023739758,0.108774166135543,246.711363587309,19.3035962925692,205.171979160261,10.8774166135543
2020-08-17,33479,273,32598,203,881,70,38249,227,438072,1472,476321,1699,8,289,-397,4641,662,28549,12,1834,350,"East TN",2455501,151.985277138963,0.108746531547834,69.1915824917196,11.1178940672392,189.004199143067,10.8746531547834
2020-08-18,34109,630,33163,565,946,65,39061,812,448669,10597,487730,11409,8,297,52,4693,570,29119,22,1856,353,"East TN",2455501,152.71832509944,0.100588248062689,464.630232282536,25.6566786167059,191.121893251113,10.0588248062689
2020-08-19,34564,455,33597,434,967,21,39558,497,453453,4784,493011,5281,7,304,-113,4580,561,29680,22,1878,360,"East TN",2455501,153.125573966372,0.0988180872960299,215.068126626705,18.5298234453987,186.519981054783,9.88180872960299
2020-08-20,35342,778,34354,757,988,21,40432,874,464992,11539,505424,12413,6,310,265,4845,507,30187,27,1905,368,"East TN",2455501,151.537303385338,0.088527878058564,505.518018522493,31.6839618472971,197.312076028476,8.8527878058564
2020-08-21,35551,209,34551,197,1000,12,40645,213,467443,2451,508088,2664,17,327,-321,4524,513,30700,17,1922,375,"East TN",2455501,141.274631938655,0.0864706130899565,108.491098150642,8.51150131887546,184.239387399964,8.64706130899565
2020-08-22,36420,869,35408,857,1012,12,41617,972,480810,13367,522427,14339,2,329,453,4977,414,31114,20,1942,382,"East TN",2455501,150.193382124463,0.077752817332863,583.954150293565,35.3899265363769,202.687761071977,7.7752817332863
2020-08-23,36673,253,35650,242,1023,11,41871,254,485916,5106,527787,5360,0,329,-94,4883,347,31461,20,1962,387,"East TN",2455501,141.193182165269,0.0723972538324085,218.285392675466,10.3033963333756,198.859621722817,7.23972538324085
2020-08-24,36865,192,35825,175,1040,17,42069,198,487259,1343,529328,1541,8,337,-485,4398,669,32130,15,1977,397,"East TN",2455501,137.894466343121,0.0720659535533043,62.7570503941965,7.81917824509133,179.108051676623,7.20659535533043
2020-08-25,37479,614,36414,589,1065,25,42754,685,496993,9734,539747,10419,16,353,120,4518,478,32608,23,2000,406,"East TN",2455501,137.24286815603,0.0709960205317492,424.312594456284,25.005080429615,183.995038079805,7.09960205317492
2020-08-26,37824,345,36734,320,1090,25,43138,384,500955,3962,544093,4346,6,359,-208,4310,547,33155,11,2011,414,"East TN",2455501,132.76313061978,0.0700833953251635,176.990357568578,14.0500859091485,175.524261647623,7.00833953251635
2020-08-27,38685,861,37578,844,1107,17,44114,976,511247,10292,555361,11268,8,367,387,4697,466,33621,29,2040,421,"East TN",2455501,136.143296215314,0.0737329034583575,458.888023258797,35.0641274428314,191.284792797885,7.37329034583575
2020-08-28,39019,334,37892,314,1127,20,44452,338,513856,2609,558308,2947,12,379,-182,4515,504,34125,10,2050,427,"East TN",2455501,141.233907051962,0.0758064516129032,120.016241084813,13.6021121555235,183.872863419726,7.58064516129032
2020-08-29,39470,451,38327,435,1143,16,44980,528,520375,6519,565355,7047,8,387,61,4576,382,34507,16,2066,436,"East TN",2455501,124.210904414211,0.0783404770778979,286.988276526868,18.366923898626,186.35708150801,7.83404770778979
2020-08-30,39733,263,38579,252,1154,11,45247,267,522256,1881,567503,2148,8,395,-55,4521,310,34817,14,2080,439,"East TN",2455501,124.618153281143,0.0850035250276966,87.4770566169592,10.7106452003074,184.117212739885,8.50035250276967
2020-08-31,40140,407,38957,378,1183,29,45697,450,525743,3487,571440,3937,2,397,-133,4388,538,35355,17,2097,444,"East TN",2455501,133.374003920178,0.0861512158054711,160.333878911065,16.5750288841259,178.700802809691,8.61512158054711
2020-09-01,40747,607,39522,565,1225,42,46371,674,531408,5665,577779,6339,6,403,105,4493,496,35851,28,2125,453,"East TN",2455501,133.088929713325,0.0951041228439209,258.155056748093,24.7200062227627,182.976915912476,9.51041228439209
2020-09-02,41235,488,39981,459,1254,29,46824,453,536201,4793,583025,5246,7,410,23,4516,458,36309,22,2147,460,"East TN",2455501,138.912588510451,0.0946778999280797,213.642755592443,19.8737447062738,183.913588306419,9.46778999280797
2020-09-03,41790,555,40503,522,1287,33,47471,647,544457,8256,591928,8903,6,416,-39,4477,588,36897,22,2169,463,"East TN",2455501,126.450773182336,0.0918040856509968,362.573666229417,22.6023121147171,182.325317725385,9.18040856509968
2020-09-04,42147,357,40846,343,1301,14,47819,348,547789,3332,595608,3680,7,423,-40,4437,390,37287,11,2180,464,"East TN",2455501,127.38744557628,0.0902680965147453,149.867583030917,14.5387845494667,180.696322257657,9.02680965147453
2020-09-05,43145,998,41829,983,1316,15,48909,1090,557108,9319,606017,10409,1,424,640,5077,357,37644,26,2206,470,"East TN",2455501,149.663958597451,0.0966258423097733,423.905345589352,40.6434369197976,206.760249741295,9.66258423097733
2020-09-06,43408,263,42076,247,1332,16,49177,268,559735,2627,608912,2895,0,424,-51,5026,314,37958,9,2215,484,"East TN",2455501,149.663958597451,0.0949069042961675,117.898546976768,10.7106452003074,204.683280519943,9.49069042961675
2020-09-07,43612,204,42273,197,1339,7,49414,237,561071,1336,610485,1573,3,427,-342,4684,543,38501,13,2228,488,"East TN",2455501,141.396806598735,0.095197848636189,64.0602467683784,8.30787688540954,190.755369270874,9.5197848636189
2020-09-08,43923,311,42562,289,1361,22,49734,320,564497,3426,614231,3746,7,434,-302,4382,606,39107,24,2252,495,"East TN",2455501,129.342240137552,0.0922583123011083,152.555425552667,12.6654397615802,178.456453489532,9.22583123011083
2020-09-09,44256,333,42878,316,1378,17,50109,375,569643,5146,619752,5521,6,440,-161,4221,488,39595,16,2268,502,"East TN",2455501,123.029882700109,0.0894437334930705,224.842099433069,13.5613872688303,171.89974673193,8.94437334930705
2020-09-10,44931,675,43516,638,1415,37,50816,707,577454,7811,628270,8518,18,458,194,4415,463,40058,39,2307,513,"East TN",2455501,127.916869103291,0.0920422651477629,346.894584852541,27.4892985178992,179.800374750407,9.20422651477629
2020-09-11,45257,326,43819,303,1438,23,51171,355,581614,4160,632785,4515,17,475,-205,4210,514,40572,26,2333,524,"East TN",2455501,126.654397615802,0.0901632729913656,183.872863419726,13.276313061978,171.451772978305,9.01632729913656
2020-09-12,45676,419,44220,401,1456,18,51683,512,588600,6986,640283,7498,10,485,92,4302,317,40889,15,2348,535,"East TN",2455501,103.074688220449,0.080954882390708,305.355200425494,17.0637275244441,175.198462554078,8.0954882390708
2020-09-13,46116,440,44640,420,1476,20,52185,502,594174,5574,646359,6076,2,487,48,4350,390,41279,21,2369,540,"East TN",2455501,110.282993165142,0.0803268619649104,247.444411547786,17.918950145001,177.15325711535,8.03268619649104
2020-09-14,46560,444,45069,429,1491,15,52670,485,599147,4973,651817,5458,9,496,-151,4199,586,41865,25,2394,550,"East TN",2455501,120.056965971506,0.0787767347333785,222.276431571398,18.0818496917737,171.00379922468,7.87767347333785
2020-09-15,47053,493,45525,456,1528,37,53210,540,607323,8176,660533,8716,7,503,-66,4133,552,42417,20,2414,553,"East TN",2455501,127.468895349666,0.0750723510863462,354.958112417792,20.0773691397397,168.315956702929,7.50723510863462
2020-09-16,47406,353,45835,310,1571,43,53604,394,610737,3414,664341,3808,6,509,-175,3958,522,42939,17,2431,562,"East TN",2455501,128.28339308353,0.0783825607212541,155.080368527645,14.375885002694,161.189101531622,7.83825607212541
2020-09-17,47957,551,46354,519,1603,32,54181,577,617912,7175,672093,7752,8,517,119,4077,424,43363,21,2452,573,"East TN",2455501,123.233507133575,0.0767861625173995,315.699321645562,22.4394125679444,166.035363048111,7.67861625173995
2020-09-18,48491,534,46840,486,1651,48,54747,566,626026,8114,680773,8680,17,534,-29,4048,546,43909,30,2482,579,"East TN",2455501,131.704283565757,0.0745186296574143,353.492016496837,21.7470894941603,164.854341334009,7.45186296574143
2020-09-19,48999,508,47325,485,1674,23,55320,573,634380,8354,689700,8927,3,537,193,4241,312,44221,30,2512,581,"East TN",2455501,135.32879848145,0.0735981544812514,363.551063510054,20.6882424401375,172.714244465793,7.35981544812514
2020-09-20,49305,306,47606,281,1699,25,55649,329,639338,4958,694987,5287,1,538,-19,4222,324,44545,13,2525,592,"East TN",2455501,129.871663664564,0.071234679608456,215.312475946864,12.4618153281143,171.940471618623,7.1234679608456
2020-09-21,49468,163,47739,133,1729,30,55801,152,640855,1517,696656,1669,3,541,-208,4014,368,44913,9,2534,597,"East TN",2455501,118.427970503779,0.0698276054327706,67.9698358909241,6.63815653098899,163.469695186441,6.98276054327706
2020-09-22,49928,460,48141,402,1787,58,56291,490,647004,6149,703295,6639,6,547,-55,3959,509,45422,29,2563,604,"East TN",2455501,117.084049242904,0.072049950890978,270.372522756049,18.7334478788646,161.229826418315,7.2049950890978
2020-09-23,50222,294,48395,254,1827,40,56573,282,649097,2093,705670,2375,8,555,-217,3742,503,45925,13,2576,613,"East TN",2455501,114.681280928006,0.0718381765830289,96.721605896312,11.9731166877961,152.392526005895,7.18381765830289
2020-09-24,50685,463,48837,442,1848,21,57054,481,655990,6893,713044,7374,11,566,-36,3706,488,46413,28,2604,618,"East TN",2455501,111.097490899006,0.0701570169226637,300.305314475539,18.8556225389442,150.92643008494,7.01570169226637
2020-09-25,51139,454,49267,430,1872,24,57540,486,662663,6673,720203,7159,11,577,14,3720,429,46842,18,2622,625,"East TN",2455501,107.839499963551,0.0708343900583312,291.549463836504,18.4890985587055,151.496578498644,7.08343900583312
2020-09-26,51697,558,49801,534,1896,24,58178,638,673219,10556,731397,11194,5,582,194,3914,359,47201,29,2651,632,"East TN",2455501,109.87574429821,0.068542101350217,455.874381643502,22.7244867747967,159.397206517122,6.8542101350217
2020-09-27,52090,393,50166,365,1924,28,58585,407,679238,6019,737823,6426,3,585,91,4005,299,47500,30,2681,639,"East TN",2455501,113.418809440517,0.0685404799701186,261.6981218904,16.0048804704213,163.103171206202,6.85404799701186
2020-09-28,52324,234,50361,195,1963,39,58810,225,680925,1687,739735,1912,4,589,-315,3690,545,48045,15,2696,646,"East TN",2455501,116.310276395733,0.0698484180227025,77.8659833573678,9.52962348620506,150.274831897849,6.98484180227025
2020-09-29,52707,383,50701,340,2006,43,59207,397,686735,5810,745942,6207,9,598,-43,3647,417,48462,33,2729,648,"East TN",2455501,113.174460120358,0.0683752667245058,252.779371704593,15.5976316034895,148.523661770042,6.83752667245058
2020-09-30,53189,482,51151,450,2038,32,59683,476,690173,3438,749856,3914,6,604,79,3726,397,48859,23,2752,652,"East TN",2455501,120.830738818677,0.0703842846150364,159.397206517122,19.6293953861147,151.740927818804,7.03842846150364
2020-10-01,53577,388,51500,349,2077,39,60062,379,693453,3280,753515,3659,11,615,0,3726,377,49236,31,2783,657,"East TN",2455501,117.776372316688,0.0743248251834647,149.01236041036,15.8012560369554,151.740927818804,7.43248251834647
2020-10-02,54042,465,51937,437,2105,28,60525,463,697074,3621,757599,4084,2,617,24,3750,439,49675,17,2800,661,"East TN",2455501,118.224346070313,0.0798213712696545,166.320437254963,18.9370723123306,152.71832509944,7.98213712696545
2020-10-03,54447,405,52325,388,2122,17,61008,483,704534,7460,765542,7943,12,629,83,3833,310,49985,22,2822,667,"East TN",2455501,111.993438406256,0.0828818275003661,323.477775003961,16.4935791107395,156.098490694974,8.28818275003661
2020-10-04,54902,455,52750,425,2152,30,61547,539,714657,10123,776204,10662,4,633,144,3977,307,50292,27,2849,680,"East TN",2455501,114.518381381233,0.0771736015215862,434.208741922728,18.5298234453987,161.962874378793,7.71736015215862
2020-10-05,55573,671,53362,612,2211,59,62298,751,721905,7248,784203,7999,5,638,151,4128,515,50807,42,2891,689,"East TN",2455501,132.315156866155,0.0784384276333543,325.758368658779,27.3263989711265,168.112332269464,7.84384276333543
2020-10-06,56323,750,54028,666,2295,84,63038,740,728545,6640,791583,7380,8,646,302,4430,440,51247,46,2937,698,"East TN",2455501,147.261190282553,0.0839376876054425,300.549663795698,30.543665019888,180.411248050805,8.39376876054425
2020-10-07,57060,737,54687,659,2373,78,63746,708,735298,6753,799044,7461,3,649,293,4723,441,51688,38,2975,704,"East TN",2455501,157.646036389315,0.0826014475075222,303.848379617846,30.0142414928766,192.343639851908,8.26014475075222
2020-10-08,57778,718,55344,657,2434,61,64424,678,741759,6461,806183,7139,10,659,266,4989,442,52130,32,3007,710,"East TN",2455501,171.085248998066,0.082820688083846,290.734966102641,29.2404686457061,203.176459712295,8.2820688083846
2020-10-09,58319,541,55843,499,2476,42,64984,560,747238,5479,812222,6039,4,663,123,5112,414,52544,20,3027,717,"East TN",2455501,174.180340386748,0.0816322794427256,245.937590740138,22.0321637010125,208.185620775557,8.16322794427256
2020-10-10,58937,618,56431,588,2506,30,65653,669,755664,8426,821317,9095,12,675,252,5364,354,52898,20,3047,731,"East TN",2455501,182.854741252396,0.0832810398924249,370.392844474508,25.1679799763877,218.448292222239,8.32810398924249
2020-10-11,59880,943,57343,912,2537,31,66682,1029,766092,10428,832774,11457,1,676,586,5950,356,53254,37,3084,738,"East TN",2455501,202.72848595867,0.0907724942549054,466.585026843809,38.4035681516725,242.313075824445,9.07724942549054
2020-10-12,60236,356,57628,285,2608,71,66999,317,769013,2921,836012,3238,6,682,-337,5613,687,53941,19,3103,749,"East TN",2455501,189.900146650317,0.090737130614372,131.86718311253,14.4980596627735,228.588789008842,9.0737130614372
2020-10-13,60741,505,58081,453,2660,52,67483,484,773398,4385,840881,4869,9,691,7,5620,489,54430,24,3127,756,"East TN",2455501,179.922549410487,0.0901659296523186,198.289473309113,20.5660677800579,228.873863215694,9.01659296523185
2020-10-14,61615,874,58893,812,2722,62,68331,848,779582,6184,847913,7032,1,692,329,5949,544,54974,44,3171,763,"East TN",2455501,185.501858887453,0.0938222595101189,286.37740322647,35.5935509698428,242.272350937752,9.38222595101189
2020-10-15,62124,509,59333,440,2791,69,68796,465,783736,4154,852532,4619,14,706,-67,5882,562,55536,19,3190,772,"East TN",2455501,176.990357568578,0.0943278172128849,188.108251635817,20.7289673268307,239.543783529308,9.43278172128849
2020-10-16,62763,639,59929,596,2834,43,69380,584,787825,4089,857205,4673,2,708,-135,5747,772,56308,22,3212,784,"East TN",2455501,180.98139646451,0.0977258075272881,190.307395517249,26.0232025969446,234.045923825728,9.77258075272881
2020-10-17,63481,718,60610,681,2871,37,70240,860,796609,8784,866849,9644,6,714,237,5984,475,56783,37,3249,791,"East TN",2455501,185.053885133828,0.100742335061056,392.750807269066,29.2404686457061,243.697721972013,10.0742335061056
2020-10-18,64287,806,61370,760,2917,46,71112,872,804719,8110,875831,8982,3,717,349,6333,454,57237,39,3288,799,"East TN",2455501,179.474575656862,0.102886870892073,365.790932278179,32.8242586747063,257.910707427934,10.2886870892073
2020-10-19,65035,748,62055,685,2980,63,71871,759,809618,4899,881489,5658,3,720,-19,6314,764,58001,67,3355,810,"East TN",2455501,195.43873124059,0.10713107724784,230.421408910035,30.4622152465016,257.136934580764,10.713107724784
2020-10-20,65721,686,62664,609,3057,77,72562,691,813233,3615,885795,4306,15,735,34,6348,637,58638,32,3387,823,"East TN",2455501,202.809935732056,0.113082780424812,175.36136210085,27.9372722715242,258.521580728332,11.3082780424812
2020-10-21,66315,594,63217,553,3098,41,73179,617,816977,3744,890156,4361,5,740,-128,6220,717,59355,27,3414,837,"East TN",2455501,191.406967457965,0.114764576379519,177.601230868975,24.1905826957513,253.308795231604,11.4764576379519
2020-10-22,67445,1130,64253,1036,3192,94,74280,1101,825543,8566,899823,9667,10,750,440,6660,680,60035,43,3457,852,"East TN",2455501,216.697122094432,0.115962868199023,393.68747966301,46.0191219632979,271.227745376605,11.5962868199023
2020-10-23,68416,971,65157,904,3259,67,75250,970,832659,7116,907909,8086,19,769,290,6950,662,60697,39,3496,860,"East TN",2455501,230.217784476569,0.115769958977595,329.301433801086,39.5438649790817,283.037962517629,11.5769958977595
2020-10-24,69653,1237,66332,1175,3321,62,76577,1327,843184,10525,919761,11852,12,781,644,7594,581,61278,50,3546,877,"East TN",2455501,251.354000670332,0.11976489265195,482.671357087617,50.3766848394686,309.264789548039,11.976489265195
2020-10-25,70582,929,67204,872,3378,57,77624,1047,851062,7878,928686,8925,9,790,437,8031,483,61761,43,3589,888,"East TN",2455501,256.363161733593,0.123204994797086,363.469613736667,37.8334197379679,327.061565032961,12.3204994797086
2020-10-26,71044,462,67610,406,3434,56,78058,434,853817,2755,931875,3189,6,796,-449,7582,905,62666,21,3610,902,"East TN",2455501,244.715844139343,0.122792045409439,129.871663664564,18.814897652251,308.776090907721,12.2792045409439
2020-10-27,71886,842,68322,712,3564,130,78841,783,858202,4385,937043,5168,12,808,80,7662,750,63416,54,3664,926,"East TN",2455501,251.068926463479,0.122521854511396,210.466214430375,34.2903545956609,312.034081843176,12.2521854511396
2020-10-28,72883,997,69233,911,3650,86,79811,970,865419,7217,945230,8187,13,821,199,7861,785,64201,41,3705,940,"East TN",2455501,267.481055800833,0.120419798816138,333.414647357097,40.6027120331044,320.138334295119,12.0419798816138
2020-10-29,73791,908,70026,793,3765,115,80645,834,871922,6503,952567,7337,11,832,151,8012,746,64947,40,3745,952,"East TN",2455501,258.440130954946,0.120677233429395,298.798493667891,36.9781971174111,326.28779218579,12.0677233429395
2020-10-30,74691,900,70833,807,3858,93,81485,840,876780,4858,958265,5698,28,860,50,8062,822,65769,39,3784,968,"East TN",2455501,255.54866399973,0.123818412900151,232.050404377762,36.6523980238656,328.324036520449,12.3818412900151
2020-10-31,74705,14,70847,14,3858,0,81501,16,876801,21,958302,37,5,865,-603,7459,612,66381,0,3784,979,"East TN",2455501,205.742127573966,0.127760047741366,1.50682080764781,0.570148413704576,303.766929844459,12.7760047741366
2020-11-01,75212,507,71237,390,3975,117,81971,470,883368,6567,965339,7037,0,865,-137,7322,644,67025,27,3811,995,"East TN",2455501,188.556225389442,0.118598750443347,286.581027659936,20.6475175534443,298.187620367493,11.8598750443347
2020-11-02,76024,812,71981,744,4043,68,82748,777,887596,4228,970344,5005,11,876,-228,7094,1029,68054,38,3849,1009,"East TN",2455501,202.809935732056,0.121916348228444,203.828057899386,33.0686079948654,288.902346201447,12.1916348228444
2020-11-03,77064,1040,72941,960,4123,80,83824,1076,894460,6864,978284,7940,31,907,30,7124,979,69033,29,3878,1022,"East TN",2455501,210.873463297307,0.120826362115371,323.355600343881,42.3538821609114,290.124092802243,12.0826362115371
2020-11-04,77975,911,73753,812,4222,99,84671,847,899345,4885,984016,5732,6,913,-5,7119,910,69943,35,3913,1046,"East TN",2455501,207.371123041693,0.125302944361367,233.435050525331,37.1003717774906,289.920468368777,12.5302944361367
2020-11-05,78553,578,74237,484,4316,94,85172,501,902007,2662,987179,3163,17,930,-366,6753,927,70870,27,3940,1060,"East TN",2455501,193.931910432942,0.130792788628221,128.812816610541,23.5389845086603,275.015159839072,13.0792788628221
2020-11-06,79519,966,75086,849,4433,117,86099,927,908417,6410,994516,7337,10,940,43,6796,913,71783,37,3977,1084,"East TN",2455501,196.619752954692,0.127279247469035,298.798493667891,39.3402405456157,276.766329966878,12.7279247469035
2020-11-07,80846,1327,76327,1241,4519,86,87518,1419,919338,10921,1006856,12340,21,961,649,7445,657,72440,52,4029,1094,"East TN",2455501,250.091529182843,0.123923878568192,502.54510179389,54.0419246418552,303.196781430755,12.3923878568192
2020-11-08,82403,1557,77766,1439,4637,118,89185,1667,932239,12901,1021424,14568,3,964,889,8334,665,73105,52,4081,1111,"East TN",2455501,292.852660210686,0.128626192386556,593.280149346304,63.4086485812875,339.401205700995,12.8626192386556
2020-11-09,83023,620,78306,540,4717,80,89766,581,935691,3452,1025457,4033,9,973,-464,7870,1075,74180,19,4100,1122,"East TN",2455501,285.033481965595,0.127338377515287,164.243468033611,25.2494297497741,320.504858275358,12.7338377515287
2020-11-10,83962,939,79156,850,4806,89,90689,923,940693,5002,1031382,5925,27,1000,6,7876,906,75086,44,4144,1140,"East TN",2455501,280.920268409583,0.129289238766055,241.294953657115,38.2406686048998,320.749207595517,12.9289238766055
2020-11-11,85266,1304,80256,1100,5010,204,91858,1169,947240,6547,1039098,7716,26,1026,383,8259,895,75981,59,4203,1154,"East TN",2455501,296.925148880005,0.130478196143931,314.233225724608,53.1052522479119,336.346839199007,13.0478196143931
2020-11-12,86103,837,80961,705,5142,132,92622,764,951456,4216,1044078,4980,15,1041,8,8267,814,76795,34,4237,1172,"East TN",2455501,307.472894533539,0.130933759820032,202.809935732056,34.086730162195,336.672638292552,13.0933759820032
2020-11-13,87562,1459,82249,1288,5313,171,93922,1300,957318,5862,1051240,7162,27,1068,526,8793,906,77701,47,4284,1188,"East TN",2455501,327.550263673279,0.13791340526056,291.671638496584,59.4176096853555,358.093928693167,13.791340526056
2020-11-14,89038,1476,83641,1392,5397,84,95457,1535,966215,8897,1061672,10432,7,1075,918,9711,551,78252,52,4336,1217,"East TN",2455501,333.618271790563,0.144829976649154,424.842017983295,60.1099327591396,395.47937467751,14.4829976649154
2020-11-15,90990,1952,85374,1733,5616,219,97418,1961,977388,11173,1074806,13134,7,1082,1339,11050,606,78858,56,4392,1234,"East TN",2455501,349.704602034371,0.154228016934547,534.880661828279,79.4949788250952,450.009997959683,15.4228016934547
2020-11-16,92515,1525,86773,1399,5742,126,98955,1537,985008,7620,1083963,9157,10,1092,172,11222,1343,80201,41,4433,1253,"East TN",2455501,386.560624491703,0.157060814275459,372.917787449486,62.1054522071056,457.014678470911,15.7060814275459
2020-11-17,93727,1212,87892,1119,5835,93,100176,1221,990152,5144,1090328,6365,31,1123,89,11311,1092,81293,46,4479,1280,"East TN",2455501,397.678518558942,0.16094391476945,259.213903802116,49.358562672139,460.639193386604,16.094391476945
2020-11-18,94924,1197,88847,955,6077,242,101209,1033,995293,5141,1096502,6174,14,1137,55,11366,1128,82421,53,4532,1295,"East TN",2455501,393.320955682771,0.162898055884607,251.435450443718,48.7476893717412,462.879062154729,16.2898055884607
2020-11-19,96004,1080,89727,880,6277,200,102068,859,999954,4661,1102022,5520,45,1182,-242,11124,1277,83698,52,4584,1315,"East TN",2455501,403.217103149215,0.163019467071655,224.801374546376,43.9828776286387,453.023639574979,16.3019467071655
2020-11-20,97130,1126,90690,963,6440,163,103091,1023,1004854,4900,1107945,5923,28,1210,-126,10998,1224,84922,36,4620,1341,"East TN",2455501,389.655715880384,0.161696499426858,241.213503883729,45.8562224165252,447.892303851638,16.1696499426858
2020-11-21,98348,1218,91754,1064,6594,154,104190,1099,1011261,6407,1115451,7506,3,1213,362,11360,853,85775,47,4667,1365,"East TN",2455501,379.148695113543,0.162386805258558,305.680999519039,49.6029119922981,462.63471283457,16.2386805258558
2020-11-22,99934,1586,93183,1429,6751,157,105856,1666,1020862,9601,1126718,11267,17,1230,803,12163,766,86541,57,4724,1392,"East TN",2455501,364.243386583838,0.162544305748189,458.847298372104,64.5896702953898,495.336796849197,16.2544305748189
2020-11-23,100825,891,93941,758,6884,133,106558,702,1023978,3116,1130536,3818,18,1248,-1158,11005,2031,88572,35,4759,1419,"East TN",2455501,338.423808420359,0.163249092822021,155.487617394577,36.2858740436269,448.17737805849,16.3249092822021
2020-11-24,101736,911,94674,733,7062,178,107263,705,1027005,3027,1134268,3732,13,1261,-736,10269,1634,90206,57,4816,1447,"East TN",2455501,326.165617525711,0.16128812016386,151.985277138963,37.1003717774906,418.203861452307,16.128812016386
2020-11-25,102643,907,95360,686,7283,221,107808,545,1029313,2308,1137121,2853,38,1299,-494,9775,1363,91569,56,4872,1472,"East TN",2455501,314.355400384687,0.16246091730471,116.188101735654,36.9374722307179,398.085767425874,16.246091730471
2020-11-26,104109,1466,96747,1387,7362,79,109478,1670,1037679,8366,1147157,10036,18,1317,-441,9334,1889,93458,25,4897,1491,"East TN",2455501,330.075206648256,0.164174144233965,408.714962852795,59.7026838922077,380.126092394179,16.4174144233965
2020-11-27,105813,1704,98314,1567,7499,137,111228,1750,1045219,7540,1156447,9290,5,1322,161,9495,1538,94996,50,4947,1519,"East TN",2455501,353.614191156917,0.167766277679271,378.334197379679,69.3952069251855,386.682799151782,16.7766277679271
2020-11-28,107439,1626,99696,1382,7743,244,112722,1494,1052752,7533,1165474,9027,2,1324,569,10064,1055,96051,45,4992,1547,"East TN",2455501,370.229944927736,0.170561541690822,367.623552179372,66.2186657631172,409.855259680204,17.0561541690822
2020-11-29,109727,2288,101817,2121,7910,167,115048,2326,1063448,10696,1178496,13022,4,1328,1279,11343,1005,97056,51,5043,1572,"East TN",2455501,398.818815386351,0.177527135076674,530.319474518642,93.178540754005,461.942389760786,17.7527135076674
2020-11-30,111965,2238,103826,2009,8139,229,117269,2221,1072899,9451,1190168,11672,15,1343,-107,11236,2330,99386,53,5096,1603,"East TN",2455501,453.67523776207,0.179618325731151,475.340877482844,91.1422964193458,457.584826884615,17.9618325731151
2020-12-01,114228,2263,105834,2008,8394,255,119407,2138,1081737,8838,1201144,10976,20,1363,423,11659,1820,101206,63,5159,1631,"East TN",2455501,508.735284571255,0.181589808002871,446.996356344388,92.1604185866754,474.811453955832,18.1589808002871
2020-12-02,115285,1057,106747,913,8538,144,120283,876,1084647,2910,1204930,3786,15,1378,-688,10971,1730,102936,42,5201,1664,"East TN",2455501,514.844017575232,0.18397262900205,154.184421020395,43.0462052346955,446.792731910922,18.397262900205
2020-12-03,117094,1809,108317,1570,8777,239,122005,1722,1090637,5990,1212642,7712,33,1411,318,11289,1458,104394,45,5246,1685,"East TN",2455501,528.812653710994,0.191295716576315,314.070326177835,73.6713200279699,459.743245879354,19.1295716576315
2020-12-04,118822,1728,109704,1387,9118,341,123462,1457,1096159,5522,1219621,6979,37,1448,-301,10988,1992,106386,36,5282,1720,"East TN",2455501,529.790050991631,0.193655617817457,284.218984231731,70.3726042058219,447.485054984706,19.3655617817457
2020-12-05,119955,1133,110613,909,9342,224,124391,929,1099221,3062,1223612,3991,5,1453,123,11111,1005,107391,24,5306,1746,"East TN",2455501,509.712681851891,0.200712098799408,162.533022792497,46.1412966233775,452.494216047967,20.0712098799408
2020-12-06,121423,1468,111875,1262,9548,206,125632,1241,1103712,4491,1229344,5732,20,1473,483,11594,965,108356,40,5346,1782,"East TN",2455501,476.31827476348,0.208149779735683,233.435050525331,59.7841336655941,472.164336320775,20.8149779735683
2020-12-07,124146,2723,114280,2405,9866,318,128203,2571,1113258,9546,1241461,12117,31,1504,-211,11383,2903,111259,51,5397,1804,"East TN",2455501,496.069844809674,0.213167488741154,493.46345206131,110.89386646554,463.571385228513,21.3167488741154
2020-12-08,126911,2765,116643,2363,10268,402,130734,2531,1121619,8361,1252353,10892,45,1549,720,12103,2000,113259,71,5468,1828,"East TN",2455501,516.513737929653,0.221191587416274,443.57546586216,112.604311706654,492.893303647606,22.1191587416274
2020-12-09,129557,2646,119028,2385,10529,261,133312,2578,1128717,7098,1262029,9676,21,1570,577,12680,2048,115307,56,5524,1851,"East TN",2455501,581.225582885122,0.228182630168654,394.054003643248,107.758050190165,516.391563269573,22.8182630168654
2020-12-10,132632,3075,121710,2682,10922,393,136261,2949,1140187,11470,1276448,14419,30,1600,2514,15194,531,115838,74,5598,1888,"East TN",2455501,632.783289438693,0.223427263893678,587.21214122902,125.229026581541,618.773928416238,22.3427263893678
2020-12-11,134618,1986,123460,1750,11158,236,138051,1790,1147362,7175,1285413,8965,35,1635,440,15634,1511,117349,50,5648,1913,"East TN",2455501,643.290310205534,0.221744285019455,365.098609204395,80.8796249726634,636.692878561239,22.1744285019455
2020-12-12,137879,3261,126187,2727,11692,534,141025,2974,1158595,11233,1299620,14207,21,1656,1879,17513,1361,118710,73,5721,1938,"East TN",2455501,729.95286908863,0.218845384696348,578.578465250065,132.803855506473,713.214940657731,21.8845384696348
2020-12-13,142171,4292,130048,3861,12123,431,145391,4366,1175880,17285,1321271,21651,15,1671,2960,20473,1317,120027,62,5783,1972,"East TN",2455501,844.959949110182,0.214942291165816,881.734521794127,174.791213687146,833.760605269556,21.4942291165816
2020-12-14,145030,2859,132505,2457,12525,402,148064,2673,1185159,9279,1333223,11952,37,1708,-1085,19388,3907,123934,71,5854,2006,"East TN",2455501,850.498533700455,0.216440356574617,486.743845756935,116.432451055813,789.574103207451,21.6440356574617
2020-12-15,149158,4128,136047,3542,13111,586,151928,3864,1200180,15021,1352108,18885,34,1742,1613,21001,2481,126415,94,5948,2037,"East TN",2455501,906.006554263264,0.212460528294321,769.08948520078,168.112332269464,855.263345443557,21.2460528294321
2020-12-16,152376,3218,138304,2257,14072,961,154314,2386,1208075,7895,1362389,10281,19,1761,663,21664,2536,128951,60,6008,2079,"East TN",2455501,929.301189451766,0.209266640095656,418.692560092625,131.052685378666,882.263945321138,20.9266640095656
2020-12-17,156444,4068,141677,3373,14767,695,157923,3609,1218775,10700,1376698,14309,58,1819,1449,23113,2561,131512,75,6083,2118,"East TN",2455501,969.741001938097,0.216079800498753,582.73240369277,165.668839067872,941.274306139562,21.6079800498753
2020-12-18,159651,3207,144413,2736,15238,471,160802,2879,1227464,8689,1388266,11568,43,1862,849,23962,2315,133827,62,6145,2148,"East TN",2455501,1019.46608859048,0.221199187189484,471.105489266752,130.604711625041,975.849734942075,22.1199187189484
2020-12-19,162291,2640,146655,2242,15636,398,163270,2468,1235829,8365,1399099,10833,27,1889,1271,25233,1342,135169,41,6186,2185,"East TN",2455501,994.175933954008,0.223615034328853,441.172697547262,107.513700870006,1027.61106592911,22.3615034328853
2020-12-20,165922,3631,149621,2966,16301,665,166588,3318,1249772,13943,1416360,17261,16,1905,2280,27513,1335,136504,55,6241,2219,"East TN",2455501,967.256783849813,0.22291747731073,702.952269211049,147.872063582951,1120.46380758957,22.291747731073
2020-12-21,168236,2314,151363,1742,16873,572,168491,1903,1256688,6916,1425179,8819,14,1919,-1323,26190,3623,140127,35,6276,2254,"East TN",2455501,945.061720602028,0.222138849014746,359.15277574719,94.2373878080278,1066.58478249449,22.2138849014746
2020-12-22,170891,2655,153065,1702,17826,953,170292,1801,1261741,5053,1432033,6854,62,1981,-294,25896,2887,143014,60,6336,2299,"East TN",2455501,885.073962502968,0.229765405067251,279.128373395083,108.124574170404,1054.61166580669,22.9765405067251
2020-12-23,173109,2218,154511,1446,18598,772,171834,1542,1267518,5777,1439352,7319,41,2022,-558,25338,2735,145749,35,6371,2340,"East TN",2455501,844.349075809784,0.227641853877837,298.065445707414,90.3277986854821,1031.8871790319,22.7641853877837
2020-12-24,175200,2091,155968,1457,19232,634,173432,1598,1273808,6290,1447240,7888,15,2037,-585,24753,2661,148410,30,6401,2380,"East TN",2455501,763.835974817359,0.219854838252389,321.237906235835,85.1557380754477,1008.06312031638,21.9854838252389
2020-12-25,177566,2366,157947,1979,19619,387,175598,2166,1282356,8548,1457954,10714,3,2040,-292,24461,2655,151065,27,6428,2416,"East TN",2455501,729.586345108391,0.212317759155091,436.326436030773,96.3550819160733,996.171453401974,21.2317759155091
2020-12-26,179506,1940,159415,1468,20091,472,177211,1613,1288010,5654,1465221,7267,2,2042,418,24879,1520,152585,43,6471,2454,"East TN",2455501,701.078924423163,0.210837542724056,295.947751599368,79.006280184777,1013.19445603972,21.0837542724056
2020-12-27,180801,1295,160324,909,20477,386,178201,990,1290803,2793,1469004,3783,27,2069,-190,24689,1458,154043,41,6512,2485,"East TN",2455501,605.945589107885,0.220594939594256,154.062246360315,52.7387282676733,1005.45672756802,22.0594939594256
2020-12-28,182197,1396,161302,978,20895,418,179221,1020,1292622,1819,1471843,2839,25,2094,-2416,22273,3787,157830,42,6554,2522,"East TN",2455501,568.560143123542,0.229941710954912,115.617953321949,56.8519418236849,907.065401317287,22.9941710954912
2020-12-29,185103,2906,163029,1727,22074,1179,181001,1780,1296711,4089,1477712,5869,50,2144,-110,22163,2966,160796,64,6618,2564,"East TN",2455501,578.782089683531,0.234440333632523,239.014360002297,118.346520730393,902.585663781037,23.4440333632523
2020-12-30,187431,2328,164645,1616,22786,712,182682,1681,1301191,4480,1483873,6161,40,2184,-533,21630,2821,163617,44,6662,2602,"East TN",2455501,583.261827219781,0.243660295141619,250.906026916707,94.8075362217323,880.87929917357,24.3660295141619
2020-12-31,190875,3444,167324,2679,23551,765,185577,2895,1308312,7121,1493889,10016,52,2236,594,22224,2798,166415,30,6692,2645,"East TN",2455501,638.362598915659,0.260348560526485,407.900465118931,140.256509771326,905.069881869321,26.0348560526485
2021-01-01,193115,2240,169040,1716,24075,524,187433,1856,1314514,6202,1501947,8058,24,2260,-443,21781,2659,169074,30,6722,2684,"East TN",2455501,633.231263192318,0.269020071374991,328.161136973677,91.2237461927322,887.028757064241,26.9020071374991
2021-01-02,195838,2723,171149,2109,24689,614,189684,2251,1321075,6561,1510759,8812,4,2264,1166,22947,1553,170627,63,6785,2720,"East TN",2455501,665.118849473081,0.273903113882911,358.867701540337,110.89386646554,934.513974948493,27.3903113882911
2021-01-03,197152,1314,172053,904,25099,410,190621,937,1324446,3371,1515067,4308,15,2279,-187,22760,1486,172113,26,6811,2763,"East TN",2455501,665.892622320252,0.269630723140047,175.442811874237,53.5125011148438,926.898421136868,26.9630723140047
2021-01-04,198708,1556,173178,1125,25530,431,191801,1180,1326811,2365,1518612,3545,46,2325,-1566,21194,3076,175189,34,6845,2811,"East TN",2455501,672.408604191161,0.268981590369689,144.369723327337,63.3679236945943,863.123248575342,26.8981590369689
2021-01-05,201611,2903,174917,1739,26694,1164,193630,1829,1332083,5272,1525713,7101,43,2368,-426,20768,3286,178475,60,6905,2855,"East TN",2455501,672.286429531081,0.263098685444053,289.1874204083,118.224346070313,845.774446844045,26.3098685444053
2021-01-06,204156,2545,176710,1793,27446,752,195533,1903,1337666,5583,1533199,7486,52,2420,59,20827,2434,180909,62,6967,2898,"East TN",2455501,681.123729943502,0.260531970968657,304.866501785175,103.644836634153,848.177215158943,26.0531970968657
2021-01-07,206668,2512,178849,2139,27819,373,197855,2322,1344775,7109,1542630,9431,33,2453,975,21802,1504,182413,44,7011,2930,"East TN",2455501,643.168135545455,0.251902915410024,384.076406403418,102.300915373278,887.883979684798,25.1902915410024
2021-01-08,209018,2350,180709,1860,28309,490,199846,1991,1352120,7345,1551966,9336,50,2503,1668,23470,632,183045,47,7058,2984,"East TN",2455501,647.647873081705,0.248165697035127,380.207542167566,95.7034837289824,955.813090689029,24.8165697035127
2021-01-09,211595,2577,182712,2003,28883,574,202025,2179,1360311,8191,1562336,10370,27,2530,755,24225,1795,184840,32,7090,3012,"East TN",2455501,641.7020396245,0.239273319502879,422.317075008318,104.948033008335,986.560380142382,23.9273319502879
2021-01-10,213262,1667,183845,1133,29417,534,203276,1251,1366117,5806,1569393,7057,36,2566,-12,24213,1643,186483,41,7131,3052,"East TN",2455501,656.077924627194,0.232945550933255,287.395525393799,67.8883861175377,986.071681502064,23.2945550933255
2021-01-11,214686,1424,184858,1013,29828,411,204373,1097,1369390,3273,1573763,4370,28,2594,-2168,22045,3564,190047,40,7171,3092,"East TN",2455501,650.702239583694,0.227955975412957,177.967754849214,57.992238651094,897.780127151241,22.7955975412957
2021-01-12,216506,1820,185995,1137,30511,683,205568,1195,1373594,4204,1579162,5399,60,2654,-2140,19905,3900,193947,39,7210,3130,"East TN",2455501,606.597187294976,0.22335310295796,219.8736632565,74.1192937815949,810.628869627827,22.335310295796
2021-01-13,218035,1529,187073,1078,30962,451,206704,1136,1378332,4738,1585036,5874,49,2703,-1336,18569,2816,196763,32,7242,3155,"East TN",2455501,565.220702414701,0.215502440341841,239.217984435763,62.2683517538783,756.220421005734,21.5502440341841
2021-01-14,220286,2251,188854,1781,31432,470,208670,1966,1386857,8525,1595527,10491,38,2741,-199,18370,2412,199175,50,7292,3196,"East TN",2455501,554.59150698778,0.204453938786699,427.244786298193,91.6717199463572,748.11616855379,20.4453938786699
2021-01-15,221251,965,189525,671,31726,294,209364,694,1389915,3058,1599279,3752,23,2764,-376,17994,1318,200493,29,7321,3236,"East TN",2455501,498.18753891772,0.201170925538436,152.799774872826,39.2995156589226,732.803611157153,20.1170925538436
2021-01-16,223684,2433,191276,1751,32408,682,211367,2003,1400806,10891,1612173,12894,13,2777,358,18352,2062,202555,54,7375,3277,"East TN",2455501,492.323155233901,0.18745109055521,525.106689021914,99.0836493245167,747.383120593313,18.745109055521
2021-01-17,224540,856,191882,606,32658,250,212039,672,1404425,3619,1616464,4291,13,2790,-840,17512,1683,204238,24,7399,3310,"East TN",2455501,459.295272125729,0.186165579656264,174.750488800453,34.8605030093655,713.174215771038,18.6165579656264
2021-01-18,225102,562,192201,319,32901,243,212393,354,1406509,2084,1618902,2438,13,2803,-2467,15045,3016,207254,21,7420,3341,"East TN",2455501,424.190419796205,0.177673408803917,99.2872737579826,22.8873863215694,612.705920298953,17.7673408803917
2021-01-19,226780,1678,193171,970,33609,708,213458,1065,1410717,4208,1624175,5273,21,2824,-1174,13871,2831,210085,52,7472,3380,"East TN",2455501,418.407485885772,0.175282696110013,214.742327533159,68.3363598711627,564.894903321155,17.5282696110013
2021-01-20,227764,984,193829,658,33935,326,214155,697,1414713,3996,1628868,4693,32,2856,-1013,12858,1965,212050,29,7501,3420,"East TN",2455501,396.212422637987,0.169989961671838,191.121893251113,40.073288506093,523.64059310096,16.9989961671838
2021-01-21,229330,1566,194971,1142,34359,424,215436,1281,1421646,6933,1637082,8214,65,2921,-762,12096,2263,214313,37,7538,3466,"East TN",2455501,368.315875253156,0.162820358560943,334.514219297813,63.7751725615261,492.608229440754,16.2820358560943
2021-01-22,230318,988,195678,707,34640,281,216253,817,1427090,5444,1643343,6261,32,2953,-728,11368,1684,215997,31,7569,3497,"East TN",2455501,369.252547647099,0.156340777051561,254.978515586025,40.2361880528658,462.960511928116,15.6340777051561
2021-01-23,231750,1432,196647,969,35103,463,217354,1101,1435372,8282,1652726,9383,19,2972,206,11574,1207,217204,41,7610,3522,"East TN",2455501,328.486936067222,0.147633960496141,382.121611842145,58.3180377446395,471.349838586912,14.7633960496141
2021-01-24,232375,625,197138,491,35237,134,217897,543,1438748,3376,1656645,3919,19,2991,-602,10972,1208,218412,20,7630,3550,"East TN",2455501,319.079487241097,0.145790298897489,159.600830950588,25.45305418324,446.833456797615,14.5790298897489
2021-01-25,233115,740,197649,511,35466,229,218446,549,1440505,1757,1658951,2306,44,3035,-1151,9821,1847,220259,20,7650,3581,"East TN",2455501,326.328517072483,0.151139853679243,93.9115887144823,30.1364161529562,399.95911221376,15.1139853679243
2021-01-26,234147,1032,198378,729,35769,303,219230,784,1444971,4466,1664201,5250,63,3098,-917,8904,1886,222145,25,7675,3603,"East TN",2455501,300.020240268687,0.144206265927147,213.805655139216,42.0280830673659,362.61439111611,14.4206265927147
2021-01-27,235100,953,199082,704,36018,249,219985,755,1449494,4523,1669479,5278,55,3153,-391,8513,1289,223434,27,7702,3626,"East TN",2455501,298.757768781198,0.143557164315087,214.945951966625,38.8108170186043,346.690960419075,14.3557164315087
2021-01-28,236428,1328,199796,714,36632,614,220781,796,1453925,4431,1674706,5227,46,3199,-178,8335,1460,224894,28,7730,3653,"East TN",2455501,289.06524574822,0.14206357644057,212.868982745273,54.0826495285484,339.441930587689,14.206357644057
2021-01-29,237022,594,200147,351,36875,243,221178,397,1456592,2667,1677770,3064,17,3216,-683,7652,1260,226154,17,7747,3673,"East TN",2455501,273.019640391105,0.143056322072792,124.781052827916,24.1905826957513,311.626832976244,14.3056322072792
2021-01-30,238176,1154,201113,966,37063,188,222275,1097,1465642,9050,1687917,10147,44,3260,237,7889,873,227027,28,7775,3693,"East TN",2455501,261.6981218904,0.13983689011395,413.235425275738,46.9965192439343,321.278631122529,13.983689011395
2021-01-31,238857,681,201555,442,37302,239,222766,491,1469567,3925,1692333,4416,29,3289,-82,7807,734,227761,30,7805,3713,"East TN",2455501,263.978715545219,0.136432414256893,179.841099637101,27.7336478380583,317.939190413687,13.6432414256893
2021-02-01,239550,693,201962,407,37588,286,223207,441,1471263,1696,1694470,2137,39,3328,-543,7264,1197,228958,11,7816,3740,"East TN",2455501,262.064645870639,0.134040935837158,87.0290828633342,28.2223464783765,295.825576939289,13.4040935837158
2021-02-02,240088,538,202311,349,37777,189,223570,363,1472322,1059,1695892,1422,57,3385,-840,6424,1321,230279,12,7828,3756,"East TN",2455501,241.946551844206,0.136947398314979,57.9107888777077,21.909989040933,261.616672117014,13.6947398314979
2021-02-03,241199,1111,203069,758,38130,353,224397,827,1478327,6005,1702724,6832,46,3431,36,6460,1029,231308,39,7867,3768,"East TN",2455501,248.381083941729,0.132711685967815,278.232425887833,45.2453491161274,263.082768037969,13.2711685967815
2021-02-04,242293,1094,203848,779,38445,315,225263,866,1486041,7714,1711304,8580,58,3489,-6,6454,1042,232350,36,7903,3787,"East TN",2455501,238.851460455524,0.122465708508662,349.419527827519,44.5530260423433,262.83841871781,12.2465708508662
2021-02-05,243110,817,204407,559,38703,258,225869,606,1489847,3806,1715716,4412,67,3556,-150,6304,900,233250,28,7931,3801,"East TN",2455501,247.933110188104,0.123623043272018,179.678200090328,33.2722324283313,256.729685713832,12.3623043272018
2021-02-06,244343,1233,205229,822,39114,411,226830,961,1498502,8655,1725332,9616,27,3583,501,6805,705,233955,22,7953,3831,"East TN",2455501,251.150376236866,0.121742616597621,391.610510441657,50.2137852926959,277.132853947117,12.1742616597621
2021-02-07,244860,517,205582,353,39278,164,227236,406,1501586,3084,1728822,3490,2,3585,-129,6676,644,234599,9,7962,3846,"East TN",2455501,244.471494819184,0.122502672038148,142.129854559212,21.0547664203761,271.879343563696,12.2502672038148
2021-02-08,245372,512,205881,299,39491,213,227556,320,1502949,1363,1730505,1683,32,3617,-628,6048,1108,235707,9,7971,3862,"East TN",2455501,237.100290327717,0.120688219786319,68.5399843046287,20.8511419869102,246.304114720377,12.0688219786319
2021-02-09,246400,1028,206513,632,39887,396,228224,668,1507182,4233,1735406,4901,16,3633,-59,5989,1071,236778,38,8009,3873,"East TN",2455501,257.055484807377,0.117781039631523,199.592669683295,41.8651835205931,243.901346405479,11.7781039631523
2021-02-10,247249,849,207096,583,40153,266,228861,637,1513169,5987,1742030,6624,39,3672,-27,5962,837,237615,30,8039,3886,"East TN",2455501,246.385564493763,0.11357044725996,269.761649455651,34.5754288025132,242.801774464763,11.357044725996
2021-02-11,248116,867,207679,583,40437,284,229512,651,1518743,5574,1748255,6225,37,3709,-99,5863,929,238544,31,8070,3904,"East TN",2455501,237.14101521441,0.11499012205353,253.51241966507,35.3084767629905,238.770010682138,11.499012205353
2021-02-12,248948,832,208272,593,40676,239,230161,649,1524253,5510,1754414,6159,34,3743,60,5923,738,239282,11,8081,3913,"East TN",2455501,237.751888514808,0.110910124554241,250.82457714332,33.8831057287291,241.213503883729,11.0910124554241
2021-02-13,249542,594,208645,373,40897,221,230595,434,1528680,4427,1759275,4861,12,3755,-25,5898,607,239889,17,8098,3925,"East TN",2455501,211.728685917864,0.110921250331438,197.963674215567,24.1905826957513,240.195381716399,11.0921250331438
2021-02-14,250083,541,209060,415,41023,126,231048,453,1531648,2968,1762696,3421,15,3770,-50,5848,576,240465,15,8113,3938,"East TN",2455501,212.7060831985,0.112534687370845,139.319837377382,22.0321637010125,238.15913738174,11.2534687370845
2021-02-15,250461,378,209269,209,41192,169,231276,228,1532972,1324,1764248,1552,5,3775,-575,5273,948,241413,10,8123,3949,"East TN",2455501,207.248948381613,0.110245087870077,63.2050241478216,15.3940071700236,214.742327533159,11.0245087870077
2021-02-16,251227,766,209697,428,41530,338,231748,472,1536381,3409,1768129,3881,8,3783,-39,5234,797,242210,25,8148,3959,"East TN",2455501,196.579028067999,0.107691837545457,158.053285256247,31.1952632069789,213.154056952125,10.7691837545457
2021-02-17,251848,621,210116,419,41732,202,232199,451,1539635,3254,1771834,3705,11,3794,-90,5144,700,242910,11,8159,3976,"East TN",2455501,187.293753901953,0.111998389477922,150.885705198247,25.2901546364673,209.488817149738,11.1998389477922
2021-02-18,252643,795,210668,552,41975,243,232805,606,1545354,5719,1778159,6325,42,3836,24,5168,729,243639,21,8180,3992,"East TN",2455501,184.361562060044,0.110119047619048,257.584908334389,32.3762849210813,210.466214430375,11.0119047619048
2021-02-19,253122,479,210972,304,42150,175,233150,345,1548062,2708,1781212,3053,5,3841,-222,4946,696,244335,11,8191,4001,"East TN",2455501,169.98567705735,0.111538174490634,124.333079074291,19.5072207260351,201.425289584488,11.1538174490634
2021-02-20,253744,622,211419,447,42325,175,233655,505,1553289,5227,1786944,5732,18,3859,75,5021,529,244864,18,8209,4011,"East TN",2455501,171.125973884759,0.110593082511114,233.435050525331,25.3308795231604,204.479656086477,11.0593082511114
2021-02-21,254092,348,211646,227,42446,121,233918,263,1555423,2134,1789341,2397,7,3866,-83,4938,424,245288,12,8221,4029,"East TN",2455501,163.266070752975,0.107712516419591,97.617553403562,14.172260569228,201.099490490943,10.7712516419591
2021-02-22,254450,358,211842,196,42608,162,234146,228,1556805,1382,1790951,1610,7,3873,-480,4458,831,246119,22,8243,4045,"East TN",2455501,162.451573019111,0.107478560461371,65.5670675760262,14.5795094361599,181.551544878214,10.7478560461371
2021-02-23,255093,643,212191,349,42902,294,234514,368,1559751,2946,1794265,3314,26,3899,-143,4315,760,246879,27,8270,4051,"East TN",2455501,157.442411955849,0.105831037649219,134.962274501212,26.1861021437173,175.727886081089,10.5831037649219
2021-02-24,255834,741,212740,549,43094,192,235124,610,1565952,6201,1801076,6811,19,3918,56,4371,666,247545,23,8293,4058,"East TN",2455501,162.329398359031,0.100027357909856,277.377203267276,30.1771410396493,178.008479735907,10.0027357909856
2021-02-25,256469,635,213185,445,43284,190,235619,495,1570720,4768,1806339,5263,21,3939,-95,4276,709,248254,16,8309,4067,"East TN",2455501,155.813416488122,0.0998580553584102,214.335078666227,25.8603030501718,174.139615500055,9.98580553584102
2021-02-26,256931,462,213509,324,43422,138,235987,368,1573843,3123,1809830,3491,14,3953,-183,4093,631,248885,11,8320,4072,"East TN",2455501,155.121093414338,0.0991334125375638,142.170579445905,18.814897652251,166.686961235202,9.91334125375638
2021-02-27,257370,439,213734,225,43636,214,236261,274,1577938,4095,1814199,4369,7,3960,10,4103,422,249307,16,8336,4080,"East TN",2455501,147.668439149485,0.0956154833975417,177.927029962521,17.8782252583078,167.094210102134,9.56154833975417
2021-02-28,257736,366,214008,274,43728,92,236574,313,1580498,2560,1817072,2873,5,3965,-53,4050,414,249721,11,8347,4089,"East TN",2455501,148.401487109962,0.0957772889545995,117.002599469518,14.9053085297053,164.935791107395,9.57772889545995
2021-03-01,257980,244,214156,148,43824,96,236730,156,1581277,779,1818007,935,4,3969,-410,3640,650,250371,11,8358,4098,"East TN",2455501,143.75885002694,0.0955056179775281,38.077769058127,9.9368723531369,148.23858756319,9.55056179775281
2021-03-02,258600,620,214546,390,44054,230,237177,447,1584733,3456,1821910,3903,7,3976,5,3645,608,250979,24,8382,4108,"East TN",2455501,142.822177632996,0.0963284499909568,158.949232763497,25.2494297497741,148.442211996656,9.63284499909568
2021-03-03,259083,483,214849,303,44234,180,237532,355,1588906,4173,1826438,4528,7,3983,-145,3500,621,251600,17,8399,4111,"East TN",2455501,132.315156866155,0.0949451935967195,184.402286946737,19.6701202728079,142.537103426144,9.49451935967195
2021-03-04,259691,608,215263,414,44428,194,238004,472,1593728,4822,1831732,5294,18,4001,47,3547,543,252143,20,8419,4116,"East TN",2455501,131.215584925439,0.093923522230536,215.597550153716,24.7607311094559,144.451173100724,9.3923522230536
2021-03-05,260162,471,215574,311,44588,160,238358,354,1597409,3681,1835767,4035,15,4016,-63,3484,519,252662,16,8435,4121,"East TN",2455501,131.582108905678,0.0914138103867062,164.324917806997,19.1814216324897,141.885505239053,9.14138103867062
2021-03-06,260625,463,215897,323,44728,140,238730,372,1601685,4276,1840415,4648,1,4017,50,3534,412,253074,10,8445,4127,"East TN",2455501,132.559506186314,0.094179127250534,189.289273349919,18.8556225389442,143.921749573712,9.4179127250534
2021-03-07,260880,255,216061,164,44819,91,238914,184,1603415,1730,1842329,1914,1,4018,-110,3424,364,253438,4,8449,4131,"East TN",2455501,128.039043763371,0.0926475828483193,77.9474331307542,10.3848461067619,139.442012037462,9.26475828483193
2021-03-08,261336,456,216353,292,44983,164,239226,312,1604996,1581,1844222,1893,3,4021,-127,3297,580,254018,9,8458,4139,"East TN",2455501,136.672719742325,0.0952126645050544,77.0922105101973,18.5705483320919,134.269951427428,9.52126645050544
2021-03-09,261875,539,216635,282,45240,257,239545,319,1607572,2576,1847117,2895,6,4027,26,3323,507,254525,21,8479,4151,"East TN",2455501,133.374003920178,0.0939421589241084,117.898546976768,21.9507139276262,135.32879848145,9.39421589241084
2021-03-10,262524,649,217098,463,45426,186,240052,507,1613044,5472,1853096,5979,7,4034,173,3496,469,254994,29,8508,4160,"East TN",2455501,140.134335111246,0.0945307224848076,243.494097538547,26.4304514638764,142.374203879371,9.45307224848076
2021-03-11,263058,534,217438,340,45620,194,240417,365,1616383,3339,1856800,3704,5,4039,88,3584,441,255435,9,8517,4168,"East TN",2455501,137.120693495951,0.0962581777565023,150.844980311554,21.7470894941603,145.957993908371,9.62581777565023
2021-03-12,263521,463,217806,368,45715,95,240833,416,1619730,3347,1860563,3763,5,4044,5,3589,453,255888,12,8529,4176,"East TN",2455501,136.794894402405,0.0998144862074528,153.247748626451,18.8556225389442,146.161618341837,9.98144862074528
2021-03-13,263968,447,218022,216,45946,231,241113,280,1623369,3639,1864482,3919,2,4046,42,3631,403,256291,20,8549,4182,"East TN",2455501,136.143296215314,0.0990152490962729,159.600830950588,18.2040243518532,147.872063582951,9.90152490962729
2021-03-14,264230,262,218198,176,46032,86,241324,211,1625211,1842,1866535,2053,0,4046,-51,3580,313,256604,10,8559,4188,"East TN",2455501,136.428370422166,0.0995620920432951,83.6081923811067,10.6699203136142,145.795094361599,9.95620920432951
2021-03-15,264586,356,218383,185,46203,171,241541,217,1626407,1196,1867948,1413,4,4050,-167,3413,519,257123,15,8574,4192,"East TN",2455501,132.355881752848,0.0975722835707662,57.544264897469,14.4980596627735,138.994038283837,9.75722835707663
2021-03-16,265285,699,218834,451,46451,248,242037,496,1629674,3267,1871711,3763,4,4054,190,3603,505,257628,36,8610,4193,"East TN",2455501,138.871863623757,0.101325526551191,153.247748626451,28.4666957985356,146.731766755542,10.1325526551191
2021-03-17,265710,425,219166,332,46544,93,242401,364,1633398,3724,1875799,4088,1,4055,-31,3572,455,258083,16,8626,4202,"East TN",2455501,129.749489004484,0.103466502224376,166.483336801736,17.3080768446032,145.469295268053,10.3466502224376
2021-03-18,266260,550,219515,349,46745,201,242786,385,1636689,3291,1879475,3676,6,4061,99,3671,445,258528,31,8657,4209,"East TN",2455501,130.401087191575,0.104476295479603,149.704683484144,22.3986876812512,149.501059050678,10.4476295479603
2021-03-19,267052,792,220045,530,47007,262,243349,563,1641734,5045,1885083,5608,15,4076,337,4008,440,258968,25,8682,4215,"East TN",2455501,143.799574913633,0.102610114192496,228.385164575376,32.2541102610017,163.225345866281,10.2610114192496
2021-03-20,267325,273,220211,166,47114,107,243543,194,1643855,2121,1887398,2315,1,4077,-42,3966,314,259282,15,8697,4217,"East TN",2455501,136.713444629019,0.106039448420318,94.278112694721,11.1178940672392,161.514900625168,10.6039448420318
2021-03-21,267606,281,220407,196,47199,85,243768,225,1645654,1799,1889422,2024,-7,4070,-31,3935,319,259601,8,8705,4224,"East TN",2455501,137.487217476189,0.1067855114257,82.4271706670044,11.4436931607847,160.252429137679,10.67855114257
2021-03-22,268131,525,220746,339,47385,186,244124,356,1647743,2089,1891867,2445,14,4084,-16,3919,527,260128,19,8724,4231,"East TN",2455501,144.369723327337,0.107989464442493,99.5723479648349,21.3805655139216,159.600830950588,10.7989464442493
2021-03-23,268568,437,220994,248,47574,189,244391,267,1650198,2455,1894589,2722,11,4095,-78,3841,504,260632,17,8741,4236,"East TN",2455501,133.699803013723,0.102893609581257,110.853141578847,17.7967754849214,156.42428978852,10.2893609581257
2021-03-24,269165,597,221451,457,47714,140,244884,493,1654897,4699,1899781,5192,4,4099,85,3926,508,261140,26,8767,4242,"East TN",2455501,140.704483524951,0.103535985322325,211.443611711011,24.3127573558308,159.88590515744,10.3535985322325
2021-03-25,269565,400,221758,307,47807,93,245217,333,1657865,2968,1903082,3301,8,4107,-66,3860,458,261598,23,8790,4246,"East TN",2455501,134.595750520973,0.102977930274918,134.4328509742,16.2899546772736,157.19806263569,10.2977930274918
2021-03-26,269975,410,222080,322,47895,88,245563,346,1660497,2632,1906060,2978,7,4114,-63,3797,466,262064,14,8804,4256,"East TN",2455501,119.038843804177,0.105544167421462,121.278712572302,16.6972035442054,154.63239477402,10.5544167421462
2021-03-27,270178,203,222260,180,47918,23,245773,210,1663009,2512,1908782,2722,2,4116,-164,3633,365,262429,12,8816,4267,"East TN",2455501,116.188101735654,0.104283576505799,110.853141578847,8.26715199871635,147.953513356337,10.4283576505799
2021-03-28,270494,316,222479,219,48015,97,246018,245,1665081,2072,1911099,2317,5,4121,-67,3566,378,262807,17,8833,4273,"East TN",2455501,117.613472769915,0.103796650828067,94.3595624681073,12.8690641950461,145.224945947894,10.3796650828067
2021-03-29,270933,439,222716,237,48217,202,246273,255,1666936,1855,1913209,2110,18,4139,-92,3474,513,263320,18,8851,4278,"East TN",2455501,114.111132514302,0.100693468278512,85.9295109226182,17.8782252583078,141.478256372121,10.0693468278512
2021-03-30,271308,375,222974,258,48334,117,246595,322,1669413,2477,1916008,2799,5,4144,-143,3331,513,263833,20,8871,4284,"East TN",2455501,111.586189539324,0.102899295018442,113.988957854222,15.271832509944,135.654597574996,10.2899295018442
2021-03-31,271969,661,223416,442,48553,219,247083,488,1674230,4817,1921313,5305,4,4148,168,3499,489,264322,18,8889,4289,"East TN",2455501,114.192582287688,0.102127066691436,216.045523907341,26.9191501041946,142.496378539451,10.2127066691436
2021-04-01,272417,448,223737,321,48680,127,247433,350,1677058,2828,1924491,3178,1,4149,-87,3412,534,264856,18,8907,4295,"East TN",2455501,116.147376848961,0.103507870521743,129.423689910939,18.2447492385464,138.953313397144,10.3507870521743
2021-04-02,272768,351,223972,235,48796,116,247685,252,1680078,3020,1927763,3272,0,4149,-78,3334,429,265285,12,8919,4300,"East TN",2455501,113.744608534063,0.0977745012210293,133.251829260098,14.2944352293076,135.776772235075,9.77745012210293
2021-04-03,273111,343,224223,251,48888,92,247960,275,1682429,2351,1930389,2626,0,4149,-55,3279,398,265683,13,8932,4309,"East TN",2455501,119.446092671109,0.101217198130236,106.943552456301,13.9686361357621,133.53690346695,10.1217198130236
2021-04-04,273282,171,224346,123,48936,48,248101,141,1684024,1595,1932125,1736,6,4155,-179,3100,344,266027,8,8940,4313,"East TN",2455501,113.540984100597,0.0990678207933035,70.6984032993674,6.96395562453446,126.24714874887,9.90678207933035
2021-04-05,273689,407,224581,235,49108,172,248324,223,1685243,1219,1933567,1442,6,4161,-93,3007,494,266521,40,8980,4319,"East TN",2455501,112.237787726415,0.100746635229394,58.7252866115713,16.5750288841259,122.459734286404,10.0746635229394
2021-04-06,274120,431,224831,250,49289,181,248602,278,1687329,2086,1935931,2364,3,4164,-6,3001,434,266955,27,9007,4324,"East TN",2455501,114.518381381233,0.100737840686644,96.273632142687,17.5524261647623,122.215384966245,10.0737840686644
2021-04-07,274752,632,225294,463,49458,169,249109,507,1692022,4693,1941131,5200,5,4169,209,3210,418,267373,24,9031,4328,"East TN",2455501,113.337359667131,0.102230295690786,211.769410804557,25.7381283900923,130.726886285121,10.2230295690786
2021-04-08,275158,406,225549,255,49609,151,249398,289,1695034,3012,1944432,3301,-1,4168,47,3257,360,267733,21,9052,4333,"East TN",2455501,111.626914426017,0.0985406950503987,134.4328509742,16.5343039974327,132.6409559597,9.85406950503987
2021-04-09,275676,518,225955,406,49721,112,249848,450,1698910,3876,1948758,4326,4,4172,109,3366,405,268138,31,9083,4336,"East TN",2455501,118.427970503779,0.103024529649917,176.175859834714,21.0954913070693,137.079968609257,10.3024529649917
2021-04-10,275980,304,226170,215,49810,89,250095,247,1701691,2781,1951786,3028,1,4173,-11,3355,314,268452,15,9098,4341,"East TN",2455501,116.839699922745,0.0997803430387438,123.314956906961,12.3803655547279,136.631994855632,9.97803430387438
2021-04-11,276217,237,226333,163,49884,74,250269,174,1703404,1713,1953673,1887,2,4175,-85,3270,320,268772,10,9108,4344,"East TN",2455501,119.527542444495,0.100612585854836,76.8478611900382,9.65179814628461,133.170379486712,10.0612585854836
2021-04-12,276682,465,226656,323,50026,142,250599,330,1705167,1763,1955766,2093,3,4178,13,3283,449,269221,15,9123,4353,"East TN",2455501,121.8895858727,0.102482093788008,85.2371878488341,18.9370723123306,133.699803013723,10.2482093788008
2021-04-13,277060,378,226896,240,50164,138,250849,250,1707224,2057,1958073,2307,3,4181,-56,3227,431,269652,16,9139,4357,"East TN",2455501,119.731166877961,0.101481347665071,93.9523136011755,15.3940071700236,131.419209358905,10.1481347665071
2021-04-14,277740,680,227398,502,50342,178,251406,557,1712045,4821,1963451,5378,0,4181,269,3496,411,270063,29,9168,4360,"East TN",2455501,121.685961439234,0.102912186379928,219.018440635944,27.6929229513651,142.374203879371,10.2912186379928
2021-04-15,278280,540,227764,366,50516,174,251786,380,1715190,3145,1966976,3525,2,4183,115,3611,423,270486,24,9192,4365,"East TN",2455501,127.14309625612,0.105926188786373,143.555225593474,21.9914388143194,147.057565849087,10.5926188786373
2021-04-16,279258,978,228659,895,50599,83,252891,1105,1722675,7485,1975566,8590,3,4186,634,4245,341,270827,32,9224,4368,"East TN",2455501,145.876544134985,0.113510892270964,349.826776694451,39.8289391859339,172.877144012566,11.3510892270964
2021-04-17,279460,202,228806,147,50654,55,253064,173,1724906,2231,1977970,2404,0,4186,-91,4154,293,271120,10,9234,4369,"East TN",2455501,141.72260569228,0.113389856400855,97.9026276104143,8.22642711202317,169.171179323486,11.3389856400855
2021-04-18,279678,218,228993,187,50685,31,253266,202,1726709,1803,1979975,2005,6,4192,-122,4032,334,271454,8,9242,4378,"East TN",2455501,140.94883284511,0.113945707550757,81.6533978198339,8.87802529911411,164.202743146918,11.3945707550757
2021-04-19,280006,328,229188,195,50818,133,253476,210,1728158,1449,1981634,1659,8,4200,-212,3820,532,271986,15,9257,4385,"East TN",2455501,135.369523368144,0.111218493892067,67.5625870239923,13.3577628353644,155.569067167963,11.1218493892067
2021-04-20,280359,353,229465,277,50894,76,253757,281,1730606,2448,1984363,2729,4,4204,-113,3707,462,272448,20,9277,4389,"East TN",2455501,134.351401200814,0.110612400152149,111.138215785699,14.375885002694,150.967154971633,11.0612400152149
2021-04-21,280872,513,229795,330,51077,183,254096,339,1734388,3782,1988484,4121,4,4208,30,3737,479,272927,14,9291,4395,"East TN",2455501,127.550345123052,0.10745815523509,167.827258062611,20.8918668736034,152.188901572429,10.745815523509
2021-04-22,281514,642,230193,398,51321,244,254547,451,1738640,4252,1993187,4703,3,4211,193,3930,446,273373,23,9314,4399,"East TN",2455501,131.704283565757,0.105337453740796,191.529142118044,26.1453772570241,160.048804704213,10.5337453740796
2021-04-23,281898,384,230471,278,51427,106,254855,308,1741843,3203,1996698,3511,0,4211,-9,3921,393,273766,11,9325,4403,"East TN",2455501,107.513700870006,0.0929396176414916,142.985077179769,15.6383564901827,159.682280723974,9.29396176414916
2021-04-24,282158,260,230659,188,51499,72,255064,209,1744841,2998,1999905,3207,0,4211,-132,3789,392,274158,20,9345,4410,"East TN",2455501,109.87574429821,0.0911784818782767,130.604711625041,10.5884705402278,154.306595680474,9.11784818782767
2021-04-25,282358,200,230807,148,51551,52,255223,159,1746492,1651,2001715,1810,4,4215,-113,3676,309,274467,17,9362,4415,"East TN",2455501,109.142696337733,0.0900183992640294,73.712044914663,8.1449773386368,149.704683484144,9.00183992640294
2021-04-26,282744,386,231051,244,51693,142,255475,252,1748464,1972,2003939,2224,6,4221,-143,3533,523,274990,15,9377,4423,"East TN",2455501,111.504739765938,0.0896211611746245,90.5721480056412,15.719806263569,143.881024687019,8.96211611746245
2021-04-27,283134,390,231255,204,51879,186,255693,218,1750828,2364,2006521,2582,3,4224,-48,3485,435,275425,25,9402,4429,"East TN",2455501,113.011560573586,0.0873725065439119,105.151657441801,15.8827058103418,141.926230125746,8.73725065439119
2021-04-28,283622,488,231601,346,52021,142,256074,381,1754956,4128,2011030,4509,6,4230,11,3496,471,275896,24,9426,4437,"East TN",2455501,111.993438406256,0.0877317484254413,183.628514099567,19.8737447062738,142.374203879371,8.77317484254413
2021-04-29,284014,392,231880,279,52134,113,256378,304,1757888,2932,2014266,3236,1,4231,18,3514,373,276269,22,9448,4441,"East TN",2455501,101.81221673296,0.0868637032117273,131.785733339143,15.9641555837281,143.107251839849,8.68637032117273
2021-04-30,284383,369,232107,227,52276,142,256618,240,1761155,3267,2017773,3507,0,4231,-1,3513,370,276639,17,9465,4446,"East TN",2455501,101.201343432562,0.0836536180308422,142.822177632996,15.0274831897849,143.066526953155,8.36536180308422
2021-05-01,284618,235,232289,182,52329,53,256807,189,1763646,2491,2020453,2680,-1,4230,-28,3485,264,276903,15,9480,4447,"East TN",2455501,100.183221265233,0.0848257737979365,109.142696337733,9.57034837289824,141.926230125746,8.48257737979365
2021-05-02,284793,175,232417,128,52376,47,256940,133,1765122,1476,2022062,1609,1,4231,-76,3409,250,277153,11,9491,4451,"East TN",2455501,99.165099097903,0.0843859045559542,65.526342689333,7.1268551713072,138.831138737064,8.43859045559542
2021-05-03,285005,212,232531,114,52474,98,257066,126,1766606,1484,2023672,1610,5,4236,-224,3185,431,277584,17,9508,4455,"East TN",2455501,92.078968813289,0.0806263619317894,65.5670675760262,8.63367597895501,129.708764117791,8.06263619317894
2021-05-04,285326,321,232752,221,52574,100,257311,245,1769006,2400,2026317,2645,7,4243,-80,3105,394,277978,12,9520,4463,"East TN",2455501,89.2689516314593,0.0817336835724389,107.717325303472,13.0726886285121,126.450773182336,8.17336835724389
2021-05-05,285790,464,233045,293,52745,171,257622,311,1773156,4150,2030778,4461,5,4248,127,3232,332,278310,22,9542,4468,"East TN",2455501,88.2915543508229,0.0783876848288434,181.673719538294,18.8963474256374,131.622833792371,7.83876848288434
2021-05-06,286076,286,233242,197,52834,89,257853,231,1775594,2438,2033447,2669,4,4252,-100,3132,382,278692,10,9552,4474,"East TN",2455501,83.9747163613454,0.076899014649914,108.694722584108,11.6473175942506,127.550345123052,7.6899014649914
2021-05-07,286442,366,233491,249,52951,117,258122,269,1779043,3449,2037165,3718,0,4252,16,3148,350,279042,15,9567,4479,"East TN",2455501,83.8525417012658,0.0775577557755776,151.415128725258,14.9053085297053,128.201943310143,7.75577557755776
2021-05-08,286613,171,233594,103,53019,68,258236,114,1780938,1895,2039174,2009,0,4252,-94,3054,265,279307,7,9574,4486,"East TN",2455501,81.2461489529021,0.0763313925538166,81.8162973666066,6.96395562453446,124.373803960984,7.63313925538166
2021-05-09,286759,146,233709,115,53050,31,258368,132,1782649,1711,2041017,1843,4,4256,-161,2893,303,279610,11,9585,4491,"East TN",2455501,80.0651272387997,0.0753363228699552,75.0559661755381,5.94583345720486,117.817097203381,7.53363228699552
2021-05-10,286994,235,233845,136,53149,99,258513,145,1784165,1516,2042678,1661,7,4263,-200,2693,428,280038,22,9607,4494,"East TN",2455501,81.001799632743,0.0761338524676418,67.6440367973786,9.57034837289824,109.672119864745,7.61338524676418
2021-05-11,287309,315,234073,228,53236,87,258757,244,1786843,2678,2045600,2922,1,4264,-57,2636,371,280409,19,9626,4498,"East TN",2455501,80.7574503125839,0.0749883316911269,118.998118917484,12.828339308353,107.350801323233,7.49883316911269
2021-05-12,287613,304,234290,217,53323,87,259008,251,1790909,4066,2049917,4317,3,4267,-53,2583,354,280763,16,9642,4500,"East TN",2455501,74.2414684416744,0.0724175766758974,175.809335854475,12.3803655547279,105.192382328494,7.24175766758974
2021-05-13,287823,210,234426,136,53397,74,259153,145,1793642,2733,2052795,2878,1,4268,-131,2452,340,281103,9,9651,4505,"East TN",2455501,71.1463770529924,0.067190407277238,117.206223902984,8.55222620556864,99.8574221716871,6.7190407277238
2021-05-14,288124,301,234645,219,53479,82,259401,248,1796327,2685,2055728,2933,1,4269,34,2486,266,281369,21,9672,4510,"East TN",2455501,68.4992594179355,0.0689005009966061,119.446092671109,12.2581908946484,101.242068319255,6.89005009966061
2021-05-15,288232,108,234726,81,53506,27,259503,102,1798315,1988,2057818,2090,0,4269,-154,2332,262,281631,6,9678,4514,"East TN",2455501,65.9335915562649,0.0679575198455267,85.1150131887546,4.39828776286387,94.9704357685051,6.79575198455267
2021-05-16,288332,100,234800,74,53532,26,259588,85,1799764,1449,2059352,1534,3,4272,-121,2211,218,281849,4,9682,4518,"East TN",2455501,64.0602467683784,0.0665394055085901,62.4719761873443,4.0724886693184,90.0427244786298,6.65394055085901
2021-05-17,288531,199,234904,104,53627,95,259698,110,1801332,1568,2061030,1678,6,4278,-117,2094,310,282159,10,9692,4525,"East TN",2455501,62.5941508474238,0.0645706190061029,68.3363598711627,8.10425245194362,85.2779127355273,6.45706190061029
2021-05-18,288744,213,235039,135,53705,78,259844,146,1803570,2238,2063414,2384,8,4286,-100,1994,305,282464,22,9714,4531,"East TN",2455501,58.440212404719,0.0610194229257887,97.0881298765507,8.67440086564819,81.2054240662089,6.10194229257887
2021-05-19,288961,217,235203,164,53758,53,260011,167,1806840,3270,2066851,3437,1,4287,-53,1941,269,282733,21,9735,4534,"East TN",2455501,54.897147262412,0.0592299515767096,139.971435564473,8.83730041242093,79.0470050714701,5.92299515767096
2021-05-20,289139,178,235336,133,53803,45,260167,156,1821008,14168,2081175,14324,3,4290,-91,1850,266,282999,7,9742,4539,"East TN",2455501,53.5939508882301,0.0357293868921776,583.343276993168,7.24902983138675,75.3410403823904,3.57293868921776
2021-05-21,289303,164,235444,108,53859,56,260288,121,1823286,2278,2083574,2399,0,4290,-58,1792,222,283221,10,9752,4542,"East TN",2455501,48.0146414112639,0.0318537671478848,97.6990031769484,6.67888141768218,72.9789969541857,3.18537671478848
2021-05-22,289374,71,235492,48,53882,23,260350,62,1824872,1586,2085222,1648,0,4290,-105,1687,176,283397,12,9764,4543,"East TN",2455501,46.5078206036161,0.0309078966574223,67.1146132703672,2.89146695521606,68.7028838514014,3.09078966574223
2021-05-23,289448,74,235543,51,53905,23,260411,61,1825937,1065,2086348,1126,3,4293,-128,1559,199,283596,5,9769,4545,"East TN",2455501,45.4489735495933,0.0304859979256186,45.8562224165252,3.01364161529562,63.4900983546738,3.04859979256186
2021-05-24,289608,160,235654,111,53954,49,260537,126,1827862,1925,2088399,2051,0,4293,-90,1469,250,283846,7,9776,4549,"East TN",2455501,43.8607029685592,0.0306551207570609,83.5267426077204,6.51598187090944,59.8248585522873,3.06551207570609
2021-05-25,289752,144,235750,96,54002,48,260625,88,1829589,1727,2090214,1815,0,4293,-72,1397,216,284062,9,9785,4555,"East TN",2455501,41.0506857867295,0.0291417910447761,73.915669348129,5.8643836838185,56.892666710378,2.91417910447761
2021-05-26,289936,184,235890,140,54046,44,260790,165,1832472,2883,2093262,3048,7,4300,-33,1364,210,284272,14,9799,4560,"East TN",2455501,39.7067645258544,0.0294952860550528,124.129454640825,7.49337915154586,55.548745449503,2.94952860550528
2021-05-27,290060,124,235966,76,54094,48,260929,139,1835444,2972,2096373,3111,4,4304,-81,1283,201,284473,11,9810,4564,"East TN",2455501,37.5076206444225,0.0501381760757994,126.695122502495,5.04988594995482,52.2500296273551,5.01381760757994
2021-05-28,290177,117,236056,90,54121,27,261027,98,1837556,2112,2098583,2210,0,4304,-59,1224,176,284649,9,9819,4567,"East TN",2455501,35.5935509698428,0.0492371243920314,90.0019995919366,4.76481174310253,49.8472613124572,4.92371243920315
2021-05-29,290228,51,236088,32,54140,19,261064,37,1838632,1076,2099696,1113,0,4304,-88,1136,139,284788,7,9826,4570,"East TN",2455501,34.7790532359791,0.0493298328036479,45.3267988895138,2.07696922135238,46.263471283457,4.93298328036479
2021-05-30,290283,55,236128,40,54155,15,261110,46,1839718,1086,2100828,1132,0,4304,-66,1070,121,284909,7,9833,4574,"East TN",2455501,34.0052803888086,0.0482734806629834,46.1005717366843,2.23986876812512,43.5756287617069,4.82734806629834
2021-05-31,290363,80,236194,66,54169,14,261181,71,1841145,1427,2102326,1498,6,4310,-95,975,169,285078,4,9837,4579,"East TN",2455501,30.7472894533539,0.0462411143821354,61.0058802663896,3.25799093545472,39.7067645258544,4.62411143821354
2021-06-01,290493,130,236287,93,54206,37,261275,94,1842461,1316,2103736,1410,3,4313,-37,938,164,285242,11,9848,4582,"East TN",2455501,30.1771410396493,0.0480698121579648,57.4220902373894,5.29423527011392,38.1999437182066,4.80698121579648
2021-06-02,290612,119,236358,71,54254,48,261348,73,1844440,1979,2105788,2052,1,4314,-19,919,137,285379,9,9857,4586,"East TN",2455501,27.5300234045924,0.0445473415296184,83.5674674944136,4.8462615164889,37.4261708710361,4.45473415296184
2021-06-03,290700,88,236414,56,54286,32,261467,119,1847606,3166,2109073,3285,1,4315,-43,876,130,285509,7,9864,4591,"East TN",2455501,26.0639274836378,0.0423622047244094,133.781252787109,3.58379002900019,35.6750007432292,4.23622047244095
2021-06-04,290791,91,236473,59,54318,32,261545,78,1849758,2152,2111303,2230,1,4316,-32,844,122,285631,7,9871,4591,"East TN",2455501,25.005080429615,0.0407232704402516,90.8164973258003,3.70596468907974,34.3718043690473,4.07232704402516
2021-06-05,290832,41,236499,26,54333,15,261575,30,1851141,1383,2112716,1413,-1,4315,-67,777,109,285740,2,9873,4596,"East TN",2455501,24.5978315626831,0.039247311827957,57.544264897469,1.66972035442054,31.643236960604,3.9247311827957
2021-06-06,290858,26,236515,16,54343,10,261594,19,1852057,916,2113651,935,-1,4314,-57,720,84,285824,2,9875,4599,"East TN",2455501,23.4168098485808,0.0377446775325587,38.077769058127,1.05884705402278,29.3219184190925,3.77446775325587
2021-06-07,290931,73,236550,35,54381,38,261646,52,1853327,1270,2114973,1322,3,4317,-68,652,138,285962,10,9885,4601,"East TN",2455501,23.1317356417285,0.036767612872618,53.8383002083892,2.97291672860243,26.552626123956,3.6767612872618
2021-06-08,291018,87,236617,67,54401,20,261716,70,1854806,1479,2116522,1549,3,4320,-29,623,113,286075,4,9889,4604,"East TN",2455501,21.3805655139216,0.0344908493664946,63.082849487742,3.54306514230701,25.3716044098536,3.44908493664946
2021-06-09,291066,48,236655,38,54411,10,261770,54,1857536,2730,2119306,2784,0,4320,-63,560,111,286186,3,9892,4607,"East TN",2455501,18.4890985587055,0.0312176357449327,113.378084553824,1.95479456127283,22.805936548183,3.12176357449327
2021-06-10,291141,75,236712,57,54429,18,261836,66,1859321,1785,2121157,1851,4,4324,-21,539,92,286278,4,9896,4610,"East TN",2455501,17.9596750316941,0.0305362462760675,75.3817652690836,3.0543665019888,21.9507139276262,3.05362462760675
2021-06-11,291211,70,236758,46,54453,24,261892,56,1860806,1485,2122698,1541,2,4326,-4,535,72,286350,4,9900,4611,"East TN",2455501,17.1044524111373,0.0304519526107942,62.7570503941965,2.85074206852288,21.7878143808534,3.04519526107942
2021-06-12,291240,29,236780,22,54460,7,261923,31,1861999,1193,2123922,1224,3,4329,-24,511,50,286400,1,9901,4614,"East TN",2455501,16.6157537708191,0.0310547920756737,49.8472613124572,1.18102171410234,20.810417100217,3.10547920756737
2021-06-13,291258,18,236794,14,54464,4,261944,21,1862842,843,2124786,864,1,4330,-41,470,58,286458,1,9902,4615,"East TN",2455501,16.2899546772736,0.0314324202963628,35.186302102911,0.733047960477312,19.1406967457965,3.14324202963628
2021-06-14,291311,53,236827,33,54484,20,261985,41,1864095,1253,2126080,1294,3,4333,-9,461,59,286517,3,9905,4616,"East TN",2455501,15.4754569434099,0.030521292878365,52.6980033809801,2.15841899473875,18.7741727655578,3.0521292878365
2021-06-15,291399,88,236896,69,54503,19,262073,88,1865977,1882,2128050,1970,0,4333,-7,454,95,286612,4,9909,4619,"East TN",2455501,15.5161818301031,0.0309680777238029,80.2280267855725,3.58379002900019,18.4890985587055,3.09680777238029
2021-06-16,291466,67,236936,40,54530,27,262111,38,1867883,1906,2129994,1944,2,4335,-14,440,79,286691,7,9916,4622,"East TN",2455501,16.2899546772736,0.0319049401197605,79.1691797315497,2.72856740844333,17.918950145001,3.19049401197605
2021-06-17,291517,51,236974,38,54543,13,262157,46,1870233,2350,2132390,2396,1,4336,-7,433,57,286748,1,9917,4626,"East TN",2455501,15.3125573966372,0.028576515623609,97.5768285168689,2.07696922135238,17.6338759381487,2.8576515623609
2021-06-18,291579,62,237025,51,54554,11,262212,55,1871961,1728,2134173,1783,2,4338,-1,432,61,286809,4,9921,4628,"East TN",2455501,14.9867583030917,0.0278867102396514,72.6124729739471,2.52494297497741,17.5931510514555,2.78867102396514
2021-06-19,291607,28,237042,17,54565,11,262230,18,1873112,1151,2135342,1169,0,4338,-16,416,44,286853,5,9926,4630,"East TN",2455501,14.9460334163985,0.0268826619964974,47.6073925443321,1.14029682740915,16.9415528643645,2.68826619964974
2021-06-20,291632,25,237063,21,54569,4,262247,17,1873866,754,2136113,771,3,4341,-13,403,35,286888,2,9928,4633,"East TN",2455501,15.2311076232508,0.0267502427827315,31.3988876404449,1.0181221673296,16.4121293373532,2.67502427827315
2021-06-21,291699,67,237103,40,54596,27,262299,52,1875138,1272,2137437,1324,6,4347,3,406,58,286946,2,9930,4634,"East TN",2455501,15.8012560369554,0.0276481465175663,53.9197499817756,2.72856740844333,16.5343039974327,2.76481465175663
2021-06-22,291792,93,237149,46,54643,47,262350,51,1876565,1427,2138915,1478,5,4352,36,442,52,286998,7,9937,4638,"East TN",2455501,16.0048804704213,0.0254947077772665,60.1913825325259,3.78741446246611,18.0003999183873,2.54947077772665
2021-06-23,291861,69,237197,48,54664,21,262405,55,1878354,1789,2140759,1844,2,4354,6,448,61,287059,5,9942,4642,"East TN",2455501,16.0863302438077,0.0273107292150488,75.0966910622313,2.8100171818297,18.2447492385464,2.73107292150488
2021-06-24,291944,83,237249,52,54695,31,262467,62,1880198,1844,2142665,1906,3,4357,27,475,53,287112,6,9948,4643,"East TN",2455501,17.3895266179896,0.0301703163017032,77.6216340372087,3.38016559553427,19.3443211792624,3.01703163017032
2021-06-25,292023,79,237305,56,54718,23,262536,69,1882004,1806,2144540,1875,0,4357,32,507,47,287159,3,9951,4645,"East TN",2455501,18.0818496917737,0.0312530143725282,76.35916254972,3.21726604876154,20.6475175534443,3.12530143725282
2021-06-26,292058,35,237323,18,54735,17,262557,21,1883188,1184,2145745,1205,0,4357,1,508,34,287193,2,9953,4647,"East TN",2455501,18.366923898626,0.0314332404114198,49.0734884652867,1.42537103426144,20.6882424401375,3.14332404114198
2021-06-27,292087,29,237343,20,54744,9,262581,24,1883902,714,2146483,738,2,4359,-9,499,36,287229,3,9956,4649,"East TN",2455501,18.5298234453987,0.0322082931533269,30.0549663795698,1.18102171410234,20.3217184598988,3.22082931533269
2021-06-28,292131,44,237367,24,54764,20,262606,25,1884454,552,2147060,577,4,4363,-15,484,55,287284,3,9959,4649,"East TN",2455501,17.5931510514555,0.0319027330354359,23.4982596219672,1.7918950145001,19.7108451595011,3.19027330354359
2021-06-29,292262,131,237453,86,54809,45,262703,97,1886468,2014,2149171,2111,0,4363,79,563,52,287336,7,9966,4652,"East TN",2455501,19.1406967457965,0.0344188767550702,85.9702358093114,5.3349601568071,22.9281112082626,3.44188767550702
2021-06-30,292347,85,237516,63,54831,22,262778,75,1888112,1644,2150890,1719,3,4366,29,592,53,287389,4,9970,4652,"East TN",2455501,19.7922949328874,0.0368176882834863,70.0060802255833,3.46161536892064,24.1091329223649,3.68176882834863
2021-07-01,292453,106,237569,53,54884,53,262843,65,1890664,2552,2153507,2617,1,4367,56,648,49,287438,2,9972,4655,"East TN",2455501,20.7289673268307,0.0346799483490131,106.577028476063,4.3168379894775,26.3897265771832,3.46799483490131
2021-07-02,292535,82,237632,63,54903,19,262917,74,1892346,1682,2155263,1756,0,4367,32,680,50,287488,3,9975,4657,"East TN",2455501,20.8511419869102,0.035531101370885,71.5129010332311,3.33944070884109,27.6929229513651,3.5531101370885
2021-07-03,292583,48,237668,36,54915,12,262957,40,1893435,1089,2156392,1129,1,4368,1,681,46,287534,3,9978,4660,"East TN",2455501,21.3805655139216,0.0375692683384991,45.9783970766047,1.95479456127283,27.7336478380583,3.75692683384991
2021-07-04,292610,27,237689,21,54921,6,262982,25,1894135,700,2157117,725,0,4368,-13,668,40,287574,1,9979,4661,"East TN",2455501,21.2991157405352,0.0377092345307504,29.5255428525584,1.09957194071597,27.2042243110469,3.77092345307504
2021-07-05,292653,43,237713,24,54940,19,263007,25,1894617,482,2157624,507,0,4368,-30,638,73,287647,2,9981,4662,"East TN",2455501,21.258390853842,0.0379591063990913,20.6475175534443,1.75117012780691,25.9824777102514,3.79591063990913
2021-07-06,292815,162,237817,104,54998,58,263120,113,1895942,1325,2159062,1438,5,4373,82,720,75,287722,6,9987,4662,"East TN",2455501,22.5208623413308,0.0421595389748256,58.5623870647986,6.59743164429581,29.3219184190925,4.21595389748256
2021-07-07,292957,142,237897,80,55060,62,263208,88,1897401,1459,2160609,1547,4,4377,81,801,57,287779,6,9993,4664,"East TN",2455501,24.8421808828422,0.04424323490071,63.0013997143556,5.78293391043213,32.6206342412404,4.42432349007099
2021-07-08,293097,140,237999,102,55098,38,263325,117,1899255,1854,2162580,1971,2,4379,76,877,62,287841,3,9996,4666,"East TN",2455501,26.2268270304105,0.0531246555714758,80.2687516722657,5.70148413704576,35.7157256299224,5.31246555714758
2021-07-09,293261,164,238121,122,55140,42,263456,131,1901000,1745,2164456,1876,0,4379,100,977,64,287905,4,10000,4668,"East TN",2455501,29.5662677392516,0.0586315674970086,76.3998874364132,6.67888141768218,39.7882142992408,5.86315674970086
2021-07-10,293365,104,238194,73,55171,31,263530,74,1902056,1056,2165586,1130,0,4379,56,1033,48,287953,13,10013,4669,"East TN",2455501,31.8468613940699,0.0623232542962802,46.0191219632979,4.23538821609114,42.0688079540591,6.23232542962802
2021-07-11,293413,48,238229,35,55184,13,263573,43,1902811,755,2166384,798,2,4381,4,1037,42,287995,7,10020,4669,"East TN",2455501,32.7020840146267,0.0637746843638718,32.4984595811608,1.95479456127283,42.2317075008318,6.37746843638718
2021-07-12,293586,173,238346,117,55240,56,263698,125,1904177,1366,2167875,1491,1,4382,92,1129,80,288075,14,10034,4670,"East TN",2455501,37.9963192847407,0.0674080577504634,60.7208060595373,7.04540539792083,45.9783970766047,6.74080577504634
2021-07-13,293800,214,238483,137,55317,77,263843,145,1905798,1621,2169641,1766,4,4386,149,1278,61,288136,17,10051,4674,"East TN",2455501,40.1140133927862,0.0683429435674449,71.9201499001629,8.71512575234138,52.0464051938891,6.83429435674449
2021-07-14,293973,173,238619,136,55354,37,263985,142,1907360,1562,2171345,1704,0,4386,103,1381,70,288206,12,10063,4675,"East TN",2455501,41.3764848802749,0.0723733233979136,69.3952069251855,7.04540539792083,56.2410685232871,7.23733233979136
2021-07-15,294193,220,238769,150,55424,70,264152,167,1909161,1801,2173313,1968,0,4386,118,1499,102,288308,15,10078,4675,"East TN",2455501,44.6344758157297,0.0770520823628063,80.1465770121861,8.95947507250048,61.0466051530828,7.70520823628063
2021-07-16,294423,230,238911,142,55512,88,264306,154,1910690,1529,2174996,1683,0,4386,164,1663,66,288374,10,10088,4679,"East TN",2455501,47.3223183374798,0.0806451612903226,68.5399843046287,9.36672393943232,67.725486570765,8.06451612903226
2021-07-17,294567,144,239011,100,55556,44,264416,110,1911908,1218,2176324,1328,0,4386,54,1717,90,288464,5,10093,4681,"East TN",2455501,48.9513138052072,0.0825107096293537,54.0826495285484,5.8643836838185,69.9246304521969,8.25107096293537
2021-07-18,294711,144,239132,121,55579,23,264548,132,1913034,1126,2177582,1258,0,4386,50,1767,94,288558,6,10099,4683,"East TN",2455501,52.8609029277528,0.0870691194856224,51.2319074600255,5.8643836838185,71.9608747868561,8.70691194856224
2021-07-19,295014,303,239343,211,55671,92,264764,216,1914724,1690,2179488,1906,3,4389,165,1932,135,288693,14,10113,4684,"East TN",2455501,58.1551381978667,0.0917936794971153,77.6216340372087,12.3396406680348,78.6804810912315,9.17936794971153
2021-07-20,295370,356,239581,238,55789,118,265018,254,1916384,1660,2181402,1914,2,4391,213,2145,141,288834,22,10135,4686,"East TN",2455501,63.9380721082989,0.0999064705382195,77.9474331307542,14.4980596627735,87.3548819568797,9.99064705382195
2021-07-21,295771,401,239874,293,55897,108,265328,310,1918500,2116,2183828,2426,3,4394,248,2393,150,288984,28,10163,4690,"East TN",2455501,73.2233462743448,0.107586317391653,98.7985751176644,16.3306795639668,97.4546538567893,10.7586317391653
2021-07-22,296245,474,240207,333,56038,141,265695,367,1920869,2369,2186564,2736,5,4399,321,2714,148,289132,21,10184,4693,"East TN",2455501,83.5674674944136,0.116444041959097,111.423289992551,19.3035962925692,110.527342485301,11.6444041959097
2021-07-23,296706,461,240527,320,56179,141,266028,333,1922772,1903,2188800,2236,1,4400,328,3042,132,289264,27,10211,4699,"East TN",2455501,92.9749163205391,0.12474645030426,91.0608466459594,18.7741727655578,123.885105320666,12.474645030426
2021-07-24,297064,358,240776,249,56288,109,266293,265,1924523,1751,2190816,2016,0,4400,226,3268,132,289396,21,10232,4703,"East TN",2455501,101.69004207288,0.129519735026221,82.1013715734589,14.5795094361599,133.088929713325,12.9519735026221
2021-07-25,297292,228,240966,190,56326,38,266496,203,1925838,1315,2192334,1518,3,4403,97,3365,128,289524,17,10249,4708,"East TN",2455501,105.110932555108,0.13204989154013,61.8203780002533,9.28527416604595,137.039243722564,13.204989154013
2021-07-26,297959,667,241427,461,56532,206,266982,486,1927567,1729,2194549,2215,10,4413,448,3813,209,289733,36,10285,4712,"East TN",2455501,119.934791311427,0.147267777704004,90.2056240254026,27.1634994243537,155.283992961111,14.7267777704004
2021-07-27,298686,727,241917,490,56769,237,267497,515,1929888,2321,2197385,2836,2,4415,534,4347,191,289924,28,10313,4718,"East TN",2455501,135.043724274598,0.155102296189702,115.49577866187,29.6069926259448,177.031082455271,15.5102296189702
2021-07-28,299505,819,242465,548,57040,271,268110,613,1932755,2867,2200865,3480,2,4417,559,4906,258,290182,37,10350,4721,"East TN",2455501,152.066726912349,0.163291659329694,141.72260569228,33.3536822017177,199.796294116761,16.3291659329694
2021-07-29,300193,688,242919,454,57274,234,268606,496,1935183,2428,2203789,2924,3,4420,474,5380,211,290393,22,10372,4725,"East TN",2455501,160.78185266469,0.16899854862119,119.07956869087,28.0187220449106,219.09989040933,16.899854862119
2021-07-30,301192,999,243668,749,57524,250,269408,802,1936986,1803,2206394,2605,4,4424,751,6131,244,290637,42,10414,4730,"East TN",2455501,182.691841705623,0.192110946913721,106.088329835744,40.6841618064908,249.684280315911,19.2110946913721
2021-07-31,301727,535,244033,365,57694,170,269804,396,1938956,1970,2208760,2366,2,4426,319,6450,214,290851,32,10446,4740,"East TN",2455501,189.900146650317,0.195664288898796,96.3550819160733,21.7878143808534,262.675519171037,19.5664288898796
2021-08-01,302261,534,244455,422,57806,112,270265,461,1941093,2137,2211358,2598,3,4429,322,6772,209,291060,28,10474,4744,"East TN",2455501,202.361961978431,0.198118166526493,105.803255628892,21.7470894941603,275.788932686242,19.8118166526493
2021-08-02,303111,850,244992,537,58119,313,270801,536,1943428,2335,2214229,2871,9,4438,416,7188,425,291485,32,10506,4752,"East TN",2455501,209.814616243284,0.19405487804878,116.921149696131,34.6161536892064,292.730485550607,19.405487804878
2021-08-03,304449,1338,245960,968,58489,370,271816,1015,1947203,3775,2219019,4790,4,4442,897,8085,437,291922,40,10546,4762,"East TN",2455501,234.697522012819,0.199639456411205,195.072207260351,54.4898983954802,329.260708914393,19.9639456411205
2021-08-04,305535,1086,246793,833,58742,253,272702,886,1950822,3619,2223524,4505,8,4450,646,8731,432,292354,40,10586,4768,"East TN",2455501,245.5710667599,0.202656780970034,183.465614552794,44.2272269487978,355.568985718189,20.2656780970034
2021-08-05,306713,1178,247682,889,59031,289,273653,951,1954787,3965,2228440,4916,10,4460,665,9396,503,292857,43,10629,4775,"East TN",2455501,265.52626123956,0.204738144497181,200.203542983693,47.9739165245707,382.651035369157,20.4738144497181
2021-08-06,308052,1339,248669,987,59383,352,274736,1083,1959415,4628,2234151,5711,3,4463,907,10303,429,293286,52,10681,4788,"East TN",2455501,279.372722715242,0.191951579781677,232.579827904774,54.5306232821734,419.588507599875,19.1951579781677
2021-08-07,308776,724,249193,524,59583,200,275320,584,1962417,3002,2237737,3586,0,4463,327,10630,397,293683,28,10709,4797,"East TN",2455501,287.069726300254,0.190357870034855,146.039443681758,29.4848179658652,432.905545548546,19.0357870034855
2021-08-08,309412,636,249644,451,59768,185,275846,526,1964532,2115,2240378,2641,5,4468,220,10850,411,294094,29,10738,4808,"East TN",2455501,291.223664742959,0.192315644383184,107.554425756699,25.901027936865,441.865020621046,19.2315644383184
2021-08-09,310782,1370,250606,962,60176,408,276854,1008,1968071,3539,2244925,4547,14,4482,572,11422,784,294878,67,10805,4820,"East TN",2455501,312.400605823414,0.197191816523326,185.176059793908,55.7930947696621,465.159655809548,19.7191816523326
2021-08-10,312109,1327,251454,848,60655,479,277771,917,1971323,3252,2249094,4169,6,4488,549,11971,772,295650,48,10853,4834,"East TN",2455501,311.952632069789,0.198004987531172,169.782052623884,54.0419246418552,487.517618604106,19.8004987531172
2021-08-11,313996,1887,252758,1304,61238,583,279154,1383,1976679,5356,2255833,6739,8,4496,1064,13035,815,296465,63,10916,4853,"East TN",2455501,344.57326631103,0.199696678943948,274.445011425367,76.8478611900382,530.848898045653,19.9696678943948
2021-08-12,315458,1462,253821,1063,61637,399,280316,1162,1981161,4482,2261477,5644,10,4506,586,13621,866,297331,45,10961,4867,"East TN",2455501,356.139134131894,0.201682961527984,229.85126049633,59.539784345435,554.713681647859,20.1682961527984
2021-08-13,317105,1647,254938,1117,62167,530,281490,1174,1986580,5419,2268070,6593,11,4517,794,14415,842,298173,30,10991,4891,"East TN",2455501,368.682399233395,0.1991214363631,268.499177968162,67.073888383674,587.049241682247,19.91214363631
2021-08-14,318636,1531,256027,1089,62609,442,282690,1200,1992055,5475,2274745,6675,1,4518,912,15327,618,298791,27,11018,4905,"East TN",2455501,401.547382794794,0.199146130566364,271.838618677003,62.3498015272647,624.190338346431,19.9146130566364
2021-08-15,319781,1145,256991,964,62790,181,283747,1057,1995864,3809,2279611,4866,11,4529,426,15753,708,299499,20,11038,4918,"East TN",2455501,422.276350121625,0.201386587821477,198.167298649033,46.6299952636957,641.539140077728,20.1386587821477
2021-08-16,321223,1442,257907,916,63316,526,284709,962,1998924,3060,2283633,4022,17,4546,178,15931,1247,300746,29,11067,4937,"East TN",2455501,425.208541963534,0.202929626950501,163.795494279986,58.7252866115713,648.788169909114,20.2929626950501
2021-08-17,322960,1737,259122,1215,63838,522,286030,1321,2003783,4859,2289813,6180,10,4556,513,16444,1214,301960,25,11092,4952,"East TN",2455501,441.90574550774,0.202829146098873,251.679799763877,70.7391281860606,669.680036782718,20.2829146098873
2021-08-18,325051,2091,260508,1386,64543,705,287509,1479,2009203,5420,2296712,6899,13,4569,934,17378,1144,303104,32,11124,4966,"East TN",2455501,450.213622393149,0.20438366887644,280.960993296276,85.1557380754477,707.717080954151,20.438366887644
2021-08-19,327442,2391,262002,1494,65440,897,289087,1578,2019154,9951,2308241,11529,23,4592,1120,18498,1248,304352,43,11167,4986,"East TN",2455501,488.047042131117,0.187558805919083,469.517218685718,97.3732040834029,753.328954050518,18.7558805919083
2021-08-20,329897,2455,263980,1978,65917,477,291196,2109,2026048,6894,2317244,9003,4,4596,1274,19772,1177,305529,37,11204,5019,"East TN",2455501,520.95275057921,0.197380729653882,366.646154898736,99.9795968317667,805.212459697634,19.7380729653882
2021-08-21,332819,2922,265943,1963,66876,959,293313,2117,2034977,8929,2328290,11046,0,4596,2167,21939,755,306284,57,11261,5043,"East TN",2455501,577.601067969429,0.198393874311327,449.84709841291,118.998118917484,893.463289161764,19.8393874311327
2021-08-22,334304,1485,267284,1341,67020,144,294829,1516,2040489,5512,2335318,7028,7,4603,546,22485,932,307216,17,11278,5062,"East TN",2455501,591.447529445111,0.198933706715494,286.214503679697,60.4764567393782,915.699077296242,19.8933706715494
2021-08-23,336253,1949,268412,1128,67841,821,296016,1187,2044456,3967,2340472,5154,18,4621,186,22671,1745,308961,38,11316,5083,"East TN",2455501,612.095046998556,0.198930311933707,209.89606601667,79.3728041650156,923.273906221174,19.8930311933707
2021-08-24,338236,1983,269799,1387,68437,596,297454,1438,2048235,3779,2345689,5217,15,4636,146,22817,1822,310783,25,11341,5121,"East TN",2455501,622.113369125079,0.204452716729902,212.461733878341,80.7574503125839,929.219739678379,20.4452716729902
2021-08-25,340463,2227,271009,1210,69454,1017,298701,1247,2052271,4036,2350972,5283,17,4653,613,23430,1597,312380,39,11380,5158,"East TN",2455501,627.651953715352,0.206266126059713,215.149576400091,90.6943226657208,954.184095221301,20.6266126059712
2021-08-26,343121,2658,272843,1834,70278,824,300663,1962,2059115,6844,2359778,8806,24,4677,740,24170,1894,314274,40,11420,5189,"East TN",2455501,638.525498462432,0.224615324912199,358.623352220178,108.246748830483,984.320511374257,22.4615324912199
2021-08-27,346130,3009,275116,2273,71014,736,303027,2364,2066183,7068,2369210,9432,19,4696,1305,25475,1685,315959,44,11464,5210,"East TN",2455501,661.087085690456,0.227668090674672,384.117131290112,122.541184059791,1037.46648850886,22.7668090674672
2021-08-28,348275,2145,276657,1541,71618,604,304699,1672,2072050,5867,2376749,7539,1,4697,922,26397,1222,317181,33,11497,5245,"East TN",2455501,629.443848729852,0.234961513857075,307.024920779914,87.3548819568797,1075.01483403998,23.4961513857075
2021-08-29,350611,2336,278484,1827,72127,509,306719,2020,2079044,6994,2385763,9014,9,4706,1071,27468,1256,318437,45,11542,5276,"East TN",2455501,664.100727305751,0.235702249975221,367.094128652361,95.1333353152778,1118.63118768838,23.5702249975221
2021-08-30,353854,3243,280898,2414,72956,829,309325,2606,2088087,9043,2397412,11649,21,4727,477,27945,2745,321182,70,11612,5316,"East TN",2455501,716.798730686732,0.233737267298911,474.4042050889,132.070807545996,1138.05695864103,23.3737267298911
2021-08-31,357440,3586,283306,2408,74134,1178,311936,2611,2096674,8587,2408610,11198,7,4734,913,28858,2666,323848,79,11691,5352,"East TN",2455501,782.080724055906,0.230161631251887,456.037281190274,146.039443681758,1175.2387801919,23.0161631251887
2021-09-01,358874,1434,284255,949,74619,485,312925,989,2098957,2283,2411882,3272,15,4749,-963,27895,2382,326230,31,11722,5394,"East TN",2455501,749.785888908211,0.233524872763093,133.251829260098,58.3994875180259,1136.02071430637,23.3524872763093
2021-09-02,361189,2315,285744,1489,75445,826,314441,1516,2103220,4263,2417661,5779,19,4768,-579,27316,2875,329105,44,11766,5425,"East TN",2455501,735.817252772448,0.238031891919907,235.34912019991,94.278112694721,1112.44100491101,23.8031891919907
2021-09-03,362942,1753,286966,1222,75976,531,315736,1295,2107326,4106,2423062,5401,17,4785,-1009,26307,2745,331850,32,11798,5454,"East TN",2455501,684.666795085809,0.235998663002303,219.955113029887,71.3907263731516,1071.34959423759,23.5998663002303
2021-09-04,366206,3264,289309,2343,76897,921,318314,2578,2115374,8048,2433688,10626,3,4788,1518,27825,1743,333593,56,11854,5486,"East TN",2455501,730.237943295482,0.239115544705738,432.742646001773,132.926030166553,1133.16997223784,23.9115544705738
2021-09-05,370663,4457,292562,3253,78101,1204,321802,3488,2127884,12510,2449686,15998,8,4796,2737,30562,1712,335305,58,11912,5538,"East TN",2455501,816.615427971726,0.235955759272875,651.516737317558,181.510819991521,1244.63398711709,23.5955759272875
2021-09-06,375576,4913,296501,3939,79075,974,326091,4289,2143523,15639,2469614,19928,11,4807,960,31522,3942,339247,102,12014,5573,"East TN",2455501,884.625988749343,0.232209634082158,811.565542021771,200.081368323613,1283.72987834255,23.2209634082158
2021-09-07,377657,2081,297956,1455,79701,626,327608,1517,2147949,4426,2475557,5943,34,4841,-1808,29714,3855,343102,62,12076,5606,"East TN",2455501,823.335034276101,0.234095627884745,242.028001617593,84.7484892085159,1210.09928320127,23.4095627884745
2021-09-08,379331,1674,299132,1176,80199,498,328869,1261,2152329,4380,2481198,5641,20,4861,-1770,27944,3424,346526,60,12136,5647,"East TN",2455501,833.109007082465,0.230019043222344,229.729085836251,68.17346032439,1138.01623375433,23.0019043222344
2021-09-09,381242,1911,300138,1006,81104,905,329949,1080,2155995,3666,2485944,4746,7,4868,-1610,26334,3514,350040,55,12191,5686,"East TN",2455501,816.656152858419,0.227113630039688,193.280312245851,77.8252584706746,1072.44916617831,22.7113630039688
2021-09-10,386730,5488,303972,3834,82758,1654,334083,4134,2168101,12106,2502184,16240,23,4891,2253,28587,3212,353252,142,12333,5721,"East TN",2455501,968.763604657461,0.231882409443644,661.372159897308,223.498178172194,1164.20233589805,23.1882409443644
2021-09-11,391012,4282,307085,3113,83927,1169,337402,3319,2179922,11821,2517324,15140,8,4899,2503,31090,1771,355023,119,12452,5766,"East TN",2455501,1010.22153931112,0.228227079248171,616.574784534806,174.383964820214,1266.13672729109,22.8227079248171
2021-09-12,392594,1582,308511,1426,84083,156,338957,1555,2185166,5244,2524123,6799,23,4922,-129,30961,1688,356711,49,12501,5810,"East TN",2455501,893.137490068218,0.230463344841947,276.888504626958,64.4267707486171,1260.88321690767,23.0463344841947
2021-09-13,394947,2353,309963,1452,84984,901,340463,1506,2190289,5123,2530752,6629,63,4985,-1930,29031,4220,360931,83,12584,5861,"East TN",2455501,788.881780133667,0.235074748928653,269.965273889117,95.8256583890619,1182.28418558982,23.5074748928653
2021-09-14,397760,2813,311918,1955,85842,858,342538,2075,2196511,6222,2539049,8297,43,5028,-939,28092,3709,364640,64,12648,5905,"East TN",2455501,818.692397193078,0.235147735147735,337.894384893348,114.559106267927,1144.04351698492,23.5147735147735
2021-09-15,399552,1792,313113,1195,86439,597,343755,1217,2200286,3775,2544041,4992,23,5051,-1548,26544,3317,367957,36,12684,5943,"East TN",2455501,823.497933822874,0.236876024378212,203.298634372375,72.9789969541857,1081.00139238388,23.6876024378212
2021-09-16,402198,2646,314965,1852,87233,794,345712,1957,2206945,6659,2552657,8616,23,5074,-557,25987,3180,371137,65,12749,5980,"East TN",2455501,853.430725542364,0.236280784854526,350.885623748473,107.758050190165,1058.31763049577,23.6280784854526
2021-09-17,404885,2687,316843,1878,88042,809,347717,2005,2214149,7204,2561866,9209,23,5097,-51,25936,2715,373852,83,12832,6036,"East TN",2455501,739.360317914755,0.228444086994404,375.035481557531,109.427770544585,1056.24066127442,22.8444086994404
2021-09-18,406340,1455,318023,1180,88317,275,349054,1337,2219621,5472,2568675,6809,3,5100,-277,25659,1729,375581,40,12872,6094,"East TN",2455501,624.231063233124,0.226908920955775,277.29575349389,59.2547101385827,1044.95986766041,22.6908920955775
2021-09-19,406984,644,318469,446,88515,198,349567,513,2221698,2077,2571265,2590,17,5117,-1067,24592,1694,377275,24,12896,6138,"East TN",2455501,586.031119514918,0.225064698146027,105.477456535347,26.2268270304105,1001.50641355878,22.5064698146027
2021-09-20,408967,1983,319726,1257,89241,726,350938,1371,2227335,5637,2578273,7008,48,5165,188,24780,1747,379022,70,12966,6180,"East TN",2455501,570.96291143844,0.220428863028977,285.400005945833,80.7574503125839,1009.1626922571,22.0428863028977
2021-09-21,410843,1876,320828,1102,90015,774,352078,1140,2231640,4305,2583718,5445,31,5196,-2031,22749,3876,382898,61,13027,6226,"East TN",2455501,532.803692606926,0.213570932861716,221.747008044387,76.3998874364132,926.450447383243,21.3570932861716
2021-09-22,412435,1592,321944,1116,90491,476,353299,1221,2236998,5358,2590297,6579,14,5210,-1348,21401,2926,385824,45,13072,6262,"East TN",2455501,524.658715268289,0.206329989622968,267.929029554458,64.8340196155489,871.553300120831,20.6329989622968
2021-09-23,414787,2352,323451,1507,91336,845,354962,1663,2243354,6356,2598316,8019,32,5242,-385,21016,2705,388529,59,13131,6299,"East TN",2455501,512.685598580493,0.202588755776517,326.572866392642,95.7849335023688,855.874218743955,20.2588755776517
2021-09-24,416330,1543,324434,983,91896,560,356061,1099,2248237,4883,2604298,5982,37,5279,-911,20105,2417,390946,40,13171,6347,"East TN",2455501,466.096328203491,0.196644042232278,243.616272198627,62.8385001675829,818.773846966464,19.6644042232278
2021-09-25,417031,701,324921,487,92110,214,356623,562,2251259,3022,2607882,3584,2,5281,-910,19195,1609,392555,21,13192,6388,"East TN",2455501,435.38976363683,0.193052261075828,145.957993908371,28.548145571922,781.714200075667,19.3052261075828
2021-09-26,417892,861,325548,627,92344,234,357346,723,2255236,3977,2612582,4700,6,5287,-430,18765,1285,393840,26,13218,6423,"East TN",2455501,444.227064049251,0.188276012295181,191.406967457965,35.0641274428314,764.202498797598,18.8276012295181
2021-09-27,419354,1462,326380,832,92974,630,358268,922,2258827,3591,2617095,4513,47,5334,-1366,17399,2781,396621,44,13262,6455,"East TN",2455501,423.009398082102,0.188810468291175,183.791413646339,59.539784345435,708.572303574708,18.8810468291175
2021-09-28,420651,1297,327169,789,93482,508,359131,863,2262489,3662,2621620,4525,14,5348,-1015,16384,2298,398919,34,13296,6489,"East TN",2455501,399.429688686749,0.186085167009656,184.280112286658,52.8201780410596,667.236543581127,18.6085167009656
2021-09-29,422333,1682,328180,1011,94153,671,360270,1139,2267987,5498,2628257,6637,30,5378,-379,16005,2031,400950,50,13346,6533,"East TN",2455501,403.094928489135,0.183640674394099,270.291072982662,68.4992594179355,651.80181152441,18.3640674394099
2021-09-30,423542,1209,328939,759,94603,450,361089,819,2272659,4672,2633748,5491,11,5389,-788,15217,1986,402936,40,13386,6569,"East TN",2455501,356.546382998826,0.17292278166629,223.620352832273,49.2363880120595,619.710600810181,17.292278166629
2021-10-01,424917,1375,329911,972,95006,403,362165,1076,2277632,4973,2639797,6049,14,5403,-296,14921,1657,404593,48,13434,6597,"East TN",2455501,349.704602034371,0.171948505591707,246.34483960707,55.996719203128,607.656034348998,17.1948505591707
2021-10-02,425471,554,330263,352,95208,202,362560,395,2280302,2670,2642862,3065,11,5414,-469,14452,1012,405605,19,13453,6634,"East TN",2455501,343.718043690473,0.169725557461407,124.821777714609,22.5615872280239,588.556062489895,16.9725557461407
2021-10-03,426010,539,330728,465,95282,74,363084,524,2283394,3092,2646478,3616,13,5427,-349,14103,875,406480,15,13468,6666,"East TN",2455501,330.604630175268,0.169282511210762,147.261190282553,21.9507139276262,574.343077033974,16.9282511210762
2021-10-04,427363,1353,331588,860,95775,493,364026,942,2287532,4138,2651558,5080,22,5449,-604,13499,1935,408415,29,13497,6689,"East TN",2455501,326.165617525711,0.167077735542466,206.882424401375,55.100771695878,549.745245471291,16.7077735542466
2021-10-05,428629,1266,332343,755,96286,511,364841,815,2291994,4462,2656835,5277,17,5466,-444,13055,1693,410108,40,13537,6729,"East TN",2455501,324.903146038222,0.162146812437882,214.905227079932,51.5577065535709,531.663395779517,16.2146812437882
2021-10-06,429566,937,333050,707,96516,230,365622,781,2296415,4421,2662037,5202,18,5484,-404,12651,1323,411431,26,13563,6764,"East TN",2455501,294.5631054518,0.158436944937833,211.850860577943,38.1592188315134,515.210541555471,15.8436944937833
2021-10-07,430683,1117,333840,790,96843,327,366480,858,2301198,4783,2667678,5641,24,5508,-382,12269,1475,412906,26,13589,6794,"East TN",2455501,290.816415876027,0.158885941644562,229.729085836251,45.4896984362865,499.653634838675,15.8885941644562
2021-10-08,431743,1060,334429,589,97314,471,367124,644,2305445,4247,2672569,4891,9,5517,-124,12145,1175,414081,31,13620,6815,"East TN",2455501,277.988076567674,0.151318198462102,199.185420816363,43.168379894775,494.60374888872,15.1318198462102
2021-10-09,432284,541,334784,355,97500,186,367541,417,2308254,2809,2675795,3226,4,5521,-293,11852,830,414911,32,13652,6844,"East TN",2455501,277.458653040663,0.151246470105973,131.378484472212,22.0321637010125,482.671357087617,15.1246470105973
2021-10-10,432604,320,335052,268,97552,52,367851,310,2310486,2232,2678337,2542,6,5527,-526,11326,840,415751,16,13668,6866,"East TN",2455501,268.539902854855,0.149628048589096,103.522661974074,13.0319637418189,461.250066687002,14.9628048589096
2021-10-11,433826,1222,335590,538,98236,684,368399,548,2313932,3446,2682331,3994,52,5579,-279,11047,1449,417200,33,13701,6880,"East TN",2455501,263.204942698048,0.142105092126215,162.655197452577,49.7658115390708,449.887823299604,14.2105092126215
2021-10-12,434762,936,336226,636,98536,300,369404,1005,2317576,3644,2686980,4649,29,5608,-366,10681,1273,418473,32,13733,6913,"East TN",2455501,249.765730089297,0.151368386133687,189.329998236612,38.1184939448202,434.982514769898,15.1368386133687
2021-10-13,435615,853,336775,549,98840,304,370054,650,2321441,3865,2691495,4515,25,5633,-400,10281,1228,419701,37,13770,6936,"East TN",2455501,246.34483960707,0.150451490257315,183.872863419726,34.738328349286,418.692560092625,15.0451490257315
2021-10-14,436566,951,337428,653,99138,298,370775,721,2325444,4003,2696219,4724,31,5664,-167,10114,1087,420788,33,13803,6967,"East TN",2455501,239.584508416001,0.150485266809152,192.384364738601,38.729367245218,411.891504014863,15.0485266809152
2021-10-15,437368,802,337939,511,99429,291,371351,576,2329338,3894,2700689,4470,24,5688,-300,9814,1078,421866,29,13832,6989,"East TN",2455501,229.07748764916,0.150320056899004,182.040243518532,32.6613591279336,399.674038006908,15.0320056899004
2021-10-16,437675,307,338178,239,99497,68,371622,271,2331568,2230,2703190,2501,7,5695,-377,9437,677,422543,12,13844,7003,"East TN",2455501,219.547864162955,0.148968789925169,101.852941619653,12.5025402148075,384.320755723577,14.8968789925169
2021-10-17,437927,252,338388,210,99539,42,371870,248,2333231,1663,2705101,1911,7,5702,-450,8987,695,423238,14,13858,7019,"East TN",2455501,216.778571867818,0.150164399940218,77.8252584706746,10.2626714466824,365.994556711645,15.0164399940218
2021-10-18,438717,790,338855,467,99862,323,372386,516,2336422,3191,2708808,3707,23,5725,-472,8515,1239,424477,37,13895,7040,"East TN",2455501,199.185420816363,0.150583525323866,150.967154971633,32.1726604876154,346.772410192462,15.0583525323866
2021-10-19,439549,832,339296,441,100253,391,372860,474,2339750,3328,2712610,3802,25,5750,-268,8247,1075,425552,23,13918,7056,"East TN",2455501,194.950032600272,0.134841982052282,154.836019207486,33.8831057287291,335.858140558688,13.4841982052282
2021-10-20,440313,764,339786,490,100527,274,373401,541,2343771,4021,2717172,4562,15,5765,-213,8034,962,426514,21,13939,7075,"East TN",2455501,191.325517684578,0.130350118783347,185.786933094305,31.1138134335926,327.18373969304,13.0350118783347
2021-10-21,440942,629,340209,423,100733,206,373871,470,2347408,3637,2721279,4107,17,5782,-244,7790,856,427370,21,13960,7093,"East TN",2455501,178.212104169373,0.123543495610535,167.257109648907,25.6159537300127,317.246867339903,12.3543495610535
2021-10-22,441488,546,340549,340,100939,206,374257,386,2350512,3104,2724769,3490,6,5788,-319,7471,859,428229,18,13978,7111,"East TN",2455501,167.786533175918,0.120681063122924,142.129854559212,22.2357881344785,304.255628484778,12.0681063122924
2021-10-23,441847,359,340793,244,101054,115,374530,273,2352897,2385,2727427,2658,0,5788,-196,7275,555,428784,15,13993,7131,"East TN",2455501,169.904227283964,0.119981845938029,108.246748830483,14.6202343228531,296.273550692914,11.9981845938029
2021-10-24,442091,244,340956,163,101135,81,374726,196,2354794,1897,2729520,2093,7,5795,-300,6975,537,429321,15,14008,7143,"East TN",2455501,169.578428190418,0.116958106392563,85.2371878488341,9.9368723531369,284.056084684958,11.6958106392563
2021-10-25,442514,423,341204,248,101310,175,374997,271,2357225,2431,2732222,2702,28,5823,-490,6485,885,430206,21,14029,7154,"East TN",2455501,154.63239477402,0.111514478517127,110.038643844983,17.2266270712168,264.100890205298,11.1514478517127
2021-10-26,443040,526,341533,329,101507,197,375335,338,2359865,2640,2735200,2978,12,5835,-232,6253,746,430952,28,14057,7162,"East TN",2455501,142.170579445905,0.109561752988048,121.278712572302,21.4212904006148,254.65271649248,10.9561752988048
2021-10-27,443661,621,341927,394,101734,227,375759,424,2364062,4197,2739821,4621,10,5845,-85,6168,696,431648,21,14078,7182,"East TN",2455501,136.34692064878,0.104110556757473,188.189701409203,25.2901546364673,251.191101123559,10.4110556757473
2021-10-28,444077,416,342181,254,101896,162,376050,291,2366859,2797,2742909,3088,16,5861,-197,5971,597,432245,15,14093,7197,"East TN",2455501,127.672519783132,0.100739713361073,125.758450108552,16.9415528643645,243.168298445002,10.0739713361073
2021-10-29,444537,460,342486,305,102051,155,376383,333,2370377,3518,2746760,3851,4,5865,-152,5819,608,432853,10,14103,7212,"East TN",2455501,124.170179527518,0.0966759128734482,156.831538655452,18.7334478788646,236.978115667638,9.66759128734482
2021-10-30,444800,263,342687,201,102113,62,376612,229,2372951,2574,2749563,2803,0,5865,-148,5671,411,433264,16,14119,7226,"East TN",2455501,120.260590404972,0.0940549331405855,114.151857400995,10.7106452003074,230.950832437046,9.40549331405855
2021-10-31,444971,171,342814,127,102157,44,376758,146,2374576,1625,2751334,1771,0,5865,-224,5447,395,433659,5,14124,7236,"East TN",2455501,117.28767367637,0.0931511873109013,72.1237743336289,6.96395562453446,221.828457817773,9.31511873109013
2021-11-01,445567,596,343175,361,102392,235,377148,390,2377694,3118,2754842,3508,14,5879,-184,5263,766,434425,23,14147,7246,"East TN",2455501,124.333079074291,0.0950928381962865,142.862902519689,24.2720324691377,214.335078666227,9.50928381962865
2021-11-02,445979,412,343394,219,102585,193,377373,225,2379905,2211,2757278,2436,25,5904,-184,5079,571,434996,16,14163,7269,"East TN",2455501,119.690441991268,0.0923090859679319,99.2058239845962,16.7786533175918,206.841699514682,9.23090859679319
2021-11-03,446553,574,343772,378,102781,196,377766,393,2384483,4578,2762249,4971,6,5910,82,5161,486,435482,14,14177,7281,"East TN",2455501,117.776372316688,0.0894863563402889,202.443411751818,23.3760849618876,210.181140223523,8.94863563402889
2021-11-04,446973,420,344073,301,102900,119,378096,330,2388019,3536,2766115,3866,13,5923,-68,5093,475,435957,9,14186,7291,"East TN",2455501,117.939271863461,0.0881668533999828,157.442411955849,17.1044524111373,207.411847928386,8.81668533999828
2021-11-05,447408,435,344358,285,103050,150,378420,324,2391601,3582,2770021,3906,2,5925,25,5118,408,436365,13,14199,7297,"East TN",2455501,116.921149696131,0.0875714715618417,159.071407423577,17.715325711535,208.429970095716,8.75714715618417
2021-11-06,447641,233,344529,171,103112,62,378608,188,2393841,2240,2772449,2428,0,5925,-86,5032,319,436684,13,14212,7305,"East TN",2455501,115.699403095336,0.0872148911998602,98.8800248910507,9.48889859951187,204.927629840102,8.72148911998602
2021-11-07,447840,199,344655,126,103185,73,378762,154,2395743,1902,2774505,2056,6,5931,-130,4902,323,437007,8,14220,7316,"East TN",2455501,116.839699922745,0.0864874196193518,83.7303670411863,8.10425245194362,199.633394569988,8.64874196193518
2021-11-08,448382,542,345001,346,103381,196,379148,386,2399276,3533,2778424,3919,25,5956,-26,4876,543,437550,25,14245,7328,"East TN",2455501,114.640556041313,0.0848104486472733,159.600830950588,22.0728885877057,198.574547515965,8.48104486472733
2021-11-09,449251,869,345618,617,103633,252,379949,801,2406552,7276,2786501,8077,10,5966,427,5303,432,437982,27,14272,7343,"East TN",2455501,133.251829260098,0.0881497450638196,328.934909820847,35.3899265363769,215.964074133955,8.81497450638196
2021-11-10,449880,629,346054,436,103826,193,380451,502,2411803,5251,2792254,5753,7,5973,185,5488,437,438419,28,14300,7355,"East TN",2455501,135.491698028223,0.0894850858190302,234.290273145888,25.6159537300127,223.498178172194,8.94850858190302
2021-11-11,450385,505,346436,382,103949,123,380855,404,2416093,4290,2796948,4694,5,5978,83,5571,417,438836,10,14310,7368,"East TN",2455501,138.953313397144,0.0894820484545779,191.162618137806,20.5660677800579,226.878343767728,8.94820484545779
2021-11-12,450868,483,346758,322,104110,161,381187,332,2419543,3450,2800730,3782,2,5980,122,5693,359,439195,24,14334,7378,"East TN",2455501,140.908107958417,0.0901038783418542,154.021521473622,19.6701202728079,231.846779944296,9.01038783418542
2021-11-13,451106,238,346899,141,104207,97,381336,149,2421542,1999,2802878,2148,4,5984,-100,5593,334,439529,11,14345,7387,"East TN",2455501,141.111732391883,0.0896513194649841,87.4770566169592,9.69252303297779,227.774291274978,8.96513194649841
2021-11-14,451467,361,347215,316,104252,45,381681,345,2424521,2979,2806202,3324,1,5985,59,5652,301,439830,12,14357,7395,"East TN",2455501,147.709164036178,0.0920907341388775,135.369523368144,14.7016840962394,230.177059589876,9.20907341388775
2021-11-15,452044,577,347504,289,104540,288,381982,301,2427289,2768,2809271,3069,26,6011,-29,5623,580,440410,19,14376,7404,"East TN",2455501,149.13453507044,0.0918727915194346,124.984677261382,23.4982596219672,228.996037875774,9.18727915194346
2021-11-16,452716,672,347937,433,104779,239,382442,460,2430896,3607,2813338,4067,24,6035,180,5803,468,440878,17,14393,7414,"East TN",2455501,141.111732391883,0.0928941386891232,165.628114181179,27.3671238578196,236.326517480547,9.28941386891232
2021-11-17,453429,713,348402,465,105027,248,382951,509,2435542,4646,2818493,5155,5,6040,296,6099,412,441290,27,14420,7424,"East TN",2455501,144.53262287411,0.0952780212660543,209.936790903364,29.0368442122402,248.381083941729,9.52780212660543
2021-11-18,454056,627,348813,411,105243,216,383429,478,2440405,4863,2823834,5341,12,6052,183,6282,432,441722,19,14439,7433,"East TN",2455501,149.501059050678,0.095737558580674,217.511619828296,25.5345039566264,255.833738206582,9.5737558580674
2021-11-19,454669,613,349255,442,105414,171,383889,460,2444879,4474,2828768,4934,7,6059,219,6501,387,442109,13,14452,7441,"East TN",2455501,154.795294320792,0.0963692132106427,200.93659094417,24.9643555429218,264.752488392389,9.63692132106427
2021-11-20,454991,322,349500,245,105491,77,384176,287,2447583,2704,2831759,2991,0,6059,21,6522,301,442410,14,14466,7448,"East TN",2455501,158.21618480302,0.0983345452027284,121.808136099313,13.1134135152052,265.607711012946,9.83345452027284
2021-11-21,455255,264,349652,152,105603,112,384340,164,2449067,1484,2833407,1648,9,6068,-93,6429,348,442758,10,14476,7459,"East TN",2455501,154.265870793781,0.0977393861422533,67.1146132703672,10.7513700870006,261.82029655048,9.77393861422533
2021-11-22,456008,753,350146,494,105862,259,384852,512,2452935,3868,2837787,4380,21,6089,160,6589,572,443330,38,14514,7464,"East TN",2455501,161.433450851781,0.10064525178847,178.375003716146,30.6658396799676,268.336278421389,10.064525178847
2021-11-23,456684,676,350613,467,106071,209,385342,490,2456236,3301,2841578,3791,21,6110,122,6711,533,443863,18,14532,7470,"East TN",2455501,161.596350398554,0.102691218130312,154.388045453861,27.5300234045924,273.304714597958,10.2691218130312
2021-11-24,457421,737,351142,529,106279,208,385915,573,2460264,4028,2846179,4601,6,6116,255,6966,476,444339,21,14553,7480,"East TN",2455501,162.573747679191,0.107057718702593,187.37520367534,30.0142414928766,283.68956070472,10.7057718702593
2021-11-25,457707,286,351300,158,106407,128,386088,173,2461900,1636,2847988,1809,1,6117,-196,6770,481,444820,10,14563,7489,"East TN",2455501,148.686561316815,0.11008528608098,73.6713200279699,11.6473175942506,275.707482912856,11.008528608098
2021-11-26,457939,232,351502,202,106437,30,386331,243,2463577,1677,2849908,1920,1,6118,-287,6483,518,445338,16,14579,7493,"East TN",2455501,133.170379486712,0.115515610217597,78.1917824509133,9.44817371281869,264.019440431912,11.5515610217597
2021-11-27,458223,284,351727,225,106496,59,386585,254,2465172,1595,2851757,1849,0,6118,-98,6385,382,445720,14,14593,7504,"East TN",2455501,131.622833792371,0.12046204620462,75.3003154956972,11.5658678208643,260.02840153598,12.046204620462
2021-11-28,458537,314,351938,211,106599,103,386802,217,2466682,1510,2853484,1727,7,6125,-107,6278,414,446134,20,14613,7514,"East TN",2455501,133.65907812703,0.122627882651791,70.3318793191288,12.7876144216598,255.670838659809,12.2627882651791
2021-11-29,459636,1099,352648,710,106988,389,387540,738,2471229,4547,2858769,5285,19,6144,426,6704,654,446788,36,14649,7522,"East TN",2455501,147.749888922872,0.128109808407206,215.231026173477,44.7566504758092,273.019640391105,12.8109808407206
2021-11-30,460474,838,353153,505,107321,333,388045,505,2474596,3367,2862641,3872,64,6208,187,6891,587,447375,26,14675,7534,"East TN",2455501,154.347320567167,0.128329297820823,157.686761276008,34.1274550488882,280.635194202731,12.8329297820823
2021-12-01,461559,1085,353922,769,107637,316,388852,807,2479768,5172,2868620,5979,48,6256,507,7398,530,447905,32,14707,7555,"East TN",2455501,168.519581136395,0.13087652065416,243.494097538547,44.1865020621046,301.282711756175,13.087652065416
2021-12-02,462462,903,354545,623,107917,280,389518,666,2484429,4661,2873947,5327,39,6295,282,7680,582,448487,18,14725,7571,"East TN",2455501,193.64683622609,0.132131438036904,216.941471414591,36.7745726839452,312.767129803653,13.2131438036904
2021-12-03,463481,1019,355280,735,108201,284,390300,782,2489407,4978,2879707,5760,21,6316,519,8199,479,448966,24,14749,7583,"East TN",2455501,225.697322053626,0.133192389006343,234.57534735274,41.4986595403545,333.903345997416,13.3192389006343
2021-12-04,463904,423,355611,331,108293,92,390681,381,2492159,2752,2882840,3133,3,6319,18,8217,402,449368,29,14778,7595,"East TN",2455501,231.358081303978,0.131776212077341,127.591070009745,17.2266270712168,334.636393957893,13.1776212077341
2021-12-05,464289,385,355827,216,108462,169,390912,231,2494091,1932,2885003,2163,12,6331,-31,8186,404,449772,14,14792,7603,"East TN",2455501,234.249548259194,0.130397537992957,88.087929917357,15.6790813768758,333.373922470404,13.0397537992957
2021-12-06,465244,955,356472,645,108772,310,391603,691,2498275,4184,2889878,4875,69,6400,131,8317,755,450527,32,14824,7617,"East TN",2455501,228.385164575376,0.130605291073323,198.533822629272,38.8922667919907,338.708882627211,13.0605291073323
2021-12-07,466086,842,357006,534,109080,308,392144,541,2501752,3477,2893896,4018,8,6408,220,8537,614,451141,25,14849,7622,"East TN",2455501,228.548064122149,0.131147016477364,163.632594733213,34.2903545956609,347.668357699712,13.1147016477364
2021-12-08,467134,1048,357638,632,109496,416,392801,657,2506368,4616,2899169,5273,4,6412,451,8988,593,451734,28,14877,7637,"East TN",2455501,227.041243314501,0.129267733804707,214.742327533159,42.6796812544568,366.035281598338,12.9267733804707
2021-12-09,468053,919,358255,617,109798,302,393467,666,2511345,4977,2904812,5643,19,6431,525,9513,375,452109,28,14905,7651,"East TN",2455501,227.692841501592,0.12794427344889,229.810535609637,37.4261708710361,387.415847112259,12.794427344889
2021-12-10,468847,794,358802,547,110045,247,394068,601,2515855,4510,2909923,5111,5,6436,160,9673,629,452738,19,14924,7664,"East TN",2455501,218.529741995625,0.124702144559174,208.144895888863,32.3355600343881,393.931828983169,12.4702144559174
2021-12-11,469244,397,359088,286,110156,111,394393,325,2518777,2922,2913170,3247,0,6436,-174,9499,571,453309,18,14942,7673,"East TN",2455501,217.470894941603,0.122387075502803,132.233707092768,16.167780017194,386.845698698555,12.2387075502803
2021-12-12,469675,431,359352,264,110323,167,394687,294,2521296,2519,2915983,2813,9,6445,-138,9361,560,453869,17,14959,7679,"East TN",2455501,219.344239729489,0.121852808263396,114.559106267927,17.5524261647623,381.225664334895,12.1852808263396
2021-12-13,470558,883,359923,571,110635,312,395290,603,2525898,4602,2921188,5205,24,6469,-164,9197,1023,454892,20,14979,7688,"East TN",2455501,216.41204788758,0.11775790482274,211.973035238023,35.9600749500815,374.546782917213,11.775790482274
2021-12-14,471315,757,360378,455,110937,302,395773,483,2529921,4023,2925694,4506,36,6505,-123,9074,844,455736,18,14997,7696,"East TN",2455501,212.950432518659,0.114126674633625,183.506339439487,30.8287392267403,369.537621853952,11.4126674633625
2021-12-15,472186,871,360966,588,111220,283,396401,628,2534725,4804,2931126,5432,19,6524,6,9080,846,456582,20,15017,7710,"East TN",2455501,205.742127573966,0.11265137528554,221.217584517375,35.4713763097633,369.781971174111,11.265137528554
2021-12-16,472981,795,361474,508,111507,287,396946,545,2538545,3820,2935491,4365,19,6543,26,9106,750,457332,21,15038,7725,"East TN",2455501,200.692241624011,0.113400045633821,177.764130415748,32.3762849210813,370.840818228133,11.3400045633821
2021-12-17,473794,813,362011,537,111783,276,397531,585,2543213,4668,2940744,5253,24,6567,52,9158,737,458069,29,15067,7739,"East TN",2455501,201.466014471181,0.112358456896272,213.927829799296,33.1093328815586,372.958512336179,11.2358456896272
2021-12-18,474366,572,362392,381,111974,191,397957,426,2546558,3345,2944515,3771,0,6567,36,9194,536,458605,19,15086,7752,"East TN",2455501,208.592869642488,0.11370234487159,153.573547719997,23.2946351885012,374.424608257134,11.370234487159
2021-12-19,474787,421,362673,281,112114,140,398268,311,2549221,2663,2947489,2974,6,6573,-163,9031,578,459183,16,15102,7761,"East TN",2455501,208.185620775557,0.113660889989208,121.115813025529,17.1451772978305,367.786451726145,11.3660889989208
2021-12-20,475722,935,363295,622,112427,313,398906,638,2553183,3962,2952089,4600,40,6613,55,9086,840,460023,27,15129,7772,"East TN",2455501,210.303314883602,0.117018866703343,187.334478788646,38.077769058127,370.02632049427,11.7018866703343
2021-12-21,476732,1010,363952,657,112780,353,399575,669,2557566,4383,2957141,5052,30,6643,211,9297,769,460792,22,15151,7782,"East TN",2455501,220.606711216978,0.120901834833211,205.742127573966,41.1321355601158,378.619271586532,12.0901834833211
2021-12-22,478239,1507,364678,726,113561,781,400323,748,2561906,4340,2962229,5088,872,7515,-108,9189,743,461535,32,15183,7797,"East TN",2455501,246.507739153843,0.126097161045558,207.20822349492,61.3724042466283,374.220983823668,12.6097161045558
2021-12-23,479408,1169,365482,804,113926,365,401186,863,2566391,4485,2967577,5348,28,7543,398,9587,743,462278,25,15208,7813,"East TN",2455501,261.738846777094,0.132144860686904,217.796694035148,47.6073925443321,390.429488727555,13.2144860686904
2021-12-24,480348,940,366131,649,114217,291,401894,708,2570228,3837,2972122,4545,0,7543,283,9870,657,462935,13,15221,7835,"East TN",2455501,266.910907387128,0.139046465676589,185.094610020521,38.281393491593,401.954631661726,13.9046465676589
2021-12-25,480829,481,366414,283,114415,198,402227,333,2572347,2119,2974574,2452,8,7551,-26,9844,499,463434,15,15236,7843,"East TN",2455501,263.204942698048,0.142053960544263,99.8574221716871,19.5886704994215,400.895784607703,14.2053960544263
2021-12-26,481172,343,366690,276,114482,67,402547,320,2574222,1875,2976769,2195,62,7613,-226,9618,507,463941,15,15251,7860,"East TN",2455501,260.02840153598,0.146140710382514,89.3911262915389,13.9686361357621,391.691960215044,14.6140710382514
2021-12-27,483055,1883,367950,1260,115105,623,403858,1311,2578976,4754,2982834,6065,64,7677,937,10555,882,464823,29,15280,7877,"East TN",2455501,298.635594121118,0.161066840136608,246.996437794161,76.6849616432655,429.851179046557,16.1066840136608
2021-12-28,485483,2428,369391,1441,116092,987,405344,1486,2583355,4379,2988699,5865,18,7695,1657,12212,753,465576,20,15300,7888,"East TN",2455501,356.383483452053,0.182806261486786,238.851460455524,98.8800248910507,497.332316297163,18.2806261486786
2021-12-29,488376,2893,371318,1927,117058,966,407347,2003,2588644,5289,2995991,7292,37,7732,2077,14289,779,466355,26,15326,7902,"East TN",2455501,412.828176408806,0.208044547123986,296.965873766698,117.817097203381,581.917905958906,20.8044547123986
2021-12-30,491201,2825,373096,1778,118105,1047,409169,1822,2593107,4463,3002276,6285,14,7746,2055,16344,756,467111,28,15354,7915,"East TN",2455501,480.268588772719,0.230064266981757,255.955912866661,115.047804908245,665.607548113399,23.0064266981757
2021-12-31,493720,2519,374906,1810,118814,709,411111,1942,2597940,4833,3009051,6775,0,7746,1798,18142,721,467832,15,15369,7934,"East TN",2455501,544.573184861256,0.249587045411465,275.911107346322,102.58598958013,738.830894387744,24.9587045411465
2022-01-01,495178,1458,376132,1226,119046,232,412449,1338,2601590,3650,3014039,4988,0,7746,929,19071,529,468361,27,15396,7942,"East TN",2455501,584.361399160497,0.25901431648296,203.135734825602,59.3768847986623,776.664314125712,25.901431648296
2022-01-02,496642,1464,377092,960,119550,504,413672,1223,2604606,3016,3018278,4239,6,7752,842,19913,616,468977,21,15417,7960,"East TN",2455501,630.013997143556,0.26801416560264,172.632794692407,59.6212341188214,810.954668721373,26.801416560264
2022-01-03,499537,2895,379265,2173,120272,722,415893,2221,2608777,4171,3024670,6392,33,7785,1800,21713,1062,470039,25,15442,7974,"East TN",2455501,671.227582477059,0.287670905440291,260.313475742832,117.898546976768,884.259464769104,28.7670905440291
2022-01-04,503711,4174,381696,2431,122015,1743,418278,2385,2614014,5237,3032292,7622,14,7799,2941,24654,1219,471258,28,15470,7992,"East TN",2455501,742.333234643358,0.296699011309155,310.405086375448,169.98567705735,1004.03135653376,29.6699011309155
2022-01-05,508641,4930,385098,3402,123543,1528,421773,3495,2619248,5234,3041021,8729,15,7814,3653,28307,1262,472520,40,15510,8015,"East TN",2455501,825.289828837374,0.320364201643349,355.487535944803,200.773691397397,1152.79936762396,32.0364201643349
2022-01-06,513809,5168,388554,3456,125255,1712,425415,3642,2624860,5612,3050275,9254,11,7825,3911,32218,1246,473766,31,15541,8032,"East TN",2455501,920.708238359504,0.338465384695515,376.868101458725,210.466214430375,1312.074399481,33.8465384695515
2022-01-07,518181,4372,391771,3217,126410,1155,428684,3269,2629544,4684,3058228,7953,12,7837,3539,35757,821,474587,26,15567,8053,"East TN",2455501,996.171453401974,0.3573418467983,323.885023870892,178.0492046226,1456.19977348818,35.73418467983
2022-01-08,521328,3147,394194,2423,127134,724,431286,2602,2634306,4762,3065592,7364,1,7838,2800,38557,346,474933,31,15598,8073,"East TN",2455501,1064.95578702676,0.365390956879328,299.898065608607,128.16121842345,1570.2294562291,36.5390956879328
2022-01-09,524821,3493,396862,2668,127959,825,434168,2882,2639308,5002,3073476,7884,15,7853,2136,40693,1342,476275,26,15624,8088,"East TN",2455501,1147.58658212723,0.371317801369615,321.075006689063,142.252029219292,1657.21781420574,37.1317801369615
2022-01-10,529468,4647,399930,3068,129538,1579,437409,3241,2644087,4779,3081496,8020,29,7882,1686,42379,2932,479207,42,15666,8119,"East TN",2455501,1218.93658361369,0.37862950058072,326.613591279336,189.248548463226,1725.87997317044,37.862950058072
2022-01-11,535072,5604,403952,4022,131120,1582,441539,4130,2649276,5189,3090815,9319,30,7912,2247,44626,3327,482534,37,15703,8142,"East TN",2455501,1277.17317158494,0.397467662286622,379.515219093782,228.222265028603,1817.38879357003,39.7467662286622
2022-01-12,540750,5678,407921,3969,132829,1709,445696,4157,2654046,4770,3099742,8927,16,7928,2406,47032,3256,485790,19,15722,8159,"East TN",2455501,1307.63538683144,0.407401100117505,363.551063510054,231.235906643899,1915.37287095383,40.7401100117505
2022-01-13,548070,7320,413148,5227,134922,2093,451166,5470,2660973,6927,3112139,12397,65,7993,3821,50853,3434,489224,29,15751,8171,"East TN",2455501,1395.27534299518,0.416251778093883,504.866420335402,298.106170594107,2070.98266300849,41.6251778093883
2022-01-14,554583,6513,417922,4774,136661,1739,456088,4922,2666853,5880,3122941,10802,69,8062,4521,55374,1923,491147,22,15773,8203,"East TN",2455501,1482.46732540528,0.423469781960348,439.910226059774,265.241187032707,2255.09987574837,42.3469781960348
2022-01-15,559132,4549,421313,3391,137819,1158,459697,3609,2671941,5088,3131638,8697,10,8072,3379,58753,1160,492307,22,15795,8214,"East TN",2455501,1539.56361654913,0.430169881597674,354.184339570621,185.257509567294,2392.70926788464,43.0169881597674
2022-01-16,562992,3860,424632,3319,138360,541,463186,3489,2676589,4648,3139775,8137,7,8079,1618,60371,2235,494542,13,15808,8226,"East TN",2455501,1554.50964996553,0.437683826302056,331.378403022438,157.19806263569,2458.60213455421,43.7683826302056
2022-01-17,567621,4629,427959,3327,139662,1302,466650,3464,2681324,4735,3147974,8199,15,8094,-212,60159,4826,499368,21,15829,8245,"East TN",2455501,1553.77660200505,0.439859803243178,333.903345997416,188.515500502749,2449.96845857526,43.9859803243178
2022-01-18,573572,5951,431623,3664,141949,2287,470381,3731,2684785,3461,3155166,7192,49,8143,250,60409,5652,505020,24,15853,8268,"East TN",2455501,1567.90813768758,0.448198163198707,292.893385097379,242.353800711138,2460.14968024855,44.8198163198707
2022-01-19,581869,8297,437611,5988,144258,2309,476545,6164,2690633,5848,3167178,12012,22,8165,2927,63336,5348,510368,16,15869,8289,"East TN",2455501,1674.56661593703,0.457455958241889,489.187338958526,337.894384893348,2579.3514235995,45.7455958241889
2022-01-20,590137,8268,443632,6021,146505,2247,482797,6252,2696350,5717,3179147,11969,44,8209,3904,67240,4320,514688,15,15884,8316,"East TN",2455501,1713.17380852217,0.472048113658071,487.436168830719,336.713363179245,2738.34138124969,47.2048113658071
2022-01-21,597437,7300,449221,5589,148216,1711,488669,5872,2702073,5723,3190742,11595,53,8262,3441,70681,3806,518494,17,15901,8341,"East TN",2455501,1745.22429434971,0.480538635123376,472.205061207468,297.291672860243,2878.47571636094,48.0538635123376
2022-01-22,603443,6006,454081,4860,149362,1146,493827,5158,2708160,6087,3201987,11245,0,8262,3075,73756,2931,521425,18,15919,8360,"East TN",2455501,1804.56045426168,0.485152596341099,457.951350864854,244.593669479263,3003.70474294248,48.5152596341099
2022-01-23,607044,3601,457053,2972,149991,629,496965,3138,2711429,3269,3208394,6407,6,8268,693,74449,2902,524327,7,15926,8386,"East TN",2455501,1794.01270860814,0.492268905113744,260.92434904323,146.650316982156,3031.92708942086,49.2268905113744
2022-01-24,613732,6688,461718,4665,152014,2023,501930,4965,2716809,5380,3218739,10345,37,8305,-36,74413,6687,531014,22,15948,8405,"East TN",2455501,1877.86525030941,0.498551543842295,421.298952840988,272.368042204015,3030.4609934999,49.8551543842295
2022-01-25,619421,5689,465738,4020,153683,1669,506178,4248,2721463,4654,3227641,8902,30,8335,-1017,73396,6676,537690,12,15960,8417,"East TN",2455501,1867.19532999579,0.493922042083477,362.532941342724,231.683880397524,2989.04378373293,49.3922042083477
2022-01-26,625190,5769,470119,4381,155071,1388,510830,4652,2726392,4929,3237222,9581,28,8363,-1071,72325,6812,544502,14,15974,8438,"East TN",2455501,1764.24281643542,0.489478042373365,390.185139407396,234.941871332978,2945.42743008453,48.9478042373365
2022-01-27,632375,7185,475818,5699,156557,1486,516919,6089,2733546,7154,3250465,13243,30,8393,227,72552,6928,551430,16,15990,8459,"East TN",2455501,1720.13776414671,0.478448638492386,539.319674477836,292.608310890527,2954.67197936389,47.8448638492386
2022-01-28,637287,4912,479470,3652,157817,1260,520812,3893,2738385,4839,3259197,8732,38,8431,-1769,70783,6643,558073,13,16003,8477,"East TN",2455501,1622.88673472338,0.469549338981813,355.609710604883,200.04064343692,2882.62965480364,46.9549338981813
2022-01-29,641328,4041,482713,3243,158615,798,524318,3506,2743818,5433,3268136,8939,5,8436,672,71455,3364,561437,7,16010,8491,"East TN",2455501,1542.86233237128,0.460944231961179,364.039762150372,164.569267127157,2909.99677866146,46.0944231961179
