"DATE","TOTAL_CASES","NEW_CASES","TOTAL_CONFIRMED","NEW_CONFIRMED","TOTAL_PROBABLE","NEW_PROBABLE","POS_TESTS","NEW_POS_TESTS","NEG_TESTS","NEW_NEG_TESTS","TOTAL_TESTS","NEW_TESTS","NEW_DEATHS","TOTAL_DEATHS","ACTIVE_CHANGE","TOTAL_ACTIVE","NEW_INACTIVE_RECOVERED","TOTAL_INACTIVE_RECOVERED","NEW_HOSPITALIZED","TOTAL_HOSPITALIZED","TOTAL_DEATHS_BY_DOD","Region","Population","New_cases_per_100k_per_week","PositivityRate_per_week","Tests_per_100k","New_cases_per_100k","Active_cases_per_100k","PositivityPercentage_per_week"
2022-03-19,127162,12,98366,11,28796,1,106323,11,546518,175,652841,186,0,1335,-4,203,16,125624,0,2703,1335,"Knox County",470313,NA,NA,39.5481307129507,2.55149230406134,43.162744810371,NA
2022-03-18,127150,25,98355,13,28795,12,106312,14,546343,219,652655,233,0,1335,8,207,17,125608,0,2703,1335,"Knox County",470313,NA,NA,49.5414755705243,5.31560896679445,44.0132422450581,NA
2022-03-17,127125,37,98342,26,28783,11,106298,31,546124,209,652422,240,1,1335,8,199,28,125591,0,2703,1335,"Knox County",470313,NA,NA,51.0298460812268,7.86710127085579,42.3122473756839,NA
2022-03-16,127088,23,98316,10,28772,13,106267,13,545915,236,652182,249,3,1334,-15,191,35,125563,2,2703,1335,"Knox County",470313,NA,NA,52.9434653092728,4.8903602494509,40.6112525063096,NA
2022-03-15,127065,55,98306,18,28759,37,106254,19,545679,257,651933,276,1,1331,10,206,44,125528,1,2701,1334,"Knox County",470313,NA,NA,58.6843229934108,11.6943397269478,43.8006178863863,NA
2022-03-14,127010,21,98288,16,28722,5,106235,22,545422,228,651657,250,10,1330,-45,196,56,125484,0,2700,1334,"Knox County",470313,NA,NA,53.1560896679445,4.46511153210734,41.6743742996685,NA
2022-03-13,126989,6,98272,6,28717,0,106213,10,545194,484,651407,494,2,1320,-32,241,36,125428,0,2700,1333,"Knox County",470313,38.0597602022483,0.0622406639004149,105.036433183858,1.27574615203067,51.2424704398985,6.22406639004149
2022-03-12,126983,9,98266,8,28717,1,106203,9,544710,293,650913,302,0,1318,-23,273,32,125392,2,2700,1333,"Knox County",470313,37.421887126233,0.0577299412915851,64.212556318877,1.913619228046,58.0464499173954,5.77299412915851
2022-03-11,126974,20,98258,13,28716,7,106194,15,544417,467,650611,482,9,1318,-45,296,56,125360,0,2698,1331,"Knox County",470313,36.3587653328741,0.051897078063672,102.484940879797,4.25248717343556,62.9368101668463,5.1897078063672
2022-03-10,126954,28,98245,20,28709,8,106179,23,543950,459,650129,482,4,1309,-43,341,67,125304,0,2698,1328,"Knox County",470313,34.4451461048281,0.0437869822485207,102.484940879797,5.95348204280979,72.5049063070764,4.37869822485207
2022-03-09,126926,64,98225,19,28701,45,106156,23,543491,419,649647,442,1,1305,-24,384,87,125237,2,2698,1326,"Knox County",470313,43.162744810371,0.0443548387096774,93.9799665329259,13.6079589549938,81.6477537299628,4.43548387096774
2022-03-08,126862,36,98206,18,28656,18,106133,19,543072,311,649205,330,1,1304,-48,408,83,125150,1,2696,1324,"Knox County",470313,39.1228819956072,0.0434938892882818,70.1660383616868,7.65447691218401,86.7507383380855,4.34938892882818
2022-03-07,126826,27,98188,22,28638,5,106114,25,542761,267,648875,292,4,1303,-64,456,87,125067,2,2695,1322,"Knox County",470313,40.3986281476379,0.0439093484419263,62.0863127321592,5.74085768413801,96.9567075543308,4.39093484419263
2022-03-06,126799,14,98166,11,28633,3,106089,13,542494,212,648583,225,2,1299,-46,520,58,124980,2,2693,1322,"Knox County",470313,42.0996230170121,0.049706457925636,47.8404807011501,2.97674102140489,110.564666509325,4.9706457925636
2022-03-05,126785,18,98155,10,28630,8,106076,11,542282,266,648358,277,0,1297,-34,566,52,124922,1,2691,1322,"Knox County",470313,44.0132422450581,0.0509881422924901,58.8969473520825,3.82723845609201,120.345387008226,5.09881422924901
2022-03-04,126767,52,98145,28,28622,24,106065,29,542016,380,648081,409,1,1297,-44,600,95,124870,1,2690,1322,"Knox County",470313,50.817221722555,0.0582010582010582,86.9633626967573,11.0564666509325,127.574615203067,5.82010582010582
2022-03-03,126715,45,98117,29,28598,16,106036,34,541636,326,647672,360,8,1296,-72,644,109,124775,4,2689,1322,"Knox County",470313,54.4318358199752,0.0659528907922912,76.5447691218401,9.56809614023002,136.930086984625,6.59528907922912
2022-03-02,126670,36,98088,28,28582,8,106002,35,541310,338,647312,373,-2,1288,-91,716,129,124666,1,2685,1320,"Knox County",470313,48.4783537771654,0.0732568402471315,79.3088857845732,7.65447691218401,152.239040808993,7.32568402471315
2022-03-01,126634,92,98060,48,28574,44,105967,60,540972,391,646939,451,3,1290,-85,807,174,124537,3,2684,1315,"Knox County",470313,60.385317862785,0.0867197318810222,95.893585760972,19.5614409978036,171.587857448125,8.67197318810222
2022-02-28,126542,134,98012,90,28530,44,105907,97,540581,549,646488,646,10,1287,-104,892,228,124363,4,2681,1314,"Knox County",470313,83.1361242406653,0.101787668734039,137.355335701969,28.4916640620183,189.660927935226,10.1787668734039
2022-02-27,126408,3,97922,3,28486,0,105810,5,540032,75,645842,80,1,1277,-136,996,138,124135,1,2677,1311,"Knox County",470313,80.7972562952757,0.104391371340524,17.0099486937423,0.637873076015334,211.773861237091,10.4391371340524
2022-02-26,126405,47,97919,33,28486,14,105805,35,539957,275,645762,310,0,1276,-84,1132,131,123997,2,2676,1308,"Knox County",470313,86.9633626967573,0.112209965766451,65.9135511882512,9.99334485757357,240.690774016453,11.2209965766451
2022-02-25,126358,106,97886,66,28472,40,105770,74,539682,406,645452,480,2,1276,-107,1216,211,123866,5,2674,1308,"Knox County",470313,98.4450780650333,0.125925925925926,102.059692162454,22.5381820192085,258.551220144882,12.5925925925926
2022-02-24,126252,143,97820,85,28432,58,105696,94,539276,463,644972,557,1,1274,-121,1323,263,123655,4,2669,1303,"Knox County",470313,119.282265214868,0.138073869520193,118.43176778018,30.4052832900643,281.302026522763,13.8073869520193
2022-02-23,126109,142,97735,96,28374,46,105602,115,538813,413,644415,528,6,1273,-186,1444,322,123392,1,2665,1300,"Knox County",470313,141.820447234076,0.157273918741809,112.265661378699,30.1926589313925,307.029573922048,15.7273918741809
2022-02-22,125967,142,97639,87,28328,55,105487,100,538400,356,643887,456,11,1267,-173,1630,304,123070,5,2664,1296,"Knox County",470313,152.451665167665,0.170101406607785,96.9567075543308,30.1926589313925,346.577704634998,17.0101406607785
2022-02-21,125825,74,97552,46,28273,28,105387,50,538044,290,643431,340,0,1256,-371,1803,445,122766,1,2659,1293,"Knox County",470313,139.694203647358,0.171937477280989,72.2922819484046,15.7342025417116,383.361718685216,17.1937477280989
2022-02-20,125751,72,97506,48,28245,24,105337,57,537754,289,643091,346,0,1256,-188,2174,260,122321,1,2658,1288,"Knox County",470313,154.365284395711,0.174013921113689,73.5680281004352,15.308953824368,462.245355752446,17.4013921113689
2022-02-19,125679,90,97458,54,28221,36,105280,68,537465,322,642745,390,0,1256,-177,2362,267,122061,1,2657,1286,"Knox County",470313,163.508131818597,0.180174362286083,82.9234998819935,19.13619228046,502.21873518274,18.0174362286083
2022-02-18,125589,142,97404,92,28185,50,105212,114,537143,498,642355,612,0,1256,-264,2539,406,121794,3,2656,1282,"Knox County",470313,171.162608730781,0.185196655311242,130.126107507128,30.1926589313925,539.853246667645,18.5196655311242
2022-02-17,125447,294,97312,232,28135,62,105098,275,536645,1208,641743,1483,1,1256,-239,2803,532,121388,2,2653,1279,"Knox County",470313,203.26888689022,0.18748495788207,315.321923910247,62.5115614495028,595.986077356994,18.748495788207
2022-02-16,125153,224,97080,144,28073,80,104823,159,535437,546,640260,705,3,1255,-378,3042,599,120856,2,2651,1278,"Knox County",470313,220.704084301306,0.189981532779317,149.900172863604,47.6278563424783,646.803299079549,18.9981532779317
2022-02-15,124929,273,96936,215,27993,58,104664,240,534891,592,639555,832,5,1252,-466,3420,734,120257,6,2649,1275,"Knox County",470313,248.557875287309,0.204545454545455,176.903466414919,58.0464499173954,727.175306657481,20.4545454545455
2022-02-14,124656,341,96721,205,27935,136,104424,245,534299,602,638723,847,19,1247,-441,3886,763,119523,8,2643,1271,"Knox County",470313,305.328579052673,0.222051773729626,180.092831794996,72.5049063070764,826.25825779853,22.2051773729626
2022-02-13,124315,120,96516,100,27799,20,104179,116,533697,283,637876,399,1,1228,-274,4327,393,118760,1,2635,1271,"Knox County",470313,315.534548268919,0.231017463933181,84.8371191100395,25.5149230406134,920.025599972784,23.1017463933181
2022-02-12,124195,154,96416,110,27779,44,104063,127,533414,414,637477,541,0,1227,-277,4601,431,118367,3,2634,1269,"Knox County",470313,329.142507223913,0.235467798486806,115.029778041432,32.7441512354538,978.284674248851,23.5467798486806
2022-02-11,124041,341,96306,250,27735,91,103936,279,533000,631,636936,910,3,1227,-403,4878,741,117936,10,2631,1264,"Knox County",470313,371.454754599596,0.252055273744971,193.488166391318,72.5049063070764,1037.18162160093,25.2055273744971
2022-02-10,123700,425,96056,274,27644,151,103657,302,532369,555,636026,857,7,1224,-437,5281,855,117195,12,2621,1260,"Knox County",470313,399.308545585599,0.288351993714398,182.219075381714,90.3653524355057,1122.86923814566,28.8351993714398
2022-02-09,123275,438,95782,308,27493,130,103355,367,531814,606,635169,973,8,1217,-708,5718,1138,116340,4,2609,1257,"Knox County",470313,444.81015834136,0.3127449150961,206.88350098764,93.1294690982388,1215.78608288523,31.27449150961
2022-02-08,122837,457,95474,334,27363,123,102988,390,531208,462,634196,852,6,1209,-833,6426,1284,115202,7,2605,1252,"Knox County",470313,483.933040336967,0.339468302658487,181.155953588355,97.1693319130026,1366.32412882485,33.9468302658487
2022-02-07,122380,589,95140,410,27240,179,102598,441,530746,625,633344,1066,10,1203,-746,7259,1325,113918,11,2598,1241,"Knox County",470313,536.663881287568,0.361200428724544,226.657566344116,125.235747257677,1543.44021959844,36.1200428724544
2022-02-06,121791,253,94730,185,27061,68,102157,215,530121,435,632278,650,0,1193,-371,8005,624,112593,14,2587,1236,"Knox County",470313,564.942920990915,0.362626089929903,138.205833136656,53.7939627439599,1702.05799116758,36.2626089929903
2022-02-05,121538,271,94545,194,26993,77,101942,220,529686,496,631628,716,0,1193,-380,8376,651,111969,7,2573,1232,"Knox County",470313,589.819970955513,0.367529880478088,152.239040808993,57.6212012000519,1780.94162823481,36.7529880478088
2022-02-04,121267,651,94351,512,26916,139,101722,579,529190,963,630912,1542,3,1193,-500,8756,1148,111318,2,2566,1222,"Knox County",470313,655.733522143764,0.377704326923077,327.866761071882,138.418457495328,1861.73888453009,37.7704326923077
2022-02-03,120616,1643,93839,501,26777,1142,101143,504,528227,741,629370,1245,1,1190,124,9256,1518,110170,13,2564,1222,"Knox County",470313,914.70999100599,0.38557637705849,264.717326546364,349.341821297731,1968.05106386598,38.557637705849
2022-02-02,118973,719,93338,538,25635,181,100639,601,527486,904,628125,1505,7,1189,-1046,9132,1758,108652,6,2551,1220,"Knox County",470313,974.457435792759,0.389387539598733,319.999659801026,152.876913885008,1941.68564339068,38.9387539598733
2022-02-01,118254,938,92800,740,25454,198,100038,834,526582,1139,626620,1973,5,1182,-960,10178,1893,106894,11,2545,1211,"Knox County",470313,1076.72975231388,0.390249511325745,419.507859659418,199.441648434128,2164.09072256136,39.0249511325745
2022-01-31,117316,711,92060,513,25256,198,99204,518,525443,605,624647,1123,11,1177,-708,11138,1408,105001,13,2534,1204,"Knox County",470313,1102.66992407184,0.396504455106237,238.777154788407,151.175919015634,2368.21010688627,39.6504455106237
2022-01-30,116605,389,91547,319,25058,70,98686,336,524838,570,623524,906,1,1166,-261,11846,649,103593,8,2521,1202,"Knox County",470313,1131.5868368512,0.398668146503885,192.637668956631,82.7108755233217,2518.74815282588,39.8668146503885
2022-01-29,116216,679,91228,590,24988,89,98350,646,524268,912,622618,1558,0,1165,-67,12107,746,102944,5,2513,1196,"Knox County",470313,1218.33757518929,0.407835972391393,331.26875081063,144.371939538137,2574.24311043922,40.7835972391393
2022-01-28,115537,937,90638,775,24899,162,97704,834,523356,1040,621060,1874,3,1165,-416,12174,1350,102198,15,2508,1193,"Knox County",470313,1279.14814176942,0.419579732914376,398.458048150912,199.229024075456,2588.48894247023,41.9579732914375
2022-01-27,114600,1434,89863,1201,24737,233,96870,1276,522316,1472,619186,2748,7,1162,49,12590,1378,100848,13,2493,1187,"Knox County",470313,1234.70965080702,0.431676221442629,584.291737630046,304.90333033533,2676.94067567769,43.1676221442629
2022-01-26,113166,999,88662,807,24504,192,95594,854,520844,965,616438,1819,4,1155,-643,12541,1638,99470,5,2480,1179,"Knox County",470313,1294.24447123511,0.44146321139905,386.763708423964,212.411734313106,2666.52208210277,44.146321139905
2022-01-25,112167,1025,87855,768,24312,257,94740,803,519879,931,614619,1734,7,1151,-417,13184,1435,97832,10,2475,1172,"Knox County",470313,1312.74279043956,0.447797993538514,368.690637936863,217.939967638573,2803.23954472872,44.7797993538514
2022-01-24,111142,1320,87087,1082,24055,238,93937,1158,518948,1550,612885,2708,13,1144,-129,13601,1436,96397,15,2465,1166,"Knox County",470313,1442.23102487067,0.44257136435154,575.786763283175,280.664153446747,2891.90390229485,44.257136435154
2022-01-23,109822,769,86005,680,23817,89,92779,709,517398,818,610177,1527,0,1131,168,13730,601,94961,7,2450,1161,"Knox County",470313,1523.02828116595,0.449599083619702,324.677395691805,163.508131818597,2919.33244456351,44.9599083619702
2022-01-22,109053,903,85325,739,23728,164,92070,770,516580,1056,608650,1826,0,1131,210,13562,693,94360,12,2443,1151,"Knox County",470313,1570.65613750843,0.449845462208486,388.252078934667,191.999795880616,2883.61155230666,44.9845462208486
2022-01-21,108150,1517,84586,1230,23564,287,91300,1292,515524,1348,606824,2640,1,1131,606,13352,910,93667,6,2431,1148,"Knox County",470313,1693.97826553806,0.457405679242768,561.328306893494,322.551152105087,2838.96043698558,45.7405679242768
2022-01-20,106633,1409,83356,1170,23277,239,90008,1217,514176,1152,604184,2369,11,1130,495,12746,903,92757,11,2425,1142,"Knox County",470313,1688.66265657126,0.465226013813855,503.707105693442,299.587721368535,2710.11007563048,46.5226013813855
2022-01-19,105224,1675,82186,1311,23038,364,88791,1344,513024,1331,601815,2675,4,1119,420,12251,1251,91854,6,2414,1140,"Knox County",470313,1832.39672303338,0.471154467342852,568.770159447007,356.145800775228,2604.86101808795,47.1154467342852
2022-01-18,103549,1045,80875,665,22674,380,87447,692,511693,686,599140,1378,6,1115,-272,11831,1311,90603,7,2408,1138,"Knox County",470313,1836.64921020682,0.474905772664154,292.99636624971,222.192454812008,2515.55878744581,47.4905772664154
2022-01-17,102504,1089,80210,856,22294,233,86755,900,511007,1279,597762,2179,7,1109,-95,12103,1177,89292,13,2401,1134,"Knox County",470313,1787.53298335364,0.474441551322461,463.308477545805,231.547926593566,2573.39261300453,47.4441551322461
2022-01-16,101415,773,79354,693,22061,80,85855,717,509728,1073,595583,1790,0,1102,213,12198,560,88115,7,2388,1131,"Knox County",470313,1788.38348078833,0.466581409436629,380.597602022483,164.358629253285,2593.59192707835,46.6581409436629
2022-01-15,100642,751,78661,598,21981,153,85138,627,508655,816,593793,1443,1,1102,406,11985,344,87555,12,2381,1127,"Knox County",470313,1756.06457827022,0.46904794804477,306.816949563376,159.680893362505,2548.30293868126,46.904794804477
2022-01-14,99891,1314,78063,1059,21828,255,84511,1097,507839,1188,592350,2285,6,1101,849,11579,459,87211,9,2369,1125,"Knox County",470313,1712.90183345984,0.467030242935052,485.846659565013,279.388407294717,2461.97744906052,46.7030242935052
2022-01-13,98577,1406,77004,1059,21573,347,83414,1105,506651,1402,590065,2507,6,1095,658,10730,742,86752,11,2360,1120,"Knox County",470313,1712.26396038383,0.454653854247037,533.049267190148,298.94984829252,2281.45936854818,45.4653854247037
2022-01-12,97171,1168,75945,890,21226,278,82309,936,505249,1058,587558,1994,1,1089,461,10072,706,86010,3,2349,1114,"Knox County",470313,1604.46341053724,0.447407189157336,423.972971191526,248.345250928637,2141.55254054215,44.7407189157336
2022-01-11,96003,1366,75055,1061,20948,305,81373,1095,504191,1283,585564,2378,2,1088,704,9611,660,85304,10,2346,1114,"Knox County",470313,1672.71582967088,0.444360592755214,505.620724921488,290.444873945649,2043.53271119446,44.4360592755214
2022-01-10,94637,1002,73994,685,20643,317,80278,715,502908,812,583186,1527,3,1086,373,8907,626,84644,5,2336,1111,"Knox County",470313,1654.21751046643,0.451881643205975,324.677395691805,213.049607389122,1893.84516268953,45.1881643205975
2022-01-09,93635,741,73309,628,20326,113,79563,664,502096,1205,581659,1869,5,1083,399,8534,337,84018,2,2331,1110,"Knox County",470313,1647.41353098894,0.445547382703706,397.394926357553,157.554649775788,1814.53627690495,44.5547382703706
2022-01-08,92894,624,72681,477,20213,147,78899,509,500891,912,579790,1421,0,1078,483,8135,141,83681,10,2329,1108,"Knox County",470313,1620.41023743762,0.437808454330878,302.139213672597,132.67759981119,1729.69915779492,43.7808454330878
2022-01-07,92270,967,72204,749,20066,218,78390,766,499979,1091,578369,1857,0,1078,783,7652,184,83540,7,2319,1104,"Knox County",470313,1546.62958497851,0.427211687449273,394.843434053492,205.607754835609,1627.00159255645,42.7211687449273
2022-01-06,91303,1170,71455,745,19848,425,77624,781,498888,1011,576512,1792,2,1078,939,6869,229,83356,7,2312,1104,"Knox County",470313,1496.45023633197,0.425767253466272,381.022850739826,248.77049964598,1460.51671971644,42.5767253466272
2022-01-05,90133,1215,70710,903,19423,312,76843,942,497877,1255,574720,2197,1,1076,977,5930,237,83127,8,2305,1100,"Knox County",470313,1506.44358118955,0.41959972394755,467.135716001897,258.33859578621,1260.86244692364,41.959972394755
2022-01-04,88918,924,69807,578,19111,346,75901,567,496622,1040,572523,1607,0,1075,718,4953,206,82890,6,2297,1099,"Knox County",470313,1412.46361465662,0.402933985330073,341.687344385547,196.464907412723,1053.12844850132,40.2933985330073
2022-01-03,87994,716,69229,538,18765,178,75334,505,495582,820,570916,1325,6,1075,539,4235,171,82684,6,2291,1094,"Knox County",470313,1351.65304807649,0.392277096453431,281.727275240106,152.239040808993,900.46415897498,39.2277096453431
2022-01-02,87278,290,68691,207,18587,83,74829,265,494762,651,569591,916,3,1069,171,3696,116,82513,9,2285,1092,"Knox County",470313,1255.75946231552,0.390013495276653,194.763912543349,61.6610640148157,785.859629650892,39.0013495276653
2022-01-01,86988,265,68484,215,18504,50,74564,237,494111,767,568675,1004,0,1066,168,3525,97,82397,15,2276,1088,"Knox County",470313,1179.42731755235,0.379790615068237,213.474856106465,56.3454550480212,749.500864318018,37.9790615068237
2021-12-31,86723,591,68269,429,18454,162,74327,470,493344,1008,567671,1478,0,1066,487,3357,104,82300,5,2261,1088,"Knox County",470313,1099.48055869176,0.365054753367574,314.258802116888,125.660995975021,713.779972061159,36.5054753367574
2021-12-30,86132,582,67840,403,18292,179,73857,404,492336,918,566193,1322,2,1066,471,2870,109,82196,6,2256,1085,"Knox County",470313,974.457435792759,0.344197380444715,281.089402164091,123.747376746975,610.231909388003,34.4197380444715
2021-12-29,85550,633,67437,475,18113,158,73453,503,491418,1195,564871,1698,1,1064,506,2399,126,82087,5,2250,1083,"Knox County",470313,850.710059045784,0.315614973262032,361.036161024679,134.591219039236,510.085836453596,31.5614973262032
2021-12-28,84917,429,66962,262,17955,167,72950,283,490223,979,563173,1262,1,1063,304,1893,124,81961,5,2245,1081,"Knox County",470313,745.461001503254,0.296168795113826,268.331940643784,91.2158498701928,402.497910965676,29.6168795113826
2021-12-27,84488,314,66700,234,17788,80,72667,254,489244,905,561911,1159,2,1062,202,1589,110,81837,1,2240,1081,"Knox County",470313,659.986009317199,0.273334087566467,246.431631700591,66.7640486229383,337.860105929456,27.3334087566467
2021-12-26,84174,61,66466,49,17708,12,72413,60,488339,426,560752,486,7,1060,-35,1387,89,81727,1,2239,1080,"Knox County",470313,611.295031181362,0.262932572244024,103.335438314484,12.9700858789785,294.909985477756,26.2932572244024
2021-12-25,84113,85,66417,63,17696,22,72353,74,487913,489,560266,563,1,1053,6,1422,78,81638,1,2238,1080,"Knox County",470313,573.022646620442,0.257028112449799,119.707513932211,18.0730704871011,302.351838031269,25.7028112449799
2021-12-24,84028,174,66354,122,17674,52,72279,137,487424,848,559703,985,0,1052,94,1416,80,81560,2,2237,1080,"Knox County",470313,484.358289054311,0.22943143812709,209.434993291702,36.9966384088894,301.076091879238,22.943143812709
2021-12-23,83854,218,66232,159,17622,59,72142,166,486576,960,558718,1126,5,1052,113,1322,100,81480,5,2235,1080,"Knox County",470313,406.963022497783,0.202912487979118,239.415027864422,46.3521101904476,281.089402164091,20.2912487979118
2021-12-22,83636,176,66073,102,17563,74,71976,101,485616,814,557592,915,47,1047,14,1209,115,81380,10,2230,1079,"Knox County",470313,309.793690584781,0.16548645320197,194.551288184677,37.421887126233,257.06284963418,16.548645320197
2021-12-21,83460,177,65971,124,17489,53,71875,120,484802,912,556677,1032,3,1000,71,1195,103,81265,6,2220,1077,"Knox County",470313,256.212352199493,0.145547398659432,219.428338149275,37.6345114849047,254.086108612775,14.5547398659432
2021-12-20,83283,114,65847,80,17436,34,71755,84,483890,623,555645,707,1,997,-8,1124,121,81162,3,2214,1075,"Knox County",470313,213.687480465137,0.127622979016168,150.325421580947,24.2391768885827,238.989779147079,12.7622979016168
2021-12-19,83169,70,65767,50,17402,20,71671,58,483267,557,554938,615,3,996,-18,1132,85,81041,6,2211,1074,"Knox County",470313,215.601099693183,0.124516237590443,130.763980583144,14.8837051070245,240.690774016453,12.4516237590443
2021-12-18,83099,88,65717,56,17382,32,71613,65,482710,660,554323,725,0,993,11,1150,77,80956,3,2205,1073,"Knox County",470313,216.238972769198,0.11973791973792,154.152660037039,18.7109435631165,244.518012472545,11.973791973792
2021-12-17,83011,119,65661,77,17350,42,71548,83,482050,1034,553598,1117,2,993,6,1139,111,80879,6,2202,1071,"Knox County",470313,204.544633042251,0.108545775212442,237.501408636376,25.3022986819416,242.179144527155,10.8545775212442
2021-12-16,82892,139,65584,107,17308,32,71465,108,481016,661,552481,769,2,991,33,1133,104,80768,3,2196,1069,"Knox County",470313,187.74730870718,0.105272108843537,163.508131818597,29.5547858553772,240.903398375125,10.5272108843537
2021-12-15,82753,157,65477,113,17276,44,71357,125,480355,841,551712,966,0,989,30,1100,127,80664,5,2193,1067,"Knox County",470313,183.707445892416,0.108413421008262,205.395130476938,33.3820243114692,233.886794538956,10.8413421008262
2021-12-14,82596,97,65364,59,17232,38,71232,63,479514,811,550746,874,3,989,-55,1070,149,80537,3,2188,1064,"Knox County",470313,166.697497198674,0.101507015416594,185.833689479134,20.6245627911625,227.508063778803,10.1507015416594
2021-12-13,82499,111,65305,74,17194,37,71169,79,478703,627,549872,706,4,986,-50,1125,157,80388,3,2185,1061,"Knox County",470313,166.059624122659,0.100658350658351,150.112797222275,23.6013038125674,239.20240350575,10.0658350658351
2021-12-12,82388,54,65231,29,17157,25,71090,40,478076,493,549166,533,6,982,-37,1175,85,80231,5,2182,1061,"Knox County",470313,162.65763438391,0.0989455184534271,113.328783172058,11.481715368276,249.833621439339,9.89455184534271
2021-12-11,82334,65,65202,45,17132,20,71050,51,477583,541,548633,592,0,976,-22,1212,87,80146,1,2177,1060,"Knox County",470313,157.767274134459,0.0987943134784956,125.873620333693,13.8205833136656,257.700722710195,9.87943134784956
2021-12-10,82269,84,65157,48,17112,36,70999,57,477042,856,548041,913,0,976,-13,1234,97,80059,3,2176,1057,"Knox County",470313,150.325421580947,0.0977022230524939,194.126039467333,17.8604461284294,262.378458600974,9.77022230524939
2021-12-09,82185,164,65109,96,17076,68,70942,107,476186,1017,547128,1124,3,976,102,1247,59,79962,2,2173,1055,"Knox County",470313,155.641030547742,0.0914505956552207,238.989779147079,34.8703948221716,265.142575263707,9.14505956552208
2021-12-08,82021,130,65013,67,17008,63,70835,65,475169,751,546004,816,0,973,33,1145,97,79903,7,2171,1054,"Knox County",470313,149.900172863604,0.0831234256926952,173.501476676171,27.6411666273312,243.454890679186,8.31234256926952
2021-12-07,81891,127,64946,70,16945,57,70770,76,474418,631,545188,707,2,973,17,1112,108,79806,2,2164,1053,"Knox County",470313,156.278903623757,0.0881098126507142,150.325421580947,27.0032935513158,236.438286843017,8.81098126507142
2021-12-06,81764,148,64876,106,16888,42,70694,115,473787,759,544481,874,8,971,38,1095,102,79698,4,2162,1053,"Knox County",470313,164.146004894613,0.0919230077352042,185.833689479134,31.4684050834232,232.823672745597,9.19230077352042
2021-12-05,81616,43,64770,28,16846,15,70579,33,473028,342,543607,375,2,963,-20,1057,61,79596,1,2158,1050,"Knox County",470313,161.807136949223,0.093316052582855,79.7341345019168,9.14284742288646,224.74394711607,9.3316052582855
2021-12-04,81573,69,64742,50,16831,19,70546,55,472686,499,543232,554,0,961,14,1077,55,79535,3,2157,1050,"Knox County",470313,162.65763438391,0.0947231027410032,117.793894704165,14.6710807483527,228.996434289505,9.47231027410032
2021-12-03,81504,147,64692,103,16812,44,70491,108,472187,1009,542678,1117,3,961,62,1063,82,79480,2,2154,1048,"Knox County",470313,176.052968980232,0.100413148913239,237.501408636376,31.2557807247514,226.0196932681,10.0413148913239
2021-12-02,81357,133,64589,86,16768,47,70383,85,471178,794,541561,879,0,958,31,1001,102,79398,4,2152,1046,"Knox County",470313,169.461613861407,0.100901916572717,186.896811272493,28.2790397033465,212.83698303045,10.0901916572717
2021-12-01,81224,185,64503,142,16721,43,70298,147,470384,1009,540682,1156,4,958,91,970,90,79296,7,2148,1044,"Knox County",470313,181.155953588355,0.109325326739668,245.793758624576,39.335506354279,206.245627911625,10.9325326739668
2021-11-30,81039,116,64361,66,16678,50,70151,68,469375,693,539526,761,3,954,16,879,97,79206,6,2141,1043,"Knox County",470313,178.817085642965,0.106892932120364,161.807136949223,24.6644256059263,186.896811272493,10.6892932120364
2021-11-29,80923,165,64295,128,16628,37,70083,139,468682,967,538765,1106,2,951,75,863,88,79109,5,2135,1040,"Knox County",470313,182.431699740386,0.106758574310693,235.162540690987,35.0830191808434,183.494821533745,10.6758574310693
2021-11-28,80758,33,64167,22,16591,11,69944,22,467715,270,537659,292,3,949,-24,788,54,79021,5,2130,1039,"Knox County",470313,180.305456153668,0.106393861892583,62.0863127321592,7.01660383616868,167.547994633361,10.6393861892583
2021-11-27,80725,59,64145,31,16580,28,69922,32,467445,266,537367,298,0,946,1,812,58,78967,1,2125,1038,"Knox County",470313,178.17921256695,0.107149224460688,63.3620588841899,12.5448371616349,172.650979241484,10.7149224460688
2021-11-26,80666,20,64114,18,16552,2,69890,20,467179,298,537069,318,0,946,-45,811,65,78909,4,2124,1036,"Knox County",470313,151.175919015634,0.106652806652807,67.6145460576254,4.25248717343556,172.438354882812,10.6652806652807
2021-11-25,80646,52,64096,26,16550,26,69870,29,466881,331,536751,360,0,946,-18,856,70,78844,3,2120,1035,"Knox County",470313,133.95334596322,0.106501980890235,76.5447691218401,11.0564666509325,182.006451023042,10.6501980890235
2021-11-24,80594,105,64070,66,16524,39,69841,73,466550,742,536391,815,0,946,18,874,87,78774,3,2117,1030,"Knox County",470313,116.943397269478,0.0969620253164557,173.288852317499,22.3255576605367,185.833689479134,9.69620253164557
2021-11-23,80489,99,64004,64,16485,35,69768,65,465808,674,535576,739,0,946,37,856,62,78687,2,2114,1026,"Knox County",470313,113.328783172058,0.0967413441955193,157.129401058444,21.049811508506,182.006451023042,9.67413441955193
2021-11-22,80390,107,63940,83,16450,24,69703,82,465134,740,534837,822,0,946,37,819,70,78625,3,2112,1026,"Knox County",470313,100.996570369095,0.0886388583973655,174.777222828202,22.7508063778803,174.139349752186,8.86388583973655
2021-11-21,80283,44,63857,32,16426,12,69621,37,464394,284,534015,321,0,946,-9,782,53,78555,2,2109,1026,"Knox County",470313,103.335438314484,0.0920228695888919,68.2524191336408,9.35547178155824,166.272248481331,9.20228695888919
2021-11-20,80239,54,63825,37,16414,17,69584,44,464110,537,533694,581,0,946,14,791,40,78502,1,2107,1024,"Knox County",470313,102.272316521125,0.0884732052578362,123.534752388303,11.481715368276,168.185867709377,8.84732052578362
2021-11-19,80185,112,63788,83,16397,29,69540,81,463573,825,533113,906,0,946,62,777,50,78462,0,2106,1024,"Knox County",470313,121.833757518929,0.0904489436619718,192.637668956631,23.8139281712392,165.209126687972,9.04489436619718
2021-11-18,80073,80,63705,44,16368,36,69459,49,462748,937,532207,986,3,946,18,715,59,78412,2,2106,1024,"Knox County",470313,127.787239561739,0.0833655705996132,209.647617650373,17.0099486937423,152.026416450321,8.33655705996132
2021-11-17,79993,105,63661,64,16332,41,69410,66,461811,833,531221,899,0,943,44,697,61,78353,1,2104,1024,"Knox County",470313,127.787239561739,0.0807004187285877,191.149298445929,22.3255576605367,148.199177994229,8.07004187285877
2021-11-16,79888,73,63597,51,16291,22,69344,67,460978,777,530322,844,0,943,9,653,64,78292,2,2103,1023,"Knox County",470313,122.259006236272,0.0794924426198918,179.454958718981,15.5215781830398,138.843706212671,7.94924426198918
2021-11-15,79815,84,63546,44,16269,40,69277,34,460201,460,529478,494,3,943,21,644,60,78228,0,2101,1020,"Knox County",470313,117.368645986822,0.075134168157424,105.036433183858,17.8604461284294,136.930086984625,7.5134168157424
2021-11-14,79731,72,63502,62,16229,10,69243,68,459741,624,528984,692,0,940,16,623,56,78168,2,2101,1020,"Knox County",470313,123.322128029631,0.0757126990003702,147.13605620087,15.308953824368,132.464975452518,7.57126990003702
2021-11-13,79659,29,63440,13,16219,16,69175,12,459117,317,528292,329,0,940,-13,607,42,78112,2,2099,1018,"Knox County",470313,118.006519062837,0.0732038834951456,69.953414003015,6.16610640148157,129.062985713769,7.32038834951456
2021-11-12,79630,66,63427,49,16203,17,69163,51,458800,687,527963,738,0,940,18,620,48,78070,4,2097,1018,"Knox County",470313,108.225798563935,0.069650742673625,156.916776699772,14.0332076723374,131.827102376502,6.96507426736251
2021-11-11,79564,67,63378,46,16186,21,69112,54,458113,962,527225,1016,0,940,-3,602,70,78022,0,2093,1016,"Knox County",470313,105.461681901202,0.0702314445331205,216.026348410527,14.2458320310091,127.99986392041,7.02314445331205
2021-11-10,79497,74,63332,50,16165,24,69058,69,457151,855,526209,924,1,940,6,605,67,77952,2,2093,1016,"Knox County",470313,98.8703267823768,0.0704784594004368,196.464907412723,15.7342025417116,128.637736996426,7.04784594004368
2021-11-09,79423,106,63282,76,16141,30,68989,134,456296,1174,525285,1308,1,939,34,599,71,77885,1,2091,1016,"Knox County",470313,105.886930618546,0.0767133248500273,278.112661142686,22.5381820192085,127.361990844395,7.67133248500273
2021-11-08,79317,78,63206,58,16111,20,68855,70,455122,687,523977,757,6,938,-10,565,82,77814,1,2090,1015,"Knox County",470313,104.611184466515,0.0794587092297016,160.956639514536,16.5846999763987,120.132762649555,7.94587092297016
2021-11-07,79239,31,63148,20,16091,11,68785,23,454435,390,523220,413,0,932,-20,575,51,77732,1,2089,1012,"Knox County",470313,95.8935857609719,0.0752962625341841,87.8138601314444,6.59135511882512,122.259006236272,7.52962625341841
2021-11-06,79208,41,63128,27,16080,14,68762,30,454045,453,522807,483,0,932,-2,595,43,77681,2,2088,1009,"Knox County",470313,98.4450780650333,0.0764319914878525,102.697565238469,8.7175987055429,126.511493409708,7.64319914878525
2021-11-05,79167,52,63101,32,16066,20,68732,36,453592,605,522324,641,0,932,-27,597,79,77638,2,2086,1008,"Knox County",470313,95.4683370436284,0.0750631540959942,136.29221390861,11.0564666509325,126.936742127052,7.50631540959942
2021-11-04,79115,68,63069,45,16046,23,68696,49,452987,668,521683,717,0,932,-1,624,69,77559,1,2084,1008,"Knox County",470313,95.6809614023002,0.0783902345985123,152.451665167665,14.4584563896809,132.67759981119,7.83902345985123
2021-11-03,79047,79,63024,59,16023,20,68647,65,452319,969,520966,1034,0,932,-2,625,81,77490,2,2083,1007,"Knox County",470313,96.7440831956591,0.0760321315150383,219.853586866619,16.7973243350705,132.890224169861,7.60321315150383
2021-11-02,78968,41,62965,19,16003,22,68582,22,451350,301,519932,323,4,932,-51,627,88,77409,1,2081,1005,"Knox County",470313,82.9234998819935,0.06753663003663,68.6776678509843,8.7175987055429,133.315472887205,6.753663003663
2021-11-01,78927,95,62946,71,15981,24,68560,83,451049,661,519609,744,1,928,-20,678,114,77321,3,2080,1002,"Knox County",470313,86.5381139794137,0.0707233065442021,158.192522851803,20.1993140738189,144.159315179466,7.07233065442021
2021-10-31,78832,26,62875,20,15957,6,68477,19,450388,278,518865,297,0,927,-43,698,69,77207,1,2077,1001,"Knox County",470313,85.4749921860548,0.0717150271290399,63.1494345255181,5.52823332546623,148.411802352901,7.17150271290399
2021-10-30,78806,56,62855,41,15951,15,68458,43,450110,522,518568,565,0,927,-23,741,79,77138,4,2076,1000,"Knox County",470313,88.6643575661315,0.0733626475352928,120.132762649555,11.9069640856196,157.554649775788,7.33626475352928
2021-10-29,78750,73,62814,59,15936,14,68415,66,449588,846,518003,912,1,927,-37,764,109,77059,1,2072,1000,"Knox County",470313,93.1294690982388,0.0755662020905923,193.913415108662,15.5215781830398,162.445010025239,7.55662020905923
2021-10-28,78677,54,62755,32,15922,22,68349,39,448742,561,517091,600,4,926,-52,801,102,76950,3,2071,999,"Knox County",470313,90.1527280768339,0.0753072625698324,127.574615203067,11.481715368276,170.312111296094,7.53072625698324
2021-10-27,78623,88,62723,57,15900,31,68310,65,448181,759,516491,824,1,922,-29,853,116,76848,3,2068,997,"Knox County",470313,92.0663473048799,0.0790152403282532,175.202471545545,18.7109435631165,181.368577947027,7.90152403282532
2021-10-26,78535,96,62666,58,15869,38,68245,55,447422,554,515667,609,0,921,-18,882,114,76732,5,2065,994,"Knox County",470313,103.760687031828,0.0813008130081301,129.488234431113,20.4119384324907,187.534684348508,8.13008130081301
2021-10-25,78439,71,62608,47,15831,24,68190,54,446868,491,515058,545,6,921,-72,900,137,76618,3,2060,992,"Knox County",470313,98.6577024237051,0.0783547794117647,115.880275476119,15.0963294656962,191.3619228046,7.83547794117647
2021-10-24,78368,38,62561,20,15807,18,68136,23,446377,337,514513,360,1,915,-73,972,110,76481,5,2057,991,"Knox County",470313,101.209194727766,0.0781426953567384,76.5447691218401,8.07972562952757,206.670876628968,7.81426953567384
2021-10-23,78330,59,62541,40,15789,19,68113,42,446040,471,514153,513,0,914,-14,1045,73,76371,1,2052,988,"Knox County",470313,101.847067803782,0.0788448315379326,109.076295998622,12.5448371616349,222.192454812008,7.88448315379326
2021-10-22,78271,90,62501,55,15770,35,68071,55,445569,551,513640,606,0,914,-68,1059,158,76298,2,2051,986,"Knox County",470313,105.461681901202,0.0820803549420754,128.850361355098,19.13619228046,225.169195833413,8.20803549420754
2021-10-21,78181,124,62446,71,15735,53,68016,78,445018,712,513034,790,3,914,-23,1127,144,76140,2,2049,984,"Knox County",470313,120.345387008226,0.0875912408759124,167.973243350705,26.3654204753005,239.627652223094,8.75912408759124
2021-10-20,78057,149,62375,83,15682,66,67938,90,444306,959,512244,1049,3,911,-47,1150,193,75996,3,2047,982,"Knox County",470313,133.315472887205,0.0887745974955277,223.042952246695,31.6810294420949,244.518012472545,8.87745974955277
2021-10-19,77908,131,62292,85,15616,46,67848,92,443347,724,511195,816,4,908,-40,1197,167,75803,4,2044,980,"Knox County",470313,140.757325440717,0.0927548621500321,173.501476676171,27.8537909860029,254.511357330118,9.27548621500321
2021-10-18,77777,121,62207,90,15570,31,67756,106,442623,607,510379,713,9,904,-72,1237,184,75636,8,2040,978,"Knox County",470313,151.388543374306,0.100268207138436,151.601167732978,25.7275473992852,263.01633167699,10.0268207138436
2021-10-17,77656,63,62117,56,15539,7,67650,61,442016,303,509666,364,1,895,-66,1309,128,75452,4,2032,975,"Knox County",470313,156.7041523411,0.108018965161822,77.3952665565272,13.395334596322,278.325285501358,10.8018965161822
2021-10-16,77593,55,62061,41,15532,14,67589,44,441713,372,509302,416,0,894,-84,1375,139,75324,1,2028,973,"Knox County",470313,155.853654906413,0.110643668489693,88.4517332074597,11.6943397269478,292.358493173695,11.0643668489693
2021-10-15,77538,125,62020,89,15518,36,67545,100,441341,794,508886,894,9,894,-69,1459,185,75185,5,2027,969,"Knox County",470313,163.295507459926,0.113248710829036,190.08617665257,26.5780448339723,310.218939302124,11.3248710829036
2021-10-14,77413,192,61931,135,15482,57,67445,143,440547,699,507992,842,0,885,6,1528,186,75000,7,2022,967,"Knox County",470313,177.753963849607,0.124852767962309,179.029710001637,40.8238768649814,324.890020050477,12.4852767962309
2021-10-13,77221,121,61796,88,15425,33,67302,99,439848,764,507150,863,7,885,-78,1522,192,74814,5,2015,962,"Knox County",470313,171.800481806797,0.131418092909535,183.494821533745,25.7275473992852,323.614273898446,13.1418092909535
2021-10-12,77100,136,61708,104,15392,32,67203,109,439084,821,506287,930,4,878,-81,1600,213,74622,3,2010,961,"Knox County",470313,172.863603600156,0.131819992035046,197.740653564754,28.9169127793618,340.198973874845,13.1819992035046
2021-10-11,76964,194,61604,136,15360,58,67094,149,438263,581,505357,730,3,874,-86,1681,277,74409,12,2007,952,"Knox County",470313,188.385181783195,0.139908712046041,155.215781830398,41.249125582325,357.421546927259,13.9908712046041
2021-10-10,76770,54,61468,41,15302,13,66945,51,437682,489,504627,540,0,871,-90,1767,144,74132,4,1995,951,"Knox County",470313,186.471562555149,0.13326941514861,114.81715368276,11.481715368276,375.707241773032,13.326941514861
2021-10-09,76716,66,61427,37,15289,29,66894,48,437193,490,504087,538,0,871,-67,1857,133,73988,7,1991,948,"Knox County",470313,188.810430500539,0.1309724564362,114.391904965417,14.0332076723374,394.843434053492,13.09724564362
2021-10-08,76650,289,61390,114,15260,175,66846,122,436703,936,503549,1058,-1,871,75,1924,215,73855,5,1984,944,"Knox County",470313,223.680825322711,0.131067078712961,224.956571474741,61.4484396561439,409.089266084501,13.1067078712961
2021-10-07,76361,259,61276,170,15085,89,66724,176,435767,1106,502491,1282,6,872,-8,1849,261,73640,9,1979,940,"Knox County",470313,237.92665735372,0.12691466083151,272.58442781722,55.0697088959905,393.142439184118,12.691466083151
2021-10-06,76102,139,61106,103,14996,36,66548,112,434661,835,501209,947,1,866,-120,1857,258,73379,4,1970,939,"Knox County",470313,241.753895809812,0.127302904564315,201.355267662174,29.5547858553772,394.843434053492,12.7302904564315
2021-10-05,75963,210,61003,118,14960,92,66436,138,433826,915,500262,1053,3,865,-73,1977,280,73121,4,1966,934,"Knox County",470313,257.488098351523,0.129472999349382,223.893449681382,44.6511153210734,420.358357094105,12.9472999349382
2021-10-04,75753,316,60885,224,14868,92,66298,245,432911,829,499209,1074,3,862,-14,2050,327,72841,4,1962,930,"Knox County",470313,283.42827010948,0.137399876771411,228.35856121349,67.1892973402819,435.879935277145,13.7399876771411
2021-10-03,75437,102,60661,93,14776,9,66053,107,432082,678,498135,785,1,859,-66,2064,167,72514,6,1958,928,"Knox County",470313,293.634239325726,0.140715451981594,166.910121557346,21.6876845845214,438.85667629855,14.0715451981594
2021-10-02,75335,67,60568,43,14767,24,65946,50,431404,472,497350,522,5,858,-144,2130,206,72347,2,1952,927,"Knox County",470313,293.846863684397,0.141348013688439,110.989915226668,14.2458320310091,452.889883970887,14.1348013688439
2021-10-01,75268,225,60525,152,14743,73,65896,167,430932,965,496828,1132,0,853,-76,2274,301,72141,9,1950,923,"Knox County",470313,280.238904729404,0.146431199411332,240.690774016453,47.8404807011501,483.507791619624,14.6431199411332
2021-09-30,75043,240,60373,166,14670,74,65729,186,429967,1104,495696,1290,1,853,-112,2350,351,71840,8,1941,920,"Knox County",470313,276.19904191464,0.147728943113332,274.285422686594,51.0298460812268,499.667242878679,14.7728943113332
2021-09-29,74803,361,60207,170,14596,191,65543,192,428863,1111,494406,1303,6,852,-95,2462,450,71489,7,1933,918,"Knox County",470313,323.401649539775,0.151557480094985,277.049539349327,76.7573934805119,523.481171049918,15.1557480094985
2021-09-28,74442,348,60037,249,14405,99,65351,270,427752,778,493103,1048,2,846,-75,2557,421,71039,1,1926,915,"Knox County",470313,352.74381103648,0.170114621190942,222.830327888024,73.9932768177788,543.680485123737,17.0114621190942
2021-09-27,74094,239,59788,162,14306,77,65081,186,426974,760,492055,946,7,844,-302,2632,534,70618,12,1925,912,"Knox County",470313,336.371735418753,0.164816396242528,201.142643303502,50.817221722555,559.62731202412,16.4816396242528
2021-09-26,73855,124,59626,99,14229,25,64895,117,426214,703,491109,820,2,837,-144,2934,266,70084,1,1913,906,"Knox County",470313,341.049471309532,0.165415663503753,174.351974110858,26.3654204753005,623.839868342997,16.5415663503753
2021-09-25,73731,110,59527,90,14204,20,64778,102,425511,705,490289,807,0,835,-176,3078,286,69818,3,1912,901,"Knox County",470313,350.192318732419,0.166076776476994,171.587857448125,23.3886794538956,654.457775991733,16.6076776476994
2021-09-24,73621,244,59437,165,14184,79,64676,182,424806,939,489482,1121,13,835,-234,3254,465,69532,5,1909,894,"Knox County",470313,354.232181547182,0.168370824812543,238.351906071063,51.8803435159139,691.879663117966,16.8370824812543
2021-09-23,73377,355,59272,246,14105,109,64494,268,423867,1370,488361,1638,14,822,-221,3488,562,69067,8,1904,891,"Knox County",470313,378.683982794437,0.171417415072237,348.278699504373,75.4816473284812,741.633763047162,17.1417415072237
2021-09-22,73022,251,59026,187,13996,64,64226,202,422497,1261,486723,1463,3,808,-327,3709,575,68505,4,1896,888,"Knox County",470313,355.295303340541,0.169195460920566,311.069436736811,53.3687140266163,788.623746313625,16.9195460920566
2021-09-21,72771,397,58839,216,13932,181,64024,230,421236,996,485260,1226,10,805,-354,4036,741,67930,7,1892,879,"Knox County",470313,365.713896915458,0.160453808752026,260.6774637316,84.4118703926959,858.151911599297,16.0453808752026
2021-09-20,72374,432,58623,310,13751,122,63794,343,420240,1295,484034,1638,5,795,113,4390,314,67189,9,1885,875,"Knox County",470313,406.750398139112,0.165729369907035,348.278699504373,91.8537229462082,933.420934569106,16.5729369907035
2021-09-19,71942,120,58313,88,13629,32,63451,97,418945,432,482396,529,1,790,-176,4277,295,66875,7,1876,868,"Knox County",470313,405.899900704425,0.169080978389931,112.478285737371,25.5149230406134,909.394382039195,16.9080978389931
2021-09-18,71822,226,58225,183,13597,43,63354,197,418513,1075,481867,1272,0,789,-108,4453,334,66580,7,1869,860,"Knox County",470313,430.564326310351,0.170923821312029,270.458184230502,48.0531050598219,946.816269165428,17.0923821312029
2021-09-17,71596,546,58042,421,13554,125,63157,448,417438,1310,480595,1758,5,789,4,4561,537,66246,11,1862,847,"Knox County",470313,494.776882629228,0.187421251574969,373.793622544986,116.092899834791,969.77969990198,18.7421251574969
2021-09-16,71050,588,57621,456,13429,132,62709,487,416128,1518,478837,2005,7,784,15,4557,566,65709,16,1851,842,"Knox County",470313,544.318358199752,0.202608431907795,426.311839136915,125.023122899006,968.929202467293,20.2608431907795
2021-09-15,70462,338,57165,249,13297,89,62222,267,414610,807,476832,1074,6,777,-306,4542,638,65143,5,1835,839,"Knox County",470313,562.816677404197,0.217743632919385,228.35856121349,71.867033231061,965.739837087216,21.7743632919385
2021-09-14,70124,555,56916,443,13208,112,61955,476,413803,1406,475758,1882,12,771,-158,4848,701,64505,8,1830,835,"Knox County",470313,596.411326074338,0.227899192754479,400.159043020287,118.006519062837,1030.80289084078,22.7899192754479
2021-09-13,69569,399,56473,299,13096,100,61479,332,412397,1134,473876,1466,20,759,-436,5006,815,63804,15,1822,832,"Knox County",470313,589.394722238169,0.230723012217104,311.707309812827,84.8371191100395,1064.39753951092,23.0723012217104
2021-09-12,69170,387,56174,358,12996,29,61147,376,411263,1460,472410,1836,0,739,79,5442,308,62989,5,1807,823,"Knox County",470313,646.165426003534,0.228725759319933,390.378322521385,82.2856268059781,1157.10175989182,22.8725759319933
2021-09-11,68783,865,55816,707,12967,158,60771,763,409803,2621,470574,3384,4,739,499,5363,362,62681,26,1802,815,"Knox County",470313,782.0323911948,0.2349123461395,719.520829745297,183.920070251088,1140.30443555675,23.49123461395
2021-09-10,67918,1027,55109,750,12809,277,60008,804,407182,2513,467190,3317,1,735,477,4864,549,62319,24,1776,805,"Knox County",470313,884.304707715925,0.234228815824646,705.274997714288,218.365216355916,1034.20488057953,23.4228815824646
2021-09-09,66891,309,54359,166,12532,143,59204,171,404669,685,463873,856,1,734,-366,4387,674,61770,18,1752,798,"Knox County",470313,824.982511646499,0.230836047774159,182.006451023042,65.7009268295794,932.783061493091,23.0836047774159
2021-09-08,66582,290,54193,226,12389,64,59033,250,403984,837,463017,1087,5,733,-404,4753,689,61096,11,1734,793,"Knox County",470313,814.776542430254,0.229389644200174,231.122677876223,61.6610640148157,1010.60357676696,22.9389644200174
2021-09-07,66292,414,53967,300,12325,114,58783,311,403147,979,461930,1290,3,728,-221,5157,632,60407,13,1723,787,"Knox County",470313,784.796507857533,0.22718343910547,274.285422686594,88.0264844901162,1096.50381767036,22.718343910547
2021-09-06,65878,991,53667,791,12211,200,58472,844,402168,3221,460640,4065,1,725,342,5378,648,59775,20,1710,786,"Knox County",470313,910.670128191226,0.222229239027471,864.318018000778,210.710739443732,1143.49380093682,22.2229239027471
2021-09-05,64887,969,52876,800,12011,169,57628,832,398947,2999,456575,3831,2,724,620,5036,347,59127,15,1690,783,"Knox County",470313,1034.4175049382,0.222938867077958,814.563918071582,206.033003552953,1070.77627027107,22.2938867077958
2021-09-04,63918,542,52076,388,11842,154,56796,407,395948,1502,452744,1909,2,722,221,4416,319,58780,10,1675,777,"Knox County",470313,965.739837087216,0.221277896667686,405.899900704425,115.242402400104,938.949167894572,22.1277896667686
2021-09-03,63376,334,51688,238,11688,96,56389,249,394446,909,450835,1158,5,720,-155,4195,484,58461,8,1665,773,"Knox County",470313,818.391156527674,0.215835446604677,246.219007341919,71.0165357963739,891.959184628109,21.5835446604677
2021-09-02,63042,323,51450,181,11592,142,56140,200,393537,681,449677,881,3,715,-160,4350,480,57977,5,1657,768,"Knox County",470313,821.367897549079,0.217495253498348,187.322059989837,68.6776678509843,924.915960222235,21.7495253498348
2021-09-01,62719,276,51269,212,11450,64,55940,226,392856,645,448796,871,3,712,-120,4510,393,57497,2,1652,765,"Knox County",470313,818.391156527674,0.219136022848983,185.195816403119,58.6843229934108,958.93585760972,21.9136022848982
2021-08-31,62443,595,51057,434,11386,161,55714,479,392211,1894,447925,2373,2,709,190,4630,403,57104,9,1650,762,"Knox County",470313,856.876165447266,0.214541357370095,504.55760312813,126.511493409708,984.450780650333,21.4541357370095
2021-08-30,61848,513,50623,403,11225,110,55235,430,390317,1630,445552,2060,9,707,97,4440,407,56701,12,1641,758,"Knox County",470313,755.241722002156,0.215776198119697,438.006178863863,109.076295998622,944.052152502695,21.5776198119697
2021-08-29,61335,483,50220,407,11115,76,54805,439,388687,1485,443492,1924,1,698,251,4343,231,56294,5,1629,752,"Knox County",470313,651.906283687672,0.217430207587688,409.089266084501,102.697565238469,923.427589711533,21.7430207587688
2021-08-28,60852,397,49813,301,11039,96,54366,320,387202,1065,441568,1385,0,697,189,4092,208,56063,4,1624,745,"Knox County",470313,621.075751680264,0.219958693203154,294.484736760413,84.4118703926959,870.058875684916,21.9958693203154
2021-08-27,60455,473,49512,375,10943,98,54046,390,386137,1166,440183,1556,5,697,198,3903,270,55855,5,1620,742,"Knox County",470313,650.630537535641,0.224796380090498,330.843502093287,100.571321651751,829.87287189595,22.4796380090498
2021-08-26,59982,450,49137,347,10845,103,53656,367,384971,1426,438627,1793,5,692,155,3705,290,55585,0,1615,741,"Knox County",470313,677.633831086957,0.221618458451764,381.235475098498,95.6809614023002,787.773248878938,22.1618458451764
2021-08-25,59532,351,48790,225,10742,126,53289,237,383545,642,436834,879,2,687,90,3550,259,55295,4,1615,736,"Knox County",470313,693.58065798734,0.222389306599833,186.896811272493,74.6311498937941,754.816473284812,22.2389306599833
2021-08-24,59181,342,48565,222,10616,120,53052,235,382903,677,435955,912,4,685,75,3460,263,55036,5,1611,726,"Knox County",470313,639.78669524338,0.230088495575221,193.913415108662,72.7175306657481,735.680281004352,23.0088495575221
2021-08-23,58839,287,48343,206,10496,81,52817,227,382226,825,435043,1052,1,681,30,3385,256,54773,1,1606,726,"Knox County",470313,591.733590183559,0.233133354383749,223.680825322711,61.0231909388003,719.733454103969,23.3133354383749
2021-08-22,58552,240,48137,217,10415,23,52590,233,381401,889,433991,1122,2,680,69,3355,169,54517,0,1605,722,"Knox County",470313,540.065871026316,0.230946085756984,238.564530429735,51.0298460812268,713.354723343816,23.0946085756984
2021-08-21,58312,498,47920,376,10392,122,52357,412,380512,1904,432869,2316,0,678,383,3286,115,54348,8,1605,720,"Knox County",470313,561.540931252166,0.218172377985462,492.438014683838,105.886930618546,698.683642595463,21.8172377985462
2021-08-20,57814,425,47544,331,10270,94,51945,357,378608,1148,430553,1505,0,678,229,2903,196,54233,6,1597,717,"Knox County",470313,551.334962035921,0.215888923687232,319.999659801026,90.3653524355057,617.248513224172,21.5888923687232
2021-08-19,57389,367,47213,254,10176,113,51588,264,377460,952,429048,1216,1,678,202,2674,164,54037,6,1591,714,"Knox County",470313,533.687140266163,0.218284825594312,258.551220144882,78.0331396325426,568.557535088335,21.8284825594312
2021-08-18,57022,263,46959,191,10063,72,51324,200,376508,914,427832,1114,2,677,97,2472,164,53873,5,1585,714,"Knox County",470313,514.976196703047,0.208725776767349,236.863535560361,55.9202063306777,525.607414636636,20.8725776767349
2021-08-17,56759,263,46768,181,9991,82,51124,197,375594,1042,426718,1239,0,675,100,2375,163,53709,5,1580,714,"Knox County",470313,498.178872367976,0.197616060225847,263.441580394333,55.9202063306777,504.982851845473,19.7616060225847
2021-08-16,56496,185,46587,127,9909,58,50927,132,374552,422,425479,554,2,675,-26,2275,209,53546,5,1575,711,"Knox County",470313,476.491187783455,0.197992499448489,117.793894704165,39.335506354279,483.720415978295,19.7992499448489
2021-08-15,56311,204,46460,181,9851,23,50795,198,374130,953,424925,1151,3,673,81,2301,120,53337,6,1570,711,"Knox County",470313,468.836710871271,0.193512919186366,244.730636831217,43.3753691690427,489.248649303762,19.3512919186366
2021-08-14,56107,219,46279,147,9828,72,50597,154,373177,794,423774,948,0,670,96,2220,123,53217,4,1564,710,"Knox County",470313,409.514514801845,0.194383331176394,201.567892020846,46.5647345491194,472.026076251347,19.4383331176394
2021-08-13,55888,266,46132,206,9756,60,50443,219,372383,1470,422826,1689,1,670,124,2124,141,53094,5,1560,708,"Knox County",470313,375.707241773032,0.172418151940336,359.122541796633,56.558079406693,451.614137818857,17.2418151940336
2021-08-12,55622,222,45926,146,9696,76,50224,152,370913,643,421137,795,2,669,82,2000,138,52953,8,1555,705,"Knox County",470313,344.876709765624,0.167156208277704,169.036365144064,47.2026076251348,425.248717343556,16.7156208277704
2021-08-11,55400,315,45780,237,9620,78,50072,248,370270,989,420342,1237,1,667,182,1918,132,52815,10,1547,703,"Knox County",470313,355.933176416557,0.170760541179561,263.01633167699,66.9766729816101,407.813519932471,17.0760541179561
2021-08-10,55085,173,45543,110,9542,63,49824,121,369281,621,419105,742,1,666,56,1736,116,52683,2,1537,700,"Knox County",470313,336.796984136097,0.172006745362563,157.767274134459,36.7840140502176,369.115886654207,17.2006745362563
2021-08-09,54912,197,45433,159,9479,38,49703,167,368660,753,418363,920,1,665,75,1680,121,52567,4,1535,696,"Knox County",470313,339.348476440158,0.168270515904838,195.614409978036,41.8869986583403,357.208922568587,16.8270515904838
2021-08-08,54715,88,45274,66,9441,22,49536,75,367907,418,417443,493,1,664,22,1605,65,52446,4,1531,695,"Knox County",470313,314.684050834232,0.166471277842907,104.823808825187,18.7109435631165,341.262095668204,16.6471277842907
2021-08-07,54627,105,45208,76,9419,29,49461,80,367489,638,416950,718,0,663,44,1583,61,52381,2,1527,695,"Knox County",470313,290.444873945649,0.16105550500455,152.664289526337,22.3255576605367,336.584359777425,16.105550500455
2021-08-06,54522,203,45132,147,9390,56,49381,163,366851,879,416232,1042,0,663,139,1539,64,52320,11,1525,695,"Knox County",470313,277.049539349327,0.169160921473012,221.554581735993,43.162744810371,327.228887995867,16.9160921473012
2021-08-05,54319,174,44985,131,9334,43,49218,147,365972,850,415190,997,2,663,102,1400,70,52256,4,1514,694,"Knox County",470313,266.843570133082,0.162790697674419,211.986485595763,36.9966384088894,297.674102140489,16.2790697674419
2021-08-04,54145,144,44854,101,9291,43,49071,104,365122,656,414193,760,1,661,69,1298,74,52186,4,1510,692,"Knox County",470313,230.484804800208,0.151093088857546,161.594512590551,30.6179076487361,275.986417555968,15.1093088857546
2021-08-03,54001,238,44753,177,9248,61,48967,183,364466,814,413433,997,0,660,161,1229,77,52112,5,1506,691,"Knox County",470313,244.305388113873,0.155053146617176,211.986485595763,50.6045973638832,261.315336807615,15.5053146617176
2021-08-02,53763,97,44576,75,9187,22,48784,82,363652,532,412436,614,2,660,-3,1068,98,52035,3,1501,688,"Knox County",470313,223.042952246695,0.148372175769436,130.551356224472,20.6245627911625,227.082815061459,14.8372175769436
2021-08-01,53666,106,44501,90,9165,16,48702,99,363120,526,411822,625,0,658,62,1071,44,51937,2,1498,688,"Knox County",470313,226.870190702787,0.149139579349904,132.890224169861,22.5381820192085,227.720688137474,14.9139579349904
2021-07-31,53560,104,44411,64,9149,40,48603,68,362594,399,411197,467,1,658,46,1009,57,51893,6,1496,686,"Knox County",470313,226.657566344116,0.153762268266085,99.2955754997204,22.1129333018649,214.537977899824,15.3762268266085
2021-07-30,53456,118,44347,83,9109,35,48535,90,362195,339,410730,429,1,657,79,963,38,51836,0,1490,686,"Knox County",470313,208.584495857014,0.158110042953569,91.2158498701928,25.0896743232698,204.757257400922,15.8110042953569
2021-07-29,53338,117,44264,65,9074,52,48445,68,361856,483,410301,551,0,656,82,884,35,51798,1,1490,685,"Knox County",470313,196.464907412723,0.156200765248706,117.15602162815,24.877049964598,187.959933065852,15.6200765248706
2021-07-28,53221,131,44199,90,9022,41,48377,95,361373,536,409750,631,0,656,80,802,51,51763,4,1489,684,"Knox County",470313,193.70079074999,0.15878535002318,134.165970321892,27.8537909860029,170.524735654766,15.878535002318
2021-07-27,53090,117,44109,78,8981,39,48282,84,360837,499,409119,583,0,656,85,722,32,51712,4,1485,684,"Knox County",470313,167.973243350705,0.15025641025641,123.960001105647,24.877049964598,153.514786961024,15.025641025641
2021-07-26,52973,97,44031,73,8942,24,48198,79,360338,371,408536,450,1,656,61,637,35,51680,4,1481,684,"Knox County",470313,167.973243350705,0.156049250535332,95.6809614023002,20.6245627911625,135.441716473923,15.6049250535332
2021-07-25,52876,51,43958,43,8918,8,48119,44,359967,320,408086,364,3,655,22,576,26,51645,5,1477,684,"Knox County",470313,156.278903623757,0.151942446043165,77.3952665565272,10.8438422922607,122.471630594944,15.1942446043165
2021-07-24,52825,64,43915,43,8910,21,48075,44,359647,348,407722,392,0,652,39,554,25,51619,1,1472,683,"Knox County",470313,147.773929276886,0.148235294117647,83.348748599337,13.6079589549938,117.793894704165,14.8235294117647
2021-07-23,52761,56,43872,31,8889,25,48031,32,359299,321,407330,353,1,652,24,515,31,51594,3,1471,681,"Knox County",470313,134.591219039236,0.134175691937425,75.0563986111377,11.9069640856196,109.501544715966,13.4175691937425
2021-07-22,52705,94,43841,69,8864,25,47999,78,358978,474,406977,552,0,651,70,491,24,51563,3,1468,680,"Knox County",470313,129.700858789785,0.137142857142857,117.368645986822,19.9866897151471,104.398560107843,13.7142857142857
2021-07-21,52611,61,43772,47,8839,14,47921,46,358504,411,406425,457,1,651,33,421,27,51539,1,1465,680,"Knox County",470313,114.81715368276,0.129165344335132,97.1693319130026,12.9700858789785,89.5148550008186,12.9165344335132
2021-07-20,52550,78,43725,43,8825,35,47875,45,358093,299,405968,344,0,650,54,388,24,51512,3,1464,680,"Knox County",470313,106.524803694561,0.126373626373626,73.1427793830917,16.5846999763987,82.4982511646499,12.6373626373626
2021-07-19,52472,48,43682,36,8790,12,47830,42,357794,348,405624,390,0,650,28,334,20,51488,0,1461,680,"Knox County",470313,96.1062101196437,0.116058906030856,82.9234998819935,10.2059692162454,71.0165357963739,11.6058906030856
2021-07-18,52424,36,43646,30,8778,6,47788,31,357446,272,405234,303,0,650,27,306,9,51468,1,1461,680,"Knox County",470313,92.9168447395671,0.113937656753852,64.4251806775488,7.65447691218401,65.0630537535641,11.3937656753852
2021-07-17,52388,27,43616,20,8772,7,47757,21,357174,202,404931,223,0,650,12,279,15,51459,1,1460,679,"Knox County",470313,85.0497434687113,0.112509534706331,47.4152319838065,5.74085768413801,59.3221960694261,11.2509534706331
2021-07-16,52361,37,43596,21,8765,16,47736,22,356972,291,404708,313,0,650,25,267,12,51444,1,1459,679,"Knox County",470313,81.0098806539475,0.110379550735864,66.5514242642666,7.86710127085579,56.7707037653648,11.0379550735864
2021-07-15,52324,55,43575,42,8749,13,47714,44,356681,364,404395,408,-1,650,36,242,20,51432,1,1458,679,"Knox County",470313,72.7175306657481,0.102953240360952,86.7507383380855,11.6943397269478,51.4550947985703,10.2953240360952
2021-07-14,52269,21,43533,17,8736,4,47670,16,356317,269,403987,285,0,651,8,206,13,51412,2,1457,679,"Knox County",470313,64.212556318877,0.0975286849073257,60.5979422214568,4.46511153210734,43.8006178863863,9.75286849073257
2021-07-13,52248,42,43516,26,8732,16,47654,29,356048,355,403702,384,3,651,28,198,11,51399,3,1455,679,"Knox County",470313,56.558079406693,0.0888985255854293,81.6477537299628,8.93022306421468,42.0996230170121,8.88985255854293
2021-07-12,52206,27,43490,21,8716,6,47625,24,355693,270,403318,294,0,648,16,170,11,51388,1,1452,679,"Knox County",470313,52.0929678745856,0.0846153846153846,62.5115614495028,5.74085768413801,36.1461409742023,8.46153846153846
2021-07-11,52179,8,43469,3,8710,5,47601,4,355423,136,403024,140,0,648,1,154,7,51377,0,1451,678,"Knox County",470313,46.1394858317759,0.0781631656082071,29.7674102140489,1.70099486937423,32.7441512354538,7.81631656082071
2021-07-10,52171,20,43466,16,8705,4,47597,16,355287,191,402884,207,0,648,12,153,8,51370,2,1451,678,"Knox County",470313,44.6511153210734,0.0763170851797144,44.0132422450581,4.25248717343556,32.5315268767821,7.63170851797144
2021-07-09,52151,27,43450,21,8701,6,47581,21,355096,338,402677,359,0,648,12,141,15,51362,0,1449,678,"Knox County",470313,42.5248717343556,0.0741454020221473,76.3321447631684,5.74085768413801,29.9800345727207,7.41454020221473
2021-07-08,52124,19,43429,14,8695,5,47560,16,354758,317,402318,333,0,648,6,129,13,51347,0,1449,677,"Knox County",470313,34.8703948221716,0.0629370629370629,70.8039114377021,4.03986281476378,27.4285422686594,6.29370629370629
2021-07-07,52105,18,43415,5,8690,13,47544,5,354441,333,401985,338,1,648,8,123,9,51334,1,1449,675,"Knox County",470313,34.2325217461563,0.0559610705596107,71.867033231061,3.82723845609201,26.1527961166287,5.59610705596107
2021-07-06,52087,24,43410,9,8677,15,47539,14,354108,263,401647,277,0,647,14,115,10,51325,2,1448,675,"Knox County",470313,30.4052832900643,0.0513347022587269,58.8969473520825,5.10298460812268,24.4518012472545,5.13347022587269
2021-07-05,52063,10,43401,7,8662,3,47525,6,353845,105,401370,111,0,647,0,101,10,51315,1,1446,675,"Knox County",470313,26.790669192644,0.0464589235127479,23.6013038125674,2.12624358671778,21.4750602258496,4.64589235127479
2021-07-04,52053,8,43394,7,8659,1,47519,7,353740,143,401259,150,0,647,0,101,8,51305,1,1445,675,"Knox County",470313,26.790669192644,0.047887323943662,31.8936538007667,1.70099486937423,21.4750602258496,4.7887323943662
2021-07-03,52045,9,43387,7,8658,2,47512,7,353597,185,401109,192,0,647,-2,101,11,51297,1,1444,675,"Knox County",470313,24.4518012472545,0.0431818181818182,40.8238768649814,1.913619228046,21.4750602258496,4.31818181818182
2021-07-02,52036,17,43380,13,8656,4,47505,17,353412,342,400917,359,-1,647,11,103,7,51286,0,1443,675,"Knox County",470313,22.3255576605367,0.0409090909090909,76.3321447631684,3.61461409742023,21.9003089431931,4.09090909090909
2021-07-01,52019,18,43367,15,8652,3,47488,17,353070,248,400558,265,-1,648,13,92,6,51279,1,1443,675,"Knox County",470313,22.1129333018649,0.0431442080378251,56.3454550480212,3.82723845609201,19.5614409978036,4.31442080378251
2021-06-30,52001,18,43352,12,8649,6,47471,11,352822,299,400293,310,0,649,9,79,9,51273,0,1442,675,"Knox County",470313,22.1129333018649,0.0474759615384615,65.9135511882512,3.82723845609201,16.7973243350705,4.74759615384615
2021-06-29,51983,21,43340,16,8643,5,47460,19,352523,438,399983,457,0,649,8,70,13,51264,1,1442,675,"Knox County",470313,21.4750602258496,0.0455531453362256,97.1693319130026,4.46511153210734,14.8837051070245,4.55531453362256
2021-06-28,51962,9,43324,2,8638,7,47441,2,352085,113,399526,115,0,649,-4,62,13,51251,0,1441,675,"Knox County",470313,21.2624358671778,0.0432900432900433,24.4518012472545,1.913619228046,13.1827102376502,4.32900432900433
2021-06-27,51953,5,43322,3,8631,2,47439,3,351972,151,399411,154,0,649,0,66,5,51238,0,1441,675,"Knox County",470313,20.6245627911625,0.041036717062635,32.7441512354538,1.06312179335889,14.0332076723374,4.1036717062635
2021-06-26,51948,3,43319,2,8629,1,47436,2,351821,206,399257,208,0,649,0,66,3,51233,0,1441,675,"Knox County",470313,19.3488166391318,0.0380085653104925,44.2258666037299,0.637873076015334,14.0332076723374,3.80085653104925
2021-06-25,51945,13,43317,9,8628,4,47434,11,351615,311,399049,322,0,649,4,66,9,51230,0,1441,675,"Knox County",470313,18.4983192044447,0.0354997269251775,68.4650434923126,2.76411666273312,14.0332076723374,3.54997269251775
2021-06-24,51932,14,43308,9,8624,5,47423,10,351304,364,398727,374,1,649,8,62,5,51221,1,1441,675,"Knox County",470313,17.6478217697576,0.0298969072164948,79.521510143245,2.97674102140489,13.1827102376502,2.98969072164948
2021-06-23,51918,13,43299,6,8619,7,47413,8,350940,282,398353,290,0,648,6,54,7,51216,0,1440,674,"Knox County",470313,16.5846999763987,0.0286458333333333,61.6610640148157,2.76411666273312,11.481715368276,2.86458333333333
2021-06-22,51905,14,43293,5,8612,9,47405,5,350658,247,398063,252,2,648,10,48,2,51209,1,1440,673,"Knox County",470313,15.0963294656962,0.0239067055393586,53.5813383852881,2.97674102140489,10.2059692162454,2.39067055393586
2021-06-21,51891,9,43288,8,8603,1,47400,9,350411,289,397811,298,0,646,5,38,4,51207,1,1439,672,"Knox County",470313,15.0963294656962,0.0252897787144362,63.3620588841899,1.913619228046,8.07972562952757,2.52897787144363
2021-06-20,51882,3,43280,2,8602,1,47391,3,350122,161,397513,164,1,646,-2,33,4,51203,0,1438,672,"Knox County",470313,14.6710807483527,0.0251572327044025,34.8703948221716,0.637873076015334,7.01660383616868,2.51572327044025
2021-06-19,51879,3,43278,1,8601,2,47388,1,349961,191,397349,192,0,645,-3,35,6,51199,0,1438,672,"Knox County",470313,14.6710807483527,0.0248414376321353,40.8238768649814,0.637873076015334,7.44185255351224,2.48414376321353
2021-06-18,51876,5,43277,3,8599,2,47387,3,349770,283,397157,286,1,645,-7,38,11,51193,0,1438,672,"Knox County",470313,12.9700858789785,0.0210129310344828,60.8105665801286,1.06312179335889,8.07972562952757,2.10129310344828
2021-06-17,51871,12,43274,8,8597,4,47384,9,349487,515,396871,524,0,644,6,45,6,51182,0,1438,672,"Knox County",470313,12.5448371616349,0.0189431704885344,111.415163944012,2.55149230406134,9.56809614023002,1.89431704885344
2021-06-16,51859,7,43266,4,8593,3,47375,4,348972,362,396347,366,1,644,-6,39,12,51176,0,1438,671,"Knox County",470313,11.2690910096042,0.0163304514889529,77.8205152738708,1.48837051070245,8.29234998819935,1.63304514889529
2021-06-15,51852,13,43262,9,8590,4,47371,14,348610,428,395981,442,0,643,-2,45,15,51164,0,1438,671,"Knox County",470313,11.0564666509325,0.0189260563380282,93.9799665329259,2.76411666273312,9.56809614023002,1.89260563380282
2021-06-14,51839,7,43253,2,8586,5,47357,3,348182,260,395539,263,1,643,-5,47,11,51149,0,1438,671,"Knox County",470313,10.6312179335889,0.0165400089405454,55.9202063306777,1.48837051070245,9.99334485757357,1.65400089405454
2021-06-13,51832,3,43251,3,8581,0,47354,4,347922,128,395276,132,0,642,-5,52,8,51138,1,1438,671,"Knox County",470313,10.6312179335889,0.0172335600907029,28.0664153446747,0.637873076015334,11.0564666509325,1.72335600907029
2021-06-12,51829,2,43248,1,8581,1,47350,1,347794,226,395144,227,0,642,-6,57,8,51130,0,1437,671,"Knox County",470313,10.4185935749171,0.0169642857142857,48.2657294184936,0.425248717343556,12.1195884442914,1.69642857142857
2021-06-11,51827,7,43247,3,8580,4,47349,2,347568,318,394917,320,0,642,-2,63,9,51122,0,1437,670,"Knox County",470313,10.8438422922607,0.0162708883025506,68.039794774969,1.48837051070245,13.395334596322,1.62708883025506
2021-06-10,51820,7,43244,4,8576,3,47347,5,347250,358,394597,363,0,642,-1,65,8,51113,0,1437,669,"Knox County",470313,9.7807204989018,0.0156176053005206,77.1826421978555,1.48837051070245,13.8205833136656,1.56176053005206
2021-06-09,51813,2,43240,1,8573,1,47342,1,346892,367,394234,368,1,642,-17,66,18,51105,0,1437,669,"Knox County",470313,8.7175987055429,0.0141843971631206,78.2457639912144,0.425248717343556,14.0332076723374,1.41843971631206
2021-06-08,51811,5,43239,3,8572,2,47341,4,346525,266,393866,270,1,641,-17,83,21,51087,0,1437,668,"Knox County",470313,7.01660383616868,0.0102933607822954,57.4085768413801,1.06312179335889,17.6478217697576,1.02933607822954
2021-06-07,51806,16,43236,10,8570,6,47337,10,346259,316,393596,326,0,640,-7,100,23,51066,2,1437,667,"Knox County",470313,8.93022306421468,0.0134596211365902,69.3155409269997,3.40198973874845,21.2624358671778,1.34596211365902
2021-06-06,51790,4,43226,2,8564,2,47327,2,345943,178,393270,180,0,640,-5,107,9,51043,0,1435,667,"Knox County",470313,9.14284742288646,0.0121713729308666,38.2723845609201,0.850497434687113,22.7508063778803,1.21713729308666
2021-06-05,51786,5,43224,2,8562,3,47325,3,345765,258,393090,261,0,640,-9,112,14,51034,0,1435,666,"Knox County",470313,9.7807204989018,0.0129310344827586,55.4949576133341,1.06312179335889,23.8139281712392,1.29310344827586
2021-06-04,51781,7,43222,2,8559,5,47322,3,345507,325,392829,328,1,640,-9,121,15,51020,0,1435,666,"Knox County",470313,9.7807204989018,0.0133587786259542,69.7407896443432,1.48837051070245,25.7275473992852,1.33587786259542
2021-06-03,51774,7,43220,4,8554,3,47319,6,345182,458,392501,464,0,639,-12,130,19,51005,0,1435,666,"Knox County",470313,9.7807204989018,0.0131998179335457,98.6577024237051,1.48837051070245,27.6411666273312,1.31998179335457
2021-06-02,51767,20,43216,7,8551,13,47313,6,344724,282,392037,288,0,639,5,142,15,50986,1,1435,666,"Knox County",470313,13.6079589549938,0.0160604629192253,61.2358152974721,4.25248717343556,30.1926589313925,1.60604629192253
2021-06-01,51747,12,43209,9,8538,3,47307,10,344442,291,391749,301,0,639,-10,137,22,50971,1,1434,666,"Knox County",470313,15.0963294656962,0.0186219739292365,63.9999319602052,2.55149230406134,29.1295371380336,1.86219739292365
2021-05-31,51735,17,43200,14,8535,3,47297,12,344151,354,391448,366,0,639,-1,147,18,50949,0,1433,666,"Knox County",470313,15.308953824368,0.0191956124314442,77.8205152738708,3.61461409742023,31.2557807247514,1.91956124314442
2021-05-30,51718,3,43186,1,8532,2,47285,1,343797,203,391082,204,0,639,-9,148,12,50931,0,1433,666,"Knox County",470313,15.0963294656962,0.0185352622061483,43.3753691690427,0.637873076015334,31.4684050834232,1.85352622061483
2021-05-29,51715,14,43185,8,8530,6,47284,6,343594,199,390878,205,0,639,-14,157,28,50919,1,1433,665,"Knox County",470313,17.0099486937423,0.0204081632653061,43.5879935277145,2.97674102140489,33.3820243114692,2.04081632653061
2021-05-28,51701,11,43177,6,8524,5,47278,10,343395,390,390673,400,0,639,-9,171,20,50891,1,1432,663,"Knox County",470313,17.8604461284294,0.0228904847396768,85.0497434687113,2.33886794538956,36.3587653328741,2.28904847396768
2021-05-27,51690,23,43171,8,8519,15,47268,9,343005,341,390273,350,0,639,-5,180,28,50871,1,1431,663,"Knox County",470313,21.2624358671778,0.0255439924314096,74.4185255351224,4.8903602494509,38.2723845609201,2.55439924314096
2021-05-26,51667,16,43163,8,8504,8,47259,11,342664,571,389923,582,0,639,-8,185,24,50843,0,1430,663,"Knox County",470313,20.4119384324907,0.0245016611295681,123.747376746975,3.40198973874845,39.335506354279,2.45016611295681
2021-05-25,51651,18,43155,8,8496,10,47248,7,342093,311,389341,318,0,639,-10,193,28,50819,1,1430,663,"Knox County",470313,21.6876845845214,0.0230927835051546,67.6145460576254,3.82723845609201,41.0365012236532,2.30927835051546
2021-05-24,51633,25,43147,21,8486,4,47241,24,341782,425,389023,449,0,639,-11,203,36,50791,1,1429,663,"Knox County",470313,23.3886794538956,0.0271132376395534,95.4683370436284,5.31560896679445,43.162744810371,2.71132376395534
2021-05-23,51608,16,43126,8,8482,8,47217,8,341357,225,388574,233,1,639,-5,214,20,50755,1,1428,662,"Knox County",470313,26.1527961166287,0.0295624753646039,49.5414755705243,3.40198973874845,45.5016127557605,2.95624753646039
2021-05-22,51592,8,43118,4,8474,4,47209,4,341132,269,388341,273,0,638,-6,219,14,50735,0,1427,661,"Knox County",470313,24.877049964598,0.0280230326295585,58.0464499173954,1.70099486937423,46.5647345491194,2.80230326295585
2021-05-21,51584,16,43114,12,8470,4,47205,14,340863,377,388068,391,0,638,-16,225,32,50721,1,1427,661,"Knox County",470313,25.9401717579569,0.0296610169491525,83.1361242406653,3.40198973874845,47.8404807011501,2.96610169491525
2021-05-20,51568,34,43102,26,8466,8,47191,27,340486,594,387677,621,0,638,6,241,28,50689,1,1426,660,"Knox County",470313,28.2790397033465,0.0331356818974538,132.039726735174,7.22922819484046,51.2424704398985,3.31356818974538
2021-05-19,51534,14,43076,6,8458,8,47164,6,339892,544,387056,550,0,638,-29,235,43,50661,1,1425,659,"Knox County",470313,27.8537909860029,0.0317460317460317,116.943397269478,2.97674102140489,49.9667242878679,3.17460317460317
2021-05-18,51520,24,43070,14,8450,10,47158,14,339348,444,386506,458,1,638,-21,264,44,50618,0,1424,659,"Knox County",470313,29.1295371380336,0.0326050420168067,97.3819562716744,5.10298460812268,56.1328306893494,3.26050420168067
2021-05-17,51496,15,43056,8,8440,7,47144,8,338904,420,386048,428,0,637,-18,285,33,50574,0,1424,658,"Knox County",470313,27.0032935513158,0.0274204468517265,91.0032255115211,3.18936538007667,60.5979422214568,2.74204468517265
2021-05-16,51481,22,43048,13,8433,9,47136,12,338484,272,385620,284,1,637,-10,303,31,50541,1,1424,658,"Knox County",470313,28.2790397033465,0.0282861896838602,60.385317862785,4.67773589077912,64.4251806775488,2.82861896838602
2021-05-15,51459,23,43035,13,8424,10,47124,17,338212,336,385336,353,0,636,-8,313,31,50510,2,1423,657,"Knox County",470313,31.4684050834232,0.0317666126418152,75.0563986111377,4.8903602494509,66.5514242642666,3.17666126418152
2021-05-14,51436,36,43022,25,8414,11,47107,26,337876,498,384983,524,0,636,4,321,32,50479,4,1421,656,"Knox County",470313,35.7208922568587,0.0341827221876942,111.415163944012,7.65447691218401,68.2524191336408,3.41827221876942
2021-05-13,51400,31,42997,17,8403,14,47081,17,337378,376,384459,393,0,636,-17,317,48,50447,0,1417,656,"Knox County",470313,35.0830191808434,0.0334448160535117,83.5613729580088,6.59135511882512,67.4019216989537,3.34448160535117
2021-05-12,51369,34,42980,28,8389,6,47064,26,337002,506,384066,532,0,636,-15,334,49,50399,0,1417,656,"Knox County",470313,39.335506354279,0.0403768506056528,113.116158813386,7.22922819484046,71.0165357963739,4.03768506056528
2021-05-11,51335,36,42952,30,8383,6,47038,31,336496,555,383534,586,0,636,-11,349,47,50350,4,1417,656,"Knox County",470313,41.8869986583403,0.0441935483870968,124.597874181662,7.65447691218401,74.2059011764506,4.41935483870968
2021-05-10,51299,21,42922,14,8377,7,47007,13,335941,277,382948,290,1,636,-26,360,46,50303,1,1413,656,"Knox County",470313,43.162744810371,0.0479405806887238,61.6610640148157,4.46511153210734,76.5447691218401,4.79405806887238
2021-05-09,51278,17,42908,14,8370,3,46994,17,335664,369,382658,386,0,635,-22,386,39,50257,1,1412,655,"Knox County",470313,42.0996230170121,0.047976501305483,82.0730024473064,3.61461409742023,82.0730024473064,4.7976501305483
2021-05-08,51261,20,42894,11,8367,9,46977,14,335295,307,382272,321,0,635,-18,408,38,50218,1,1411,655,"Knox County",470313,41.4617499409967,0.0474934036939314,68.2524191336408,4.25248717343556,86.7507383380855,4.74934036939314
2021-05-07,51241,43,42883,31,8358,12,46963,33,334988,576,381951,609,0,635,3,426,40,50180,0,1410,655,"Knox County",470313,42.9501204516992,0.0484440166827077,129.488234431113,9.14284742288646,90.5779767941775,4.84440166827077
2021-05-06,51198,40,42852,26,8346,14,46930,28,334412,340,381342,368,1,635,-8,423,47,50140,0,1410,655,"Knox County",470313,44.8637396797452,0.0523932729624838,78.2457639912144,8.50497434687113,89.9401037181622,5.23932729624838
2021-05-05,51158,51,42826,32,8332,19,46902,38,334072,585,380974,623,0,634,5,431,46,50093,4,1410,654,"Knox County",470313,48.4783537771654,0.0546654099905749,132.464975452518,10.8438422922607,91.6410985875364,5.46654099905749
2021-05-04,51107,50,42794,32,8313,18,46864,34,333487,536,380351,570,0,634,6,426,44,50047,0,1406,654,"Knox County",470313,51.4550947985703,0.0558888538048626,121.195884442914,10.6312179335889,90.5779767941775,5.58888538048626
2021-05-03,51057,24,42762,9,8295,15,46830,7,332951,309,379781,316,1,634,-37,420,60,50003,1,1406,654,"Knox County",470313,52.0929678745856,0.053554650798622,67.1892973402819,5.10298460812268,89.3022306421468,5.3554650798622
2021-05-02,51033,25,42753,18,8280,7,46823,20,332642,288,379465,308,0,633,-17,457,42,49943,2,1405,653,"Knox County",470313,53.7939627439599,0.0558587479935795,65.4883024709077,5.31560896679445,97.1693319130026,5.58587479935795
2021-05-01,51008,45,42735,35,8273,10,46803,38,332354,450,379157,488,0,633,7,474,38,49901,2,1403,653,"Knox County",470313,59.1095717107543,0.0603290676416819,103.760687031828,9.56809614023002,100.783946010423,6.03290676416819
2021-04-30,50963,58,42700,30,8263,28,46765,29,331904,567,378669,596,0,633,-9,467,67,49863,3,1401,653,"Knox County",470313,62.298937090831,0.0593453655552157,126.72411776838,12.3322128029631,99.2955754997204,5.93453655552157
2021-04-29,50905,54,42670,34,8235,20,46736,35,331337,571,378073,606,0,633,-2,476,56,49796,2,1398,652,"Knox County",470313,65.2756781122359,0.0573139435414885,128.850361355098,11.481715368276,101.209194727766,5.73139435414885
2021-04-28,50851,47,42636,28,8215,19,46701,34,330766,543,377467,577,4,633,-38,478,81,49740,1,1396,652,"Knox County",470313,64.4251806775488,0.0569199653279399,122.684254953616,9.99334485757357,101.63444344511,5.69199653279399
2021-04-27,50804,39,42608,17,8196,22,46667,20,330223,392,376890,412,1,629,-33,516,71,49659,2,1395,650,"Knox County",470313,62.0863127321592,0.0554041780199818,87.6012357727726,8.29234998819935,109.714169074638,5.54041780199818
2021-04-26,50765,69,42591,36,8174,33,46647,40,329831,480,376478,520,1,628,2,549,66,49588,0,1393,649,"Knox County",470313,71.6544088723892,0.0615911035072712,110.564666509325,14.6710807483527,116.730772910806,6.15911035072712
2021-04-25,50696,38,42555,25,8141,13,46607,26,329351,341,375958,367,0,627,-4,547,42,49522,3,1393,647,"Knox County",470313,74.4185255351224,0.0622546270330903,78.0331396325426,8.07972562952757,116.305524193463,6.22546270330903
2021-04-24,50658,35,42530,22,8128,13,46581,28,329010,510,375591,538,0,627,-28,551,63,49480,3,1390,647,"Knox County",470313,72.2922819484046,0.0586283185840708,114.391904965417,7.44185255351224,117.15602162815,5.86283185840708
2021-04-23,50623,43,42508,31,8115,12,46553,36,328500,553,375053,589,0,627,-4,579,47,49417,2,1387,646,"Knox County",470313,69.1029165683279,0.0606816292601829,125.235747257677,9.14284742288646,123.10950367096,6.06816292601829
2021-04-22,50580,79,42477,62,8103,17,46517,65,327947,787,374464,852,1,627,15,583,63,49370,1,1385,645,"Knox County",470313,74.4185255351224,0.064591439688716,181.155953588355,16.7973243350705,123.960001105647,6.4591439688716
2021-04-21,50501,62,42415,34,8086,28,46452,35,327160,479,373612,514,1,626,-2,568,63,49307,1,1384,644,"Knox County",470313,77.607890915199,0.0659282700421941,109.288920357294,13.1827102376502,120.77063572557,6.59282700421941
2021-04-20,50439,38,42381,34,8058,4,46417,39,326681,474,373098,513,1,625,-32,570,69,49244,1,1383,643,"Knox County",470313,77.3952665565272,0.0690983817107629,109.076295998622,8.07972562952757,121.195884442914,6.90983817107629
2021-04-19,50401,65,42347,41,8054,24,46378,39,326207,336,372585,375,0,624,-3,602,68,49175,0,1382,642,"Knox County",470313,76.5447691218401,0.0715048025613661,79.7341345019168,13.8205833136656,127.99986392041,7.15048025613661
2021-04-18,50336,38,42306,27,8030,11,46339,32,325871,364,372210,396,0,624,-12,605,50,49107,1,1382,642,"Knox County",470313,76.5447691218401,0.0725443473656341,84.1992460340241,8.07972562952757,128.637736996426,7.25443473656341
2021-04-17,50298,37,42279,18,8019,19,46307,23,325507,335,371814,358,0,624,-23,617,60,49057,1,1381,641,"Knox County",470313,76.9700178391837,0.0747845426744509,76.1195204044966,7.86710127085579,131.189229300487,7.47845426744509
2021-04-16,50261,346,42261,330,8000,16,46284,369,325172,2088,371456,2457,1,624,279,640,66,48997,4,1380,641,"Knox County",470313,141.395198516732,0.110155535224154,522.418049256559,73.5680281004352,136.079589549938,11.0155535224154
2021-04-15,49915,86,41931,54,7984,32,45915,55,323084,577,368999,632,1,623,12,361,73,48931,0,1376,640,"Knox County",470313,142.883569027435,0.112869399428027,134.378594680564,18.2856948457729,76.7573934805119,11.2869399428027
2021-04-14,49829,85,41877,60,7952,25,45860,62,322507,684,368367,746,0,622,-1,349,86,48858,3,1376,639,"Knox County",470313,147.773929276886,0.113018075588826,158.617771569146,18.0730704871011,74.2059011764506,11.3018075588826
2021-04-13,49744,68,41817,38,7927,30,45798,43,321823,339,367621,382,-5,622,-8,350,81,48772,1,1373,639,"Knox County",470313,154.152660037039,0.116535727646839,81.2225050126193,14.4584563896809,74.4185255351224,11.6535727646839
2021-04-12,49676,63,41779,43,7897,20,45755,50,321484,360,367239,410,1,627,-24,358,86,48691,0,1372,639,"Knox County",470313,153.727411319696,0.11782196617729,87.175987055429,13.395334596322,76.1195204044966,11.782196617729
2021-04-11,49613,26,41736,14,7877,12,45705,14,321124,296,366829,310,2,626,-26,382,50,48605,0,1372,638,"Knox County",470313,151.175919015634,0.116336166194523,65.9135511882512,5.52823332546623,81.2225050126193,11.6336166194523
2021-04-10,49587,50,41722,33,7865,17,45691,41,320828,571,366519,612,0,624,6,408,44,48555,1,1372,638,"Knox County",470313,153.940035678367,0.114254820688412,130.126107507128,10.6312179335889,86.7507383380855,11.4254820688412
2021-04-09,49537,82,41689,62,7848,20,45650,71,320257,620,365907,691,5,624,11,402,66,48511,2,1371,637,"Knox County",470313,97.8072049890179,0.0888183980967486,146.923431842199,17.4351974110858,85.4749921860548,8.88183980967486
2021-04-08,49455,49,41627,26,7828,23,45579,26,319637,465,365216,491,-6,619,-23,391,78,48445,0,1369,637,"Knox County",470313,89.9401037181622,0.0842943437671609,104.398560107843,10.4185935749171,83.1361242406653,8.42943437671609
2021-04-07,49406,77,41601,54,7805,23,45553,57,319172,768,364725,825,2,625,9,414,66,48367,1,1369,636,"Knox County",470313,88.2391088487879,0.0811609782316582,175.415095904217,16.3720756177269,88.0264844901162,8.11609782316582
2021-04-06,49329,75,41547,41,7782,34,45496,45,318404,421,363900,466,2,623,-4,405,77,48301,0,1368,636,"Knox County",470313,89.7274793594904,0.0798948751642576,99.0829511410486,15.9468269003834,86.1128652620702,7.98948751642576
2021-04-05,49254,44,41506,32,7748,12,45451,35,317983,266,363434,301,0,621,-60,409,104,48224,3,1368,636,"Knox County",470313,85.6876165447266,0.0781926406926407,63.9999319602052,9.35547178155824,86.9633626967573,7.81926406926407
2021-04-04,49210,49,41474,31,7736,18,45416,40,317717,341,363133,381,3,621,-27,469,73,48120,0,1365,634,"Knox County",470313,90.5779767941775,0.0836209185027874,81.0098806539475,10.4185935749171,99.7208242170639,8.36209185027874
2021-04-03,49161,81,41443,64,7718,17,45376,71,317376,593,362752,664,0,618,6,496,75,48047,0,1365,633,"Knox County",470313,97.1693319130026,0.0903377847604085,141.182574158061,17.222573052414,105.461681901202,9.03377847604085
2021-04-02,49080,76,41379,45,7701,31,45305,45,316783,529,362088,574,0,618,6,490,70,47972,2,1365,630,"Knox County",470313,95.8935857609719,0.0861696380334954,122.046381877601,16.1594512590551,104.185935749171,8.61696380334954
2021-04-01,49004,75,41334,63,7670,12,45260,67,316254,580,361514,647,1,618,-20,484,94,47902,1,1363,628,"Knox County",470313,101.421819086438,0.0933125972006221,137.56796006064,15.9468269003834,102.910189597141,9.33125972006221
2021-03-31,48929,87,41271,66,7658,21,45193,72,315674,765,360867,837,3,617,-16,504,100,47808,2,1362,628,"Knox County",470313,103.548062673156,0.0968992248062016,177.966588208278,18.4983192044447,107.162676770576,9.68992248062016
2021-03-30,48842,57,41205,33,7637,24,45121,38,314909,460,360030,498,1,614,-25,520,81,47708,2,1360,626,"Knox County",470313,99.7208242170639,0.0943106099436187,105.886930618546,12.1195884442914,110.564666509325,9.43106099436187
2021-03-29,48785,43,41172,21,7613,22,45083,22,314449,399,359532,421,5,613,-58,545,96,47627,0,1358,624,"Knox County",470313,99.5081998583922,0.0882645450024863,89.5148550008186,9.14284742288646,115.880275476119,8.82645450024863
2021-03-28,48742,80,41151,46,7591,34,45061,49,314050,484,359111,533,2,608,13,603,65,47531,5,1358,623,"Knox County",470313,106.099554977217,0.0872065165309056,113.328783172058,17.0099486937423,128.212488279082,8.72065165309056
2021-03-27,48662,42,41105,39,7557,3,45012,42,313566,442,358578,484,0,606,-16,590,58,47466,2,1353,622,"Knox County",470313,97.8072049890179,0.0838758137205809,102.910189597141,8.93022306421468,125.448371616349,8.38758137205809
2021-03-26,48620,79,41066,54,7554,25,44970,60,313124,416,358094,476,0,606,1,606,78,47408,2,1351,620,"Knox County",470313,98.4450780650333,0.0898357289527721,101.209194727766,16.7973243350705,128.850361355098,8.98357289527721
2021-03-25,48541,88,41012,64,7529,24,44910,67,312708,570,357618,637,0,606,6,605,82,47330,4,1349,618,"Knox County",470313,101.209194727766,0.0900669068450849,135.441716473923,18.7109435631165,128.637736996426,9.00669068450849
2021-03-24,48453,123,40948,91,7505,32,44843,95,312138,780,356981,875,1,606,39,599,83,47248,3,1345,617,"Knox County",470313,108.86367163995,0.0950560652395515,186.046313837806,26.1527961166287,127.361990844395,9.50560652395515
2021-03-23,48330,87,40857,57,7473,30,44748,63,311358,530,356106,593,1,605,16,560,70,47165,3,1342,616,"Knox County",470313,115.242402400104,0.0990296093555611,126.086244692364,18.4983192044447,119.069640856196,9.90296093555611
2021-03-22,48243,115,40800,78,7443,37,44685,81,310828,517,355513,598,2,604,31,544,82,47095,1,1339,615,"Knox County",470313,130.551356224472,0.108913250714967,127.149366485723,24.4518012472545,115.667651117447,10.8913250714967
2021-03-21,48128,50,40722,33,7406,17,44604,34,310311,330,354915,364,0,602,4,513,46,47013,1,1338,615,"Knox County",470313,124.172625464318,0.109759125900174,77.3952665565272,10.6312179335889,109.076295998622,10.9759125900174
2021-03-20,48078,59,40689,29,7389,30,44570,33,309981,315,354551,348,0,602,3,509,56,46967,4,1337,614,"Knox County",470313,127.787239561739,0.111282446671807,73.9932768177788,12.5448371616349,108.225798563935,11.1282446671807
2021-03-19,48019,146,40660,102,7359,44,44537,117,309666,955,354203,1072,3,602,51,506,92,46911,3,1333,614,"Knox County",470313,142.033071592748,0.109204368174727,227.933312496146,31.0431563660796,107.58792548792,10.9204368174727
2021-03-18,47873,68,40558,50,7315,18,44420,66,308711,627,353131,693,2,599,-16,455,82,46819,1,1330,613,"Knox County",470313,137.780584419312,0.107638124587277,147.348680559542,14.4584563896809,96.7440831956591,10.7638124587277
2021-03-17,47805,46,40508,36,7297,10,44354,41,308084,498,352438,539,1,597,-40,471,85,46737,3,1329,613,"Knox County",470313,121.408508801585,0.103399096743523,114.604529324088,9.7807204989018,100.146072934408,10.3399096743523
2021-03-16,47759,128,40472,84,7287,44,44313,100,307586,698,351899,798,0,596,47,511,81,46652,3,1326,611,"Knox County",470313,130.126107507128,0.106980961015413,169.674238220079,27.2159179099876,108.651047281279,10.6980961015413
2021-03-15,47631,44,40388,28,7243,16,44213,40,306888,290,351101,330,1,596,-65,464,108,46571,1,1323,610,"Knox County",470313,115.029778041432,0.104005791505792,70.1660383616868,9.35547178155824,98.6577024237051,10.4005791505792
2021-03-14,47587,60,40360,38,7227,22,44173,46,306598,405,350771,451,0,595,-13,529,73,46463,0,1322,609,"Knox County",470313,117.15602162815,0.104703379815646,95.893585760972,12.7574615203067,112.478285737371,10.4703379815646
2021-03-13,47527,71,40322,34,7205,37,44127,41,306193,623,350320,664,1,595,-11,542,81,46390,1,1322,609,"Knox County",470313,119.707513932211,0.0991862766659336,141.182574158061,15.0963294656962,115.242402400104,9.91862766659336
2021-03-12,47456,63,40288,60,7168,3,44086,67,305570,691,349656,758,0,594,-52,553,115,46309,1,1321,607,"Knox County",470313,102.059692162454,0.0947318686510749,161.169263873208,13.395334596322,117.581270345493,9.47318686510749
2021-03-11,47393,83,40228,56,7165,27,44019,66,304879,627,348898,693,2,594,-21,605,102,46194,0,1320,605,"Knox County",470313,105.24905754253,0.0947318686510749,147.348680559542,17.6478217697576,128.637736996426,9.47318686510749
2021-03-10,47310,95,40172,71,7138,24,43953,82,304252,1001,348205,1083,2,592,26,626,67,46092,1,1320,604,"Knox County",470313,115.667651117447,0.0925266903914591,230.272180441536,20.1993140738189,133.102848528533,9.25266903914591
2021-03-09,47215,80,40101,50,7114,30,43871,55,303251,597,347122,652,0,590,-5,600,85,46025,2,1319,604,"Knox County",470313,105.461681901202,0.085726624919024,138.631081853999,17.0099486937423,127.574615203067,8.5726624919024
2021-03-08,47135,85,40051,57,7084,28,43816,63,302654,411,346470,474,1,590,-30,605,114,45940,0,1317,599,"Knox County",470313,114.179280606745,0.0879581151832461,100.783946010423,18.0730704871011,128.637736996426,8.79581151832461
2021-03-07,47050,64,39994,40,7056,24,43753,42,302243,327,345996,369,0,589,-5,635,69,45826,0,1317,597,"Knox County",470313,115.029778041432,0.0886426592797784,78.4583883498861,13.6079589549938,135.016467756579,8.86426592797784
2021-03-06,46986,125,39954,87,7032,38,43711,95,301916,848,345627,943,0,589,40,640,85,45757,1,1317,597,"Knox County",470313,126.511493409708,0.0945293644408689,200.504770227487,26.5780448339723,136.079589549938,9.45293644408689
2021-03-05,46861,70,39867,44,6994,26,43616,49,301068,520,344684,569,2,589,-19,600,87,45672,2,1316,597,"Knox County",470313,127.99986392041,0.0945013589797198,120.983260084242,14.8837051070245,127.574615203067,9.45013589797198
2021-03-04,46791,112,39823,85,6968,27,43567,100,300548,1094,344115,1194,5,587,-1,619,108,45585,1,1314,595,"Knox County",470313,134.165970321892,0.0919757759273278,253.873484254103,23.8139281712392,131.614478017831,9.19757759273278
2021-03-03,46679,74,39738,33,6941,41,43467,40,299454,497,342921,537,1,582,-49,620,122,45477,4,1313,593,"Knox County",470313,129.700858789785,0.0937104263402279,114.179280606745,15.7342025417116,131.827102376502,9.37104263402279
2021-03-02,46605,133,39705,91,6900,42,43427,99,298957,807,342384,906,-1,581,9,669,125,45355,2,1309,592,"Knox County",470313,140.969949799389,0.0977564102564103,192.637668956631,28.2790397033465,142.24569595142,9.77564102564103
2021-03-01,46472,59,39614,33,6858,26,43328,35,298150,165,341478,200,1,582,-58,660,116,45230,1,1307,587,"Knox County",470313,135.441716473923,0.0974989402289105,42.5248717343556,12.5448371616349,140.332076723374,9.74989402289106
2021-02-28,46413,77,39581,53,6832,24,43293,63,297985,563,341278,626,2,581,-18,718,93,45114,2,1306,587,"Knox County",470313,138.205833136656,0.0966834170854271,133.102848528533,16.3720756177269,152.664289526337,9.66834170854271
2021-02-27,46336,82,39528,47,6808,35,43230,58,297422,670,340652,728,1,579,-33,736,114,45021,3,1304,586,"Knox County",470313,129.062985713769,0.0932773109243697,154.790533113054,17.4351974110858,156.491527982429,9.32773109243698
2021-02-26,46254,107,39481,70,6773,37,43172,80,296752,506,339924,586,5,578,-17,769,119,44907,1,1301,585,"Knox County",470313,136.930086984625,0.0994347917102784,124.597874181662,22.7508063778803,163.508131818597,9.94347917102784
2021-02-25,46147,131,39411,92,6736,39,43092,97,296246,1029,339338,1126,2,573,-7,786,136,44788,5,1300,585,"Knox County",470313,140.969949799389,0.100233595243151,239.415027864422,27.8537909860029,167.122745916018,10.0233595243151
2021-02-24,46016,102,39319,72,6697,30,42995,80,295217,969,338212,1049,2,571,-30,793,130,44652,2,1295,584,"Knox County",470313,146.923431842199,0.0980655046925876,223.042952246695,21.6876845845214,168.61111642672,9.80655046925876
2021-02-23,45914,122,39247,68,6667,54,42915,75,294248,758,337163,833,5,569,-32,823,149,44522,6,1293,583,"Knox County",470313,144.584563896809,0.0947940947940948,177.116090773591,25.9401717579569,174.989847186873,9.47940947940948
2021-02-22,45792,62,39179,33,6613,29,42840,38,293490,306,336330,344,3,564,-110,855,169,44373,3,1287,581,"Knox County",470313,145.222436972824,0.0927815570672714,73.1427793830917,13.1827102376502,181.79382666437,9.27815570672714
2021-02-21,45730,82,39146,41,6584,41,42802,45,293184,499,335986,544,2,561,-31,965,111,44204,3,1284,579,"Knox County",470313,146.285558766183,0.0907869481765835,115.667651117447,17.4351974110858,205.182506118266,9.07869481765835
2021-02-20,45648,137,39105,98,6543,39,42757,115,292685,1007,335442,1122,1,559,8,996,128,44093,2,1281,576,"Knox County",470313,157.979898493131,0.0945753033547466,238.564530429735,29.1295371380336,211.773861237091,9.45753033547466
2021-02-19,45511,95,39007,43,6504,52,42642,48,291678,274,334320,322,1,558,-83,988,177,43965,2,1279,575,"Knox County",470313,155.42840618907,0.0932584269662921,68.4650434923126,20.1993140738189,210.072866367717,9.32584269662921
2021-02-18,45416,155,38964,111,6452,44,42594,119,291404,987,333998,1106,4,557,-37,1071,188,43788,6,1277,573,"Knox County",470313,160.531390797193,0.0977443609022556,235.162540690987,32.9567755941256,227.720688137474,9.77443609022556
2021-02-17,45261,114,38853,68,6408,46,42475,76,290417,892,332892,968,1,553,-50,1108,163,43600,4,1271,567,"Knox County",470313,163.082883101254,0.098492078640962,205.820379194281,24.2391768885827,235.58778940833,9.8492078640962
2021-02-16,45147,146,38785,90,6362,56,42399,101,289525,818,331924,919,2,552,-41,1158,185,43437,4,1267,564,"Knox County",470313,168.185867709377,0.101784037558685,195.401785619364,31.0431563660796,246.219007341919,10.1784037558685
2021-02-15,45001,76,38695,36,6306,40,42298,43,288707,312,331005,355,2,550,-140,1199,214,43252,1,1263,564,"Knox County",470313,171.162608730781,0.102511244377811,75.4816473284812,16.1594512590551,254.936606047462,10.2511244377811
2021-02-14,44925,164,38659,134,6266,30,42255,134,288395,706,330650,840,2,548,19,1339,143,43038,5,1262,563,"Knox County",470313,188.597806141867,0.112926136363636,178.604461284294,34.8703948221716,284.704016261511,11.2926136363636
2021-02-13,44761,135,38525,91,6236,44,42121,106,287689,870,329810,976,4,546,-9,1320,140,42895,7,1257,562,"Knox County",470313,188.172557424524,0.114290922347794,207.521374063655,28.7042884206901,280.664153446747,11.4290922347794
2021-02-12,44626,179,38434,114,6192,65,42015,124,286819,995,328834,1119,3,542,12,1329,164,42755,3,1250,558,"Knox County",470313,206.033003552953,0.111889224892567,237.92665735372,38.0597602022483,282.577772674793,11.1889224892567
2021-02-11,44447,162,38320,112,6127,50,41891,118,285824,1133,327715,1251,5,539,-34,1317,191,42591,5,1247,557,"Knox County",470313,207.521374063655,0.109209707529558,265.993072698394,34.4451461048281,280.026280370732,10.9209707529558
2021-02-10,44285,148,38208,106,6077,42,41773,112,284691,1032,326464,1144,7,534,-48,1351,189,42400,6,1242,555,"Knox County",470313,214.750602258496,0.111750454270139,243.242266320514,31.4684050834232,287.255508565572,11.1750454270139
2021-02-09,44137,209,38102,154,6035,55,41661,165,283659,1022,325320,1187,0,527,12,1399,197,42211,6,1236,553,"Knox County",470313,228.145936854818,0.116705471478463,252.385113743401,44.4384909624016,297.461477781818,11.6705471478463
2021-02-08,43928,107,37948,72,5980,35,41496,76,282637,371,324133,447,4,527,-159,1387,262,42014,2,1230,548,"Knox County",470313,234.737291973643,0.119902354968409,95.0430883262848,22.7508063778803,294.909985477756,11.9902354968409
2021-02-07,43821,108,37876,75,5945,33,41420,83,282266,716,323686,799,1,523,-28,1546,135,41752,2,1228,545,"Knox County",470313,222.830327888024,0.11324570273003,169.886862578751,22.963430736552,328.717258506569,11.324570273003
2021-02-06,43713,304,37801,176,5912,128,41337,197,281550,1396,322887,1593,2,522,136,1574,166,41617,6,1226,544,"Knox County",470313,258.763844503554,0.11604774535809,338.710603364143,64.6378050362206,334.670740549379,11.604774535809
2021-02-05,43409,177,37625,131,5784,46,41140,143,280154,727,321294,870,8,520,-5,1438,174,41451,4,1220,540,"Knox County",470313,258.33859578621,0.122616924975998,184.983192044447,37.6345114849047,305.753827770017,12.2616924975998
2021-02-04,43232,199,37494,148,5738,51,40997,161,279427,1581,320424,1742,2,512,-1,1443,198,41277,7,1216,537,"Knox County",470313,266.205697057066,0.120406065278849,370.391632806238,42.3122473756839,306.816949563376,12.0406065278849
2021-02-03,43033,230,37346,165,5687,65,40836,172,277846,1634,318682,1806,5,510,-9,1444,234,41079,7,1209,529,"Knox County",470313,283.640894468152,0.118072003789673,383.999591761231,48.903602494509,307.029573922048,11.8072003789673
2021-02-02,42803,91,37181,70,5622,21,40664,77,276212,291,316876,368,7,505,-159,1453,243,40845,1,1202,529,"Knox County",470313,258.551220144882,0.119213114754098,78.2457639912144,19.3488166391318,308.943193150094,11.9213114754098
2021-02-01,42712,153,37111,82,5601,71,40587,97,275921,425,316508,522,4,498,-124,1612,273,40602,2,1201,527,"Knox County",470313,268.331940643784,0.120779220779221,110.989915226668,32.5315268767821,342.750466178906,12.0779220779221
2021-01-31,42559,174,37029,120,5530,54,40490,129,275496,939,315986,1068,7,494,13,1736,154,40329,4,1199,524,"Knox County",470313,282.365148316121,0.122474589032501,227.082815061459,36.9966384088894,369.115886654207,12.2474589032501
2021-01-30,42385,277,36909,233,5476,44,40361,250,274557,1518,314918,1768,7,487,92,1723,178,40175,9,1195,522,"Knox County",470313,276.624290631983,0.12635068762279,375.919866131704,58.8969473520825,366.351769991474,12.635068762279
2021-01-29,42108,101,36676,52,5432,49,40111,62,273039,376,313150,438,4,480,-140,1631,237,39997,1,1186,516,"Knox County",470313,260.464839372928,0.122925311203319,93.1294690982388,21.4750602258496,346.79032899367,12.2925311203319
2021-01-28,42007,157,36624,116,5383,41,40049,129,272663,656,312712,785,9,476,-75,1771,223,39760,5,1185,511,"Knox County",470313,251.534616308714,0.13560325684678,166.910121557346,33.3820243114692,376.557739207719,13.560325684678
2021-01-27,41850,168,36508,123,5342,45,39920,125,272007,893,311927,1018,12,467,-73,1846,229,39537,2,1180,507,"Knox County",470313,238.351906071063,0.14563432210491,216.45159712787,35.7208922568587,392.504566108102,14.563432210491
2021-01-26,41682,234,36385,173,5297,61,39795,193,271114,1041,310909,1234,3,455,-26,1919,257,39308,7,1178,503,"Knox County",470313,268.757189361128,0.144153373335285,262.378458600974,49.7540999291961,408.026144291142,14.4153373335285
2021-01-25,41448,157,36212,105,5236,52,39602,115,270073,415,309675,530,9,452,-200,1945,348,39051,1,1171,496,"Knox County",470313,269.607686795815,0.146615991814062,112.690910096042,33.3820243114692,413.554377616608,14.6615991814062
2021-01-24,41291,157,36107,104,5184,53,39487,111,269658,791,309145,902,4,443,-98,2145,251,38703,2,1170,492,"Knox County",470313,265.993072698394,0.147565543071161,191.787171521944,33.3820243114692,456.079249350964,14.7565543071161
2021-01-23,41134,308,36003,221,5131,87,39376,231,268867,1492,308243,1723,7,439,62,2243,239,38452,7,1168,487,"Knox County",470313,272.58442781722,0.145701357466063,366.351769991474,65.4883024709077,476.916436500798,14.5701357466063
2021-01-22,40826,178,35782,143,5044,35,39145,176,267375,1173,306520,1349,3,432,-152,2181,327,38213,8,1161,483,"Knox County",470313,288.956503434947,0.14321707996287,286.830259848229,37.8471358435765,463.733726263148,14.321707996287
2021-01-21,40648,268,35639,195,5009,73,38969,203,266202,1080,305171,1283,11,429,-125,2333,382,37886,6,1153,475,"Knox County",470313,312.557807247514,0.143550192810051,272.797052175891,56.9833281240365,496.052628781258,14.3550192810051
2021-01-20,40380,192,35444,131,4936,61,38766,130,265122,736,303888,866,10,418,-156,2458,338,37504,8,1147,469,"Knox County",470313,317.660791855637,0.146950678331431,184.13269460976,40.8238768649814,522.630673615231,14.6950678331431
2021-01-19,40188,310,35313,195,4875,115,38636,219,264386,957,303022,1176,8,408,-87,2614,389,37166,14,1139,459,"Knox County",470313,333.820243114692,0.151360326989398,250.046245798011,65.9135511882512,555.800073568028,15.1360326989398
2021-01-18,39878,129,35118,80,4760,49,38417,87,263429,472,301846,559,7,400,-366,2701,488,36777,4,1125,456,"Knox County",470313,327.866761071882,0.147238483074574,118.857016497524,27.4285422686594,574.298392772473,14.7238483074574
2021-01-17,39749,181,35038,138,4711,43,38330,151,262957,690,301287,841,3,393,-210,3067,388,36289,8,1121,447,"Knox County",470313,332.969745680005,0.153520584840323,178.817085642965,38.4850089195918,652.118908046344,15.3520584840323
2021-01-16,39568,421,34900,340,4668,81,38179,389,262267,1757,300446,2146,1,390,6,3277,414,35901,7,1113,441,"Knox County",470313,356.996298209916,0.164841849148418,456.291873709636,89.5148550008186,696.770023367417,16.4841849148418
2021-01-15,39147,187,34560,149,4587,38,37790,153,260510,755,298300,908,0,389,-99,3271,286,35487,4,1106,433,"Knox County",470313,358.909917437962,0.171230235248747,193.062917673975,39.7607550716225,695.494277215386,17.1230235248747
2021-01-14,38960,338,34411,267,4549,71,37637,290,259755,1479,297392,1769,6,389,-92,3370,424,35201,8,1102,423,"Knox County",470313,373.793622544986,0.171687840290381,376.132490490376,71.867033231061,716.544088723892,17.1687840290381
2021-01-13,38622,249,34144,201,4478,48,37347,206,258276,946,295623,1152,12,383,-248,3462,485,34777,6,1094,416,"Knox County",470313,385.913210989277,0.174833352824231,244.943261189888,52.9434653092728,736.105529721696,17.4833352824231
2021-01-12,38373,332,33943,261,4430,71,37141,283,257330,1181,294471,1464,10,371,-175,3710,497,34292,6,1088,414,"Knox County",470313,390.590946880056,0.176377418259984,311.282061095483,70.5912870790304,788.836370672297,17.6377418259984
2021-01-11,38041,244,33682,197,4359,47,36858,228,256149,726,293007,954,4,361,-395,3885,635,33795,5,1082,409,"Knox County",470313,415.042748127311,0.184102230885857,202.843638172876,51.8803435159139,826.045633439858,18.4102230885857
2021-01-10,37797,328,33485,205,4312,123,36630,222,255423,1013,292053,1235,5,357,-4,4280,327,33160,17,1077,403,"Knox County",470313,446.298528852062,0.183942667220607,262.591082959646,69.7407896443432,910.032255115211,18.3942667220607
2021-01-09,37469,475,33280,393,4189,82,36408,426,254410,1384,290818,1810,5,352,101,4284,369,32833,12,1060,397,"Knox County",470313,457.780244220338,0.194575979337064,384.850089195918,100.996570369095,910.882752549898,19.4575979337064
2021-01-08,36994,459,32887,371,4107,88,35982,392,253026,1432,289008,1824,7,347,267,4183,185,32464,6,1048,395,"Knox County",470313,515.614069779062,0.200528996865204,387.826830217323,97.5945806303462,889.407692324048,20.0528996865204
2021-01-07,36535,389,32516,346,4019,43,35590,354,251594,1309,287184,1663,10,340,73,3916,306,32279,10,1042,387,"Knox County",470313,526.457912071323,0.208968521084934,353.594308471167,82.7108755233217,832.636988558683,20.8968521084934
2021-01-06,36146,496,32170,362,3976,134,35236,378,250285,1187,285521,1565,9,330,58,3843,429,31973,15,1032,384,"Knox County",470313,578.976128663252,0.217118402282454,332.757121321333,105.461681901202,817.115410375643,21.7118402282454
2021-01-05,35650,520,31808,328,3842,192,34858,345,249098,1193,283956,1538,14,321,32,3785,474,31544,14,1017,375,"Knox County",470313,618.949508093546,0.221456228161299,327.016263637195,110.564666509325,804.78319757268,22.1456228161299
2021-01-04,35130,322,31480,228,3650,94,34513,249,247905,654,282418,903,6,307,-222,3753,538,31070,6,1003,369,"Knox County",470313,635.534208069945,0.224520781932055,191.999795880616,68.4650434923126,797.979218095183,22.4520781932055
2021-01-03,34808,285,31252,182,3556,103,34264,195,247251,608,281515,803,2,301,-15,3975,298,30532,10,997,361,"Knox County",470313,626.391360647058,0.231446665347318,170.737360013438,60.5979422214568,845.181825720318,23.1446665347318
2021-01-02,34523,422,31070,319,3453,103,34069,345,246643,1095,280712,1440,0,299,105,3990,317,30234,22,987,352,"Knox County",470313,615.122269637454,0.231922760887428,306.179076487361,89.7274793594904,848.371191100395,23.1922760887428
2021-01-01,34101,419,30751,349,3350,70,33724,374,245548,1297,279272,1671,2,299,2,3885,415,29917,8,965,348,"Knox County",470313,606.617295290583,0.233747260774288,355.295303340541,89.089606283475,826.045633439858,23.3747260774288
2020-12-31,33682,448,30402,311,3280,137,33350,322,244251,929,277601,1251,12,297,1,3883,435,29502,8,957,342,"Knox County",470313,619.162132452218,0.240758913967942,265.993072698394,95.2557126849566,825.620384722515,24.0758913967942
2020-12-30,33234,363,30091,248,3143,115,33028,271,243322,931,276350,1202,6,285,-147,3882,504,29067,9,949,339,"Knox County",470313,590.883092748871,0.238533151680291,255.574479123477,77.1826421978555,825.407760363843,23.8533151680291
2020-12-29,32871,590,29843,398,3028,192,32757,420,242391,1081,275148,1501,7,279,111,4029,472,28563,14,940,335,"Knox County",470313,605.766797855896,0.248090297571543,319.149162366339,125.448371616349,856.663541088594,24.8090297571543
2020-12-28,32281,252,29445,174,2836,78,32337,185,241310,565,273647,750,4,272,-330,3918,578,28091,4,926,327,"Knox County",470313,590.883092748871,0.245068461359944,159.468269003834,53.5813383852881,833.062237276027,24.5068461359944
2020-12-27,32029,230,29271,156,2758,74,32152,172,240745,489,272897,661,3,268,-74,4248,301,27513,8,922,322,"Knox County",470313,579.188753021924,0.246460594620104,140.544701082045,48.903602494509,903.228275637714,24.6460594620104
2020-12-26,31799,358,29115,288,2684,70,31980,328,240256,1064,272236,1392,0,265,59,4322,299,27212,10,914,315,"Knox County",470313,565.58079406693,0.245847176079734,295.973107271115,76.1195204044966,918.962478179425,24.5847176079734
2020-12-25,31441,353,28827,287,2614,66,31652,308,239192,1070,270844,1378,1,265,-106,4263,458,26913,5,904,309,"Knox County",470313,551.547586394592,0.246588813767671,292.99636624971,75.0563986111377,906.41764101779,24.6588813767671
2020-12-24,31088,351,28540,277,2548,74,31344,311,238122,1273,269466,1584,5,264,-105,4369,451,26455,8,899,302,"Knox County",470313,530.92302360343,0.235592820028342,336.796984136097,74.6311498937941,928.955823036999,23.5592820028342
2020-12-23,30737,472,28263,351,2474,121,31033,371,236849,1411,267882,1782,6,259,-14,4474,480,26004,9,891,295,"Knox County",470313,554.099078698654,0.231542882404951,378.896607153109,100.358697293079,951.281380697535,23.1542882404951
2020-12-22,30265,530,27912,392,2353,138,30662,432,235438,1470,266100,1902,7,253,-26,4488,549,25524,15,882,289,"Knox County",470313,541.341617178347,0.222986559424278,404.411530193722,112.690910096042,954.25812171894,22.2986559424278
2020-12-21,29735,442,27520,361,2215,81,30230,391,233968,1423,264198,1814,2,246,-136,4514,576,24975,5,867,283,"Knox County",470313,581.740245325985,0.22001331684581,385.700586630606,93.9799665329259,959.786355044406,22.001331684581
2020-12-20,29293,514,27159,431,2134,83,29839,478,232545,2245,262384,2723,2,244,235,4650,277,24399,7,862,280,"Knox County",470313,642.12556318877,0.208270377733598,578.976128663252,109.288920357294,988.703267823768,20.8270377733598
2020-12-19,28779,525,26728,441,2051,84,29361,489,230300,1445,259661,1934,6,242,252,4415,267,24122,14,855,274,"Knox County",470313,677.633831086957,0.211938705496684,411.215509671219,111.627788302684,938.736543535901,21.1938705496684
2020-12-18,28254,480,26287,420,1967,60,28872,430,228855,1358,257727,1788,4,236,98,4163,378,23855,11,841,267,"Knox County",470313,704.637124638273,0.214533895172618,380.172353305139,102.059692162454,885.155205150612,21.4533895172618
2020-12-17,27774,733,25867,635,1907,98,28442,663,227497,1898,255939,2561,11,232,288,4065,434,23477,11,830,261,"Knox County",470313,785.859629650892,0.224351902923331,544.530982558424,155.853654906413,864.318018000778,22.4351902923332
2020-12-16,27041,564,25232,453,1809,111,27779,472,225599,1729,253378,2201,8,221,99,3777,457,23043,11,819,257,"Knox County",470313,805.421070648696,0.224820746498693,467.986213436584,119.920138290883,803.082202703306,22.4820746498693
2020-12-15,26477,765,24779,675,1698,90,27307,716,223870,2415,251177,3131,2,213,325,3678,438,22586,15,808,253,"Knox County",470313,855.387794936564,0.225297176820208,665.726867001337,162.65763438391,782.0323911948,22.5297176820208
2020-12-14,25712,472,24104,411,1608,61,26591,461,221455,1624,248046,2085,6,211,-11,3353,477,22148,7,793,245,"Knox County",470313,861.766525696717,0.225841807221579,443.321787830657,100.358697293079,712.929474626472,22.5841807221579
2020-12-13,25240,628,23693,572,1547,56,26130,754,219831,2935,245961,3689,2,205,400,3364,226,21671,10,786,237,"Knox County",470313,886.0057025853,0.229167864742078,784.37125914019,133.528097245877,715.268342571862,22.9167864742078
2020-12-12,24612,464,23121,392,1491,72,25376,454,216896,2171,242272,2625,3,203,182,2964,279,21445,19,776,231,"Knox County",470313,873.035616706321,0.218473451327434,558.138941513418,98.6577024237051,630.21859910315,21.8473451327434
2020-12-11,24148,557,22729,523,1419,34,24922,429,214725,1407,239647,1836,6,200,282,2782,269,21166,10,757,227,"Knox County",470313,889.407692324048,0.217839805825243,390.378322521385,118.43176778018,591.520965824887,21.7839805825243
2020-12-10,23591,473,22206,415,1385,58,24493,538,213318,1910,237811,2448,8,194,325,2500,140,20897,9,747,225,"Knox County",470313,834.125359069386,0.212267554815432,520.504430028513,100.571321651751,531.560896679445,21.2267554815432
2020-12-09,23118,407,21791,337,1327,70,23955,359,211408,924,235363,1283,2,186,78,2175,327,20757,13,738,215,"Knox County",470313,800.743334757917,0.217055623793648,272.797052175891,86.5381139794137,462.457980111117,21.7055623793648
2020-12-08,22711,491,21454,446,1257,45,23596,538,210484,2077,234080,2615,9,184,126,2097,356,20430,10,725,212,"Knox County",470313,742.484260481849,0.213075206561727,556.0126979267,104.398560107843,445.873280134719,21.3075206561727
2020-12-07,22220,323,21008,271,1212,52,23058,317,208407,1135,231465,1452,3,175,-128,1971,448,20074,6,715,210,"Knox County",470313,710.803231039754,0.212503135189365,308.730568791422,68.6776678509843,419.082610942075,21.2503135189365
2020-12-06,21897,332,20737,291,1160,41,22741,187,207272,668,230013,855,6,172,103,2099,223,19626,6,709,207,"Knox County",470313,647.866420872908,0.215189873417722,181.79382666437,70.5912870790304,446.298528852062,21.5189873417722
2020-12-05,21565,289,20446,263,1119,26,22554,213,206604,714,229158,927,2,166,55,1996,232,19403,8,703,203,"Knox County",470313,610.657158105347,0.226086194814296,197.102780488738,61.4484396561439,424.398219908869,22.6086194814296
2020-12-04,21276,354,20183,322,1093,32,22341,297,205890,1091,228231,1388,5,164,17,1941,332,19171,11,695,201,"Knox County",470313,567.494413294976,0.223285922684172,295.122609836428,75.2690229698095,412.703880181921,22.3285922684172
2020-12-03,20922,441,19861,424,1061,17,22044,448,204799,1215,226843,1663,2,159,180,1924,259,18839,10,684,196,"Knox County",470313,560.690433817479,0.231660610821958,353.594308471167,93.7673421742542,409.089266084501,23.1660610821958
2020-12-02,20481,192,19437,170,1044,22,21596,185,203584,575,225180,760,2,157,-144,1744,334,18580,7,674,194,"Knox County",470313,514.976196703047,0.226190476190476,161.594512590551,40.8238768649814,370.816881523581,22.6190476190476
2020-12-01,20289,403,19267,380,1022,23,21411,409,203009,1832,224420,2241,5,155,88,1888,310,18246,7,667,189,"Knox County",470313,496.26525313993,0.221408572043937,476.491187783455,85.6876165447266,401.434789172317,22.1408572043937
2020-11-30,19886,385,18887,371,999,14,21002,436,201177,1815,222179,2251,1,150,24,1800,360,17936,3,660,186,"Knox County",470313,509.44796337758,0.215666831928607,478.617431370173,81.8603780886346,382.723845609201,21.5666831928607
2020-11-29,19501,226,18516,218,985,8,20566,261,199362,1465,219928,1726,0,149,41,1776,185,17576,5,657,183,"Knox County",470313,486.909781358372,0.205275648046732,366.989643067489,48.0531050598219,377.620861001078,20.5275648046732
2020-11-28,19275,271,18298,257,977,14,20305,299,197897,1967,218202,2266,0,149,72,1735,199,17391,8,652,177,"Knox County",470313,483.08254290228,0.189914599430663,481.806796750249,57.6212012000519,368.903262295535,18.9914599430663
2020-11-27,19004,235,18041,215,963,20,20006,249,195930,1247,215936,1496,3,149,-6,1663,238,17192,12,644,173,"Knox County",470313,457.780244220338,0.184390873175845,318.08604057298,49.9667242878679,353.594308471167,18.4390873175845
2020-11-26,18769,344,17826,341,943,3,19757,441,194683,1429,214440,1870,4,146,48,1669,292,16954,5,632,170,"Knox County",470313,437.155681429176,0.18080888183981,397.607550716225,73.1427793830917,354.870054623198,18.080888183981
2020-11-25,18425,219,17485,193,940,26,19316,123,193254,325,212570,448,0,142,-58,1621,277,16662,3,627,164,"Knox County",470313,442.896539113314,0.180354529191738,95.2557126849566,46.5647345491194,344.664085406952,18.0354529191738
2020-11-24,18206,153,17292,130,914,23,19193,116,192929,673,212122,789,2,142,-111,1679,262,16385,6,624,162,"Knox County",470313,389.740449445369,0.177484787018256,167.760618992033,32.5315268767821,356.996298209916,17.7484787018256
2020-11-23,18053,167,17162,147,891,20,19077,100,192256,391,211333,491,3,140,-97,1790,261,16123,7,618,160,"Knox County",470313,343.388339254922,0.174884437596302,104.398560107843,35.508267898187,380.597602022483,17.4884437596302
2020-11-22,17886,220,17015,212,871,8,18977,258,191865,1804,210842,2062,2,137,86,1887,132,15862,5,611,153,"Knox County",470313,342.112593102891,0.168329441732116,438.431427581207,46.7773589077912,401.222164813645,16.8329441732116
2020-11-21,17666,173,16803,169,863,4,18719,198,190061,1465,208780,1663,0,135,2,1801,171,15730,4,606,151,"Knox County",470313,321.275405953057,0.168386438371697,353.594308471167,36.7840140502176,382.936469967872,16.8386438371697
2020-11-20,17493,178,16634,169,859,9,18521,163,188596,791,207117,954,7,135,-17,1799,188,15559,5,602,149,"Knox County",470313,309.155817508765,0.169022592726833,202.843638172876,37.8471358435765,382.511221250529,16.9022592726833
2020-11-19,17315,166,16465,148,850,18,18358,128,187805,663,206163,791,2,128,-29,1816,193,15371,4,597,145,"Knox County",470313,271.308681665189,0.15087524312309,168.185867709377,35.2956435395152,386.125835347949,15.087524312309
2020-11-18,17149,168,16317,163,832,5,18230,179,187142,874,205372,1053,0,126,-9,1845,177,15178,7,593,140,"Knox County",470313,260.464839372928,0.146353966423171,223.893449681382,35.7208922568587,392.291941749431,14.6353966423171
2020-11-17,16981,248,16154,240,827,8,18051,260,186268,1033,204319,1293,9,126,86,1854,153,15001,7,586,138,"Knox County",470313,280.664153446747,0.154809197062718,274.923295762609,52.730840950601,394.205560977477,15.4809197062718
2020-11-16,16733,272,15914,261,819,11,17791,286,185235,1409,203026,1695,2,117,79,1768,191,14848,6,579,137,"Knox County",470313,302.989711107284,0.154768163179476,360.398287948664,57.8338255587237,375.919866131704,15.4768163179476
2020-11-15,16461,274,15653,247,808,27,17505,295,183826,2278,201331,2573,2,115,162,1689,110,14657,3,573,135,"Knox County",470313,314.47142647556,0.150568748752744,547.082474862485,58.2590742760672,359.122541796633,15.0568748752744
2020-11-14,16187,306,15406,293,781,13,17210,321,181548,1699,198758,2020,0,113,188,1527,118,14547,7,570,131,"Knox County",470313,342.750466178906,0.157240581944311,429.501204516992,65.0630537535641,324.677395691805,15.7240581944311
2020-11-13,15881,219,15113,200,768,19,16889,190,179849,965,196738,1155,4,113,73,1339,142,14429,6,563,128,"Knox County",470313,351.468064884449,0.156805293005671,245.581134265904,46.5647345491194,284.704016261511,15.6805293005671
2020-11-12,15662,143,14913,130,749,13,16699,136,178884,955,195583,1091,1,109,-3,1266,145,14287,3,557,127,"Knox County",470313,346.577704634998,0.153216911764706,231.97317531091,30.4052832900643,269.182438078471,15.3216911764706
2020-11-11,15519,191,14783,177,736,14,16563,191,177929,1229,194492,1420,3,108,23,1269,165,14142,7,554,125,"Knox County",470313,351.468064884449,0.149284253578732,301.926589313925,40.6112525063096,269.820311154486,14.9284253578732
2020-11-10,15328,168,14606,163,722,5,16372,186,176700,1131,193072,1317,2,105,24,1246,142,13977,4,547,123,"Knox County",470313,334.458116190707,0.142400851743412,280.026280370732,35.7208922568587,264.929950905036,14.2400851743412
2020-11-09,15160,135,14443,121,717,14,16186,131,175569,490,191755,621,1,103,-15,1222,149,13835,2,543,121,"Knox County",470313,305.328579052673,0.142198685888006,132.039726735174,28.7042884206901,259.826966296913,14.2198685888006
2020-11-08,15025,215,14322,203,703,12,16055,252,175079,2625,191134,2877,1,102,94,1237,120,13686,3,541,119,"Knox County",470313,292.783741891039,0.133987239310542,611.720279898706,45.7142371144323,263.01633167699,13.3987239310542
2020-11-07,14810,169,14119,161,691,8,15803,187,172454,1918,188257,2105,1,101,59,1143,109,13566,5,538,114,"Knox County",470313,263.654204753005,0.120253164556962,447.574275004093,35.9335166155305,243.029641961842,12.0253164556962
2020-11-06,14641,155,13958,138,683,17,15616,160,170536,1236,186152,1396,0,100,24,1084,131,13457,5,533,114,"Knox County",470313,250.046245798011,0.114805578645978,296.823604705802,32.9567755941256,230.484804800208,11.4805578645978
2020-11-05,14486,158,13820,142,666,16,15456,151,169300,613,184756,764,1,100,34,1060,123,13326,6,528,111,"Knox County",470313,253.235611178088,0.119809523809524,162.445010025239,33.5946486701409,225.381820192085,11.9809523809524
2020-11-04,14328,145,13678,133,650,12,15305,148,168687,934,183992,1082,-1,99,20,1026,126,13203,5,522,110,"Knox County",470313,243.454890679186,0.119563078134226,230.059556082864,30.8305320074078,218.152591997244,11.9563078134226
2020-11-03,14183,196,13545,183,638,13,15157,195,167753,836,182910,1031,3,100,44,1006,149,13077,5,517,108,"Knox County",470313,249.408372721996,0.123936816524909,219.215713790603,41.6743742996685,213.900104823809,12.3936816524909
2020-11-02,13987,116,13362,110,625,6,14962,115,166917,807,181879,922,1,97,-36,962,151,12928,2,512,107,"Knox County",470313,245.368509907232,0.118699027218237,196.039658695379,24.6644256059263,204.544633042251,11.8699027218237
2020-11-01,13871,124,13252,116,619,8,14847,131,166110,1273,180957,1404,0,96,15,998,109,12777,3,510,105,"Knox County",470313,226.0196932681,0.124885110294118,298.524599575177,26.3654204753005,212.199109954435,12.4885110294118
2020-10-31,13747,5,13136,5,611,0,14716,7,164837,4,179553,11,0,96,-99,983,104,12668,0,507,103,"Knox County",470313,191.149298445929,0.137216338880484,2.33886794538956,1.06312179335889,209.009744574358,13.7216338880484
2020-10-30,13742,156,13131,146,611,10,14709,148,164833,854,179542,1002,1,96,27,1082,128,12564,4,507,102,"Knox County",470313,191.3619228046,0.143983268983269,213.049607389122,33.1693999527974,230.059556082864,14.3983268983269
2020-10-29,13586,152,12985,138,601,14,14561,136,163979,1569,178540,1705,0,95,49,1055,103,12436,4,503,102,"Knox County",470313,190.08617665257,0.122956546038843,362.524531535382,32.3189025181103,224.318698398726,12.2956546038843
2020-10-28,13434,103,12847,96,587,7,14425,102,162410,1055,176835,1157,3,95,-47,1006,147,12333,8,499,101,"Knox County",470313,181.155953588355,0.115320796460177,246.006382983247,21.9003089431931,213.900104823809,11.5320796460177
2020-10-27,13331,119,12751,113,580,6,14323,127,161355,799,175678,926,1,92,-6,1053,124,12186,3,491,100,"Knox County",470313,164.783877970628,0.107478602497545,196.890156130067,25.3022986819416,223.893449681382,10.7478602497545
2020-10-26,13212,81,12638,74,574,7,14196,73,160556,372,174752,445,2,91,-72,1059,151,12062,2,488,98,"Knox County",470313,157.342025417116,0.108872180451128,94.6178396089413,17.222573052414,225.169195833413,10.8872180451128
2020-10-25,13131,132,12564,121,567,11,14123,151,160184,1365,174307,1516,0,89,53,1131,79,11911,3,486,98,"Knox County",470313,159.04302028649,0.11002661934339,322.338527746416,28.0664153446747,240.478149657781,11.002661934339
2020-10-24,12999,172,12443,167,556,5,13972,202,158819,1789,172791,1991,0,89,56,1078,116,11832,5,483,97,"Knox County",470313,194.551288184677,0.107412491420728,423.33509811551,36.5713896915458,229.209058648177,10.7412491420728
2020-10-23,12827,159,12276,148,551,11,13770,172,157030,1239,170800,1411,1,89,40,1022,118,11716,5,478,96,"Knox County",470313,195.189161260692,0.105234400611955,300.012970085879,33.8072730288127,217.302094562557,10.5234400611955
2020-10-22,12668,182,12128,168,540,14,13598,169,155791,1607,169389,1776,1,88,59,982,122,11598,5,473,96,"Knox County",470313,201.567892020846,0.108002602472349,377.620861001078,38.6976332782636,208.797120215686,10.8002602472349
2020-10-21,12486,72,11960,68,526,4,13429,74,154184,682,167613,756,0,87,-32,923,104,11476,1,468,96,"Knox County",470313,194.976536902021,0.109738124929146,160.744015155864,15.308953824368,196.252283054051,10.9738124929146
2020-10-20,12414,127,11892,121,522,6,13355,150,153502,739,166857,889,0,87,13,955,114,11372,7,467,95,"Knox County",470313,196.677531771395,0.112818761384335,189.023054859211,27.0032935513158,203.056262531548,11.2818761384335
2020-10-19,12287,112,11771,107,516,5,13205,117,152763,939,165968,1056,1,87,-9,942,120,11258,6,460,94,"Knox County",470313,203.26888689022,0.110164981373071,224.531322757398,23.8139281712392,200.292145868815,11.0164981373071
2020-10-18,12175,140,11664,135,511,5,13088,168,151824,1431,164912,1599,0,86,51,951,89,11138,7,454,94,"Knox County",470313,204.969881759594,0.11099388056552,339.986349516173,29.7674102140489,202.205765096861,11.099388056552
2020-10-17,12035,128,11529,125,506,3,12920,154,150393,1458,163313,1612,1,86,42,900,85,11049,3,447,93,"Knox County",470313,195.614409978036,0.110341795801736,342.750466178906,27.2159179099876,191.3619228046,11.0341795801736
2020-10-16,11907,72,11404,71,503,1,12766,61,148935,390,161701,451,1,85,-26,858,97,10964,3,444,92,"Knox County",470313,177.116090773591,0.109718638653397,95.893585760972,15.308953824368,182.431699740386,10.9718638653397
2020-10-15,11835,74,11333,62,502,12,12705,66,148545,941,161250,1007,1,84,-56,884,129,10867,3,441,90,"Knox County",470313,154.152660037039,0.10719131614654,214.112729182481,15.7342025417116,187.959933065852,10.719131614654
2020-10-14,11761,149,11271,143,490,6,12639,150,147604,1086,160243,1236,0,83,57,940,92,10738,5,438,88,"Knox County",470313,170.524735654766,0.11031847133758,262.803707318318,31.6810294420949,199.866897151471,11.031847133758
2020-10-13,11612,71,11128,68,484,3,12489,63,146518,581,159007,644,1,83,-36,883,106,10646,6,433,88,"Knox County",470313,158.617771569146,0.102432610124918,136.930086984625,15.0963294656962,187.74730870718,10.2432610124918
2020-10-12,11541,79,11060,66,481,13,12426,87,145937,806,158363,893,0,82,-42,919,121,10540,5,427,87,"Knox County",470313,151.601167732978,0.100644987906477,189.873552293898,16.7973243350705,195.401785619364,10.0644987906477
2020-10-11,11462,170,10994,163,468,7,12339,179,145131,1612,157470,1791,0,82,94,961,76,10419,8,422,85,"Knox County",470313,157.979898493131,0.0995546240503013,380.810226381155,36.1461409742023,204.332008683579,9.95546240503013
2020-10-10,11292,130,10831,122,461,8,12160,132,143519,1393,155679,1525,0,82,46,867,84,10343,3,414,85,"Knox County",470313,158.405147210475,0.0977872002120048,324.252146974462,27.6411666273312,184.345318968432,9.77872002120048
2020-10-09,11162,120,10709,118,453,2,12028,134,142126,1336,154154,1470,0,82,34,821,86,10259,3,411,85,"Knox County",470313,168.61111642672,0.0946766285314032,312.557807247514,25.5149230406134,174.56459846953,9.46766285314032
2020-10-08,11042,110,10591,102,451,8,11894,103,140790,943,152684,1046,1,82,32,787,77,10173,4,408,85,"Knox County",470313,176.265593338904,0.0985473561882626,222.40507917068,23.3886794538956,167.335370274689,9.85473561882626
2020-10-07,10932,104,10489,88,443,16,11791,95,139847,1650,151638,1745,0,81,11,755,93,10096,5,404,85,"Knox County",470313,166.697497198674,0.087008997147246,371.029505882253,22.1129333018649,160.531390797193,8.7008997147246
2020-10-06,10828,115,10401,102,427,13,11696,114,138197,1393,149893,1507,0,81,3,744,112,10003,4,399,84,"Knox County",470313,176.052968980232,0.0845945675052621,320.42490851837,24.4518012472545,158.192522851803,8.45945675052621
2020-10-05,10713,118,10299,109,414,9,11582,123,136804,1238,148386,1361,0,81,11,741,107,9891,5,395,84,"Knox County",470313,184.345318968432,0.0842508377213978,289.38175215229,25.0896743232698,157.554649775788,8.42508377213978
2020-10-04,10595,96,10190,89,405,7,11459,99,135566,1827,147025,1926,1,81,31,730,64,9784,2,390,82,"Knox County",470313,168.61111642672,0.0756143667296786,409.514514801845,20.4119384324907,155.215781830398,7.56143667296786
2020-10-03,10499,77,10101,76,398,1,11360,92,133739,1864,145099,1956,0,80,6,699,71,9720,2,388,82,"Knox County",470313,157.342025417116,0.0690218872037054,415.893245561998,16.3720756177269,148.624426711573,6.90218872037054
2020-10-02,10422,82,10025,79,397,3,11268,82,131875,602,143143,684,0,80,-17,693,99,9649,1,386,82,"Knox County",470313,149.262299787588,0.0692420537897311,145.435061331496,17.4351974110858,147.348680559542,6.92420537897311
2020-10-01,10340,71,9946,68,394,3,11186,73,131273,683,142459,756,0,80,2,710,69,9550,1,385,82,"Knox County",470313,140.969949799389,0.0682435832913941,160.744015155864,15.0963294656962,150.963294656962,6.82435832913941
2020-09-30,10269,75,9878,72,391,3,11113,70,130590,675,141703,745,1,80,-31,708,105,9481,2,384,82,"Knox County",470313,134.803843397907,0.0730833799664242,158.405147210475,15.9468269003834,150.538045939619,7.30833799664242
2020-09-29,10194,80,9806,75,388,5,11043,87,129915,1140,140958,1227,-1,79,-17,739,98,9376,2,382,82,"Knox County",470313,127.361990844395,0.0723281340265742,260.890088090272,17.0099486937423,157.129401058444,7.23281340265742
2020-09-28,10114,57,9731,51,383,6,10956,49,128775,431,139731,480,1,80,-70,756,126,9278,3,380,81,"Knox County",470313,114.391904965417,0.0710059171597633,102.059692162454,12.1195884442914,160.744015155864,7.10059171597633
2020-09-27,10057,72,9680,67,377,5,10907,79,128344,978,139251,1057,0,79,-18,826,90,9152,3,377,79,"Knox County",470313,109.288920357294,0.0770456191165822,224.74394711607,15.308953824368,175.627720262889,7.70456191165822
2020-09-26,9985,127,9613,122,372,5,10828,136,127366,2087,138194,2223,4,79,9,844,114,9062,5,374,79,"Knox County",470313,119.920138290883,0.0803123257110987,472.663949327363,27.0032935513158,179.454958718981,8.03123257110987
2020-09-25,9858,102,9491,100,367,2,10692,103,125279,1439,135971,1542,0,75,-3,835,105,8948,1,369,79,"Knox County",470313,124.172625464318,0.074346201743462,327.866761071882,21.6876845845214,177.541339490935,7.4346201743462
2020-09-24,9756,92,9391,89,365,3,10589,105,123840,1717,134429,1822,0,75,-52,838,144,8843,3,368,76,"Knox County",470313,128.637736996426,0.0691512752858399,387.40158149998,19.5614409978036,178.17921256695,6.91512752858399
2020-09-23,9664,53,9302,52,362,1,10484,49,122123,432,132607,481,2,75,-123,890,174,8699,2,365,76,"Knox County",470313,123.960001105647,0.0688405797101449,102.272316521125,11.2690910096042,189.235679217883,6.88405797101449
2020-09-22,9611,82,9250,75,361,7,10435,88,121691,1141,132126,1229,1,73,-53,1013,134,8525,3,363,76,"Knox County",470313,124.38524982299,0.0689381933438986,261.315336807615,17.4351974110858,215.388475334511,6.89381933438986
2020-09-21,9529,34,9175,30,354,4,10347,32,120550,379,130897,411,0,72,-103,1066,137,8391,2,360,76,"Knox County",470313,119.494889573539,0.0675413576725613,87.3886114141008,7.22922819484046,226.657566344116,6.75413576725613
2020-09-20,9495,97,9145,78,350,19,10315,88,120171,707,130486,795,0,72,-17,1169,114,8254,1,358,76,"Knox County",470313,124.810498540334,0.0706809361401858,169.036365144064,20.6245627911625,248.557875287309,7.06809361401858
2020-09-19,9398,132,9067,129,331,3,10227,136,119464,1466,129691,1602,1,72,31,1186,100,8140,5,357,74,"Knox County",470313,125.873620333693,0.0762496828216189,340.624222592189,28.0664153446747,252.172489384729,7.62496828216189
2020-09-18,9266,118,8938,114,328,4,10091,129,117998,1606,128089,1735,3,71,-16,1155,131,8040,3,352,74,"Knox County",470313,129.275610072441,0.0776470588235294,368.903262295535,25.0896743232698,245.581134265904,7.76470588235294
2020-09-17,9148,126,8824,119,324,7,9962,124,116392,1516,126354,1640,0,68,-15,1171,141,7909,6,349,74,"Knox County",470313,136.504838267282,0.0818446724946155,348.703948221716,26.790669192644,248.983124004652,8.18446724946155
2020-09-16,9022,99,8705,77,317,22,9838,117,114876,768,124714,885,1,68,-90,1186,188,7768,3,343,72,"Knox County",470313,146.285558766183,0.0860552006749428,188.172557424524,21.049811508506,252.172489384729,8.60552006749428
2020-09-15,8923,132,8628,126,295,6,9721,136,114108,1338,123829,1474,0,67,-65,1276,197,7580,3,340,71,"Knox County",470313,156.916776699772,0.089206274877078,313.408304682201,28.0664153446747,271.308681665189,8.9206274877078
2020-09-14,8791,127,8502,124,289,3,9585,136,112770,901,122355,1037,0,67,-68,1341,195,7383,5,337,71,"Knox County",470313,176.690842056248,0.0944589877835951,220.491459942634,27.0032935513158,285.129264978855,9.44589877835951
2020-09-13,8664,143,8378,136,286,7,9449,148,111869,1008,121318,1156,0,67,-8,1409,151,7188,0,332,71,"Knox County",470313,186.471562555149,0.0971770385140099,245.793758624576,30.4052832900643,299.587721368535,9.71770385140099
2020-09-12,8521,130,8242,123,279,7,9301,141,110861,1177,120162,1318,1,67,29,1417,100,7037,1,332,71,"Knox County",470313,186.046313837806,0.100703082747431,280.238904729404,27.6411666273312,301.28871623791,10.0703082747431
2020-09-11,8391,104,8119,95,272,9,9160,106,109684,773,118844,879,0,66,-17,1388,121,6937,5,331,69,"Knox County",470313,183.069572816401,0.108236976993682,186.896811272493,22.1129333018649,295.122609836428,10.8236976993682
2020-09-10,8287,192,8024,189,263,3,9054,192,108911,1501,117965,1693,0,66,89,1405,103,6816,5,326,67,"Knox County",470313,197.102780488738,0.115612414119877,359.97303923132,40.8238768649814,298.737223933848,11.5612414119877
2020-09-09,8095,91,7835,82,260,9,8862,93,107410,1710,116272,1803,0,66,-23,1316,114,6713,2,321,67,"Knox County",470313,195.401785619364,0.101709401709402,383.361718685216,19.3488166391318,279.81365601206,10.1709401709402
2020-09-08,8004,126,7753,124,251,2,8769,133,105700,702,114469,835,1,66,30,1339,95,6599,8,319,67,"Knox County",470313,194.126039467333,0.108817796124298,177.541339490935,26.790669192644,284.704016261511,10.8817796124298
2020-09-07,7878,95,7629,92,249,3,8636,98,104998,347,113634,445,1,65,11,1309,83,6504,0,311,67,"Knox County",470313,187.322059989837,0.112067905031369,94.6178396089413,20.1993140738189,278.325285501358,11.2067905031369
2020-09-06,7783,96,7537,92,246,4,8538,94,104651,476,113189,570,0,64,23,1298,73,6421,1,311,67,"Knox County",470313,177.328715132263,0.113615272438022,121.195884442914,20.4119384324907,275.986417555968,11.3615272438022
2020-09-05,7687,284,7445,282,242,2,8444,295,104175,1506,112619,1801,0,64,215,1275,69,6348,4,310,64,"Knox County",470313,210.072866367717,0.125965611761774,382.936469967872,60.385317862785,271.096057306517,12.5965611761774
2020-09-04,7403,93,7163,89,240,4,8149,97,102669,565,110818,662,1,64,16,1060,76,6279,0,306,64,"Knox County",470313,207.733998422327,0.12831348444103,140.757325440717,19.7740653564754,225.381820192085,12.831348444103
2020-09-03,7310,190,7074,184,236,6,8052,198,102104,1798,110156,1996,2,63,107,1044,81,6203,6,306,64,"Knox County",470313,207.308749704984,0.124260355029586,424.398219908869,40.3986281476379,221.979830453336,12.4260355029586
2020-09-02,7120,124,6890,120,230,4,7854,121,100306,1461,108160,1582,2,61,41,937,81,6122,5,300,63,"Knox County",470313,214.325353541152,0.131288810036751,336.371735418753,26.3654204753005,199.229024075456,13.1288810036751
2020-09-01,6996,153,6770,146,226,7,7733,158,98845,660,106578,818,2,59,64,896,87,6041,4,295,62,"Knox County",470313,220.06621122529,0.134747269494539,173.926725393515,32.5315268767821,190.511425369913,13.4747269494539
2020-08-31,6843,99,6624,93,219,6,7575,94,98185,431,105760,525,0,57,18,832,81,5954,3,291,59,"Knox County",470313,220.916708659978,0.132889112396279,111.627788302684,21.049811508506,176.903466414919,13.2889112396279
2020-08-30,6744,72,6531,71,213,1,7481,76,97754,423,105235,499,1,57,5,814,66,5873,1,288,59,"Knox County",470313,215.813724051855,0.131802613218318,106.099554977217,15.308953824368,173.076227958827,13.1802613218318
2020-08-29,6672,118,6460,113,212,5,7405,125,97331,1391,104736,1516,5,56,37,809,76,5807,3,287,57,"Knox County",470313,180.51808051234,0.114372203211371,322.338527746416,25.0896743232698,172.013106165469,11.4372203211371
2020-08-28,6554,89,6347,85,207,4,7280,91,95940,309,103220,400,0,51,-7,772,96,5731,3,284,57,"Knox County",470313,179.667583077653,0.117639040348964,85.0497434687113,18.9235679217883,164.146004894613,11.7639040348964
2020-08-27,6465,116,6262,112,203,4,7189,134,95631,1987,102820,2121,0,51,24,779,92,5635,2,281,57,"Knox County",470313,163.933380535941,0.107090202385739,450.976264742841,24.6644256059263,165.634375405315,10.7090202385739
2020-08-26,6349,77,6150,76,199,1,7055,86,93644,794,100699,880,0,51,-15,755,92,5543,3,279,56,"Knox County",470313,153.940035678367,0.113034472555112,187.109435631165,16.3720756177269,160.531390797193,11.3034472555112
2020-08-25,6272,87,6074,82,198,5,6969,96,92850,896,99819,992,2,51,-7,770,92,5451,3,276,55,"Knox County",470313,139.90682800603,0.101254868022501,210.923363802404,18.4983192044447,163.720756177269,10.1254868022501
2020-08-24,6185,32,5992,28,193,4,6873,29,91954,261,98827,290,0,49,-66,777,98,5359,1,273,55,"Knox County",470313,125.660995975021,0.0951030158256196,61.6610640148157,6.8039794774969,165.209126687972,9.51030158256196
2020-08-23,6153,76,5964,75,189,1,6844,74,91693,566,98537,640,0,49,13,843,63,5261,3,272,55,"Knox County",470313,126.511493409708,0.0928498318467612,136.079589549938,16.1594512590551,179.242334360309,9.28498318467612
2020-08-22,6077,136,5889,135,188,1,6770,153,91127,1892,97897,2045,0,49,69,830,67,5198,4,269,55,"Knox County",470313,130.3387318658,0.0899837133550489,434.816813483786,28.9169127793618,176.478217697576,8.99837133550489
2020-08-21,5941,30,5754,30,187,0,6617,41,89235,262,95852,303,1,49,-62,761,91,5131,1,265,55,"Knox County",470313,117.793894704165,0.0843075230367212,64.4251806775488,6.37873076015334,161.807136949223,8.43075230367212
2020-08-20,5911,119,5724,117,187,2,6576,130,88973,2068,95549,2198,3,48,24,823,92,5040,3,264,55,"Knox County",470313,118.43176778018,0.0828796951551443,467.348340360568,25.3022986819416,174.989847186873,8.28796951551443
2020-08-19,5792,46,5607,41,185,5,6446,48,86905,608,93351,656,2,45,-50,799,94,4948,4,261,55,"Knox County",470313,111.840412661355,0.0801516002245929,139.481579288686,9.7807204989018,169.886862578751,8.01516002245929
2020-08-18,5746,134,5566,132,180,2,6398,152,86297,1164,92695,1316,0,43,3,849,131,4854,4,257,55,"Knox County",470313,121.833757518929,0.0841836734693878,279.81365601206,28.4916640620183,180.51808051234,8.41836734693877
2020-08-17,5612,50,5434,42,178,8,6246,50,85133,289,91379,339,1,43,-70,846,119,4723,0,253,54,"Knox County",470313,125.660995975021,0.0864345738295318,72.0796575897328,10.6312179335889,179.880207436324,8.64345738295318
2020-08-16,5562,83,5392,78,170,5,6196,82,84844,587,91040,669,0,42,11,916,72,4604,1,253,53,"Knox County",470313,127.149366485723,0.0871644964124369,142.24569595142,17.6478217697576,194.763912543349,8.71644964124369
2020-08-15,5479,119,5314,116,165,3,6114,132,84257,1223,90371,1355,1,42,42,905,76,4532,2,252,52,"Knox County",470313,123.534752388303,0.0928905792861322,288.106006000259,25.3022986819416,192.425044597959,9.28905792861323
2020-08-14,5360,91,5198,83,162,8,5982,96,83034,1024,89016,1120,0,41,5,863,86,4456,2,250,52,"Knox County",470313,136.504838267282,0.0901607212857703,238.139281712392,19.3488166391318,183.494821533745,9.01607212857703
2020-08-13,5269,127,5115,126,154,1,5886,229,82010,1778,87896,2007,1,41,13,858,113,4370,4,248,51,"Knox County",470313,138.205833136656,0.105735727686947,426.737087854259,27.0032935513158,182.431699740386,10.5735727686947
2020-08-12,5142,79,4989,72,153,7,5657,88,80232,892,85889,980,0,40,-40,845,119,4257,1,244,50,"Knox County",470313,145.222436972824,0.106473156948369,208.371871498343,16.7973243350705,179.667583077653,10.6473156948369
2020-08-11,5063,111,4917,108,146,3,5569,117,79340,1121,84909,1238,0,40,2,885,109,4138,5,243,50,"Knox County",470313,140.332076723374,0.103009859885833,263.228956035661,23.6013038125674,188.172557424524,10.3009859885833
2020-08-10,4952,37,4809,35,143,2,5452,35,78219,365,83671,400,1,40,-94,883,130,4029,0,238,48,"Knox County",470313,137.56796006064,0.100270305058566,85.0497434687113,7.86710127085579,187.74730870718,10.0270305058566
2020-08-09,4915,85,4774,81,141,4,5417,109,77854,826,83271,935,1,39,25,977,59,3899,4,238,48,"Knox County",470313,137.993208777984,0.10031113876789,198.803775358113,18.0730704871011,207.733998422327,10.031113876789
2020-08-08,4830,157,4693,156,137,1,5308,176,77028,2284,82336,2460,1,38,96,952,60,3840,4,234,47,"Knox County",470313,146.072934407512,0.0929978118161926,523.055922332574,33.3820243114692,202.418389455533,9.29978118161926
2020-08-07,4673,50,4537,46,136,4,5132,44,74744,403,79876,447,0,37,-34,856,84,3780,0,230,45,"Knox County",470313,137.355335701969,0.0942482579426007,95.0430883262848,10.6312179335889,182.006451023042,9.42482579426007
2020-08-06,4623,113,4491,105,132,8,5088,121,74341,1463,79429,1584,-1,37,41,890,73,3696,5,230,43,"Knox County",470313,134.378594680564,0.0857782197911487,336.796984136097,24.0265525299109,189.235679217883,8.57782197911487
2020-08-05,4510,99,4386,99,124,0,4967,100,72878,1107,77845,1207,1,38,-1,849,99,3623,3,225,42,"Knox County",470313,138.631081853999,0.0848748639825898,256.637600916836,21.049811508506,180.51808051234,8.48748639825898
2020-08-04,4411,112,4287,111,124,1,4867,106,71771,1082,76638,1188,1,37,-31,850,142,3524,9,222,41,"Knox County",470313,138.843706212671,0.0840530349105948,252.597738102072,23.8139281712392,180.730704871011,8.40530349105948
2020-08-03,4299,50,4176,50,123,0,4761,81,70689,593,75450,674,2,36,-59,881,107,3382,1,213,41,"Knox County",470313,141.607822875404,0.0867569158328429,143.308817744778,10.6312179335889,187.322059989837,8.67569158328429
2020-08-02,4249,97,4126,91,123,6,4680,95,70096,692,74776,787,3,34,29,940,65,3275,2,212,40,"Knox County",470313,144.159315179466,0.0866179465676291,167.335370274689,20.6245627911625,199.866897151471,8.66179465676291
2020-08-01,4152,118,4035,110,117,8,4585,118,69404,1417,73989,1535,1,31,29,911,88,3210,1,210,40,"Knox County",470313,135.866965191266,0.0895984909727836,326.37839056118,25.0896743232698,193.70079074999,8.95984909727836
2020-07-31,4034,117,3925,114,109,3,4467,116,67987,1060,72454,1176,2,30,9,882,106,3122,1,209,39,"Knox County",470313,150.112797222275,0.0904183535762483,250.046245798011,24.877049964598,187.534684348508,9.04183535762483
2020-07-30,3917,189,3811,186,106,3,4351,227,66927,2420,71278,2647,1,28,78,873,110,3016,7,208,36,"Knox County",470313,166.272248481331,0.0914912090297374,562.816677404197,40.1860037889661,185.621065120462,9.14912090297373
2020-07-29,3728,75,3625,71,103,4,4124,60,64507,438,68631,498,0,27,-40,795,115,2906,3,201,34,"Knox County",470313,161.169263873208,0.0944150499706055,105.886930618546,15.9468269003834,169.036365144064,9.44150499706055
2020-07-28,3653,154,3554,152,99,2,4064,186,64069,1211,68133,1397,1,27,46,835,107,2791,3,198,30,"Knox County",470313,170.099486937423,0.101331191186596,297.036229064474,32.7441512354538,177.541339490935,10.1331191186596
2020-07-27,3499,83,3402,76,97,7,3878,85,62858,677,66736,762,3,26,-36,789,116,2684,2,195,30,"Knox County",470313,177.116090773591,0.100772551692797,162.019761307895,17.6478217697576,167.760618992033,10.0772551692797
2020-07-26,3416,118,3326,113,90,5,3793,132,62181,1473,65974,1605,0,23,49,825,69,2568,2,193,29,"Knox County",470313,181.581202305699,0.0960498960498961,341.262095668204,25.0896743232698,175.415095904217,9.6049896049896
2020-07-25,3298,175,3213,172,85,3,3661,197,60708,1949,64369,2146,2,23,95,776,78,2499,3,191,28,"Knox County",470313,193.70079074999,0.0980353826605415,456.291873709636,37.2092627675612,164.9965023293,9.80353826605415
2020-07-24,3123,106,3041,99,82,7,3464,113,58759,916,62223,1029,0,21,-15,681,121,2421,4,188,25,"Knox County",470313,191.3619228046,0.0991669972233241,218.79046507326,22.5381820192085,144.797188255481,9.91669972233241
2020-07-23,3017,205,2942,197,75,8,3351,254,57843,2389,61194,2643,0,21,89,696,116,2300,4,184,25,"Knox County",470313,194.763912543349,0.101884920634921,561.96617996951,43.5879935277145,147.986553635558,10.1884920634921
2020-07-22,2812,69,2745,61,67,8,3097,63,55454,437,58551,500,3,21,-68,607,134,2184,3,180,24,"Knox County",470313,193.488166391318,0.102162269390994,106.312179335889,14.6710807483527,129.062985713769,10.2162269390994
2020-07-21,2743,232,2684,228,59,4,3034,280,55017,1691,58051,1971,0,18,120,675,112,2050,12,177,24,"Knox County",470313,210.072866367717,0.10548048048048,419.082610942075,49.3288512118525,143.52144210345,10.548048048048
2020-07-20,2511,74,2456,70,55,4,2754,57,53326,364,56080,421,0,18,-59,555,133,1938,4,165,23,"Knox County",470313,208.159247139671,0.106253029568589,89.5148550008186,15.7342025417116,118.006519062837,10.6253029568589
2020-07-19,2437,84,2386,74,51,10,2697,74,52962,577,55659,651,0,18,-16,614,100,1805,0,161,22,"Knox County",470313,200.93001894483,0.110885589146459,138.418457495328,17.8604461284294,130.551356224472,11.0885589146459
2020-07-18,2353,112,2312,109,41,3,2623,146,52385,2258,55008,2404,1,18,36,630,75,1705,8,161,20,"Knox County",470313,187.534684348508,0.102609418858509,511.148958246955,23.8139281712392,133.95334596322,10.2609418858509
2020-07-17,2241,74,2203,74,38,0,2477,80,50127,347,52604,427,0,17,3,594,71,1630,6,153,19,"Knox County",470313,180.730704871011,0.105800155262282,90.7906011528493,15.7342025417116,126.298869051036,10.5800155262282
2020-07-16,2167,187,2129,185,38,2,2397,228,49780,2035,52177,2263,2,17,97,591,88,1559,3,147,17,"Knox County",470313,176.903466414919,0.107444714599977,481.168923674234,39.7607550716225,125.660995975021,10.7444714599977
2020-07-15,1980,78,1944,78,36,0,2169,80,47745,511,49914,591,3,15,-14,494,89,1471,4,144,17,"Knox County",470313,178.817085642965,0.10827222731439,125.660995975021,16.5846999763987,105.036433183858,10.827222731439
2020-07-14,1902,95,1866,95,36,0,2089,127,47234,777,49323,904,2,12,12,508,81,1382,1,140,16,"Knox County",470313,149.687548504932,0.103380759691946,192.212420239287,20.1993140738189,108.013174205263,10.3380759691946
2020-07-13,1807,94,1771,92,36,2,1962,59,46457,655,48419,714,1,10,20,496,73,1301,2,139,15,"Knox County",470313,153.940035678367,0.099823987930601,151.81379209165,19.9866897151471,105.461681901202,9.9823987930601
2020-07-12,1713,69,1679,67,34,2,1903,87,45802,916,47705,1003,0,9,27,476,42,1228,4,137,12,"Knox County",470313,150.750670298291,0.097158680471948,213.262231747793,14.6710807483527,101.209194727766,9.7158680471948
2020-07-11,1644,28,1612,27,32,1,1816,36,44886,883,46702,919,0,9,-16,449,44,1186,2,133,11,"Knox County",470313,132.890224169861,0.10218443043542,195.401785619364,5.95348204280979,95.4683370436284,10.218443043542
2020-07-10,1616,78,1585,74,31,4,1780,68,44003,418,45783,486,0,9,29,465,49,1142,6,131,10,"Knox County",470313,133.740721604548,0.0995639534883721,103.335438314484,16.5846999763987,98.8703267823768,9.95639534883721
2020-07-09,1538,70,1511,66,27,4,1712,88,43585,1652,45297,1740,0,9,23,436,47,1093,8,125,10,"Knox County",470313,108.86367163995,0.0857322636463741,369.966384088894,14.8837051070245,92.7042203808953,8.57322636463741
2020-07-08,1468,70,1445,65,23,5,1624,63,41933,594,43557,657,1,9,15,413,54,1046,5,117,10,"Knox County",470313,107.162676770576,0.0822045773003269,139.694203647358,14.8837051070245,87.8138601314444,8.2204577300327
2020-07-07,1398,79,1380,79,18,0,1561,104,41339,1304,42900,1408,0,8,38,398,41,992,7,112,10,"Knox County",470313,103.760687031828,0.0729031326692652,299.375097009864,16.7973243350705,84.6244947513677,7.29031326692652
2020-07-06,1319,35,1301,35,18,0,1457,34,40035,658,41492,692,1,8,-19,360,53,951,6,105,9,"Knox County",470313,91.2158498701928,0.0695148443157133,147.13605620087,7.44185255351224,76.5447691218401,6.95148443157133
2020-07-05,1284,77,1266,77,18,0,1423,109,39377,1080,40800,1189,2,7,34,379,41,898,6,99,9,"Knox County",470313,92.9168447395671,0.0707939641799464,252.810362460744,16.3720756177269,80.5846319366039,7.07939641799464
2020-07-04,1207,41,1189,40,18,1,1314,50,38297,1141,39611,1191,0,5,4,345,37,857,1,93,8,"Knox County",470313,95.6809614023002,0.0700801303816379,253.235611178088,8.7175987055429,73.3554037417635,7.00801303816379
2020-07-03,1166,62,1149,61,17,1,1264,49,37156,910,38420,959,0,5,27,341,35,820,4,92,6,"Knox County",470313,92.2789716635517,0.0634252169474222,203.906759966235,13.1827102376502,72.5049063070764,6.34252169474222
2020-07-02,1104,68,1088,68,16,0,1215,102,36246,1228,37461,1330,0,5,33,314,35,785,2,88,6,"Knox County",470313,91.8537229462082,0.0688122811742526,282.790397033465,14.4584563896809,66.7640486229383,6.88122811742526
2020-07-01,1036,49,1020,49,16,0,1113,34,35018,737,36131,771,0,5,25,281,24,750,4,86,6,"Knox County",470313,87.3886114141008,0.0639257294429708,163.933380535941,10.4185935749171,59.7474447867697,6.39257294429708
2020-06-30,987,40,971,39,16,1,1079,73,34281,1514,35360,1587,0,5,18,256,22,726,3,82,5,"Knox County",470313,79.0962614259015,0.0584272574167638,337.434857212112,8.50497434687113,54.4318358199752,5.84272574167638
2020-06-29,947,51,932,51,15,0,1006,79,32767,1333,33773,1412,0,5,20,238,31,704,3,79,5,"Knox County",470313,82.4982511646499,0.0587747363431686,300.225594444551,10.8438422922607,50.6045973638832,5.87747363431686
2020-06-28,896,10,881,10,15,0,927,30,31434,684,32361,714,0,5,-5,218,15,673,1,76,5,"Knox County",470313,68.2524191336408,0.0523606228026118,151.81379209165,2.12624358671778,46.3521101904476,5.23606228026117
2020-06-27,886,29,871,29,15,0,897,16,30750,111,31647,127,0,5,18,223,11,658,3,75,5,"Knox County",470313,65.7009268295794,0.0555072463768116,27.0032935513158,6.16610640148157,47.4152319838065,5.55072463768116
2020-06-26,857,37,842,37,15,0,881,14,30639,319,31520,333,0,5,17,205,20,647,8,72,5,"Knox County",470313,60.385317862785,0.0554670066942939,70.8039114377021,7.86710127085579,43.5879935277145,5.54670066942939
2020-06-25,820,32,805,32,15,0,867,52,30320,702,31187,754,0,5,13,188,19,627,1,64,5,"Knox County",470313,52.730840950601,0.0522990522990523,160.318766438521,6.8039794774969,39.9733794302943,5.22990522990523
2020-06-24,788,35,773,34,15,1,815,32,29618,272,30433,304,0,5,22,175,13,608,1,63,5,"Knox County",470313,49.7540999291961,0.0565857388644619,64.6378050362206,7.44185255351224,37.2092627675612,5.65857388644619
2020-06-23,753,27,739,24,14,3,783,25,29346,215,30129,240,0,5,18,153,9,595,4,62,5,"Knox County",470313,46.989983266463,0.0638516992790937,51.0298460812268,5.74085768413801,32.5315268767821,6.38516992790937
2020-06-22,726,36,715,36,11,0,758,31,29131,572,29889,603,0,5,20,135,16,586,0,58,5,"Knox County",470313,43.8006178863863,0.0650406504065041,128.212488279082,7.65447691218401,28.7042884206901,6.50406504065041
2020-06-21,690,31,679,31,11,0,727,37,28559,815,29286,852,0,5,16,115,15,570,1,58,5,"Knox County",470313,48.2657294184936,0.0644257703081232,181.155953588355,6.59135511882512,24.4518012472545,6.44257703081232
2020-06-20,659,17,648,17,11,0,690,9,27744,437,28434,446,0,5,11,99,6,555,2,57,5,"Knox County",470313,45.7142371144323,0.0566251415628539,94.8304639676131,3.61461409742023,21.049811508506,5.66251415628539
2020-06-19,642,30,631,28,11,2,681,10,27307,334,27988,344,0,5,8,88,22,549,1,55,5,"Knox County",470313,44.2258666037299,0.0553203499858877,73.1427793830917,6.37873076015334,18.7109435631165,5.53203499858877
2020-06-18,612,15,603,15,9,0,671,18,26973,804,27644,822,0,5,2,80,13,527,0,54,5,"Knox County",470313,40.6112525063096,0.0448629188590418,174.777222828202,3.18936538007667,17.0099486937423,4.48629188590418
2020-06-17,597,17,588,17,9,0,653,13,26169,282,26822,295,0,5,-3,78,20,514,0,54,5,"Knox County",470313,36.7840140502176,0.0397001665741255,62.7241858081746,3.61461409742023,16.5846999763987,3.97001665741255
2020-06-16,580,9,571,8,9,1,640,9,25887,178,26527,187,0,5,-2,81,11,494,0,54,5,"Knox County",470313,32.9567755941256,0.0357847280924204,39.7607550716225,1.913619228046,17.222573052414,3.57847280924204
2020-06-15,571,8,563,8,8,0,631,9,25709,218,26340,227,0,5,-5,83,13,483,0,54,5,"Knox County",470313,27.0032935513158,0.0330917113142137,48.2657294184936,1.70099486937423,17.6478217697576,3.30917113142137
2020-06-14,563,8,555,8,8,0,622,9,25491,624,26113,633,0,5,4,88,4,470,0,54,5,"Knox County",470313,22.1129333018649,0.0260663507109005,134.591219039236,1.70099486937423,18.7109435631165,2.60663507109005
2020-06-13,555,10,547,8,8,2,613,9,24867,213,25480,222,0,5,0,84,10,466,3,54,5,"Knox County",470313,20.6245627911625,0.0282051282051282,47.2026076251348,2.12624358671778,17.8604461284294,2.82051282051282
2020-06-12,545,19,539,19,6,0,604,19,24654,750,25258,769,0,5,1,84,18,456,0,51,5,"Knox County",470313,18.2856948457729,0.0272583201267829,163.508131818597,4.03986281476378,17.8604461284294,2.72583201267829
2020-06-11,526,7,520,7,6,0,585,10,23904,379,24489,389,0,5,1,83,6,438,2,51,5,"Knox County",470313,16.5846999763987,0.0286554004408523,82.7108755233217,1.48837051070245,17.6478217697576,2.86554004408523
2020-06-10,519,12,513,12,6,0,575,12,23525,706,24100,718,0,5,-6,82,18,432,0,49,5,"Knox County",470313,15.5215781830398,0.024483306836248,152.664289526337,2.55149230406134,17.4351974110858,2.4483306836248
2020-06-09,507,16,501,16,6,0,563,19,22819,508,23382,527,0,5,5,88,11,414,1,49,5,"Knox County",470313,17.0099486937423,0.0249641319942611,112.053037020027,3.40198973874845,18.7109435631165,2.49641319942611
2020-06-08,491,8,485,8,6,0,544,8,22311,336,22855,344,0,5,4,83,4,403,1,48,5,"Knox County",470313,17.0099486937423,0.0238756246529706,73.1427793830917,1.70099486937423,17.6478217697576,2.38756246529706
2020-06-07,483,7,477,7,6,0,536,8,21975,848,22511,856,0,5,0,79,7,399,1,47,5,"Knox County",470313,16.7973243350705,0.0222222222222222,182.006451023042,1.48837051070245,16.7973243350705,2.22222222222222
2020-06-06,476,11,470,11,6,0,528,12,21127,478,21655,490,0,5,5,79,6,392,0,46,5,"Knox County",470313,17.0099486937423,0.021500122159785,104.185935749171,2.33886794538956,16.7973243350705,2.1500122159785
2020-06-05,465,18,459,18,6,0,516,17,20649,518,21165,535,0,5,7,74,11,386,1,46,5,"Knox County",470313,16.7973243350705,0.0222855662088624,113.754031889401,3.82723845609201,15.7342025417116,2.22855662088624
2020-06-04,447,4,441,4,6,0,499,4,20131,338,20630,342,0,5,-1,67,5,375,0,45,5,"Knox County",470313,16.1594512590551,0.0209863588667366,72.7175306657481,0.850497434687113,14.2458320310091,2.09863588667366
2020-06-03,443,4,437,4,6,0,495,4,19793,399,20288,403,0,5,-3,68,7,370,0,45,5,"Knox County",470313,14.4584563896809,0.0205890763511581,85.6876165447266,0.850497434687113,14.4584563896809,2.05890763511581
2020-06-02,439,26,433,25,6,1,491,24,19394,939,19885,963,0,5,21,71,5,363,2,45,5,"Knox County",470313,16.5846999763987,0.0195779303330791,204.757257400922,5.52823332546623,15.0963294656962,1.95779303330791
2020-06-01,413,17,408,17,5,0,467,20,18455,972,18922,992,0,5,4,50,13,358,0,43,5,"Knox County",470313,18.4983192044447,0.0194280724732591,210.923363802404,3.61461409742023,10.6312179335889,1.94280724732591
2020-05-31,396,7,391,7,5,0,447,7,17483,317,17930,324,0,5,3,46,4,345,0,43,5,"Knox County",470313,18.4983192044447,0.0217337614225735,68.8902922096561,1.48837051070245,9.7807204989018,2.17337614225735
2020-05-30,389,6,384,6,5,0,440,6,17166,294,17606,300,0,5,-1,43,7,341,2,43,5,"Knox County",470313,17.4351974110858,0.0212490282456595,63.7873076015334,1.27574615203067,9.14284742288646,2.12490282456595
2020-05-29,383,8,378,8,5,0,434,7,16872,205,17306,212,0,5,0,44,8,334,0,41,5,"Knox County",470313,15.308953824368,0.0203619909502262,45.076364038417,1.70099486937423,9.35547178155824,2.03619909502262
2020-05-28,375,11,370,11,5,0,427,11,16667,336,17094,347,0,5,7,44,4,326,0,41,5,"Knox County",470313,16.7973243350705,0.022310081897769,73.780652459107,2.33886794538956,9.35547178155824,2.2310081897769
2020-05-27,364,5,359,5,5,0,416,6,16331,420,16747,426,0,5,0,37,5,322,1,41,5,"Knox County",470313,17.0099486937423,0.0227272727272727,90.5779767941775,1.06312179335889,7.86710127085579,2.27272727272727
2020-05-26,359,9,354,9,5,0,410,10,15911,1142,16321,1152,0,5,7,37,2,317,0,40,5,"Knox County",470313,13.395334596322,0.0178523847588596,244.943261189888,1.913619228046,7.86710127085579,1.78523847588596
2020-05-25,350,9,345,9,5,0,400,11,14769,381,15169,392,0,5,5,30,4,315,1,40,5,"Knox County",470313,11.6943397269478,0.018395179194418,83.348748599337,1.913619228046,6.37873076015334,1.8395179194418
2020-05-24,341,2,336,2,5,0,389,3,14388,273,14777,276,0,5,1,25,1,311,0,39,5,"Knox County",470313,10.6312179335889,0.0173913043478261,58.6843229934108,0.425248717343556,5.31560896679445,1.73913043478261
2020-05-23,339,7,334,7,5,0,386,10,14115,360,14501,370,0,5,4,24,3,310,2,39,5,"Knox County",470313,10.8438422922607,0.0182677165354331,78.6710127085579,1.48837051070245,5.10298460812268,1.82677165354331
2020-05-22,332,1,327,1,5,0,376,1,13755,253,14131,254,0,5,-14,20,15,307,0,37,5,"Knox County",470313,9.35547178155824,0.0161641280696301,54.0065871026317,0.212624358671778,4.25248717343556,1.61641280696301
2020-05-21,331,0,326,0,5,0,375,0,13502,250,13877,250,0,5,-1,34,1,292,0,37,5,"Knox County",470313,7.01660383616868,0.0131410256410256,53.1560896679445,0,7.22922819484046,1.31410256410256
2020-05-20,331,7,326,7,5,0,375,7,13252,360,13627,367,0,5,4,35,3,291,0,37,5,"Knox County",470313,7.44185255351224,0.0137210062071219,78.0331396325426,1.48837051070245,7.44185255351224,1.37210062071219
2020-05-19,324,7,319,7,5,0,368,7,12892,369,13260,376,0,5,4,31,3,288,2,37,5,"Knox County",470313,7.01660383616868,0.0170678336980306,79.9467588605886,1.48837051070245,6.59135511882512,1.70678336980306
2020-05-18,317,3,312,3,5,0,361,4,12523,478,12884,482,0,5,0,27,3,285,0,35,5,"Knox County",470313,5.74085768413801,0.0134736842105263,102.484940879797,0.637873076015334,5.74085768413801,1.34736842105263
2020-05-17,314,3,309,3,5,0,357,5,12045,216,12402,221,0,5,1,27,2,282,1,35,5,"Knox County",470313,5.95348204280979,0.0146551724137931,46.989983266463,0.637873076015334,5.74085768413801,1.46551724137931
2020-05-16,311,0,306,0,5,0,352,0,11829,349,12181,349,0,5,-4,26,4,280,0,34,5,"Knox County",470313,4.46511153210734,0.0104393214441061,74.2059011764506,0,5.52823332546623,1.04393214441061
2020-05-15,311,1,306,1,5,0,352,4,11480,540,11832,544,0,5,-4,30,5,276,0,34,5,"Knox County",470313,4.46511153210734,0.0104287369640788,115.667651117447,0.212624358671778,6.37873076015334,1.04287369640788
2020-05-14,310,3,305,3,5,0,348,7,10940,458,11288,465,0,5,0,34,3,271,0,34,5,"Knox County",470313,5.10298460812268,0.0121255349500713,98.8703267823768,0.637873076015334,7.22922819484046,1.21255349500713
2020-05-13,307,7,302,7,5,0,341,5,10482,341,10823,346,0,5,1,34,6,268,0,34,5,"Knox County",470313,5.10298460812268,0.011498383039885,73.5680281004352,1.48837051070245,7.22922819484046,1.1498383039885
2020-05-12,300,6,295,6,5,0,336,8,10141,401,10477,409,0,5,3,33,3,262,0,34,5,"Knox County",470313,4.8903602494509,0.01171875,86.9633626967573,1.27574615203067,7.01660383616868,1.171875
2020-05-11,294,16,289,16,5,0,328,12,9740,254,10068,266,0,5,9,30,7,259,1,34,5,"Knox County",470313,7.65447691218401,0.0157692307692308,56.558079406693,3.40198973874845,6.37873076015334,1.57692307692308
2020-05-10,278,5,273,5,5,0,316,5,9486,221,9802,226,0,5,1,21,4,252,1,33,5,"Knox County",470313,8.07972562952757,0.0157389635316699,48.0531050598219,1.06312179335889,4.46511153210734,1.57389635316699
2020-05-09,273,2,268,2,5,0,311,4,9265,352,9576,356,0,5,-1,20,3,248,0,32,5,"Knox County",470313,8.50497434687113,0.0172281776416539,75.694271687153,0.425248717343556,4.25248717343556,1.72281776416539
2020-05-08,271,3,266,3,5,0,307,4,8913,265,9220,269,0,5,-2,21,5,245,0,32,5,"Knox County",470313,8.93022306421468,0.0192554557124519,57.1959524827083,0.637873076015334,4.46511153210734,1.92554557124519
2020-05-07,268,3,263,3,5,0,303,3,8648,220,8951,223,0,5,-2,23,5,240,0,32,5,"Knox County",470313,8.93022306421468,0.0195704057279236,47.4152319838065,0.637873076015334,4.8903602494509,1.95704057279236
2020-05-06,265,1,260,1,5,0,300,1,8428,185,8728,186,0,5,-7,25,8,235,0,32,5,"Knox County",470313,7.65447691218401,0.0191214470284238,39.5481307129507,0.212624358671778,5.31560896679445,1.91214470284238
2020-05-05,264,4,259,4,5,0,299,5,8243,305,8542,310,0,5,-1,32,5,227,0,32,5,"Knox County",470313,7.22922819484046,0.0185185185185185,65.9135511882512,0.850497434687113,6.8039794774969,1.85185185185185
2020-05-04,260,4,255,4,5,0,294,7,7938,259,8232,266,0,5,-3,33,7,222,0,32,5,"Knox County",470313,4.67773589077912,0.0157952069716776,56.558079406693,0.850497434687113,7.01660383616868,1.57952069716776
2020-05-03,256,7,251,5,5,2,287,6,7679,290,7966,296,0,5,6,36,1,215,2,32,5,"Knox County",470313,5.10298460812268,0.0157397691500525,62.9368101668463,1.48837051070245,7.65447691218401,1.57397691500525
2020-05-02,249,3,246,3,3,0,281,5,7389,308,7670,313,0,5,1,30,2,214,1,30,5,"Knox County",470313,5.31560896679445,0.0166398282340311,66.5514242642666,0.637873076015334,6.37873076015334,1.66398282340311
2020-05-01,246,9,243,8,3,1,276,7,7081,354,7357,361,0,5,4,29,5,212,0,29,5,"Knox County",470313,6.59135511882512,0.0173913043478261,76.7573934805119,1.913619228046,6.16610640148157,1.73913043478261
2020-04-30,237,4,235,4,2,0,269,3,6727,119,6996,122,0,5,-1,25,5,207,0,29,5,"Knox County",470313,6.8039794774969,0.0183387270765912,25.9401717579569,0.850497434687113,5.31560896679445,1.83387270765912
2020-04-29,233,8,231,8,2,0,266,10,6608,671,6874,681,0,5,5,26,3,202,0,29,5,"Knox County",470313,8.29234998819935,0.0183056619838229,144.797188255481,1.70099486937423,5.52823332546623,1.83056619838229
2020-04-28,225,8,223,8,2,0,256,10,5937,391,6193,401,1,5,4,21,3,199,0,29,5,"Knox County",470313,9.14284742288646,0.019672131147541,85.262367827383,1.70099486937423,4.46511153210734,1.9672131147541
2020-04-27,217,2,215,2,2,0,246,4,5546,161,5792,165,0,4,1,17,1,196,0,29,5,"Knox County",470313,8.7175987055429,0.0192389910218042,35.0830191808434,0.425248717343556,3.61461409742023,1.92389910218042
2020-04-26,215,1,213,1,2,0,242,1,5385,172,5627,173,0,4,-2,16,3,195,0,29,4,"Knox County",470313,7.44185255351224,0.0180505415162455,36.7840140502176,0.212624358671778,3.40198973874845,1.80505415162455
2020-04-25,214,0,212,0,2,0,241,0,5213,53,5454,53,0,4,-6,18,6,192,0,29,4,"Knox County",470313,6.8039794774969,0.0178936605316973,11.2690910096042,0,3.82723845609201,1.78936605316973
2020-04-24,214,8,212,8,2,0,241,10,5160,836,5401,846,0,4,5,24,3,186,1,29,4,"Knox County",470313,6.59135511882512,0.0155673904137649,179.880207436324,1.70099486937423,5.10298460812268,1.55673904137648
2020-04-23,206,1,204,1,2,0,231,2,4324,137,4555,139,0,4,0,19,1,183,0,28,4,"Knox County",470313,5.95348204280979,0.0150528885272579,29.5547858553772,0.212624358671778,4.03986281476378,1.50528885272579
2020-04-22,205,5,203,3,2,2,229,2,4187,189,4416,191,0,4,1,19,4,182,0,28,4,"Knox County",470313,5.31560896679445,0.0147357723577236,40.6112525063096,1.06312179335889,4.03986281476378,1.47357723577236
2020-04-21,200,4,200,4,0,0,227,5,3998,475,4225,480,0,4,-2,18,6,178,1,28,4,"Knox County",470313,4.46511153210734,0.0117244748412311,102.059692162454,0.850497434687113,3.82723845609201,1.17244748412311
2020-04-20,196,3,196,3,0,0,222,2,3523,175,3745,177,0,4,-1,20,4,172,1,27,4,"Knox County",470313,4.67773589077912,0.0106847984458475,37.6345114849047,0.637873076015334,4.25248717343556,1.06847984458475
2020-04-19,193,0,193,0,0,0,220,0,3348,72,3568,72,0,4,-4,21,4,168,0,26,4,"Knox County",470313,4.46511153210734,0.0107252298263534,15.308953824368,0,4.46511153210734,1.07252298263534
2020-04-18,193,0,193,0,0,0,220,1,3276,135,3496,136,0,4,-5,25,5,164,0,26,4,"Knox County",470313,4.46511153210734,0.0107790298873101,28.9169127793618,0,5.31560896679445,1.07790298873101
2020-04-17,193,2,193,2,0,0,219,3,3141,104,3360,107,0,4,-2,30,4,159,1,26,4,"Knox County",470313,3.18936538007667,0.0115207373271889,22.7508063778803,0.425248717343556,6.37873076015334,1.15207373271889
2020-04-16,191,7,191,7,0,0,216,9,3037,213,3253,222,0,4,2,32,5,155,2,25,4,"Knox County",470313,4.46511153210734,0.015884476534296,47.2026076251348,1.48837051070245,6.8039794774969,1.5884476534296
2020-04-15,184,9,184,9,0,0,207,10,2824,84,3031,94,0,4,3,30,6,150,1,23,4,"Knox County",470313,5.31560896679445,0.0232919254658385,19.9866897151471,1.913619228046,6.37873076015334,2.32919254658385
2020-04-14,175,4,175,4,0,0,197,4,2740,102,2937,106,0,4,1,27,3,144,1,22,4,"Knox County",470313,5.31560896679445,0.0317286652078775,22.5381820192085,0.850497434687113,5.74085768413801,3.17286652078775
2020-04-13,171,4,171,4,0,0,193,9,2638,242,2831,251,0,4,-2,26,6,141,1,21,4,"Knox County",470313,5.52823332546623,0.0364372469635627,53.3687140266163,0.850497434687113,5.52823332546623,3.64372469635628
2020-04-12,167,5,167,5,0,0,184,6,2396,166,2580,172,0,4,1,28,4,135,0,20,4,"Knox County",470313,6.59135511882512,0.0386029411764706,36.5713896915458,1.06312179335889,5.95348204280979,3.86029411764706
2020-04-11,162,5,162,5,0,0,178,8,2230,313,2408,321,1,4,-4,27,8,131,1,20,4,"Knox County",470313,7.65447691218401,0.0384917517674784,68.2524191336408,1.06312179335889,5.74085768413801,3.84917517674784
2020-04-10,157,4,157,4,0,0,170,5,1917,123,2087,128,0,3,0,31,4,123,0,19,4,"Knox County",470313,8.07972562952757,0.0394126738794436,27.2159179099876,0.850497434687113,6.59135511882512,3.94126738794436
2020-04-09,153,1,153,1,0,0,165,1,1794,81,1959,82,0,3,-2,31,3,119,0,19,4,"Knox County",470313,6.8039794774969,0.037261698440208,17.4351974110858,0.212624358671778,6.59135511882512,3.7261698440208
2020-04-08,152,8,152,8,0,0,164,12,1713,111,1877,123,0,3,-3,33,11,116,1,19,4,"Knox County",470313,6.59135511882512,0.0380388841927303,26.1527961166287,1.70099486937423,7.01660383616868,3.80388841927303
2020-04-07,144,20,144,20,0,0,152,25,1602,366,1754,391,0,3,11,36,9,105,2,18,3,"Knox County",470313,9.99334485757357,0.0449591280653951,83.1361242406653,4.25248717343556,7.65447691218401,4.49591280653951
2020-04-06,124,8,124,8,0,0,127,14,1236,54,1363,68,2,3,-2,25,8,96,1,16,3,"Knox County",470313,10.8438422922607,0.0552529182879377,14.4584563896809,1.70099486937423,5.31560896679445,5.52529182879377
2020-04-05,116,4,116,4,0,0,113,10,1182,75,1295,85,0,1,-2,27,6,88,0,15,3,"Knox County",470313,10.6312179335889,0.0626043405676127,18.0730704871011,0.850497434687113,5.74085768413801,6.26043405676127
2020-04-04,112,15,112,15,0,0,103,6,1107,127,1210,133,0,1,4,29,11,82,1,15,2,"Knox County",470313,12.7574615203067,0.0722772277227723,28.2790397033465,3.18936538007667,6.16610640148157,7.22772277227723
2020-04-03,97,4,97,4,0,0,97,3,980,51,1077,54,0,1,-8,25,12,71,1,14,1,"Knox County",470313,12.7574615203067,0.0758547008547008,11.481715368276,0.850497434687113,5.31560896679445,7.58547008547009
2020-04-02,93,7,93,7,0,0,94,7,929,106,1023,113,0,1,NA,33,8,59,0,13,1,"Knox County",470313,14.0332076723374,0.0796277145811789,24.0265525299109,1.48837051070245,7.01660383616868,7.96277145811789
2020-04-01,86,15,86,15,0,0,87,15,823,140,910,155,NA,NA,NA,NA,7,51,1,13,1,"Knox County",470313,15.5215781830398,0.0800800800800801,32.9567755941256,3.18936538007667,NA,8.00800800800801
2020-03-31,71,8,71,8,0,0,72,11,683,58,755,69,NA,NA,NA,NA,12,44,1,12,1,"Knox County",470313,12.9700858789785,0.0974889217134417,14.6710807483527,1.70099486937423,NA,9.74889217134417
2020-03-30,63,13,63,13,0,0,61,15,625,130,686,145,NA,NA,NA,NA,9,32,2,11,1,"Knox County",470313,14.0332076723374,0.0888594164456233,30.8305320074078,2.76411666273312,NA,8.88594164456233
2020-03-29,50,8,50,8,0,0,46,8,495,55,541,63,NA,NA,NA,NA,6,23,1,9,1,"Knox County",470313,14.8837051070245,0.0887978142076503,13.395334596322,1.70099486937423,NA,8.87978142076503
2020-03-28,42,7,42,7,0,0,38,6,440,62,478,68,NA,NA,NA,NA,1,17,1,8,0,"Knox County",470313,13.1827102376502,0.0974512743628186,14.4584563896809,1.48837051070245,NA,9.74512743628186
2020-03-27,35,2,35,2,0,0,32,2,378,54,410,56,NA,NA,NA,NA,5,16,1,7,0,"Knox County",470313,12.7574615203067,0.0956651718983558,11.9069640856196,0.425248717343556,NA,9.56651718983558
2020-03-26,33,7,33,7,0,0,30,7,324,82,354,89,NA,NA,NA,NA,3,11,2,6,0,"Knox County",470313,12.7574615203067,0.0992248062015504,18.9235679217883,1.48837051070245,NA,9.92248062015504
2020-03-25,26,6,26,6,0,0,23,7,242,68,265,75,NA,NA,NA,NA,3,8,1,4,0,"Knox County",470313,10.8438422922607,0.0991150442477876,15.9468269003834,1.27574615203067,NA,9.91150442477876
2020-03-24,20,7,20,7,0,0,16,7,174,43,190,50,NA,NA,NA,NA,2,5,0,3,0,"Knox County",470313,10.6312179335889,0.0952380952380952,10.6312179335889,1.48837051070245,NA,9.52380952380952
2020-03-23,13,4,13,4,0,0,9,4,131,22,140,26,NA,NA,NA,NA,3,3,2,3,0,"Knox County",470313,8.7175987055429,0.0960187353629977,5.52823332546623,0.850497434687113,NA,9.60187353629976
2020-03-22,9,2,9,2,0,0,5,0,109,9,114,9,NA,NA,NA,NA,0,0,1,1,0,"Knox County",470313,7.44185255351224,0.0884718498659517,1.913619228046,0.425248717343556,NA,8.84718498659517
2020-03-21,7,1,7,1,0,0,5,2,100,17,105,19,NA,NA,NA,NA,0,0,0,0,0,"Knox County",470313,6.16610640148157,0.0895061728395062,4.03986281476378,0.212624358671778,NA,8.95061728395062
2020-03-20,6,5,6,5,0,0,3,2,83,38,86,40,NA,NA,NA,NA,0,0,0,0,0,"Knox County",470313,6.8039794774969,0.0941558441558442,8.50497434687113,1.06312179335889,NA,9.41558441558442
2020-03-19,1,0,1,0,0,0,1,0,45,11,46,11,NA,NA,NA,NA,0,0,0,0,0,"Knox County",470313,5.31560896679445,0.0956521739130435,2.33886794538956,0,NA,9.56521739130435
2020-03-18,1,0,1,0,0,0,1,0,34,15,35,15,NA,NA,NA,NA,0,0,0,0,0,"Knox County",470313,4.03986281476378,0.0882352941176471,3.18936538007667,0,NA,8.82352941176471
2020-03-17,1,0,1,0,0,0,1,0,19,5,20,5,NA,NA,NA,NA,0,0,0,0,0,"Knox County",470313,2.55149230406134,0.064,1.06312179335889,0,NA,6.4
2020-03-16,1,1,1,1,0,0,1,1,14,3,15,4,NA,NA,NA,NA,0,0,0,0,0,"Knox County",470313,1.913619228046,0.0485436893203883,0.850497434687113,0.212624358671778,NA,4.85436893203883
2020-03-15,0,0,0,0,0,0,0,0,11,1,11,1,NA,NA,NA,NA,0,0,0,0,0,"Knox County",470313,1.48837051070245,0.0526315789473684,0.212624358671778,0,NA,5.26315789473684
2020-03-14,0,0,0,0,0,0,0,0,10,8,10,8,NA,NA,NA,NA,0,0,0,0,0,"Knox County",470313,1.27574615203067,0.0357142857142857,1.70099486937423,0,NA,3.57142857142857
2020-03-13,0,0,0,0,0,0,0,0,2,0,2,0,NA,NA,NA,NA,0,0,0,0,0,"Knox County",470313,0.212624358671778,0.0227272727272727,0,0,NA,2.27272727272727
2020-03-12,0,0,0,0,0,0,0,0,2,2,2,2,NA,NA,NA,NA,0,0,0,0,0,"Knox County",470313,0.212624358671778,0.0285714285714286,0.425248717343556,0,NA,2.85714285714286
2020-03-12,0,0,0,0,0,0,0,0,0,0,0,0,NA,NA,NA,NA,0,0,0,0,0,"Anderson",76978,NA,NA,0,0,NA,NA
2020-03-13,0,0,0,0,0,0,0,0,1,1,1,1,NA,NA,NA,NA,0,0,0,0,0,"Anderson",76978,NA,NA,1.29907246226194,0,NA,NA
2020-03-14,0,0,0,0,0,0,0,0,1,0,1,0,NA,NA,NA,NA,0,0,0,0,0,"Anderson",76978,NA,NA,0,0,NA,NA
2020-03-15,0,0,0,0,0,0,0,0,1,0,1,0,NA,NA,NA,NA,0,0,0,0,0,"Anderson",76978,NA,NA,0,0,NA,NA
2020-03-16,0,0,0,0,0,0,0,0,2,1,2,1,NA,NA,NA,NA,0,0,0,0,0,"Anderson",76978,NA,NA,1.29907246226194,0,NA,NA
2020-03-17,0,0,0,0,0,0,0,0,4,2,4,2,NA,NA,NA,NA,0,0,0,0,0,"Anderson",76978,NA,NA,2.59814492452389,0,NA,NA
2020-03-18,0,0,0,0,0,0,0,0,4,0,4,0,NA,NA,NA,NA,0,0,0,0,0,"Anderson",76978,0,0,0,0,NA,0
2020-03-19,1,1,1,1,0,0,2,2,5,1,7,3,NA,NA,NA,NA,0,0,0,0,0,"Anderson",76978,1.29907246226194,0.285714285714286,3.89721738678583,1.29907246226194,NA,28.5714285714286
2020-03-20,1,0,1,0,0,0,2,0,7,2,9,2,NA,NA,NA,NA,0,0,0,0,0,"Anderson",76978,1.29907246226194,0.25,2.59814492452389,0,NA,25
2020-03-21,1,0,1,0,0,0,2,0,7,0,9,0,NA,NA,NA,NA,0,0,0,0,0,"Anderson",76978,1.29907246226194,0.25,0,0,NA,25
2020-03-22,1,0,1,0,0,0,2,0,10,3,12,3,NA,NA,NA,NA,0,0,0,0,0,"Anderson",76978,1.29907246226194,0.181818181818182,3.89721738678583,0,NA,18.1818181818182
2020-03-23,1,0,1,0,0,0,2,0,15,5,17,5,NA,NA,NA,NA,0,0,0,0,0,"Anderson",76978,1.29907246226194,0.133333333333333,6.49536231130973,0,NA,13.3333333333333
2020-03-24,1,0,1,0,0,0,2,0,20,5,22,5,NA,NA,NA,NA,0,0,0,0,0,"Anderson",76978,1.29907246226194,0.111111111111111,6.49536231130973,0,NA,11.1111111111111
2020-03-25,2,1,2,1,0,0,4,2,29,9,33,11,NA,NA,NA,NA,1,1,0,0,0,"Anderson",76978,2.59814492452389,0.137931034482759,14.2897970848814,1.29907246226194,NA,13.7931034482759
2020-03-26,3,1,3,1,0,0,5,1,44,15,49,16,NA,NA,NA,NA,0,1,1,1,0,"Anderson",76978,2.59814492452389,0.0714285714285714,20.7851593961911,1.29907246226194,NA,7.14285714285714
2020-03-27,4,1,4,1,0,0,6,1,53,9,59,10,NA,NA,NA,NA,3,4,0,1,0,"Anderson",76978,3.89721738678583,0.08,12.9907246226195,1.29907246226194,NA,8
2020-03-28,7,3,7,3,0,0,9,3,72,19,81,22,NA,NA,NA,NA,0,4,1,2,0,"Anderson",76978,7.79443477357167,0.0972222222222222,28.5795941697628,3.89721738678583,NA,9.72222222222222
2020-03-29,7,0,7,0,0,0,9,0,83,11,92,11,NA,NA,NA,NA,0,4,0,2,0,"Anderson",76978,7.79443477357167,0.0875,14.2897970848814,0,NA,8.75
2020-03-30,8,1,8,1,0,0,10,1,127,44,137,45,NA,NA,NA,NA,1,5,0,2,0,"Anderson",76978,9.09350723583361,0.0666666666666667,58.4582608017875,1.29907246226194,NA,6.66666666666667
2020-03-31,9,1,9,1,0,0,11,1,142,15,153,16,NA,NA,NA,NA,1,6,0,2,0,"Anderson",76978,10.3925796980956,0.0687022900763359,20.7851593961911,1.29907246226194,NA,6.87022900763359
2020-04-01,9,0,9,0,0,0,11,0,163,21,174,21,NA,NA,NA,NA,0,6,0,2,0,"Anderson",76978,9.09350723583361,0.049645390070922,27.2805217075008,0,NA,4.9645390070922
2020-04-02,9,0,9,0,0,0,11,0,179,16,190,16,0,0,NA,3,0,6,0,2,0,"Anderson",76978,7.79443477357167,0.0425531914893617,20.7851593961911,0,3.89721738678583,4.25531914893617
2020-04-03,9,0,9,0,0,0,11,0,192,13,203,13,0,0,-2,1,2,8,0,2,0,"Anderson",76978,6.49536231130972,0.0347222222222222,16.8879420094053,0,1.29907246226194,3.47222222222222
2020-04-04,9,0,9,0,0,0,11,0,219,27,230,27,0,0,0,1,0,8,0,2,0,"Anderson",76978,2.59814492452389,0.0134228187919463,35.0749564810725,0,1.29907246226194,1.34228187919463
2020-04-05,9,0,9,0,0,0,11,0,248,29,259,29,0,0,0,1,0,8,0,2,0,"Anderson",76978,2.59814492452389,0.0119760479041916,37.6731014055964,0,1.29907246226194,1.19760479041916
2020-04-06,9,0,9,0,0,0,11,0,262,14,273,14,0,0,-1,0,1,9,0,2,0,"Anderson",76978,1.29907246226194,0.00735294117647059,18.1870144716672,0,0,0.735294117647059
2020-04-07,10,1,10,1,0,0,12,1,304,42,316,43,0,0,1,1,0,9,0,2,0,"Anderson",76978,1.29907246226194,0.00613496932515337,55.8601158772636,1.29907246226194,1.29907246226194,0.613496932515337
2020-04-08,10,0,10,0,0,0,12,0,322,18,334,18,1,1,-1,0,0,9,0,2,1,"Anderson",76978,1.29907246226194,0.00625,23.383304320715,0,0,0.625
2020-04-09,10,0,10,0,0,0,12,0,350,28,362,28,0,1,0,0,0,9,0,2,1,"Anderson",76978,1.29907246226194,0.00581395348837209,36.3740289433345,0,0,0.581395348837209
2020-04-10,10,0,10,0,0,0,12,0,366,16,378,16,0,1,0,0,0,9,0,2,1,"Anderson",76978,1.29907246226194,0.00571428571428571,20.7851593961911,0,0,0.571428571428571
2020-04-11,10,0,10,0,0,0,12,0,439,73,451,73,0,1,0,0,0,9,0,2,1,"Anderson",76978,1.29907246226194,0.00452488687782805,94.832289745122,0,0,0.452488687782805
2020-04-12,12,2,12,2,0,0,14,2,477,38,491,40,0,1,2,2,0,9,0,2,1,"Anderson",76978,3.89721738678583,0.0129310344827586,51.9628984904778,2.59814492452389,2.59814492452389,1.29310344827586
2020-04-13,13,1,13,1,0,0,15,1,514,37,529,38,0,1,0,2,1,10,0,2,1,"Anderson",76978,5.19628984904778,0.015625,49.3647535659539,1.29907246226194,2.59814492452389,1.5625
2020-04-14,13,0,13,0,0,0,15,0,526,12,541,12,0,1,0,2,0,10,0,2,1,"Anderson",76978,3.89721738678583,0.0133333333333333,15.5888695471433,0,2.59814492452389,1.33333333333333
2020-04-15,13,0,13,0,0,0,15,0,544,18,559,18,0,1,-2,0,2,12,0,2,1,"Anderson",76978,3.89721738678583,0.0133333333333333,23.383304320715,0,0,1.33333333333333
2020-04-16,13,0,13,0,0,0,15,0,566,22,581,22,0,1,0,0,0,12,0,2,1,"Anderson",76978,3.89721738678583,0.0136986301369863,28.5795941697628,0,0,1.36986301369863
2020-04-17,13,0,13,0,0,0,15,0,586,20,601,20,0,1,0,0,0,12,0,2,1,"Anderson",76978,3.89721738678583,0.0134529147982063,25.9814492452389,0,0,1.34529147982063
2020-04-18,13,0,13,0,0,0,15,0,616,30,631,30,0,1,0,0,0,12,0,2,1,"Anderson",76978,3.89721738678583,0.0166666666666667,38.9721738678584,0,0,1.66666666666667
2020-04-19,14,1,14,1,0,0,16,1,628,12,644,13,0,1,0,0,1,13,0,2,1,"Anderson",76978,2.59814492452389,0.0130718954248366,16.8879420094053,1.29907246226194,0,1.30718954248366
2020-04-20,19,5,18,4,1,1,19,3,648,20,667,23,0,1,5,5,0,13,0,2,1,"Anderson",76978,7.79443477357167,0.0289855072463768,29.8786666320247,6.49536231130973,6.49536231130973,2.89855072463768
2020-04-21,20,1,19,1,1,0,22,3,1071,423,1093,426,0,1,1,6,0,13,0,2,1,"Anderson",76978,9.09350723583361,0.0126811594202899,553.404868923589,1.29907246226194,7.79443477357167,1.26811594202899
2020-04-22,21,1,20,1,1,0,24,2,1141,70,1165,72,0,1,0,6,1,14,0,2,1,"Anderson",76978,10.3925796980956,0.0148514851485149,93.53321728286,1.29907246226194,7.79443477357167,1.48514851485149
2020-04-23,21,0,20,0,1,0,24,0,1191,50,1215,50,0,1,-1,5,1,15,0,2,1,"Anderson",76978,10.3925796980956,0.0141955835962145,64.9536231130973,0,6.49536231130973,1.41955835962145
2020-04-24,22,1,21,1,1,0,25,1,1299,108,1324,109,0,1,1,6,0,15,0,2,1,"Anderson",76978,11.6916521603575,0.0138312586445367,141.598898386552,1.29907246226194,7.79443477357167,1.38312586445367
2020-04-25,22,0,21,0,1,0,25,0,1336,37,1361,37,0,1,0,6,0,15,0,2,1,"Anderson",76978,11.6916521603575,0.0136986301369863,48.065681103692,0,7.79443477357167,1.36986301369863
2020-04-26,22,0,21,0,1,0,25,0,1372,36,1397,36,0,1,0,6,0,15,0,2,1,"Anderson",76978,10.3925796980956,0.0119521912350598,46.76660864143,0,7.79443477357167,1.19521912350598
2020-04-27,22,0,21,0,1,0,25,0,1411,39,1436,39,0,1,-1,5,1,16,0,2,1,"Anderson",76978,3.89721738678583,0.00780234070221066,50.6638260282159,0,6.49536231130973,0.780234070221066
2020-04-28,22,0,21,0,1,0,25,0,1690,279,1715,279,0,1,0,5,0,16,0,2,1,"Anderson",76978,2.59814492452389,0.00482315112540193,362.441216971083,0,6.49536231130973,0.482315112540193
2020-04-29,26,4,25,4,1,0,28,3,2070,380,2098,383,0,1,4,9,0,16,0,2,1,"Anderson",76978,6.49536231130972,0.00428724544480171,497.544753046325,5.19628984904778,11.6916521603575,0.428724544480171
2020-04-30,26,0,25,0,1,0,29,1,2102,32,2131,33,0,1,-1,8,1,17,0,2,1,"Anderson",76978,6.49536231130972,0.00545851528384279,42.8693912546442,0,10.3925796980956,0.545851528384279
2020-05-01,26,0,25,0,1,0,29,0,2154,52,2183,52,0,1,-2,6,2,19,0,2,1,"Anderson",76978,5.19628984904778,0.00465657741559953,67.5517680376211,0,7.79443477357167,0.465657741559953
2020-05-02,26,0,25,0,1,0,29,0,2221,67,2250,67,0,1,0,6,0,19,0,2,1,"Anderson",76978,5.19628984904778,0.00449943757030371,87.0378549715503,0,7.79443477357167,0.449943757030371
2020-05-03,27,1,26,1,1,0,30,1,2314,93,2344,94,0,1,1,7,0,19,0,2,1,"Anderson",76978,6.49536231130972,0.00527983104540655,122.112811452623,1.29907246226194,9.09350723583361,0.527983104540655
2020-05-04,27,0,26,0,1,0,30,0,2406,92,2436,92,0,1,-1,6,1,20,0,2,1,"Anderson",76978,6.49536231130972,0.005,119.514666528099,0,7.79443477357167,0.5
2020-05-05,28,1,27,1,1,0,30,0,2475,69,2505,69,0,1,-1,5,2,22,0,2,1,"Anderson",76978,7.79443477357167,0.00632911392405063,89.6359998960742,1.29907246226194,6.49536231130973,0.632911392405063
2020-05-06,30,2,29,2,1,0,31,1,2525,50,2556,51,0,1,2,7,0,22,0,2,1,"Anderson",76978,5.19628984904778,0.00655021834061135,66.2526955753592,2.59814492452389,9.09350723583361,0.655021834061135
2020-05-07,30,0,29,0,1,0,33,2,2597,72,2630,74,0,1,-1,6,1,23,0,2,1,"Anderson",76978,5.19628984904778,0.00801603206412826,96.1313622073839,0,7.79443477357167,0.801603206412826
2020-05-08,30,0,29,0,1,0,33,0,2652,55,2685,55,0,1,0,6,0,23,0,2,1,"Anderson",76978,5.19628984904778,0.00796812749003984,71.448985424407,0,7.79443477357167,0.796812749003984
2020-05-09,30,0,29,0,1,0,33,0,2734,82,2767,82,0,1,0,6,0,23,0,2,1,"Anderson",76978,5.19628984904778,0.00773694390715667,106.523941905479,0,7.79443477357167,0.773694390715667
2020-05-10,30,0,29,0,1,0,33,0,2827,93,2860,93,0,1,-3,3,3,26,0,2,1,"Anderson",76978,3.89721738678583,0.00581395348837209,120.813738990361,0,3.89721738678583,0.581395348837209
2020-05-11,32,2,31,2,1,0,33,0,2909,82,2942,82,0,1,2,5,0,26,0,2,1,"Anderson",76978,6.49536231130972,0.00592885375494071,106.523941905479,2.59814492452389,6.49536231130973,0.592885375494071
2020-05-12,33,1,32,1,1,0,35,2,3042,133,3077,135,0,1,1,6,0,26,0,2,1,"Anderson",76978,6.49536231130972,0.00874125874125874,175.374782405363,1.29907246226194,7.79443477357167,0.874125874125874
2020-05-13,35,2,34,2,1,0,38,3,3220,178,3258,181,0,1,1,7,1,27,1,3,1,"Anderson",76978,6.49536231130972,0.00997150997150997,235.132115669412,2.59814492452389,9.09350723583361,0.997150997150997
2020-05-14,35,0,34,0,1,0,39,1,3346,126,3385,127,0,1,-1,6,1,28,0,3,1,"Anderson",76978,6.49536231130972,0.00794701986754967,164.982202707267,0,7.79443477357167,0.794701986754967
2020-05-15,36,1,35,1,1,0,39,0,3417,71,3456,71,0,1,1,7,0,28,0,3,1,"Anderson",76978,7.79443477357167,0.00778210116731518,92.2341448205981,1.29907246226194,9.09350723583361,0.778210116731518
2020-05-16,36,0,35,0,1,0,41,2,3657,240,3698,242,0,1,-1,6,1,29,0,3,1,"Anderson",76978,7.79443477357167,0.00859291084854995,314.375535867391,0,7.79443477357167,0.859291084854995
2020-05-17,36,0,35,0,1,0,41,0,3727,70,3768,70,0,1,0,6,0,29,0,3,1,"Anderson",76978,7.79443477357167,0.00881057268722467,90.9350723583361,0,7.79443477357167,0.881057268722467
2020-05-18,37,1,36,1,1,0,42,1,3804,77,3846,78,0,1,-2,4,3,32,0,3,1,"Anderson",76978,6.49536231130972,0.00995575221238938,101.327652056432,1.29907246226194,5.19628984904778,0.995575221238938
2020-05-19,37,0,36,0,1,0,42,0,3856,52,3898,52,0,1,0,4,0,32,0,3,1,"Anderson",76978,5.19628984904778,0.00852618757612668,67.5517680376211,0,5.19628984904778,0.852618757612667
2020-05-20,37,0,36,0,1,0,43,1,3921,65,3964,66,0,1,0,4,0,32,0,3,1,"Anderson",76978,2.59814492452389,0.00708215297450425,85.7387825092884,0,5.19628984904778,0.708215297450425
2020-05-21,37,0,36,0,1,0,44,1,4001,80,4045,81,0,1,-1,3,1,33,0,3,1,"Anderson",76978,2.59814492452389,0.00757575757575758,105.224869443218,0,3.89721738678583,0.757575757575758
2020-05-22,38,1,37,1,1,0,45,1,4029,28,4074,29,0,1,-1,2,2,35,1,4,1,"Anderson",76978,2.59814492452389,0.00970873786407767,37.6731014055964,1.29907246226194,2.59814492452389,0.970873786407767
2020-05-23,38,0,37,0,1,0,46,1,4192,163,4238,164,0,1,0,2,0,35,0,4,1,"Anderson",76978,2.59814492452389,0.00925925925925926,213.047883810959,0,2.59814492452389,0.925925925925926
2020-05-24,38,0,37,0,1,0,46,0,4247,55,4293,55,0,1,0,2,0,35,0,4,1,"Anderson",76978,2.59814492452389,0.00952380952380952,71.448985424407,0,2.59814492452389,0.952380952380952
2020-05-25,38,0,37,0,1,0,47,1,4281,34,4328,35,0,1,0,2,0,35,0,4,1,"Anderson",76978,1.29907246226194,0.0103734439834025,45.4675361791681,0,2.59814492452389,1.03734439834025
2020-05-26,38,0,37,0,1,0,47,0,4412,131,4459,131,0,1,-1,1,1,36,0,4,1,"Anderson",76978,1.29907246226194,0.0089126559714795,170.178492556315,0,1.29907246226194,0.89126559714795
2020-05-27,38,0,37,0,1,0,47,0,4515,103,4562,103,0,1,0,1,0,36,0,4,1,"Anderson",76978,1.29907246226194,0.00668896321070234,133.80446361298,0,1.29907246226194,0.668896321070234
2020-05-28,38,0,37,0,1,0,47,0,4563,48,4610,48,0,1,0,1,0,36,0,4,1,"Anderson",76978,1.29907246226194,0.00530973451327434,62.3554781885734,0,1.29907246226194,0.530973451327434
2020-05-29,39,1,38,1,1,0,47,0,4613,50,4660,50,0,1,0,1,1,37,0,4,1,"Anderson",76978,1.29907246226194,0.00341296928327645,64.9536231130973,1.29907246226194,1.29907246226194,0.341296928327645
2020-05-30,39,0,38,0,1,0,48,1,4665,52,4713,53,0,1,0,1,0,37,0,4,1,"Anderson",76978,1.29907246226194,0.00421052631578947,68.8508404998831,0,1.29907246226194,0.421052631578947
2020-05-31,40,1,39,1,1,0,49,1,4731,66,4780,67,0,1,1,2,0,37,0,4,1,"Anderson",76978,2.59814492452389,0.00616016427104723,87.0378549715503,1.29907246226194,2.59814492452389,0.616016427104723
2020-06-01,40,0,39,0,1,0,49,0,4855,124,4904,124,0,1,0,2,0,37,0,4,1,"Anderson",76978,2.59814492452389,0.00347222222222222,161.084985320481,0,2.59814492452389,0.347222222222222
2020-06-02,40,0,39,0,1,0,49,0,4982,127,5031,127,0,1,0,2,0,37,0,4,1,"Anderson",76978,2.59814492452389,0.0034965034965035,164.982202707267,0,2.59814492452389,0.34965034965035
2020-06-03,41,1,40,1,1,0,50,1,5042,60,5092,61,0,1,1,3,0,37,0,4,2,"Anderson",76978,3.89721738678583,0.00566037735849057,79.2434201979787,1.29907246226194,3.89721738678583,0.566037735849057
2020-06-04,41,0,40,0,1,0,50,0,5090,48,5140,48,1,2,-2,1,1,38,0,4,2,"Anderson",76978,3.89721738678583,0.00566037735849057,62.3554781885734,0,1.29907246226194,0.566037735849057
2020-06-05,42,1,41,1,1,0,53,3,5147,57,5200,60,0,2,1,2,0,38,0,4,2,"Anderson",76978,3.89721738678583,0.0111111111111111,77.9443477357167,1.29907246226194,2.59814492452389,1.11111111111111
2020-06-06,43,1,42,1,1,0,54,1,5200,53,5254,54,0,2,1,3,0,38,0,4,2,"Anderson",76978,5.19628984904778,0.011090573012939,70.149912962145,1.29907246226194,3.89721738678583,1.1090573012939
2020-06-07,45,2,43,1,2,1,57,3,5295,95,5352,98,0,2,2,5,0,38,0,4,2,"Anderson",76978,6.49536231130972,0.013986013986014,127.309101301671,2.59814492452389,6.49536231130973,1.3986013986014
2020-06-08,46,1,44,1,2,0,57,0,5336,41,5393,41,0,2,1,6,0,38,0,4,2,"Anderson",76978,7.79443477357167,0.016359918200409,53.2619709527397,1.29907246226194,7.79443477357167,1.6359918200409
2020-06-09,47,1,45,1,2,0,60,3,5517,181,5577,184,0,2,1,7,0,38,0,4,2,"Anderson",76978,9.09350723583361,0.0201465201465201,239.029333056198,1.29907246226194,9.09350723583361,2.01465201465201
2020-06-10,52,5,50,5,2,0,63,3,5725,208,5788,211,0,2,2,9,3,41,0,4,2,"Anderson",76978,14.2897970848814,0.0186781609195402,274.10428953727,6.49536231130973,11.6916521603575,1.86781609195402
2020-06-11,55,3,53,3,2,0,66,3,5870,145,5936,148,0,2,2,11,1,42,1,5,2,"Anderson",76978,18.1870144716672,0.0201005025125628,192.262724414768,3.89721738678583,14.2897970848814,2.01005025125628
2020-06-12,57,2,55,2,2,0,70,4,5952,82,6022,86,0,2,2,13,0,42,0,5,2,"Anderson",76978,19.4860869339292,0.0206812652068127,111.720231754527,2.59814492452389,16.8879420094053,2.06812652068127
2020-06-13,58,1,55,0,3,1,70,0,5995,43,6065,43,0,2,0,13,1,43,0,5,2,"Anderson",76978,19.4860869339292,0.0197287299630086,55.8601158772636,1.29907246226194,16.8879420094053,1.97287299630086
2020-06-14,60,2,57,2,3,0,70,0,6170,175,6240,175,0,2,1,14,1,44,1,6,2,"Anderson",76978,19.4860869339292,0.0146396396396396,227.33768089584,2.59814492452389,18.1870144716672,1.46396396396396
2020-06-15,60,0,57,0,3,0,71,1,6228,58,6299,59,0,2,0,14,0,44,0,6,2,"Anderson",76978,18.1870144716672,0.0154525386313466,76.6452752734548,0,18.1870144716672,1.54525386313466
2020-06-16,64,4,61,4,3,0,75,4,6289,61,6364,65,0,2,3,17,1,45,0,6,2,"Anderson",76978,22.0842318584531,0.0190597204574333,84.4397100470264,5.19628984904778,22.0842318584531,1.90597204574333
2020-06-17,66,2,63,2,3,0,79,4,6326,37,6405,41,0,2,0,17,2,47,0,6,2,"Anderson",76978,18.1870144716672,0.0259319286871961,53.2619709527397,2.59814492452389,22.0842318584531,2.59319286871961
2020-06-18,70,4,67,4,3,0,84,5,6456,130,6540,135,0,2,2,19,2,49,0,6,2,"Anderson",76978,19.4860869339292,0.0298013245033113,175.374782405363,5.19628984904778,24.682376782977,2.98013245033113
2020-06-19,72,2,69,2,3,0,86,2,6521,65,6607,67,0,2,0,19,2,51,0,6,2,"Anderson",76978,19.4860869339292,0.0273504273504274,87.0378549715503,2.59814492452389,24.682376782977,2.73504273504274
2020-06-20,73,1,70,1,3,0,87,1,6559,38,6646,39,0,2,-1,18,2,53,0,6,2,"Anderson",76978,19.4860869339292,0.0292598967297762,50.6638260282159,1.29907246226194,23.383304320715,2.92598967297762
2020-06-21,74,1,71,1,3,0,88,1,6619,60,6707,61,0,2,-1,17,2,55,0,6,2,"Anderson",76978,18.1870144716672,0.0385438972162741,79.2434201979787,1.29907246226194,22.0842318584531,3.85438972162741
2020-06-22,76,2,73,2,3,0,90,2,6711,92,6801,94,0,2,0,17,2,57,1,7,2,"Anderson",76978,20.7851593961911,0.0378486055776892,122.112811452623,2.59814492452389,22.0842318584531,3.78486055776892
2020-06-23,76,0,73,0,3,0,90,0,6800,89,6890,89,0,2,-1,16,1,58,0,7,2,"Anderson",76978,15.5888695471433,0.0285171102661597,115.617449141313,0,20.7851593961911,2.85171102661597
2020-06-24,77,1,74,1,3,0,91,1,6831,31,6922,32,0,2,-2,14,3,61,0,7,2,"Anderson",76978,14.2897970848814,0.02321083172147,41.5703187923822,1.29907246226194,18.1870144716672,2.321083172147
2020-06-25,81,4,78,4,3,0,92,1,6944,113,7036,114,0,2,0,14,4,65,0,7,2,"Anderson",76978,14.2897970848814,0.0161290322580645,148.094260697862,5.19628984904778,18.1870144716672,1.61290322580645
2020-06-26,86,5,83,5,3,0,98,6,6972,28,7070,34,0,2,3,17,2,67,0,7,2,"Anderson",76978,18.1870144716672,0.0259179265658747,44.1684637169061,6.49536231130973,22.0842318584531,2.59179265658747
2020-06-27,87,1,83,0,4,1,98,0,6984,12,7082,12,0,2,-4,13,5,72,0,7,2,"Anderson",76978,18.1870144716672,0.0252293577981651,15.5888695471433,1.29907246226194,16.8879420094053,2.52293577981651
2020-06-28,91,4,87,4,4,0,106,8,7093,109,7199,117,0,2,3,16,1,73,0,7,2,"Anderson",76978,22.0842318584531,0.0365853658536585,151.991478084648,5.19628984904778,20.7851593961911,3.65853658536585
2020-06-29,97,6,92,5,5,1,114,8,7315,222,7429,230,0,2,3,19,3,76,1,8,2,"Anderson",76978,27.2805217075008,0.0382165605095541,298.786666320247,7.79443477357167,24.682376782977,3.82165605095541
2020-06-30,102,5,96,4,6,1,120,6,7479,164,7599,170,0,2,2,21,3,79,0,8,2,"Anderson",76978,33.7758840188106,0.0423131170662905,220.842318584531,6.49536231130973,27.2805217075008,4.23131170662905
2020-07-01,104,2,98,2,6,0,124,4,7600,121,7724,125,0,2,-2,19,4,83,0,8,2,"Anderson",76978,35.0749564810725,0.0411471321695761,162.384057782743,2.59814492452389,24.682376782977,4.11471321695761
2020-07-02,110,6,104,6,6,0,130,6,7839,239,7969,245,0,2,4,23,2,85,0,8,2,"Anderson",76978,37.6731014055964,0.0407288317256163,318.272753254177,7.79443477357167,29.8786666320247,4.07288317256163
2020-07-03,120,10,113,9,7,1,142,12,7963,124,8105,136,0,2,7,30,3,88,0,8,2,"Anderson",76978,44.1684637169061,0.042512077294686,176.673854867625,12.9907246226195,38.9721738678584,4.2512077294686
2020-07-04,131,11,124,11,7,0,156,14,8147,184,8303,198,0,2,8,38,3,91,2,10,2,"Anderson",76978,57.1591883395256,0.0475020475020475,257.216347527865,14.2897970848814,49.3647535659539,4.75020475020475
2020-07-05,140,9,133,9,7,0,169,13,8303,156,8472,169,0,2,8,46,1,92,1,11,2,"Anderson",76978,63.6545506508353,0.0494893951296151,219.543246122269,11.6916521603575,59.7573332640495,4.94893951296151
2020-07-06,141,1,134,1,7,0,170,1,8330,27,8500,28,0,2,-4,42,5,97,0,11,2,"Anderson",76978,57.1591883395256,0.0522875816993464,36.3740289433345,1.29907246226194,54.5610434150017,5.22875816993464
2020-07-07,157,16,150,16,7,0,190,20,8563,233,8753,253,0,2,12,54,4,101,0,11,2,"Anderson",76978,71.448985424407,0.0606585788561525,328.665332952272,20.7851593961911,70.149912962145,6.06585788561525
2020-07-08,173,16,165,15,8,1,206,16,8703,140,8909,156,0,2,10,64,6,107,0,11,2,"Anderson",76978,89.6359998960742,0.0691983122362869,202.655304112863,20.7851593961911,83.1406375847645,6.91983122362869
2020-07-09,187,14,179,14,8,0,220,14,8971,268,9191,282,0,2,11,75,3,110,0,11,2,"Anderson",76978,100.02857959417,0.0736497545008183,366.338434357868,18.1870144716672,97.4304346696459,7.36497545008183
2020-07-10,193,6,185,6,8,0,227,7,9001,30,9228,37,0,2,1,76,5,115,1,12,2,"Anderson",76978,94.832289745122,0.0756901157613535,48.065681103692,7.79443477357167,98.7295071319078,7.56901157613535
2020-07-11,201,8,193,8,8,0,235,8,9170,169,9405,177,0,2,1,77,7,122,1,13,2,"Anderson",76978,90.9350723583361,0.0716878402903811,229.935825820364,10.3925796980956,100.02857959417,7.16878402903811
2020-07-12,212,11,204,11,8,0,248,13,9353,183,9601,196,0,2,6,83,5,127,0,13,2,"Anderson",76978,93.53321728286,0.0699734278122232,254.618202603341,14.2897970848814,107.823014367741,6.99734278122232
2020-07-13,218,6,209,5,9,1,255,7,9392,39,9647,46,0,2,-6,77,12,139,2,15,2,"Anderson",76978,100.02857959417,0.0741063644289451,59.7573332640495,7.79443477357167,100.02857959417,7.41063644289451
2020-07-14,229,11,219,10,10,1,266,11,9532,140,9798,151,0,2,0,77,11,150,0,15,2,"Anderson",76978,93.53321728286,0.0727272727272727,196.159941801554,14.2897970848814,100.02857959417,7.27272727272727
2020-07-15,245,16,234,15,11,1,285,19,9634,102,9919,121,0,2,0,77,16,166,0,15,2,"Anderson",76978,93.53321728286,0.0782178217821782,157.187767933695,20.7851593961911,100.02857959417,7.82178217821782
2020-07-16,263,18,252,18,11,0,308,23,9923,289,10231,312,0,2,4,81,14,180,1,16,2,"Anderson",76978,98.7295071319078,0.0846153846153846,405.310608225727,23.383304320715,105.224869443218,8.46153846153846
2020-07-17,270,7,259,7,11,0,317,9,9994,71,10311,80,0,2,-8,73,15,195,1,17,3,"Anderson",76978,100.02857959417,0.0831024930747922,103.925796980956,9.09350723583361,94.832289745122,8.31024930747922
2020-07-18,277,7,266,7,11,0,328,11,10208,214,10536,225,0,2,-4,69,11,206,0,17,3,"Anderson",76978,98.7295071319078,0.0822281167108753,292.291304008938,9.09350723583361,89.6359998960742,8.22281167108753
2020-07-19,285,8,274,8,11,0,337,9,10289,81,10626,90,0,2,-5,64,13,219,2,19,3,"Anderson",76978,94.832289745122,0.0868292682926829,116.916521603575,10.3925796980956,83.1406375847645,8.68292682926829
2020-07-20,313,28,302,28,11,0,367,30,10458,169,10825,199,1,3,9,73,18,237,0,19,3,"Anderson",76978,123.411883914885,0.0950764006791171,258.515419990127,36.3740289433345,94.832289745122,9.50764006791171
2020-07-21,336,23,324,22,12,1,391,24,10750,292,11141,316,0,3,12,85,11,248,1,20,3,"Anderson",76978,139.000753462028,0.0930752047654505,410.506898074775,29.8786666320247,110.421159292265,9.30752047654505
2020-07-22,365,29,353,29,12,0,424,33,10885,135,11309,168,0,3,13,98,16,264,0,20,3,"Anderson",76978,155.888695471433,0.1,218.244173660007,37.6731014055964,127.309101301671,10
2020-07-23,388,23,376,23,12,0,455,31,11312,427,11767,458,0,3,9,107,14,278,2,22,3,"Anderson",76978,162.384057782743,0.095703125,594.975187715971,29.8786666320247,139.000753462028,9.5703125
2020-07-24,394,6,382,6,12,0,463,8,11424,112,11887,120,0,3,-16,91,22,300,0,22,4,"Anderson",76978,161.084985320481,0.0926395939086294,155.888695471433,7.79443477357167,118.215594065837,9.26395939086294
2020-07-25,426,32,413,31,13,1,499,36,11681,257,12180,293,1,4,26,117,5,305,1,23,4,"Anderson",76978,193.56179687703,0.104014598540146,380.62823144275,41.5703187923822,151.991478084648,10.4014598540146
2020-07-26,465,39,451,38,14,1,541,42,12084,403,12625,445,0,4,31,148,8,313,2,25,4,"Anderson",76978,233.83304320715,0.102051025512756,578.087245706565,50.6638260282159,192.262724414768,10.2051025512756
2020-07-27,483,18,468,17,15,1,562,21,12264,180,12826,201,0,4,-19,129,37,350,1,26,4,"Anderson",76978,220.842318584531,0.0974512743628186,261.113564914651,23.383304320715,167.580347631791,9.74512743628186
2020-07-28,523,40,508,40,15,0,608,46,12644,380,13252,426,0,4,24,153,16,366,1,27,5,"Anderson",76978,242.926550442984,0.10279488394126,553.404868923589,51.9628984904778,198.758086726078,10.279488394126
2020-07-29,527,4,512,4,15,0,612,4,12680,36,13292,40,1,5,-15,138,18,384,0,27,5,"Anderson",76978,210.449738886435,0.0948058497226425,51.9628984904778,5.19628984904778,179.271999792148,9.48058497226425
2020-07-30,564,37,549,37,15,0,665,53,13165,485,13830,538,0,5,20,158,17,401,0,27,5,"Anderson",76978,228.636753358102,0.101793504604944,698.900984696926,48.065681103692,205.253449037387,10.1793504604944
2020-07-31,576,12,561,12,15,0,679,14,13347,182,14026,196,0,5,-8,150,20,421,0,27,5,"Anderson",76978,236.431188131674,0.100981767180926,254.618202603341,15.5888695471433,194.860869339292,10.0981767180926
2020-08-01,599,23,584,23,15,0,704,25,13756,409,14460,434,0,5,17,167,6,427,1,28,5,"Anderson",76978,224.739535971316,0.0899122807017544,563.797448621684,29.8786666320247,216.945101197745,8.99122807017544
2020-08-02,606,7,591,7,15,0,711,7,13884,128,14595,135,0,5,2,169,5,432,1,29,6,"Anderson",76978,183.169217178934,0.0862944162436548,175.374782405363,9.09350723583361,219.543246122269,8.62944162436548
2020-08-03,631,25,615,24,16,1,742,31,14111,227,14853,258,0,5,14,183,11,443,0,29,6,"Anderson",76978,192.262724414768,0.0888011840157869,335.160695263582,32.4768115565486,237.730260593936,8.88011840157869
2020-08-04,638,7,622,7,16,0,750,8,14354,243,15104,251,2,7,-19,164,24,467,0,29,6,"Anderson",76978,149.393333160124,0.0766738660907127,326.067188027748,9.09350723583361,213.047883810959,7.66738660907127
2020-08-05,653,15,637,15,16,0,769,19,14563,209,15332,228,-1,6,-1,163,17,484,0,29,6,"Anderson",76978,163.683130245005,0.0769607843137255,296.188521395723,19.4860869339292,211.748811348697,7.69607843137255
2020-08-06,675,22,659,22,16,0,799,30,14884,321,15683,351,0,6,3,166,19,503,1,30,6,"Anderson",76978,144.197043311076,0.0723151645979493,455.974434253943,28.5795941697628,215.646028735483,7.23151645979493
2020-08-07,679,4,663,4,16,0,803,4,14965,81,15768,85,0,6,-21,145,25,528,0,30,6,"Anderson",76978,133.80446361298,0.0711825487944891,110.421159292265,5.19628984904778,188.365507027982,7.11825487944891
2020-08-08,690,11,674,11,16,0,819,16,15285,320,16104,336,0,6,1,146,10,538,0,30,6,"Anderson",76978,118.215594065837,0.0699513381995134,436.488347320014,14.2897970848814,189.664579490244,6.99513381995134
2020-08-09,697,7,681,7,16,0,828,9,15422,137,16250,146,0,6,-9,137,16,554,0,30,6,"Anderson",76978,118.215594065837,0.0706948640483384,189.664579490244,9.09350723583361,177.972927329886,7.06948640483384
2020-08-10,702,5,686,5,16,0,834,6,15561,139,16395,145,0,6,-11,126,16,570,0,30,6,"Anderson",76978,92.2341448205981,0.059662775616083,188.365507027982,6.49536231130973,163.683130245005,5.9662775616083
2020-08-11,723,21,707,21,16,0,856,22,15764,203,16620,225,0,6,9,135,12,582,1,31,6,"Anderson",76978,110.421159292265,0.0699208443271768,292.291304008938,27.2805217075008,175.374782405363,6.99208443271768
2020-08-12,731,8,715,8,16,0,864,8,16003,239,16867,247,0,6,-8,127,16,598,0,31,6,"Anderson",76978,101.327652056432,0.0618892508143322,320.8708981787,10.3925796980956,164.982202707267,6.18892508143322
2020-08-13,749,18,733,18,16,0,888,24,16231,228,17119,252,1,7,3,130,14,612,2,33,6,"Anderson",76978,96.1313622073839,0.0619777158774373,327.36626049001,23.383304320715,168.879420094053,6.19777158774373
2020-08-14,766,17,749,16,17,1,910,22,16560,329,17470,351,0,7,-9,121,26,638,0,33,6,"Anderson",76978,113.019304216789,0.0628672150411281,455.974434253943,22.0842318584531,157.187767933695,6.28672150411281
2020-08-15,776,10,759,10,17,0,922,12,16783,223,17705,235,-1,6,5,126,6,644,0,33,6,"Anderson",76978,111.720231754527,0.0643347907557776,305.282028631557,12.9907246226195,163.683130245005,6.43347907557776
2020-08-16,788,12,771,12,17,0,936,14,16925,142,17861,156,0,6,7,133,5,649,0,33,7,"Anderson",76978,118.215594065837,0.0670391061452514,202.655304112863,15.5888695471433,172.776637480839,6.70391061452514
2020-08-17,792,4,775,4,17,0,939,3,16968,43,17907,46,0,6,-13,120,17,666,0,33,7,"Anderson",76978,116.916521603575,0.0694444444444444,59.7573332640495,5.19628984904778,155.888695471433,6.94444444444444
2020-08-18,806,14,789,14,17,0,956,17,17132,164,18088,181,0,6,5,125,9,675,0,33,7,"Anderson",76978,107.823014367741,0.0681198910081744,235.132115669412,18.1870144716672,162.384057782743,6.81198910081744
2020-08-19,820,14,803,14,17,0,970,14,17306,174,18276,188,0,6,0,125,14,689,0,33,7,"Anderson",76978,115.617449141313,0.0752306600425834,244.225622905246,18.1870144716672,162.384057782743,7.52306600425834
2020-08-20,835,15,818,15,17,0,986,16,17748,442,18734,458,0,6,5,130,10,699,0,33,8,"Anderson",76978,111.720231754527,0.0606811145510836,594.975187715971,19.4860869339292,168.879420094053,6.06811145510836
2020-08-21,838,3,821,3,17,0,989,3,17784,36,18773,39,1,7,-7,123,9,708,0,33,8,"Anderson",76978,93.53321728286,0.0606293169608596,50.6638260282159,3.89721738678583,159.785912858219,6.06293169608596
2020-08-22,856,18,839,18,17,0,1008,19,18328,544,19336,563,1,8,10,133,7,715,1,34,8,"Anderson",76978,103.925796980956,0.052728387492336,731.377796253475,23.383304320715,172.776637480839,5.2728387492336
2020-08-23,857,1,840,1,17,0,1009,1,18412,84,19421,85,0,8,-5,128,6,721,0,34,8,"Anderson",76978,89.6359998960742,0.0467948717948718,110.421159292265,1.29907246226194,166.281275169529,4.67948717948718
2020-08-24,858,1,840,0,18,1,1009,0,18451,39,19460,39,0,8,-19,109,20,741,0,34,8,"Anderson",76978,85.7387825092884,0.0450740502253702,50.6638260282159,1.29907246226194,141.598898386552,4.50740502253703
2020-08-25,866,8,848,8,18,0,1017,8,18603,152,19620,160,0,8,-2,107,10,751,1,35,8,"Anderson",76978,77.9443477357167,0.0398172323759791,207.851593961911,10.3925796980956,139.000753462028,3.98172323759791
2020-08-26,872,6,854,6,18,0,1023,6,18783,180,19806,186,0,8,-14,93,20,771,0,35,8,"Anderson",76978,67.5517680376211,0.034640522875817,241.627477980722,7.79443477357167,120.813738990361,3.4640522875817
2020-08-27,875,3,857,3,18,0,1026,3,19194,411,20220,414,0,8,-16,77,19,790,0,35,8,"Anderson",76978,51.9628984904778,0.0269179004037685,537.815999376445,3.89721738678583,100.02857959417,2.69179004037685
2020-08-28,875,0,857,0,18,0,1026,0,19232,38,20258,38,0,8,-20,57,20,810,0,35,8,"Anderson",76978,48.065681103692,0.0249158249158249,49.3647535659539,0,74.0471303489309,2.49158249158249
2020-08-29,884,9,865,8,19,1,1034,8,19494,262,20528,270,0,8,3,60,6,816,0,35,8,"Anderson",76978,36.3740289433345,0.0218120805369128,350.749564810725,11.6916521603575,77.9443477357167,2.18120805369128
2020-08-30,900,16,881,16,19,0,1050,16,19577,83,20627,99,0,8,8,68,8,824,0,35,8,"Anderson",76978,55.8601158772636,0.0339966832504146,128.608173763933,20.7851593961911,88.3369274338123,3.39966832504146
2020-08-31,902,2,883,2,19,0,1052,2,19635,58,20687,60,0,8,-15,53,17,841,0,35,8,"Anderson",76978,57.1591883395256,0.0350448247758761,77.9443477357167,2.59814492452389,68.8508404998831,3.50448247758761
2020-09-01,909,7,889,6,20,1,1058,6,19746,111,20804,117,0,8,0,53,7,848,0,35,8,"Anderson",76978,55.8601158772636,0.0346283783783784,151.991478084648,9.09350723583361,68.8508404998831,3.46283783783784
2020-09-02,917,8,895,6,22,2,1068,10,20062,316,21130,326,0,8,5,58,3,851,0,35,8,"Anderson",76978,58.4582608017875,0.033987915407855,423.497622697394,10.3925796980956,75.3462028111928,3.3987915407855
2020-09-03,933,16,909,14,24,2,1084,16,20386,324,21470,340,0,8,10,68,6,857,0,35,9,"Anderson",76978,75.3462028111928,0.0464,441.684637169061,20.7851593961911,88.3369274338123,4.64
2020-09-04,942,9,917,8,25,1,1094,10,20575,189,21669,199,0,8,6,74,3,860,0,35,9,"Anderson",76978,87.0378549715503,0.0481927710843374,258.515419990127,11.6916521603575,96.1313622073839,4.81927710843374
2020-09-05,961,19,936,19,25,0,1115,21,20844,269,21959,290,0,8,16,90,3,863,1,36,10,"Anderson",76978,100.02857959417,0.0566037735849057,376.731014055964,24.682376782977,116.916521603575,5.66037735849057
2020-09-06,963,2,938,2,25,0,1117,2,20900,56,22017,58,0,8,-1,89,3,866,0,36,10,"Anderson",76978,81.8415651225025,0.0482014388489209,75.3462028111928,2.59814492452389,115.617449141313,4.82014388489209
2020-09-07,966,3,941,3,25,0,1122,5,20988,88,22110,93,0,8,-8,81,11,877,0,36,10,"Anderson",76978,83.1406375847645,0.0491918482080112,120.813738990361,3.89721738678583,105.224869443218,4.91918482080112
2020-09-08,975,9,944,3,31,6,1126,4,21163,175,22289,179,1,9,4,85,4,881,0,36,10,"Anderson",76978,85.7387825092884,0.0457912457912458,232.533970744888,11.6916521603575,110.421159292265,4.57912457912458
2020-09-09,984,9,953,9,31,0,1135,9,21404,241,22539,250,0,9,-3,82,12,893,1,37,11,"Anderson",76978,87.0378549715503,0.0475514549325763,324.768115565486,11.6916521603575,106.523941905479,4.75514549325763
2020-09-10,1013,29,981,28,32,1,1165,30,21773,369,22938,399,1,10,25,107,3,896,0,37,11,"Anderson",76978,103.925796980956,0.0551771117166213,518.329912442516,37.6731014055964,139.000753462028,5.51771117166213
2020-09-11,1014,1,982,1,32,0,1167,2,21906,133,23073,135,0,10,-13,94,14,910,0,37,11,"Anderson",76978,93.53321728286,0.051994301994302,175.374782405363,1.29907246226194,122.112811452623,5.1994301994302
2020-09-12,1017,3,985,3,32,0,1172,5,22048,142,23220,147,0,10,-5,89,8,918,0,37,11,"Anderson",76978,72.7480578866689,0.0452022204599524,190.963651952506,3.89721738678583,115.617449141313,4.52022204599524
2020-09-13,1038,21,1005,20,33,1,1193,21,22292,244,23485,265,0,10,16,105,5,923,1,38,11,"Anderson",76978,97.4304346696459,0.0517711171662125,344.254202499415,27.2805217075008,136.402608537504,5.17711171662125
2020-09-14,1044,6,1010,5,34,1,1199,6,22398,106,23597,112,0,10,-7,98,13,936,1,39,11,"Anderson",76978,101.327652056432,0.0517821116341627,145.496115773338,7.79443477357167,127.309101301671,5.17821116341627
2020-09-15,1060,16,1026,16,34,0,1216,17,22638,240,23854,257,1,11,5,103,10,946,1,40,12,"Anderson",76978,110.421159292265,0.0575079872204473,333.86162280132,20.7851593961911,133.80446361298,5.75079872204473
2020-09-16,1068,8,1034,8,34,0,1228,12,22774,136,24002,148,0,11,-5,98,13,959,0,40,12,"Anderson",76978,109.122086830003,0.063568010936432,192.262724414768,10.3925796980956,127.309101301671,6.3568010936432
2020-09-17,1090,22,1054,20,36,2,1248,20,23195,421,24443,441,0,11,15,113,7,966,1,41,12,"Anderson",76978,100.02857959417,0.0551495016611296,572.890955857518,28.5795941697628,146.7951882356,5.51495016611296
2020-09-18,1109,19,1073,19,36,0,1266,18,23419,224,24685,242,0,11,6,119,13,979,0,41,12,"Anderson",76978,123.411883914885,0.0614143920595533,314.375535867391,24.682376782977,154.589623009171,6.14143920595533
2020-09-19,1124,15,1088,15,36,0,1287,21,23701,282,24988,303,0,11,9,128,6,985,1,42,12,"Anderson",76978,139.000753462028,0.0650452488687783,393.618956065369,19.4860869339292,166.281275169529,6.50452488687783
2020-09-20,1131,7,1095,7,36,0,1297,10,23853,152,25150,162,0,11,0,128,7,992,0,42,13,"Anderson",76978,120.813738990361,0.0624624624624625,210.449738886435,9.09350723583361,166.281275169529,6.24624624624625
2020-09-21,1133,2,1097,2,36,0,1299,2,23886,33,25185,35,0,11,-6,122,8,1000,0,42,13,"Anderson",76978,115.617449141313,0.0629722921914358,45.4675361791681,2.59814492452389,158.486840395957,6.29722921914358
2020-09-22,1147,14,1111,14,36,0,1316,17,24134,248,25450,265,0,11,0,122,14,1014,1,43,13,"Anderson",76978,113.019304216789,0.06265664160401,344.254202499415,18.1870144716672,158.486840395957,6.265664160401
2020-09-23,1147,0,1111,0,36,0,1316,0,24175,41,25491,41,0,11,-12,110,12,1026,0,43,13,"Anderson",76978,102.626724518694,0.0591000671591672,53.2619709527397,0,142.897970848814,5.91000671591672
2020-09-24,1160,13,1124,13,36,0,1331,15,24499,324,25830,339,1,12,0,110,12,1038,0,43,13,"Anderson",76978,90.9350723583361,0.0598413842826244,440.385564706799,16.8879420094053,142.897970848814,5.98413842826244
2020-09-25,1174,14,1137,13,37,1,1344,13,24735,236,26079,249,1,13,-2,108,15,1053,0,43,13,"Anderson",76978,84.4397100470264,0.0559540889526542,323.469043103224,18.1870144716672,140.29982592429,5.59540889526542
2020-09-26,1188,14,1151,14,37,0,1361,17,25035,300,26396,317,0,13,8,116,6,1059,0,43,13,"Anderson",76978,83.1406375847645,0.0525568181818182,411.805970537037,18.1870144716672,150.692405622386,5.25568181818182
2020-09-27,1207,19,1168,17,39,2,1377,16,25242,207,26619,223,0,13,12,128,7,1066,0,43,13,"Anderson",76978,98.7295071319078,0.0544588155207624,289.693159084414,24.682376782977,166.281275169529,5.44588155207624
2020-09-28,1210,3,1170,2,40,1,1379,2,25279,37,26658,39,0,13,-9,119,12,1078,0,43,13,"Anderson",76978,100.02857959417,0.0543109300746775,50.6638260282159,3.89721738678583,154.589623009171,5.43109300746775
2020-09-29,1221,11,1180,10,41,1,1389,10,25573,294,26962,304,0,13,-7,112,18,1096,0,43,13,"Anderson",76978,96.1313622073839,0.0482804232804233,394.918028527631,14.2897970848814,145.496115773338,4.82804232804233
2020-09-30,1233,12,1190,10,43,2,1399,10,25639,66,27038,76,0,13,3,115,9,1105,0,43,13,"Anderson",76978,111.720231754527,0.0536522301228184,98.7295071319078,15.5888695471433,149.393333160124,5.36522301228184
2020-10-01,1249,16,1204,14,45,2,1414,15,25919,280,27333,295,0,13,4,119,12,1117,0,43,13,"Anderson",76978,115.617449141313,0.0552228875582169,383.226376367274,20.7851593961911,154.589623009171,5.52228875582169
2020-10-02,1256,7,1210,6,46,1,1421,7,26001,82,27422,89,0,13,1,120,6,1123,0,43,13,"Anderson",76978,106.523941905479,0.0573343261355175,115.617449141313,9.09350723583361,155.888695471433,5.73343261355175
2020-10-03,1272,16,1226,16,46,0,1445,24,26265,264,27710,288,0,13,3,123,13,1136,0,43,13,"Anderson",76978,109.122086830003,0.0639269406392694,374.13286913144,20.7851593961911,159.785912858219,6.39269406392694
2020-10-04,1288,16,1240,14,48,2,1461,16,26602,337,28063,353,0,13,8,131,8,1144,0,43,13,"Anderson",76978,105.224869443218,0.0581717451523546,458.572579178467,20.7851593961911,170.178492556315,5.81717451523546
2020-10-05,1314,26,1265,25,49,1,1488,27,26813,211,28301,238,0,13,11,142,15,1159,1,44,13,"Anderson",76978,135.103536075242,0.0663420572124163,309.179246018343,33.7758840188106,184.468289641196,6.63420572124163
2020-10-06,1342,28,1292,27,50,1,1519,31,27150,337,28669,368,0,13,15,157,13,1172,1,45,13,"Anderson",76978,157.187767933695,0.0761570005858231,478.058666112396,36.3740289433345,203.954376575125,7.61570005858231
2020-10-07,1348,6,1298,6,50,0,1527,8,27385,235,28912,243,0,13,-3,154,9,1181,0,45,13,"Anderson",76978,149.393333160124,0.0683030949839915,315.674608329653,7.79443477357167,200.05715918834,6.83030949839915
2020-10-08,1358,10,1306,8,52,2,1536,9,27624,239,29160,248,0,13,-3,151,13,1194,1,46,13,"Anderson",76978,141.598898386552,0.066776135741653,322.169970640962,12.9907246226195,196.159941801554,6.6776135741653
2020-10-09,1373,15,1319,13,54,2,1552,16,27797,173,29349,189,0,13,-2,149,17,1211,0,46,13,"Anderson",76978,151.991478084648,0.0679813181110535,245.524695367508,19.4860869339292,193.56179687703,6.79813181110535
2020-10-10,1389,16,1335,16,54,0,1572,20,28009,212,29581,232,0,13,3,152,13,1224,1,47,14,"Anderson",76978,151.991478084648,0.0678781400320684,301.384811244771,20.7851593961911,197.459014263816,6.78781400320684
2020-10-11,1417,28,1363,28,54,0,1603,31,28298,289,29901,320,0,13,18,170,10,1234,0,47,14,"Anderson",76978,167.580347631791,0.0772578890097933,415.703187923822,36.3740289433345,220.842318584531,7.72578890097933
2020-10-12,1433,16,1378,15,55,1,1619,16,28377,79,29996,95,0,13,-11,159,27,1261,0,47,14,"Anderson",76978,154.589623009171,0.0772861356932153,123.411883914885,20.7851593961911,206.552521499649,7.72861356932153
2020-10-13,1453,20,1396,18,57,2,1637,18,28498,121,30135,139,0,13,7,166,13,1274,0,47,14,"Anderson",76978,144.197043311076,0.0804911323328786,180.57107225441,25.9814492452389,215.646028735483,8.04911323328786
2020-10-14,1475,22,1418,22,57,0,1661,24,28798,300,30459,324,0,13,12,178,10,1284,0,47,14,"Anderson",76978,164.982202707267,0.0866192630898513,420.89947777287,28.5795941697628,231.234898282626,8.66192630898513
2020-10-15,1497,22,1434,16,63,6,1675,14,28949,151,30624,165,0,13,2,180,20,1304,1,48,14,"Anderson",76978,180.57107225441,0.0949453551912568,214.346956273221,28.5795941697628,233.83304320715,9.49453551912568
2020-10-16,1504,7,1437,3,67,4,1679,4,29048,99,30727,103,0,13,-11,169,18,1322,0,48,15,"Anderson",76978,170.178492556315,0.0921625544267054,133.80446361298,9.09350723583361,219.543246122269,9.21625544267054
2020-10-17,1532,28,1464,27,68,1,1709,30,29296,248,31005,278,0,13,14,183,14,1336,2,50,15,"Anderson",76978,185.767362103458,0.0962078651685393,361.142144508821,36.3740289433345,237.730260593936,9.62078651685393
2020-10-18,1551,19,1483,19,68,0,1731,22,29535,239,31266,261,0,13,4,187,15,1351,0,50,15,"Anderson",76978,174.075709943101,0.0937728937728938,339.057912650368,24.682376782977,242.926550442984,9.37728937728938
2020-10-19,1555,4,1487,4,68,0,1736,5,29612,77,31348,82,0,13,-16,171,20,1371,1,51,15,"Anderson",76978,158.486840395957,0.0865384615384615,106.523941905479,5.19628984904778,222.141391046793,8.65384615384615
2020-10-20,1582,27,1514,27,68,0,1771,35,29811,199,31582,234,0,13,6,177,21,1392,0,51,15,"Anderson",76978,167.580347631791,0.0926053904630269,303.982956169295,35.0749564810725,229.935825820364,9.26053904630269
2020-10-21,1599,17,1531,17,68,0,1790,19,30027,216,31817,235,0,13,8,185,9,1401,1,52,15,"Anderson",76978,161.084985320481,0.0949926362297496,305.282028631557,22.0842318584531,240.32840551846,9.49926362297496
2020-10-22,1620,21,1552,21,68,0,1815,25,30359,332,32174,357,1,14,-4,181,24,1425,0,52,15,"Anderson",76978,159.785912858219,0.0903225806451613,463.768869027514,27.2805217075008,235.132115669412,9.03225806451613
2020-10-23,1635,15,1566,14,69,1,1831,16,30634,275,32465,291,0,14,-7,174,22,1447,0,52,15,"Anderson",76978,170.178492556315,0.0874568469505178,378.030086518226,19.4860869339292,226.038608433578,8.74568469505178
2020-10-24,1666,31,1596,30,70,1,1864,33,31010,376,32874,409,0,14,19,193,12,1459,2,54,17,"Anderson",76978,174.075709943101,0.0829320492241841,531.320637065136,40.2712463301203,250.720985216555,8.29320492241841
2020-10-25,1683,17,1612,16,71,1,1883,19,31206,196,33089,215,0,14,0,193,17,1476,4,58,17,"Anderson",76978,171.477565018577,0.0833790455293472,279.300579386318,22.0842318584531,250.720985216555,8.33790455293472
2020-10-26,1699,16,1627,15,72,1,1901,18,31340,134,33241,152,-1,13,-11,182,28,1504,1,59,17,"Anderson",76978,187.06643456572,0.0871632329635499,197.459014263816,20.7851593961911,236.431188131674,8.71632329635499
2020-10-27,1728,29,1651,24,77,5,1925,24,31495,155,33420,179,1,14,10,192,18,1522,2,61,17,"Anderson",76978,189.664579490244,0.0837867247007617,232.533970744888,37.6731014055964,249.421912754293,8.37867247007617
2020-10-28,1784,56,1705,54,79,2,1984,59,31929,434,33913,493,0,14,34,226,22,1544,0,61,17,"Anderson",76978,240.32840551846,0.0925572519083969,640.442723895139,72.7480578866689,293.5903764712,9.25572519083969
2020-10-29,1813,29,1726,21,87,8,2003,19,32135,206,34138,225,0,14,6,232,23,1567,2,63,17,"Anderson",76978,250.720985216555,0.0957230142566191,292.291304008938,37.6731014055964,301.384811244771,9.57230142566191
2020-10-30,1850,37,1760,34,90,3,2041,38,32286,151,34327,189,2,16,20,252,15,1582,1,64,17,"Anderson",76978,279.300579386318,0.112781954887218,245.524695367508,48.065681103692,327.36626049001,11.2781954887218
2020-10-31,1850,0,1760,0,90,0,2041,0,32287,1,34328,1,0,16,-10,242,10,1592,0,64,19,"Anderson",76978,239.029333056198,0.121733149931224,1.29907246226194,0,314.375535867391,12.1733149931224
2020-11-01,1855,5,1765,5,90,0,2049,8,32531,244,34580,252,0,16,-10,232,15,1607,0,64,19,"Anderson",76978,223.440463509055,0.111334674714956,327.36626049001,6.49536231130973,301.384811244771,11.1334674714956
2020-11-02,1888,33,1796,31,92,2,2084,35,32798,267,34882,302,0,16,8,240,25,1632,0,64,20,"Anderson",76978,245.524695367508,0.111517367458867,392.319883603107,42.8693912546442,311.777390942867,11.1517367458867
2020-11-03,1914,26,1821,25,93,1,2109,25,32978,180,35087,205,0,16,6,246,20,1652,0,64,21,"Anderson",76978,241.627477980722,0.110377924415117,266.309854763699,33.7758840188106,319.571825716438,11.0377924415117
2020-11-04,1932,18,1836,15,96,3,2127,18,33057,79,35184,97,2,18,1,247,15,1667,1,65,21,"Anderson",76978,192.262724414768,0.112509834775767,126.010028839409,23.383304320715,320.8708981787,11.2509834775767
2020-11-05,1956,24,1854,18,102,6,2147,20,33156,99,35303,119,0,18,1,248,23,1690,0,65,22,"Anderson",76978,185.767362103458,0.123605150214592,154.589623009171,31.1777390942867,322.169970640962,12.3605150214592
2020-11-06,2005,49,1900,46,105,3,2196,49,33523,367,35719,416,0,18,24,272,25,1715,2,67,23,"Anderson",76978,201.356231650601,0.111350574712644,540.414144300969,63.6545506508353,353.347709735249,11.1350574712644
2020-11-07,2085,80,1977,77,108,3,2273,77,33970,447,36243,524,0,18,50,322,30,1745,0,67,23,"Anderson",76978,305.282028631557,0.121148825065274,680.713970225259,103.925796980956,418.301332848346,12.1148825065274
2020-11-08,2139,54,2028,51,111,3,2335,62,34580,610,36915,672,0,18,39,361,15,1760,1,68,23,"Anderson",76978,368.936579282392,0.122483940042827,872.976694640027,70.149912962145,468.965158876562,12.2483940042827
2020-11-09,2147,8,2035,7,112,1,2344,9,34654,74,36998,83,0,18,-46,315,54,1814,0,68,23,"Anderson",76978,336.459767725844,0.122873345935728,107.823014367741,10.3925796980956,409.207825612513,12.2873345935728
2020-11-10,2166,19,2053,18,113,1,2366,22,34825,171,37191,193,0,18,-16,299,35,1849,1,69,23,"Anderson",76978,327.36626049001,0.122148288973384,250.720985216555,24.682376782977,388.422666216322,12.2148288973384
2020-11-11,2205,39,2089,36,116,3,2408,42,35098,273,37506,315,1,19,13,312,25,1874,1,70,23,"Anderson",76978,354.646782197511,0.121016365202412,409.207825612513,50.6638260282159,405.310608225727,12.1016365202412
2020-11-12,2212,7,2095,6,117,1,2416,8,35296,198,37712,206,0,19,-13,299,20,1894,0,70,24,"Anderson",76978,332.562550339058,0.111664591116646,267.608927225961,9.09350723583361,388.422666216322,11.1664591116646
2020-11-13,2268,56,2148,53,120,3,2475,59,35558,262,38033,321,2,21,31,330,23,1917,2,72,24,"Anderson",76978,341.656057574892,0.12057044079516,417.002260386084,72.7480578866689,428.693912546442,12.057044079516
2020-11-14,2309,41,2188,40,121,1,2520,45,35954,396,38474,441,1,22,20,350,20,1937,1,73,25,"Anderson",76978,290.992231546676,0.110712684894666,572.890955857518,53.2619709527397,454.675361791681,11.0712684894666
2020-11-15,2407,98,2286,98,121,0,2628,108,36536,582,39164,690,1,23,79,429,18,1955,1,74,25,"Anderson",76978,348.151419886201,0.130280124499778,896.359998960742,127.309101301671,557.302086310374,13.0280124499778
2020-11-16,2456,49,2315,29,141,20,2657,29,36813,277,39470,306,0,23,-6,423,55,2010,1,75,25,"Anderson",76978,401.413390838941,0.126618122977346,397.516173452155,63.6545506508353,549.507651536803,12.6618122977346
2020-11-17,2472,16,2330,15,142,1,2673,16,37019,206,39692,222,2,25,-37,386,51,2061,1,76,26,"Anderson",76978,397.516173452155,0.122750899640144,288.394086622152,20.7851593961911,501.441970433111,12.2750899640144
2020-11-18,2502,30,2356,26,146,4,2699,26,37313,294,40012,320,0,25,-5,381,35,2096,0,76,27,"Anderson",76978,385.824521291798,0.116121308858739,415.703187923822,38.9721738678584,494.946608121801,11.6121308858739
2020-11-19,2560,58,2410,54,150,4,2761,62,37729,416,40490,478,0,25,19,400,39,2135,1,77,27,"Anderson",76978,452.077216867157,0.124190064794816,620.95663696121,75.3462028111928,519.628984904778,12.4190064794816
2020-11-20,2590,30,2437,27,153,3,2792,31,37842,113,40634,144,0,25,-10,390,40,2175,0,77,28,"Anderson",76978,418.301332848346,0.121876201460977,187.06643456572,38.9721738678584,506.638260282159,12.1876201460977
2020-11-21,2647,57,2486,49,161,8,2840,48,38186,344,41026,392,0,25,33,423,24,2199,1,78,28,"Anderson",76978,439.086492244537,0.125391849529781,509.236405206682,74.0471303489309,549.507651536803,12.5391849529781
2020-11-22,2703,56,2535,49,168,7,2897,57,38669,483,41566,540,0,25,42,465,14,2213,1,79,31,"Anderson",76978,384.525448829536,0.111990008326395,701.49912962145,72.7480578866689,604.068694951804,11.1990008326395
2020-11-23,2710,7,2541,6,169,1,2903,6,38691,22,41594,28,0,25,-64,401,71,2284,0,79,32,"Anderson",76978,329.964405414534,0.115819209039548,36.3740289433345,9.09350723583361,520.92805736704,11.5819209039548
2020-11-24,2723,13,2553,12,170,1,2915,12,38848,157,41763,169,2,27,-35,366,46,2330,0,79,32,"Anderson",76978,326.067188027748,0.116851762433607,219.543246122269,16.8879420094053,475.460521187872,11.6851762433607
2020-11-25,2751,28,2574,21,177,7,2936,21,38885,37,41821,58,1,28,-11,355,38,2368,0,79,32,"Anderson",76978,323.469043103224,0.131011608623549,75.3462028111928,36.3740289433345,461.170724102991,13.1011608623549
2020-11-26,2796,45,2616,42,180,3,2981,45,39235,350,42216,395,0,28,-30,325,75,2443,1,80,33,"Anderson",76978,306.581101093819,0.127462340672074,513.133622593468,58.4582608017875,422.198550235132,12.7462340672074
2020-11-27,2895,99,2706,90,189,9,3076,95,39661,426,42737,521,0,28,56,381,43,2486,3,83,35,"Anderson",76978,396.217100989893,0.135045173561579,676.816752838473,128.608173763933,494.946608121801,13.5045173561579
2020-11-28,2926,31,2731,25,195,6,3106,30,39804,143,42910,173,1,29,5,386,25,2511,2,85,35,"Anderson",76978,362.441216971083,0.141188959660297,224.739535971316,40.2712463301203,501.441970433111,14.1188959660297
2020-11-29,3017,91,2820,89,197,2,3202,96,40241,437,43443,533,0,29,65,451,26,2537,1,86,35,"Anderson",76978,407.908753150251,0.162493340436867,692.405622385617,118.215594065837,585.881680480137,16.2493340436867
2020-11-30,3087,70,2886,66,201,4,3275,73,40493,252,43768,325,0,29,1,452,69,2606,0,86,37,"Anderson",76978,489.750318272753,0.171113155473781,422.198550235132,90.9350723583361,587.180752942399,17.1113155473781
2020-12-01,3163,76,2952,66,211,10,3347,72,40924,431,44271,503,1,30,14,466,61,2667,6,92,38,"Anderson",76978,571.591883395256,0.172248803827751,653.433448517758,98.7295071319078,605.367767414066,17.2248803827751
2020-12-02,3178,15,2966,14,212,1,3363,16,41032,108,44395,124,0,30,-40,426,55,2722,0,92,38,"Anderson",76978,554.70394138585,0.165889665889666,161.084985320481,19.4860869339292,553.404868923589,16.5889665889666
2020-12-03,3219,41,2995,29,224,12,3396,33,41256,224,44652,257,1,31,-14,412,54,2776,1,93,39,"Anderson",76978,549.507651536803,0.170361247947455,333.86162280132,53.2619709527397,535.217854451921,17.0361247947455
2020-12-04,3286,67,3055,60,231,7,3459,63,41414,158,44873,221,1,32,-25,387,91,2867,0,93,39,"Anderson",76978,507.93733274442,0.179307116104869,287.09501415989,87.0378549715503,502.741042895373,17.9307116104869
2020-12-05,3317,31,3074,19,243,12,3477,18,41481,67,44958,85,0,32,1,388,30,2897,0,93,39,"Anderson",76978,507.93733274442,0.18115234375,110.421159292265,40.2712463301203,504.040115357635,18.115234375
2020-12-06,3353,36,3103,29,250,7,3505,28,41689,208,45194,236,0,32,12,400,24,2921,2,95,40,"Anderson",76978,436.488347320014,0.173043974871502,306.581101093819,46.76660864143,519.628984904778,17.3043974871502
2020-12-07,3493,140,3227,124,266,16,3641,136,42282,593,45923,729,2,34,28,428,110,3031,4,99,41,"Anderson",76978,527.42341967835,0.169837587006961,947.023824988958,181.870144716672,556.003013848112,16.9837587006961
2020-12-08,3564,71,3276,49,288,22,3693,52,42580,298,46273,350,1,35,-8,420,78,3109,2,101,43,"Anderson",76978,520.92805736704,0.172827172827173,454.675361791681,92.2341448205981,545.610434150017,17.2827172827173
2020-12-09,3669,105,3367,91,302,14,3797,104,42841,261,46638,365,0,35,46,466,59,3168,3,104,44,"Anderson",76978,637.844578970615,0.193490860454748,474.16144872561,136.402608537504,605.367767414066,19.3490860454748
2020-12-10,3763,94,3445,78,318,16,3884,87,43373,532,47257,619,3,38,81,547,10,3178,3,107,45,"Anderson",76978,706.695419470498,0.187332053742802,804.125854140144,122.112811452623,710.592636857284,18.7332053742802
2020-12-11,3836,73,3498,53,338,20,3935,51,43539,166,47474,217,1,39,30,577,42,3220,2,109,45,"Anderson",76978,714.48985424407,0.183006535947712,281.898724310842,94.832289745122,749.564810725142,18.3006535947712
2020-12-12,3924,88,3559,61,365,27,4000,65,44052,513,48052,578,0,39,55,632,33,3253,2,111,45,"Anderson",76978,788.536984593001,0.169036845507434,750.863883187404,114.318376679051,821.013796149549,16.9036845507434
2020-12-13,4156,232,3742,183,414,49,4204,204,44924,872,49128,1076,1,40,188,820,43,3296,0,111,47,"Anderson",76978,1043.15518719634,0.177681748856126,1397.80196939385,301.384811244771,1065.23941905479,17.7681748856126
2020-12-14,4271,115,3828,86,443,29,4303,99,45215,291,49518,390,0,40,-37,783,152,3448,1,112,48,"Anderson",76978,1010.67837563979,0.184144645340751,506.638260282159,149.393333160124,1017.1737379511,18.4144645340751
2020-12-15,4406,135,3913,85,493,50,4399,96,45742,527,50141,623,1,41,42,825,92,3540,6,118,51,"Anderson",76978,1093.81901322456,0.182523267838676,809.322143989192,175.374782405363,1071.7347813661,18.2523267838676
2020-12-16,4475,69,3943,30,532,39,4435,36,46065,323,50500,359,2,43,-17,808,84,3624,4,122,52,"Anderson",76978,1047.05240458313,0.165199378560331,466.367013952038,89.6359998960742,1049.65054950765,16.5199378560331
2020-12-17,4676,201,4117,174,559,27,4629,194,46593,528,51222,722,2,45,114,922,85,3709,2,124,54,"Anderson",76978,1186.05315804516,0.187894073139975,937.930317753124,261.113564914651,1197.74481020551,18.7894073139975
2020-12-18,4774,98,4193,76,581,22,4716,87,46959,366,51675,453,1,46,23,945,74,3783,2,126,54,"Anderson",76978,1218.5299696017,0.185908117114973,588.479825404661,127.309101301671,1227.62347683754,18.5908117114973
2020-12-19,4879,105,4274,81,605,24,4803,87,47217,258,52020,345,0,46,74,1019,31,3814,1,127,55,"Anderson",76978,1240.61420146016,0.202368951612903,448.179999480371,136.402608537504,1323.75483904492,20.2368951612903
2020-12-20,5019,140,4396,122,623,18,4940,137,47681,464,52621,601,2,48,84,1103,54,3868,3,130,56,"Anderson",76978,1121.09953493206,0.2107071285428,780.742549819429,181.870144716672,1432.87692587493,21.07071285428
2020-12-21,5067,48,4414,18,653,30,4963,23,47901,220,52864,243,3,51,-83,1020,128,3996,2,132,59,"Anderson",76978,1034.06167996051,0.197250448296473,315.674608329653,62.3554781885734,1325.05391150718,19.7250448296473
2020-12-22,5137,70,4458,44,679,26,5010,47,48007,106,53017,153,1,52,-31,989,100,4096,2,134,64,"Anderson",76978,949.621969913482,0.212447844228095,198.758086726078,90.9350723583361,1284.78266517706,21.2447844228095
2020-12-23,5211,74,4500,42,711,32,5053,43,48323,316,53376,359,2,54,-8,981,80,4176,2,136,66,"Anderson",76978,956.117332224792,0.214881780250348,466.367013952038,96.1313622073839,1274.39008547897,21.4881780250348
2020-12-24,5269,58,4524,24,745,34,5080,27,48475,152,53555,179,1,55,-47,934,104,4280,1,137,71,"Anderson",76978,770.349970121333,0.193313330475782,232.533970744888,75.3462028111928,1213.33367975266,19.3313330475782
2020-12-25,5362,93,4601,77,761,16,5172,92,48884,409,54056,501,0,55,-16,918,109,4389,1,138,72,"Anderson",76978,763.854607810024,0.191516169676606,650.835303593234,120.813738990361,1192.54852035647,19.1516169676606
2020-12-26,5418,56,4630,29,788,27,5200,28,49003,119,54203,147,0,55,6,924,50,4439,3,141,74,"Anderson",76978,700.200057159188,0.181859825927623,190.963651952506,72.7480578866689,1200.34295513004,18.1859825927623
2020-12-27,5478,60,4667,37,811,23,5236,36,49139,136,54375,172,1,56,30,954,29,4468,6,147,75,"Anderson",76978,596.274260178233,0.168757126567845,223.440463509055,77.9443477357167,1239.3151289979,16.8757126567845
2020-12-28,5525,47,4688,21,837,26,5256,20,49208,69,54464,89,2,58,-85,869,130,4598,4,151,82,"Anderson",76978,594.975187715971,0.183125,115.617449141313,61.0564057263114,1128.89396970563,18.3125
2020-12-29,5621,96,4740,52,881,44,5304,48,49303,95,54607,143,2,60,-34,835,128,4726,5,156,85,"Anderson",76978,628.751071734781,0.184905660377358,185.767362103458,124.710956377147,1084.72550598872,18.4905660377358
2020-12-30,5656,35,4758,18,898,17,5321,17,49431,128,54752,145,6,66,-89,746,118,4844,1,157,88,"Anderson",76978,578.087245706566,0.194767441860465,188.365507027982,45.4675361791681,969.108056847411,19.4767441860465
2020-12-31,5819,163,4858,100,961,63,5423,102,49735,304,55158,406,6,72,63,809,94,4938,1,158,93,"Anderson",76978,714.48985424407,0.213973799126638,527.42341967835,211.748811348697,1050.94962196991,21.3973799126638
2021-01-01,5884,65,4900,42,984,23,5478,55,50011,276,55489,331,0,72,-25,784,90,5028,2,160,94,"Anderson",76978,678.115825300735,0.213538032100488,429.992985008704,84.4397100470264,1018.47281041336,21.3538032100488
2021-01-02,5977,93,4941,41,1036,52,5519,41,50296,285,55815,326,0,72,49,833,44,5072,2,162,96,"Anderson",76978,726.181506404427,0.197890818858561,423.497622697394,120.813738990361,1082.1273610642,19.7890818858561
2021-01-03,6002,25,4953,12,1049,13,5535,16,50348,52,55883,68,0,72,-9,824,34,5106,1,163,99,"Anderson",76978,680.713970225259,0.198275862068966,88.3369274338123,32.4768115565486,1070.43570890384,19.8275862068966
2021-01-04,6039,37,4977,24,1062,13,5566,31,50455,107,56021,138,1,73,-57,767,93,5199,0,163,104,"Anderson",76978,667.72324560264,0.199100834938985,179.271999792148,48.065681103692,996.388578554912,19.9100834938985
2021-01-05,6111,72,5008,31,1103,41,5597,31,50573,118,56170,149,2,75,-47,720,117,5316,2,165,107,"Anderson",76978,636.545506508353,0.187460012795905,193.56179687703,93.53321728286,935.3321728286,18.7460012795905
2021-01-06,6185,74,5048,40,1137,34,5640,43,50734,161,56374,204,5,80,-12,708,81,5397,2,167,109,"Anderson",76978,687.209332536569,0.196670776818742,265.010782301437,96.1313622073839,919.743303281457,19.6670776818742
2021-01-07,6290,105,5128,80,1162,25,5732,92,50955,221,56687,313,1,81,65,773,39,5436,1,168,112,"Anderson",76978,611.863129725376,0.202092871157619,406.609680687989,136.402608537504,1004.18301332848,20.2092871157619
2021-01-08,6372,82,5178,50,1194,32,5784,52,51154,199,56938,251,5,86,61,834,16,5452,2,170,115,"Anderson",76978,633.947361583829,0.211180124223602,326.067188027748,106.523941905479,1083.42643352646,21.1180124223602
2021-01-09,6482,110,5247,69,1235,41,5859,75,51585,431,57444,506,2,88,45,879,63,5515,0,170,117,"Anderson",76978,656.031593442282,0.208717004297115,657.330665904544,142.897970848814,1141.88469432825,20.8717004297115
2021-01-10,6542,60,5272,25,1270,35,5884,25,51679,94,57563,119,2,90,28,907,30,5545,3,173,118,"Anderson",76978,701.49912962145,0.207738095238095,154.589623009171,77.9443477357167,1178.25872327158,20.7738095238095
2021-01-11,6575,33,5282,10,1293,23,5897,13,51750,71,57647,84,1,91,-93,814,125,5670,1,174,120,"Anderson",76978,696.302839772403,0.203567035670357,109.122086830003,42.8693912546442,1057.44498428122,20.3567035670357
2021-01-12,6628,53,5316,34,1312,19,5935,38,51922,172,57857,210,2,93,-100,714,151,5821,1,175,120,"Anderson",76978,671.620462989426,0.200355660936574,272.805217075008,68.8508404998831,927.537738055029,20.0355660936574
2021-01-13,6654,26,5333,17,1321,9,5954,19,52012,90,57966,109,3,96,-44,670,67,5888,0,175,121,"Anderson",76978,609.264984800852,0.197236180904523,141.598898386552,33.7758840188106,870.378549715503,19.7236180904523
2021-01-14,6751,97,5395,62,1356,35,6028,74,52419,407,58447,481,5,101,9,679,83,5971,2,177,123,"Anderson",76978,598.872405102757,0.168181818181818,624.853854347995,126.010028839409,882.070201875861,16.8181818181818
2021-01-15,6785,34,5415,20,1370,14,6052,24,52574,155,58626,179,0,101,-16,663,50,6021,1,178,126,"Anderson",76978,536.516926914183,0.158767772511848,232.533970744888,44.1684637169061,861.285042479669,15.8767772511848
2021-01-16,6849,64,5445,30,1404,34,6085,33,52818,244,58903,277,1,102,2,665,61,6082,1,179,129,"Anderson",76978,476.759593650134,0.154900616860864,359.843072046559,83.1406375847645,863.883187404193,15.4900616860864
2021-01-17,6886,37,5465,20,1421,17,6108,23,52922,104,59030,127,0,102,-7,658,44,6126,0,179,131,"Anderson",76978,446.880927018109,0.152692569870484,164.982202707267,48.065681103692,854.78968016836,15.2692569870484
2021-01-18,6905,19,5473,8,1432,11,6118,10,53018,96,59136,106,1,103,-68,590,86,6212,0,179,132,"Anderson",76978,428.693912546442,0.148421759570181,137.701680999766,24.682376782977,766.452752734548,14.8421759570181
2021-01-19,6947,42,5490,17,1457,25,6138,20,53130,112,59268,132,1,104,-78,512,119,6331,0,179,134,"Anderson",76978,414.40411546156,0.143869596031184,171.477565018577,54.5610434150017,665.125100678116,14.3869596031184
2021-01-20,6975,28,5506,16,1469,12,6157,19,53282,152,59439,171,3,107,-29,483,54,6385,0,179,137,"Anderson",76978,417.002260386084,0.137813985064494,222.141391046793,36.3740289433345,627.451999272519,13.7813985064494
2021-01-21,7031,56,5546,40,1485,16,6196,39,53523,241,59719,280,5,112,-43,440,94,6479,2,181,138,"Anderson",76978,363.740289433345,0.132075471698113,363.740289433345,72.7480578866689,571.591883395256,13.2075471698113
2021-01-22,7069,38,5564,18,1505,20,6218,22,53668,145,59886,167,2,114,-16,424,52,6531,0,181,141,"Anderson",76978,368.936579282392,0.131746031746032,216.945101197745,49.3647535659539,550.806723999065,13.1746031746032
2021-01-23,7107,38,5578,14,1529,24,6231,13,53928,260,60159,273,0,114,8,432,30,6561,1,182,141,"Anderson",76978,335.160695263582,0.116242038216561,354.646782197511,49.3647535659539,561.19930369716,11.6242038216561
2021-01-24,7120,13,5590,12,1530,1,6245,14,53995,67,60240,81,0,114,-21,411,34,6595,0,182,143,"Anderson",76978,303.982956169295,0.113223140495868,105.224869443218,16.8879420094053,533.918781989659,11.3223140495868
2021-01-25,7137,17,5601,11,1536,6,6256,11,54055,60,60311,71,2,116,-47,364,62,6657,1,183,145,"Anderson",76978,301.384811244771,0.117446808510638,92.2341448205981,22.0842318584531,472.862376263348,11.7446808510638
2021-01-26,7164,27,5622,21,1542,6,6281,25,54218,163,60499,188,0,116,-36,328,63,6720,1,184,148,"Anderson",76978,281.898724310842,0.116165718927701,244.225622905246,35.0749564810725,426.095767621918,11.6165718927701
2021-01-27,7181,17,5630,8,1551,9,6290,9,54304,86,60594,95,4,120,-17,311,30,6750,0,184,150,"Anderson",76978,267.608927225961,0.115151515151515,123.411883914885,22.0842318584531,404.011535763465,11.5151515151515
2021-01-28,7268,87,5670,40,1598,47,6337,47,54530,226,60867,273,4,124,24,335,59,6809,0,184,151,"Anderson",76978,307.880173556081,0.122822299651568,354.646782197511,113.019304216789,435.189274857752,12.2822299651568
2021-01-29,7281,13,5674,4,1607,9,6342,5,54575,45,60917,50,1,125,-34,301,46,6855,1,185,151,"Anderson",76978,275.403361999532,0.120271580989331,64.9536231130973,16.8879420094053,391.020811140845,12.0271580989331
2021-01-30,7321,40,5709,35,1612,5,6378,36,54834,259,61212,295,2,127,1,302,37,6892,2,187,152,"Anderson",76978,278.001506924056,0.13960113960114,383.226376367274,51.9628984904778,392.319883603107,13.960113960114
2021-01-31,7337,16,5716,7,1621,9,6389,11,55003,169,61392,180,1,128,-4,298,19,6911,0,187,154,"Anderson",76978,281.898724310842,0.125,233.83304320715,20.7851593961911,387.12359375406,12.5
2021-02-01,7357,20,5728,12,1629,8,6402,13,55056,53,61458,66,1,129,-26,272,45,6956,1,188,156,"Anderson",76978,285.795941697628,0.127288578901482,85.7387825092884,25.9814492452389,353.347709735249,12.7288578901482
2021-02-02,7364,7,5734,6,1630,1,6408,6,55125,69,61533,75,5,134,-45,227,47,7003,0,188,157,"Anderson",76978,259.814492452389,0.122823984526112,97.4304346696459,9.09350723583361,294.889448933461,12.2823984526112
2021-02-03,7386,22,5740,6,1646,16,6418,10,55317,192,61735,202,4,138,1,228,17,7020,0,188,158,"Anderson",76978,266.309854763699,0.112182296231376,262.412637376913,28.5795941697628,296.188521395723,11.2182296231376
2021-02-04,7416,30,5754,14,1662,16,6435,17,55641,324,62076,341,2,140,-5,223,33,7053,0,188,158,"Anderson",76978,192.262724414768,0.0810587262200165,442.983709631323,38.9721738678584,289.693159084414,8.10587262200166
2021-02-05,7434,18,5765,11,1669,7,6452,17,55798,157,62250,174,2,142,-13,210,29,7082,0,188,159,"Anderson",76978,198.758086726078,0.0825206301575394,226.038608433578,23.383304320715,272.805217075008,8.25206301575394
2021-02-06,7460,26,5781,16,1679,10,6472,20,56020,222,62492,242,1,143,8,218,17,7099,1,189,159,"Anderson",76978,180.57107225441,0.0734375,314.375535867391,33.7758840188106,283.197796773104,7.34375
2021-02-07,7473,13,5788,7,1685,6,6480,8,56127,107,62607,115,0,143,-10,208,23,7122,0,189,159,"Anderson",76978,176.673854867625,0.0748971193415638,149.393333160124,16.8879420094053,270.207072150485,7.48971193415638
2021-02-08,7498,25,5794,6,1704,19,6485,5,56149,22,62634,27,2,145,-12,196,35,7157,0,189,159,"Anderson",76978,183.169217178934,0.070578231292517,35.0749564810725,32.4768115565486,254.618202603341,7.0578231292517
2021-02-09,7522,24,5804,10,1718,14,6496,11,56318,169,62814,180,2,147,-24,172,46,7203,2,191,159,"Anderson",76978,205.253449037387,0.068696330991413,233.83304320715,31.1777390942867,223.440463509055,6.8696330991413
2021-02-10,7547,25,5819,15,1728,10,6515,19,56513,195,63028,214,1,148,8,180,16,7219,1,192,159,"Anderson",76978,209.150666424173,0.0750193348801237,278.001506924056,32.4768115565486,233.83304320715,7.50193348801237
2021-02-11,7560,13,5827,8,1733,5,6527,12,56693,180,63220,192,-1,147,-16,164,30,7249,0,192,160,"Anderson",76978,187.06643456572,0.0804195804195804,249.421912754293,16.8879420094053,213.047883810959,8.04195804195804
2021-02-12,7587,27,5842,15,1745,12,6542,15,56887,194,63429,209,0,147,13,177,14,7263,0,192,160,"Anderson",76978,198.758086726078,0.0763358778625954,271.506144612746,35.0749564810725,229.935825820364,7.63358778625954
2021-02-13,7613,26,5852,10,1761,16,6552,10,57076,189,63628,199,0,147,11,188,15,7278,0,192,160,"Anderson",76978,198.758086726078,0.0704225352112676,258.515419990127,33.7758840188106,244.225622905246,7.04225352112676
2021-02-14,7627,14,5862,10,1765,4,6563,11,57137,61,63700,72,2,149,1,189,11,7289,0,192,160,"Anderson",76978,200.05715918834,0.0759377859103385,93.53321728286,18.1870144716672,245.524695367508,7.59377859103385
2021-02-15,7643,16,5870,8,1773,8,6572,9,57210,73,63782,82,0,149,-6,183,22,7311,1,193,161,"Anderson",76978,188.365507027982,0.0757839721254355,106.523941905479,20.7851593961911,237.730260593936,7.57839721254355
2021-02-16,7672,29,5884,14,1788,15,6589,17,57294,84,63883,101,0,149,11,194,18,7329,0,193,161,"Anderson",76978,194.860869339292,0.0869971936389149,131.206318688456,37.6731014055964,252.020057678817,8.69971936389149
2021-02-17,7691,19,5896,12,1795,7,6601,12,57402,108,64003,120,0,149,-8,186,27,7356,0,193,163,"Anderson",76978,187.06643456572,0.0882051282051282,155.888695471433,24.682376782977,241.627477980722,8.82051282051282
2021-02-18,7715,24,5918,22,1797,2,6627,26,57558,156,64185,182,0,149,9,195,15,7371,0,193,163,"Anderson",76978,201.356231650601,0.103626943005181,236.431188131674,31.1777390942867,253.319130141079,10.3626943005181
2021-02-19,7728,13,5929,11,1799,2,6642,15,57604,46,64246,61,0,149,0,195,13,7384,0,193,164,"Anderson",76978,183.169217178934,0.122399020807834,79.2434201979787,16.8879420094053,253.319130141079,12.2399020807834
2021-02-20,7747,19,5936,7,1811,12,6651,9,57726,122,64377,131,1,150,3,198,15,7399,0,193,165,"Anderson",76978,174.075709943101,0.132176234979973,170.178492556315,24.682376782977,257.216347527865,13.2176234979973
2021-02-21,7759,12,5943,7,1816,5,6658,7,57790,64,64448,71,2,152,-1,197,11,7410,1,194,165,"Anderson",76978,171.477565018577,0.127005347593583,92.2341448205981,15.5888695471433,255.917275065603,12.7005347593583
2021-02-22,7764,5,5945,2,1819,3,6664,6,57827,37,64491,43,1,153,-17,180,21,7431,0,194,166,"Anderson",76978,157.187767933695,0.129760225669958,55.8601158772636,6.49536231130973,233.83304320715,12.9760225669958
2021-02-23,7788,24,5954,9,1834,15,6672,8,57970,143,64642,151,2,155,-2,178,24,7455,0,194,168,"Anderson",76978,150.692405622386,0.10935441370224,196.159941801554,31.1777390942867,231.234898282626,10.935441370224
2021-02-24,7820,32,5973,19,1847,13,6695,23,58144,174,64839,197,0,155,15,193,17,7472,0,194,168,"Anderson",76978,167.580347631791,0.11244019138756,255.917275065603,41.5703187923822,250.720985216555,11.244019138756
2021-02-25,7837,17,5981,8,1856,9,6706,11,58271,127,64977,138,1,156,-3,190,19,7491,0,194,168,"Anderson",76978,158.486840395957,0.0997474747474748,179.271999792148,22.0842318584531,246.82376782977,9.97474747474748
2021-02-26,7849,12,5989,8,1860,4,6715,9,58370,99,65085,108,0,156,-17,173,29,7520,0,194,168,"Anderson",76978,157.187767933695,0.0870083432657926,140.29982592429,15.5888695471433,224.739535971316,8.70083432657926
2021-02-27,7858,9,5996,7,1862,2,6721,6,58462,92,65183,98,0,156,-6,167,15,7535,0,194,168,"Anderson",76978,144.197043311076,0.086848635235732,127.309101301671,11.6916521603575,216.945101197745,8.6848635235732
2021-02-28,7872,14,6006,10,1866,4,6732,11,58533,71,65265,82,0,156,0,167,14,7549,0,194,168,"Anderson",76978,146.7951882356,0.0905752753977968,106.523941905479,18.1870144716672,216.945101197745,9.05752753977968
2021-03-01,7880,8,6011,5,1869,3,6739,7,58568,35,65307,42,0,156,-11,156,19,7568,0,194,169,"Anderson",76978,150.692405622386,0.0919117647058824,54.5610434150017,10.3925796980956,202.655304112863,9.19117647058824
2021-03-02,7903,23,6022,11,1881,12,6749,10,58684,116,65433,126,1,157,-2,154,24,7592,1,195,169,"Anderson",76978,149.393333160124,0.0973451327433628,163.683130245005,29.8786666320247,200.05715918834,9.73451327433628
2021-03-03,7936,33,6043,21,1893,12,6774,25,58800,116,65574,141,1,158,13,167,19,7611,0,195,170,"Anderson",76978,150.692405622386,0.107482993197279,183.169217178934,42.8693912546442,216.945101197745,10.7482993197279
2021-03-04,7961,25,6056,13,1905,12,6791,17,58963,163,65754,180,0,158,13,180,12,7623,0,195,170,"Anderson",76978,161.084985320481,0.109395109395109,233.83304320715,32.4768115565486,233.83304320715,10.9395109395109
2021-03-05,7994,33,6073,17,1921,16,6813,22,59097,134,65910,156,0,158,18,198,15,7638,2,197,170,"Anderson",76978,188.365507027982,0.118787878787879,202.655304112863,42.8693912546442,257.216347527865,11.8787878787879
2021-03-06,8004,10,6078,5,1926,5,6821,8,59186,89,66007,97,0,158,-1,197,11,7649,0,197,170,"Anderson",76978,189.664579490244,0.121359223300971,126.010028839409,12.9907246226195,255.917275065603,12.1359223300971
2021-03-07,8010,6,6081,3,1929,3,6824,3,59225,39,66049,42,0,158,-10,187,16,7665,0,197,170,"Anderson",76978,179.271999792148,0.11734693877551,54.5610434150017,7.79443477357167,242.926550442984,11.734693877551
2021-03-08,8026,16,6088,7,1938,9,6833,9,59302,77,66135,86,1,159,-4,183,19,7684,0,197,170,"Anderson",76978,189.664579490244,0.113526570048309,111.720231754527,20.7851593961911,237.730260593936,11.3526570048309
2021-03-09,8047,21,6096,8,1951,13,6841,8,59367,65,66208,73,0,159,3,186,18,7702,3,200,171,"Anderson",76978,187.06643456572,0.118709677419355,94.832289745122,27.2805217075008,241.627477980722,11.8709677419355
2021-03-10,8069,22,6109,13,1960,9,6857,16,59524,157,66381,173,0,159,11,197,11,7713,1,201,171,"Anderson",76978,172.776637480839,0.102850061957869,224.739535971316,28.5795941697628,255.917275065603,10.2850061957869
2021-03-11,8092,23,6119,10,1973,13,6867,10,59621,97,66488,107,0,159,1,198,22,7735,1,202,172,"Anderson",76978,170.178492556315,0.103542234332425,139.000753462028,29.8786666320247,257.216347527865,10.3542234332425
2021-03-12,8112,20,6136,17,1976,3,6887,20,59727,106,66614,126,0,159,8,206,12,7747,0,202,172,"Anderson",76978,153.29055054691,0.105113636363636,163.683130245005,25.9814492452389,267.608927225961,10.5113636363636
2021-03-13,8123,11,6140,4,1983,7,6891,4,59803,76,66694,80,0,159,2,208,9,7756,1,203,172,"Anderson",76978,154.589623009171,0.101892285298399,103.925796980956,14.2897970848814,270.207072150485,10.1892285298399
2021-03-14,8129,6,6144,4,1985,2,6897,6,59839,36,66736,42,0,159,-13,195,19,7775,1,204,172,"Anderson",76978,154.589623009171,0.106259097525473,54.5610434150017,7.79443477357167,253.319130141079,10.6259097525473
2021-03-15,8147,18,6150,6,1997,12,6903,6,59872,33,66775,39,0,159,-9,186,27,7802,1,205,172,"Anderson",76978,157.187767933695,0.109375,50.6638260282159,23.383304320715,241.627477980722,10.9375
2021-03-16,8180,33,6163,13,2017,20,6918,15,59965,93,66883,108,0,159,-2,184,35,7837,2,207,172,"Anderson",76978,172.776637480839,0.114074074074074,140.29982592429,42.8693912546442,239.029333056198,11.4074074074074
2021-03-17,8197,17,6174,11,2023,6,6931,13,60052,87,66983,100,0,159,-5,179,22,7859,0,207,173,"Anderson",76978,166.281275169529,0.122923588039867,129.907246226195,22.0842318584531,232.533970744888,12.2923588039867
2021-03-18,8213,16,6186,12,2027,4,6946,15,60133,81,67079,96,1,160,-1,178,16,7875,0,207,173,"Anderson",76978,157.187767933695,0.133671742808799,124.710956377147,20.7851593961911,231.234898282626,13.3671742808799
2021-03-19,8237,24,6200,14,2037,10,6959,13,60252,119,67211,132,0,160,13,191,11,7886,1,208,173,"Anderson",76978,162.384057782743,0.120603015075377,171.477565018577,31.1777390942867,248.122840292031,12.0603015075377
2021-03-20,8249,12,6206,6,2043,6,6967,8,60291,39,67258,47,0,160,3,194,9,7895,1,209,173,"Anderson",76978,163.683130245005,0.134751773049645,61.0564057263114,15.5888695471433,252.020057678817,13.4751773049645
2021-03-21,8259,10,6212,6,2047,4,6974,7,60353,62,67327,69,-1,159,-5,189,16,7911,0,209,173,"Anderson",76978,168.879420094053,0.130287648054146,89.6359998960742,12.9907246226195,245.524695367508,13.0287648054146
2021-03-22,8265,6,6213,1,2052,5,6975,1,60419,66,67394,67,0,159,-9,180,15,7926,1,210,173,"Anderson",76978,153.29055054691,0.116316639741519,87.0378549715503,7.79443477357167,233.83304320715,11.6316639741519
2021-03-23,8271,6,6214,1,2057,5,6976,1,60462,43,67438,44,0,159,-15,165,21,7947,0,210,174,"Anderson",76978,118.215594065837,0.104504504504505,57.1591883395256,7.79443477357167,214.346956273221,10.4504504504505
2021-03-24,8279,8,6221,7,2058,1,6983,7,60583,121,67566,128,1,160,-11,154,18,7965,0,210,174,"Anderson",76978,106.523941905479,0.0891938250428816,166.281275169529,10.3925796980956,200.05715918834,8.91938250428817
2021-03-25,8289,10,6226,5,2063,5,6989,6,60684,101,67673,107,0,160,-10,144,20,7985,0,210,174,"Anderson",76978,98.7295071319078,0.0723905723905724,139.000753462028,12.9907246226195,187.06643456572,7.23905723905724
2021-03-26,8306,17,6238,12,2068,5,7000,11,60750,66,67750,77,0,160,2,146,15,8000,0,210,175,"Anderson",76978,89.6359998960742,0.0760667903525046,100.02857959417,22.0842318584531,189.664579490244,7.60667903525046
2021-03-27,8310,4,6242,4,2068,0,7006,6,60814,64,67820,70,1,161,-12,134,15,8015,2,212,175,"Anderson",76978,79.2434201979786,0.0693950177935943,90.9350723583361,5.19628984904778,174.075709943101,6.93950177935943
2021-03-28,8313,3,6242,0,2071,3,7006,0,60843,29,67849,29,1,162,-12,122,14,8029,0,212,176,"Anderson",76978,70.149912962145,0.0613026819923372,37.6731014055964,3.89721738678583,158.486840395957,6.13026819923372
2021-03-29,8328,15,6246,4,2082,11,7010,4,60929,86,67939,90,1,163,-16,106,30,8059,0,212,177,"Anderson",76978,81.8415651225025,0.0642201834862385,116.916521603575,19.4860869339292,137.701680999766,6.42201834862385
2021-03-30,8333,5,6249,3,2084,2,7013,3,60987,58,68000,61,1,164,-12,94,16,8075,0,212,177,"Anderson",76978,80.5424926602406,0.0658362989323843,79.2434201979787,6.49536231130973,122.112811452623,6.58362989323843
2021-03-31,8356,23,6263,14,2093,9,7029,16,61151,164,68180,180,1,165,10,104,12,8087,1,213,177,"Anderson",76978,100.02857959417,0.0749185667752443,233.83304320715,29.8786666320247,135.103536075242,7.49185667752443
2021-04-01,8365,9,6267,4,2098,5,7033,4,61208,57,68241,61,0,165,-8,96,17,8104,0,213,177,"Anderson",76978,98.7295071319078,0.0774647887323944,79.2434201979787,11.6916521603575,124.710956377147,7.74647887323944
2021-04-02,8374,9,6274,7,2100,2,7040,7,61278,70,68318,77,0,165,-1,95,10,8114,0,213,177,"Anderson",76978,88.3369274338123,0.0704225352112676,100.02857959417,11.6916521603575,123.411883914885,7.04225352112676
2021-04-03,8380,6,6279,5,2101,1,7046,6,61328,50,68374,56,0,165,-8,87,14,8128,0,213,177,"Anderson",76978,90.9350723583361,0.0722021660649819,72.7480578866689,7.79443477357167,113.019304216789,7.22021660649819
2021-04-04,8382,2,6281,2,2101,0,7048,2,61366,38,68414,40,0,165,-5,82,7,8135,0,213,177,"Anderson",76978,89.6359998960742,0.0743362831858407,51.9628984904778,2.59814492452389,106.523941905479,7.43362831858407
2021-04-05,8396,14,6284,3,2112,11,7050,2,61424,58,68474,60,0,165,4,86,10,8145,2,215,177,"Anderson",76978,88.3369274338123,0.0747663551401869,77.9443477357167,18.1870144716672,111.720231754527,7.47663551401869
2021-04-06,8401,5,6288,4,2113,1,7056,6,61466,42,68522,48,0,165,3,89,2,8147,0,215,177,"Anderson",76978,88.3369274338123,0.0823754789272031,62.3554781885734,6.49536231130973,115.617449141313,8.23754789272031
2021-04-07,8421,20,6301,13,2120,7,7070,14,61625,159,68695,173,0,165,10,99,10,8157,2,217,177,"Anderson",76978,84.4397100470264,0.0796116504854369,224.739535971316,25.9814492452389,128.608173763933,7.96116504854369
2021-04-08,8424,3,6303,2,2121,1,7073,3,61716,91,68789,94,5,170,-17,82,15,8172,1,218,177,"Anderson",76978,76.6452752734548,0.072992700729927,122.112811452623,3.89721738678583,106.523941905479,7.2992700729927
2021-04-09,8432,8,6309,6,2123,2,7082,9,61803,87,68885,96,-4,166,8,90,4,8176,0,218,177,"Anderson",76978,75.3462028111928,0.0740740740740741,124.710956377147,10.3925796980956,116.916521603575,7.40740740740741
2021-04-10,8437,5,6314,5,2123,0,7087,5,61874,71,68961,76,0,166,-6,84,11,8187,0,218,177,"Anderson",76978,74.0471303489309,0.0698466780238501,98.7295071319078,6.49536231130973,109.122086830003,6.98466780238501
2021-04-11,8444,7,6319,5,2125,2,7092,5,61918,44,69010,49,-1,165,0,84,8,8195,0,218,177,"Anderson",76978,80.5424926602406,0.0738255033557047,63.6545506508353,9.09350723583361,109.122086830003,7.38255033557047
2021-04-12,8447,3,6322,3,2125,0,7095,3,61987,69,69082,72,0,165,-7,77,10,8205,0,218,177,"Anderson",76978,66.2526955753592,0.0740131578947368,93.53321728286,3.89721738678583,100.02857959417,7.40131578947368
2021-04-13,8457,10,6327,5,2130,5,7101,6,62048,61,69149,67,5,170,-7,70,12,8217,0,218,177,"Anderson",76978,72.7480578866689,0.0717703349282297,87.0378549715503,12.9907246226195,90.9350723583361,7.17703349282297
2021-04-14,8471,14,6336,9,2135,5,7112,11,62186,138,69298,149,0,170,7,77,7,8224,0,218,177,"Anderson",76978,64.9536231130973,0.0696517412935323,193.56179687703,18.1870144716672,100.02857959417,6.96517412935323
2021-04-15,8480,9,6341,5,2139,4,7117,5,62267,81,69384,86,0,170,6,83,3,8227,0,218,177,"Anderson",76978,72.7480578866689,0.0739495798319328,111.720231754527,11.6916521603575,107.823014367741,7.39495798319328
2021-04-16,8493,13,6352,11,2141,2,7130,13,62420,153,69550,166,0,170,6,89,7,8234,0,218,177,"Anderson",76978,79.2434201979786,0.0721804511278196,215.646028735483,16.8879420094053,115.617449141313,7.21804511278196
2021-04-17,8498,5,6355,3,2143,2,7134,4,62485,65,69619,69,0,170,0,89,5,8239,0,218,177,"Anderson",76978,79.2434201979786,0.0714285714285714,89.6359998960742,6.49536231130973,115.617449141313,7.14285714285714
2021-04-18,8505,7,6361,6,2144,1,7140,6,62530,45,69670,51,0,170,0,89,7,8246,0,218,177,"Anderson",76978,79.2434201979786,0.0727272727272727,66.2526955753592,9.09350723583361,115.617449141313,7.27272727272727
2021-04-19,8511,6,6364,3,2147,3,7143,3,62553,23,69696,26,0,170,-6,83,12,8258,0,218,178,"Anderson",76978,83.1406375847645,0.0781758957654723,33.7758840188106,7.79443477357167,107.823014367741,7.81758957654723
2021-04-20,8517,6,6367,3,2150,3,7146,3,62652,99,69798,102,0,170,-1,82,7,8265,0,218,178,"Anderson",76978,77.9443477357167,0.0693374422187981,132.505391150718,7.79443477357167,106.523941905479,6.93374422187981
2021-04-21,8529,12,6373,6,2156,6,7152,6,62807,155,69959,161,1,171,-2,80,13,8278,0,218,178,"Anderson",76978,75.3462028111928,0.0605143721633888,209.150666424173,15.5888695471433,103.925796980956,6.05143721633888
2021-04-22,8547,18,6379,6,2168,12,7159,7,62951,144,70110,151,0,171,12,92,6,8284,0,218,178,"Anderson",76978,87.0378549715503,0.0578512396694215,196.159941801554,23.383304320715,119.514666528099,5.78512396694215
2021-04-23,8557,10,6384,5,2173,5,7165,6,63117,166,70282,172,0,171,8,100,2,8286,0,218,178,"Anderson",76978,83.1406375847645,0.0478142076502732,223.440463509055,12.9907246226195,129.907246226195,4.78142076502732
2021-04-24,8569,12,6390,6,2179,6,7172,7,63184,67,70356,74,0,171,8,108,4,8290,1,219,178,"Anderson",76978,92.2341448205981,0.0515603799185889,96.1313622073839,15.5888695471433,140.29982592429,5.15603799185889
2021-04-25,8573,4,6392,2,2181,2,7174,2,63224,40,70398,42,0,171,0,108,4,8294,0,219,178,"Anderson",76978,88.3369274338123,0.0467032967032967,54.5610434150017,5.19628984904778,140.29982592429,4.67032967032967
2021-04-26,8582,9,6396,4,2186,5,7178,4,63299,75,70477,79,0,171,2,110,7,8301,0,219,179,"Anderson",76978,92.2341448205981,0.0448143405889885,102.626724518694,11.6916521603575,142.897970848814,4.48143405889885
2021-04-27,8592,10,6402,6,2190,4,7184,6,63367,68,70551,74,0,171,-3,107,13,8314,0,219,179,"Anderson",76978,97.4304346696459,0.050464807436919,96.1313622073839,12.9907246226195,139.000753462028,5.0464807436919
2021-04-28,8609,17,6414,12,2195,5,7197,13,63505,138,70702,151,0,171,1,108,16,8330,1,220,180,"Anderson",76978,103.925796980956,0.0605652759084791,196.159941801554,22.0842318584531,140.29982592429,6.05652759084791
2021-04-29,8615,6,6416,2,2199,4,7200,3,63654,149,70854,152,0,171,-1,107,7,8337,0,220,180,"Anderson",76978,88.3369274338123,0.0551075268817204,197.459014263816,7.79443477357167,139.000753462028,5.51075268817204
2021-04-30,8622,7,6419,3,2203,4,7204,4,63776,122,70980,126,0,171,-2,105,9,8346,0,220,180,"Anderson",76978,84.4397100470264,0.0558739255014327,163.683130245005,9.09350723583361,136.402608537504,5.58739255014327
2021-05-01,8627,5,6422,3,2205,2,7207,3,63839,63,71046,66,0,171,-1,104,6,8352,1,221,180,"Anderson",76978,75.3462028111928,0.0507246376811594,85.7387825092884,6.49536231130973,135.103536075242,5.07246376811594
2021-05-02,8630,3,6423,1,2207,2,7208,1,63890,51,71098,52,0,171,-7,97,10,8362,0,221,180,"Anderson",76978,74.0471303489309,0.0485714285714286,67.5517680376211,3.89721738678583,126.010028839409,4.85714285714286
2021-05-03,8640,10,6428,5,2212,5,7213,5,63996,106,71209,111,0,171,-3,94,13,8375,0,221,180,"Anderson",76978,75.3462028111928,0.0478142076502732,144.197043311076,12.9907246226195,122.112811452623,4.78142076502732
2021-05-04,8642,2,6428,0,2214,2,7214,1,64072,76,71286,77,0,171,-11,83,13,8388,0,221,180,"Anderson",76978,64.9536231130973,0.0408163265306122,100.02857959417,2.59814492452389,107.823014367741,4.08163265306122
2021-05-05,8650,8,6432,4,2218,4,7217,3,64189,117,71406,120,0,171,-3,80,11,8399,0,221,180,"Anderson",76978,53.2619709527397,0.0284090909090909,155.888695471433,10.3925796980956,103.925796980956,2.84090909090909
2021-05-06,8655,5,6435,3,2220,2,7223,6,64241,52,71464,58,0,171,-4,76,9,8408,1,222,180,"Anderson",76978,51.9628984904778,0.0377049180327869,75.3462028111928,6.49536231130973,98.7295071319078,3.77049180327869
2021-05-07,8660,5,6437,2,2223,3,7226,3,64362,121,71588,124,0,171,-4,72,9,8417,0,222,180,"Anderson",76978,49.3647535659539,0.0361842105263158,161.084985320481,6.49536231130973,93.53321728286,3.61842105263158
2021-05-08,8666,6,6440,3,2226,3,7228,2,64431,69,71659,71,0,171,-6,66,12,8429,1,223,181,"Anderson",76978,50.6638260282159,0.034257748776509,92.2341448205981,7.79443477357167,85.7387825092884,3.4257748776509
2021-05-09,8667,1,6440,0,2227,1,7229,1,64459,28,71688,29,0,171,-4,62,5,8434,0,223,181,"Anderson",76978,48.065681103692,0.0355932203389831,37.6731014055964,1.29907246226194,80.5424926602406,3.55932203389831
2021-05-10,8672,5,6440,0,2232,5,7229,0,64547,88,71776,88,0,171,-5,57,10,8444,0,223,181,"Anderson",76978,41.5703187923822,0.0282186948853616,114.318376679051,6.49536231130973,74.0471303489309,2.82186948853616
2021-05-11,8680,8,6441,1,2239,7,7231,2,64589,42,71820,44,0,171,3,60,5,8449,0,223,182,"Anderson",76978,49.3647535659539,0.0318352059925094,57.1591883395256,10.3925796980956,77.9443477357167,3.18352059925094
2021-05-12,8693,13,6448,7,2245,6,7237,6,64693,104,71930,110,0,171,8,68,5,8454,2,225,182,"Anderson",76978,55.8601158772636,0.0381679389312977,142.897970848814,16.8879420094053,88.3369274338123,3.81679389312977
2021-05-13,8697,4,6450,2,2247,2,7239,2,64796,103,72035,105,0,171,-3,65,7,8461,2,227,182,"Anderson",76978,54.5610434150017,0.0280210157618214,136.402608537504,5.19628984904778,84.4397100470264,2.80210157618214
2021-05-14,8705,8,6453,3,2252,5,7244,5,64883,87,72127,92,0,171,2,67,6,8467,0,227,182,"Anderson",76978,58.4582608017875,0.0333951762523191,119.514666528099,10.3925796980956,87.0378549715503,3.33951762523191
2021-05-15,8710,5,6455,2,2255,3,7246,2,64948,65,72194,67,0,171,1,68,4,8471,0,227,182,"Anderson",76978,57.1591883395256,0.0336448598130841,87.0378549715503,6.49536231130973,88.3369274338123,3.36448598130841
2021-05-16,8712,2,6456,1,2256,1,7247,1,64984,36,72231,37,0,171,-5,63,7,8478,0,227,182,"Anderson",76978,58.4582608017875,0.0331491712707182,48.065681103692,2.59814492452389,81.8415651225025,3.31491712707182
2021-05-17,8718,6,6461,5,2257,1,7252,5,65043,59,72295,64,1,172,0,63,5,8483,0,227,182,"Anderson",76978,59.7573332640495,0.0443159922928709,83.1406375847645,7.79443477357167,81.8415651225025,4.43159922928709
2021-05-18,8722,4,6461,0,2261,4,7252,0,65134,91,72386,91,0,172,0,63,4,8487,1,228,182,"Anderson",76978,54.5610434150017,0.0371024734982332,118.215594065837,5.19628984904778,81.8415651225025,3.71024734982332
2021-05-19,8729,7,6466,5,2263,2,7258,6,65253,119,72511,125,0,172,5,68,2,8489,0,228,182,"Anderson",76978,46.76660864143,0.036144578313253,162.384057782743,9.09350723583361,88.3369274338123,3.6144578313253
2021-05-20,8731,2,6468,2,2263,0,7260,2,65372,119,72632,121,0,172,-1,67,3,8492,0,228,182,"Anderson",76978,44.1684637169061,0.0351758793969849,157.187767933695,2.59814492452389,87.0378549715503,3.51758793969849
2021-05-21,8733,2,6468,0,2265,2,7260,0,65442,70,72702,70,0,172,-7,60,9,8501,0,228,182,"Anderson",76978,36.3740289433345,0.0278260869565217,90.9350723583361,2.59814492452389,77.9443477357167,2.78260869565217
2021-05-22,8738,5,6470,2,2268,3,7262,2,65482,40,72744,42,0,172,-3,57,8,8509,0,228,182,"Anderson",76978,36.3740289433345,0.0290909090909091,54.5610434150017,6.49536231130973,74.0471303489309,2.90909090909091
2021-05-23,8738,0,6470,0,2268,0,7262,0,65511,29,72773,29,0,172,-3,54,3,8512,0,228,182,"Anderson",76978,33.7758840188106,0.0276752767527675,37.6731014055964,0,70.149912962145,2.76752767527675
2021-05-24,8746,8,6474,4,2272,4,7265,3,65570,59,72835,62,0,172,1,55,7,8519,0,228,182,"Anderson",76978,36.3740289433345,0.0240740740740741,80.5424926602406,10.3925796980956,71.448985424407,2.40740740740741
2021-05-25,8748,2,6474,0,2274,2,7266,1,65615,45,72881,46,0,172,-10,45,12,8531,0,228,182,"Anderson",76978,33.7758840188106,0.0282828282828283,59.7573332640495,2.59814492452389,58.4582608017875,2.82828282828283
2021-05-26,8755,7,6479,5,2276,2,7272,6,65715,100,72987,106,0,172,0,45,7,8538,0,228,182,"Anderson",76978,33.7758840188106,0.0294117647058824,137.701680999766,9.09350723583361,58.4582608017875,2.94117647058824
2021-05-27,8757,2,6480,1,2277,1,7273,1,65765,50,73038,51,0,172,-1,44,3,8541,1,229,182,"Anderson",76978,33.7758840188106,0.0320197044334975,66.2526955753592,2.59814492452389,57.1591883395256,3.20197044334975
2021-05-28,8762,5,6484,4,2278,1,7278,5,65848,83,73126,88,0,172,0,44,5,8546,0,229,182,"Anderson",76978,37.6731014055964,0.0424528301886792,114.318376679051,6.49536231130973,57.1591883395256,4.24528301886792
2021-05-29,8763,1,6484,0,2279,1,7278,0,65885,37,73163,37,0,172,-5,39,6,8552,0,229,182,"Anderson",76978,32.4768115565486,0.0381861575178998,48.065681103692,1.29907246226194,50.6638260282159,3.81861575178998
2021-05-30,8766,3,6485,1,2281,2,7279,1,65935,50,73214,51,0,172,0,39,3,8555,0,229,182,"Anderson",76978,36.3740289433345,0.0385487528344671,66.2526955753592,3.89721738678583,50.6638260282159,3.85487528344671
2021-05-31,8770,4,6488,3,2282,1,7282,3,65986,51,73268,54,0,172,1,40,3,8558,0,229,182,"Anderson",76978,31.1777390942867,0.0392609699769053,70.149912962145,5.19628984904778,51.9628984904778,3.92609699769053
2021-06-01,8773,3,6490,2,2283,1,7283,1,66034,48,73317,49,0,172,1,41,2,8560,1,230,182,"Anderson",76978,32.4768115565486,0.0389908256880734,63.6545506508353,3.89721738678583,53.2619709527397,3.89908256880734
2021-06-02,8777,4,6491,1,2286,3,7285,2,66075,41,73360,43,0,172,-2,39,6,8566,0,230,182,"Anderson",76978,28.5795941697628,0.0348525469168901,55.8601158772636,5.19628984904778,50.6638260282159,3.48525469168901
2021-06-03,8778,1,6491,0,2287,1,7288,3,66165,90,73453,93,1,173,-3,36,3,8569,0,230,183,"Anderson",76978,27.2805217075008,0.036144578313253,120.813738990361,1.29907246226194,46.76660864143,3.6144578313253
2021-06-04,8779,1,6492,1,2287,0,7290,2,66218,53,73508,55,-1,172,-2,34,4,8573,0,230,183,"Anderson",76978,22.0842318584531,0.031413612565445,71.448985424407,1.29907246226194,44.1684637169061,3.1413612565445
2021-06-05,8780,1,6493,1,2287,0,7291,1,66275,57,73566,58,0,172,-3,31,4,8577,0,230,183,"Anderson",76978,22.0842318584531,0.032258064516129,75.3462028111928,1.29907246226194,40.2712463301203,3.2258064516129
2021-06-06,8780,0,6493,0,2287,0,7291,0,66300,25,73591,25,0,172,-4,27,4,8581,0,230,183,"Anderson",76978,18.1870144716672,0.0318302387267905,32.4768115565486,0,35.0749564810725,3.18302387267904
2021-06-07,8781,1,6493,0,2288,1,7291,0,66364,64,73655,64,0,172,-1,26,2,8583,0,230,183,"Anderson",76978,14.2897970848814,0.0232558139534884,83.1406375847645,1.29907246226194,33.7758840188106,2.32558139534884
2021-06-08,8782,1,6493,0,2289,1,7291,0,66401,37,73692,37,0,172,-1,25,2,8585,1,231,184,"Anderson",76978,11.6916521603575,0.0213333333333333,48.065681103692,1.29907246226194,32.4768115565486,2.13333333333333
2021-06-09,8782,0,6493,0,2289,0,7291,0,66483,82,73774,82,0,172,-4,21,4,8589,0,231,184,"Anderson",76978,6.49536231130972,0.0144927536231884,106.523941905479,0,27.2805217075008,1.44927536231884
2021-06-10,8786,4,6494,1,2292,3,7292,1,66540,57,73832,58,0,172,4,25,0,8589,0,231,184,"Anderson",76978,10.3925796980956,0.0105540897097625,75.3462028111928,5.19628984904778,32.4768115565486,1.05540897097625
2021-06-11,8787,1,6494,0,2293,1,7293,1,66595,55,73888,56,1,173,-3,22,3,8592,0,231,184,"Anderson",76978,10.3925796980956,0.00789473684210526,72.7480578866689,1.29907246226194,28.5795941697628,0.789473684210526
2021-06-12,8788,1,6494,0,2294,1,7294,1,66650,55,73944,56,2,175,-4,18,3,8595,0,231,184,"Anderson",76978,10.3925796980956,0.00793650793650794,72.7480578866689,1.29907246226194,23.383304320715,0.793650793650794
2021-06-13,8789,1,6494,0,2295,1,7295,1,66688,38,73983,39,0,175,-3,15,4,8599,0,231,184,"Anderson",76978,11.6916521603575,0.0102040816326531,50.6638260282159,1.29907246226194,19.4860869339292,1.02040816326531
2021-06-14,8791,2,6496,2,2295,0,7297,2,66774,86,74071,88,0,175,1,16,1,8600,0,231,184,"Anderson",76978,12.9907246226194,0.0144230769230769,114.318376679051,2.59814492452389,20.7851593961911,1.44230769230769
2021-06-15,8791,0,6496,0,2295,0,7298,1,66805,31,74103,32,0,175,-2,14,2,8602,0,231,184,"Anderson",76978,11.6916521603575,0.0170316301703163,41.5703187923822,0,18.1870144716672,1.70316301703163
2021-06-16,8792,1,6497,1,2295,0,7299,1,66849,44,74148,45,0,175,0,14,1,8603,0,231,184,"Anderson",76978,12.9907246226194,0.0213903743315508,58.4582608017875,1.29907246226194,18.1870144716672,2.13903743315508
2021-06-17,8792,0,6497,0,2295,0,7299,0,66935,86,74234,86,0,175,-1,13,1,8604,0,231,184,"Anderson",76978,7.79443477357167,0.0174129353233831,111.720231754527,0,16.8879420094053,1.74129353233831
2021-06-18,8794,2,6498,1,2296,1,7303,4,66985,50,74288,54,0,175,1,14,1,8605,0,231,184,"Anderson",76978,9.09350723583361,0.025,70.149912962145,2.59814492452389,18.1870144716672,2.5
2021-06-19,8794,0,6498,0,2296,0,7303,0,67033,48,74336,48,0,175,-1,13,1,8606,0,231,184,"Anderson",76978,7.79443477357167,0.0229591836734694,62.3554781885734,0,16.8879420094053,2.29591836734694
2021-06-20,8794,0,6498,0,2296,0,7304,1,67056,23,74360,24,0,175,-2,11,2,8608,0,231,184,"Anderson",76978,6.49536231130972,0.0238726790450928,31.1777390942867,0,14.2897970848814,2.38726790450928
2021-06-21,8795,1,6498,0,2297,1,7304,0,67096,40,74400,40,0,175,0,11,1,8609,0,231,184,"Anderson",76978,5.19628984904778,0.0212765957446809,51.9628984904778,1.29907246226194,14.2897970848814,2.12765957446809
2021-06-22,8799,4,6499,1,2300,3,7304,0,67138,42,74442,42,0,175,2,13,2,8611,1,232,184,"Anderson",76978,10.3925796980956,0.0176991150442478,54.5610434150017,5.19628984904778,16.8879420094053,1.76991150442478
2021-06-23,8800,1,6500,1,2300,0,7305,1,67186,48,74491,49,0,175,1,14,0,8611,0,232,184,"Anderson",76978,10.3925796980956,0.0174927113702624,63.6545506508353,1.29907246226194,18.1870144716672,1.74927113702624
2021-06-24,8800,0,6500,0,2300,0,7306,1,67231,45,74537,46,0,175,-3,11,3,8614,0,232,184,"Anderson",76978,10.3925796980956,0.0231023102310231,59.7573332640495,0,14.2897970848814,2.31023102310231
2021-06-25,8801,1,6501,1,2300,0,7307,1,67267,36,74574,37,0,175,1,12,0,8614,0,232,184,"Anderson",76978,9.09350723583361,0.013986013986014,48.065681103692,1.29907246226194,15.5888695471433,1.3986013986014
2021-06-26,8802,1,6502,1,2300,0,7308,1,67300,33,74608,34,0,175,0,12,1,8615,0,232,184,"Anderson",76978,10.3925796980956,0.0183823529411765,44.1684637169061,1.29907246226194,15.5888695471433,1.83823529411765
2021-06-27,8802,0,6502,0,2300,0,7308,0,67332,32,74640,32,0,175,0,12,0,8615,0,232,184,"Anderson",76978,10.3925796980956,0.0142857142857143,41.5703187923822,0,15.5888695471433,1.42857142857143
2021-06-28,8803,1,6502,0,2301,1,7309,1,67348,16,74657,17,0,175,1,13,0,8615,0,232,184,"Anderson",76978,10.3925796980956,0.0194552529182879,22.0842318584531,1.29907246226194,16.8879420094053,1.94552529182879
2021-06-29,8806,3,6505,3,2301,0,7312,3,67407,59,74719,62,0,175,2,15,1,8616,0,232,184,"Anderson",76978,9.09350723583361,0.0288808664259928,80.5424926602406,3.89721738678583,19.4860869339292,2.88808664259928
2021-06-30,8806,0,6505,0,2301,0,7312,0,67453,46,74765,46,0,175,-1,14,1,8617,0,232,184,"Anderson",76978,7.79443477357167,0.0255474452554745,59.7573332640495,0,18.1870144716672,2.55474452554745
2021-07-01,8807,1,6506,1,2301,0,7313,1,67490,37,74803,38,0,175,1,15,0,8617,0,232,184,"Anderson",76978,9.09350723583361,0.0263157894736842,49.3647535659539,1.29907246226194,19.4860869339292,2.63157894736842
2021-07-02,8807,0,6506,0,2301,0,7313,0,67533,43,74846,43,0,175,0,15,0,8617,0,232,184,"Anderson",76978,7.79443477357167,0.0220588235294118,55.8601158772636,0,19.4860869339292,2.20588235294118
2021-07-03,8807,0,6506,0,2301,0,7313,0,67554,21,74867,21,0,175,-1,14,1,8618,0,232,184,"Anderson",76978,6.49536231130972,0.0193050193050193,27.2805217075008,0,18.1870144716672,1.93050193050193
2021-07-04,8808,1,6506,0,2302,1,7314,1,67579,25,74893,26,0,175,0,14,1,8619,0,232,184,"Anderson",76978,7.79443477357167,0.0237154150197628,33.7758840188106,1.29907246226194,18.1870144716672,2.37154150197628
2021-07-05,8808,0,6506,0,2302,0,7315,1,67594,15,74909,16,0,175,-1,13,1,8620,0,232,184,"Anderson",76978,6.49536231130972,0.0238095238095238,20.7851593961911,0,16.8879420094053,2.38095238095238
2021-07-06,8809,1,6506,0,2303,1,7315,0,67624,30,74939,30,1,176,-3,10,3,8623,0,232,184,"Anderson",76978,3.89721738678583,0.0136363636363636,38.9721738678584,1.29907246226194,12.9907246226195,1.36363636363636
2021-07-07,8810,1,6506,0,2304,1,7315,0,67670,46,74985,46,0,176,-2,8,3,8626,0,232,184,"Anderson",76978,5.19628984904778,0.0136363636363636,59.7573332640495,1.29907246226194,10.3925796980956,1.36363636363636
2021-07-08,8811,1,6507,1,2304,0,7316,1,67711,41,75027,42,0,176,-1,7,2,8628,0,232,184,"Anderson",76978,5.19628984904778,0.0133928571428571,54.5610434150017,1.29907246226194,9.09350723583361,1.33928571428571
2021-07-09,8813,2,6508,1,2305,1,7317,1,67755,44,75072,45,0,176,1,8,1,8629,0,232,184,"Anderson",76978,7.79443477357167,0.0176991150442478,58.4582608017875,2.59814492452389,10.3925796980956,1.76991150442478
2021-07-10,8815,2,6509,1,2306,1,7318,1,67777,22,75095,23,0,176,2,10,0,8629,1,233,184,"Anderson",76978,10.3925796980956,0.0219298245614035,29.8786666320247,2.59814492452389,12.9907246226195,2.19298245614035
2021-07-11,8815,0,6509,0,2306,0,7318,0,67792,15,75110,15,0,176,0,10,0,8629,0,233,184,"Anderson",76978,9.09350723583361,0.0184331797235023,19.4860869339292,0,12.9907246226195,1.84331797235023
2021-07-12,8823,8,6513,4,2310,4,7322,4,67828,36,75150,40,0,176,7,17,1,8630,1,234,184,"Anderson",76978,19.4860869339292,0.029045643153527,51.9628984904778,10.3925796980956,22.0842318584531,2.9045643153527
2021-07-13,8824,1,6513,0,2311,1,7322,0,67849,21,75171,21,0,176,0,17,1,8631,0,234,186,"Anderson",76978,19.4860869339292,0.0301724137931034,27.2805217075008,1.29907246226194,22.0842318584531,3.01724137931034
2021-07-14,8829,5,6518,5,2311,0,7327,5,67903,54,75230,59,0,176,5,22,0,8631,1,235,186,"Anderson",76978,24.682376782977,0.0489795918367347,76.6452752734548,6.49536231130973,28.5795941697628,4.89795918367347
2021-07-15,8832,3,6521,3,2311,0,7329,2,67936,33,75265,35,0,176,3,25,0,8631,0,235,186,"Anderson",76978,27.2805217075008,0.0546218487394958,45.4675361791681,3.89721738678583,32.4768115565486,5.46218487394958
2021-07-16,8842,10,6523,2,2319,8,7330,1,67964,28,75294,29,0,176,10,35,0,8631,0,235,186,"Anderson",76978,37.6731014055964,0.0585585585585586,37.6731014055964,12.9907246226195,45.4675361791681,5.85585585585586
2021-07-17,8847,5,6524,1,2323,4,7331,1,68000,36,75331,37,0,176,4,39,1,8632,0,235,186,"Anderson",76978,41.5703187923822,0.0550847457627119,48.065681103692,6.49536231130973,50.6638260282159,5.50847457627119
2021-07-18,8850,3,6526,2,2324,1,7333,2,68020,20,75353,22,0,176,-1,38,4,8636,0,235,186,"Anderson",76978,45.4675361791681,0.0617283950617284,28.5795941697628,3.89721738678583,49.3647535659539,6.17283950617284
2021-07-19,8855,5,6530,4,2325,1,7337,4,68054,34,75391,38,1,177,2,40,2,8638,0,235,186,"Anderson",76978,41.5703187923822,0.0622406639004149,49.3647535659539,6.49536231130973,51.9628984904778,6.22406639004149
2021-07-20,8870,15,6541,11,2329,4,7348,11,68089,35,75437,46,0,177,10,50,5,8643,1,236,186,"Anderson",76978,59.7573332640495,0.0977443609022556,59.7573332640495,19.4860869339292,64.9536231130973,9.77443609022556
2021-07-21,8877,7,6545,4,2332,3,7353,5,68174,85,75527,90,0,177,5,55,2,8645,0,236,187,"Anderson",76978,62.3554781885734,0.0875420875420875,116.916521603575,9.09350723583361,71.448985424407,8.75420875420875
2021-07-22,8887,10,6550,5,2337,5,7357,4,68230,56,75587,60,0,177,9,64,1,8646,0,236,187,"Anderson",76978,71.448985424407,0.0869565217391304,77.9443477357167,12.9907246226195,83.1406375847645,8.69565217391304
2021-07-23,8897,10,6554,4,2343,6,7362,5,68301,71,75663,76,0,177,10,74,0,8646,0,236,187,"Anderson",76978,71.448985424407,0.0867208672086721,98.7295071319078,12.9907246226195,96.1313622073839,8.67208672086721
2021-07-24,8905,8,6558,4,2347,4,7366,4,68355,54,75721,58,0,177,7,81,1,8647,0,236,188,"Anderson",76978,75.3462028111928,0.0897435897435897,75.3462028111928,10.3925796980956,105.224869443218,8.97435897435897
2021-07-25,8910,5,6561,3,2349,2,7367,1,68377,22,75744,23,0,177,2,83,3,8650,0,236,188,"Anderson",76978,77.9443477357167,0.0869565217391304,29.8786666320247,6.49536231130973,107.823014367741,8.69565217391304
2021-07-26,8933,23,6570,9,2363,14,7375,8,68427,50,75802,58,2,179,13,96,8,8658,0,236,188,"Anderson",76978,101.327652056432,0.0924574209245742,75.3462028111928,29.8786666320247,124.710956377147,9.24574209245742
2021-07-27,8948,15,6575,5,2373,10,7380,5,68480,53,75860,58,0,179,12,108,3,8661,0,236,188,"Anderson",76978,101.327652056432,0.0756501182033097,75.3462028111928,19.4860869339292,140.29982592429,7.56501182033097
2021-07-28,8968,20,6583,8,2385,12,7392,12,68563,83,75955,95,0,179,14,122,6,8667,0,236,188,"Anderson",76978,118.215594065837,0.0911214953271028,123.411883914885,25.9814492452389,158.486840395957,9.11214953271028
2021-07-29,8980,12,6593,10,2387,2,7404,12,68612,49,76016,61,0,179,8,130,4,8671,0,236,188,"Anderson",76978,120.813738990361,0.10955710955711,79.2434201979787,15.5888695471433,168.879420094053,10.955710955711
2021-07-30,9011,31,6614,21,2397,10,7427,23,68661,49,76088,72,0,179,19,149,12,8683,1,237,188,"Anderson",76978,148.094260697862,0.152941176470588,93.53321728286,40.2712463301203,193.56179687703,15.2941176470588
2021-07-31,9024,13,6620,6,2404,7,7433,6,68703,42,76136,48,0,179,8,157,5,8688,0,237,188,"Anderson",76978,154.589623009171,0.16144578313253,62.3554781885734,16.8879420094053,203.954376575125,16.144578313253
2021-08-01,9043,19,6632,12,2411,7,7448,15,68742,39,76190,54,0,179,14,171,5,8693,0,237,188,"Anderson",76978,172.776637480839,0.181614349775785,70.149912962145,24.682376782977,222.141391046793,18.1614349775785
2021-08-02,9054,11,6637,5,2417,6,7453,5,68821,79,76274,84,0,179,3,174,8,8701,0,237,188,"Anderson",76978,157.187767933695,0.165254237288136,109.122086830003,14.2897970848814,226.038608433578,16.5254237288136
2021-08-03,9077,23,6648,11,2429,12,7466,13,68893,72,76359,85,0,179,14,188,9,8710,1,238,188,"Anderson",76978,167.580347631791,0.172344689378758,110.421159292265,29.8786666320247,244.225622905246,17.2344689378758
2021-08-04,9103,26,6670,22,2433,4,7487,21,68995,102,76482,123,0,179,24,212,2,8712,0,238,188,"Anderson",76978,175.374782405363,0.180265654648956,159.785912858219,33.7758840188106,275.403361999532,18.0265654648956
2021-08-05,9133,30,6686,16,2447,14,7503,16,69093,98,76596,114,0,179,13,225,17,8729,1,239,188,"Anderson",76978,198.758086726078,0.170689655172414,148.094260697862,38.9721738678584,292.291304008938,17.0689655172414
2021-08-06,9158,25,6702,16,2456,9,7521,18,69236,143,76757,161,0,179,17,242,8,8737,1,240,188,"Anderson",76978,190.963651952506,0.14050822122571,209.150666424173,32.4768115565486,314.375535867391,14.050822122571
2021-08-07,9171,13,6708,6,2463,7,7528,7,69311,75,76839,82,0,179,5,247,8,8745,0,240,188,"Anderson",76978,190.963651952506,0.135135135135135,106.523941905479,16.8879420094053,320.8708981787,13.5135135135135
2021-08-08,9185,14,6716,8,2469,6,7538,10,69363,52,76901,62,0,179,6,253,8,8753,0,240,188,"Anderson",76978,184.468289641196,0.126582278481013,80.5424926602406,18.1870144716672,328.665332952272,12.6582278481013
2021-08-09,9221,36,6735,19,2486,17,7557,19,69462,99,77019,118,0,179,16,269,20,8773,0,240,188,"Anderson",76978,216.945101197745,0.139597315436242,153.29055054691,46.76660864143,349.450492348463,13.9597315436242
2021-08-10,9260,39,6755,20,2505,19,7577,20,69562,100,77139,120,0,179,20,289,19,8792,2,242,188,"Anderson",76978,237.730260593936,0.142307692307692,155.888695471433,50.6638260282159,375.431941593702,14.2307692307692
2021-08-11,9314,54,6779,24,2535,30,7606,29,69694,132,77300,161,0,179,30,319,24,8816,1,243,188,"Anderson",76978,274.10428953727,0.145476772616137,209.150666424173,70.149912962145,414.40411546156,14.5476772616137
2021-08-12,9362,48,6815,36,2547,12,7643,37,69862,168,77505,205,0,179,27,346,21,8837,0,243,190,"Anderson",76978,297.487593857985,0.154015401540154,266.309854763699,62.3554781885734,449.479071942633,15.4015401540154
2021-08-13,9425,63,6850,35,2575,28,7681,38,69976,114,77657,152,2,181,45,391,16,8853,1,244,191,"Anderson",76978,346.852347423939,0.177777777777778,197.459014263816,81.8415651225025,507.93733274442,17.7777777777778
2021-08-14,9475,50,6885,35,2590,15,7713,32,70162,186,77875,218,0,181,29,420,21,8874,0,244,191,"Anderson",76978,394.918028527631,0.178571428571429,283.197796773104,64.9536231130973,545.610434150017,17.8571428571429
2021-08-15,9498,23,6898,13,2600,10,7728,15,70251,89,77979,104,0,181,16,436,7,8881,0,244,191,"Anderson",76978,406.609680687989,0.176252319109462,135.103536075242,29.8786666320247,566.395593546208,17.6252319109462
2021-08-16,9536,38,6922,24,2614,14,7752,24,70340,89,78092,113,0,181,11,447,27,8908,0,244,192,"Anderson",76978,409.207825612513,0.181733457595527,146.7951882356,49.3647535659539,580.685390631089,18.1733457595527
2021-08-17,9579,43,6943,21,2636,22,7776,24,70448,108,78224,132,1,182,14,461,28,8936,0,244,192,"Anderson",76978,414.40411546156,0.183410138248848,171.477565018577,55.8601158772636,598.872405102757,18.3410138248848
2021-08-18,9631,52,6970,27,2661,25,7807,31,70560,112,78367,143,0,182,15,476,37,8973,0,244,193,"Anderson",76978,411.805970537037,0.188378631677601,185.767362103458,67.5517680376211,618.358492036686,18.8378631677601
2021-08-19,9705,74,7003,33,2702,41,7842,35,70712,152,78554,187,0,182,48,524,26,8999,0,244,193,"Anderson",76978,445.581854555847,0.189704480457579,242.926550442984,96.1313622073839,680.713970225259,18.9704480457579
2021-08-20,9765,60,7045,42,2720,18,7886,44,70906,194,78792,238,0,182,26,550,34,9033,2,246,193,"Anderson",76978,441.684637169061,0.180616740088106,309.179246018343,77.9443477357167,714.48985424407,18.0616740088106
2021-08-21,9847,82,7079,34,2768,48,7920,34,71180,274,79100,308,0,182,61,611,21,9054,1,247,193,"Anderson",76978,483.254955961444,0.168979591836735,400.114318376679,106.523941905479,793.733274442048,16.8979591836735
2021-08-22,9869,22,7100,21,2769,1,7948,28,71336,156,79284,184,0,182,-3,608,25,9079,0,247,193,"Anderson",76978,481.955883499182,0.168582375478927,239.029333056198,28.5795941697628,789.836057055263,16.8582375478927
2021-08-23,9917,48,7114,14,2803,34,7965,17,71471,135,79436,152,0,182,-4,604,52,9131,2,249,194,"Anderson",76978,494.946608121801,0.158482142857143,197.459014263816,62.3554781885734,784.639767206215,15.8482142857143
2021-08-24,9961,44,7141,27,2820,17,7989,24,71557,86,79546,110,1,183,-23,581,66,9197,0,249,195,"Anderson",76978,496.245680584063,0.161119515885023,142.897970848814,57.1591883395256,754.76110057419,16.1119515885023
2021-08-25,10032,71,7167,26,2865,45,8011,22,71601,44,79612,66,0,183,15,596,56,9253,1,250,195,"Anderson",76978,520.92805736704,0.163855421686747,85.7387825092884,92.2341448205981,774.247187508119,16.3855421686747
2021-08-26,10100,68,7203,36,2897,32,8055,44,71773,172,79828,216,1,184,15,611,52,9305,2,252,196,"Anderson",76978,513.133622593468,0.167189952904239,280.59965184858,88.3369274338123,793.733274442048,16.7189952904239
2021-08-27,10175,75,7258,55,2917,20,8116,61,71950,177,80066,238,0,184,29,640,46,9351,0,252,196,"Anderson",76978,532.619709527397,0.180533751962323,309.179246018343,97.4304346696459,831.406375847645,18.0533751962323
2021-08-28,10234,59,7290,32,2944,27,8156,40,72154,204,80310,244,0,184,31,671,28,9379,0,252,196,"Anderson",76978,502.741042895373,0.19504132231405,316.973680791915,76.6452752734548,871.677622177765,19.504132231405
2021-08-29,10298,64,7339,49,2959,15,8210,54,72365,211,80575,265,0,184,40,711,24,9403,1,253,197,"Anderson",76978,557.302086310374,0.20294345468629,344.254202499415,83.1406375847645,923.640520668243,20.294345468629
2021-08-30,10369,71,7385,46,2984,25,8258,48,72591,226,80849,274,0,184,3,714,68,9471,3,256,197,"Anderson",76978,587.180752942399,0.207360226468507,355.945854659773,92.2341448205981,927.537738055029,20.7360226468507
2021-08-31,10503,134,7467,82,3036,52,8345,87,72848,257,81193,344,0,184,48,762,86,9557,0,256,198,"Anderson",76978,704.097274545974,0.216150576806314,446.880927018109,174.075709943101,989.893216243602,21.6150576806314
2021-09-01,10534,31,7489,22,3045,9,8369,24,72939,91,81308,115,0,184,-17,745,48,9605,0,256,199,"Anderson",76978,652.134376055496,0.211084905660377,149.393333160124,40.2712463301203,967.808984385149,21.1084905660377
2021-09-02,10593,59,7515,26,3078,33,8398,29,73040,101,81438,130,1,185,-9,736,67,9672,0,256,199,"Anderson",76978,640.442723895139,0.21304347826087,168.879420094053,76.6452752734548,956.117332224792,21.304347826087
2021-09-03,10622,29,7533,18,3089,11,8416,18,73113,73,81529,91,0,185,-38,698,67,9739,0,256,199,"Anderson",76978,580.685390631089,0.205058099794942,118.215594065837,37.6731014055964,906.752578658838,20.5058099794942
2021-09-04,10729,107,7603,70,3126,37,8492,76,73434,321,81926,397,0,185,76,774,31,9770,1,257,199,"Anderson",76978,643.040868819663,0.207920792079208,515.731767517992,139.000753462028,1005.48208579075,20.7920792079208
2021-09-05,10841,112,7677,74,3164,38,8568,76,73738,304,82306,380,0,185,76,850,36,9806,1,258,200,"Anderson",76978,705.396347008236,0.20681686886193,493.647535659539,145.496115773338,1104.21159292265,20.681686886193
2021-09-06,10956,115,7754,77,3202,38,8655,87,74145,407,82800,494,0,185,-4,846,119,9925,3,261,201,"Anderson",76978,762.555535347762,0.203485392106612,641.741796357401,149.393333160124,1099.01530307361,20.3485392106612
2021-09-07,10993,37,7774,20,3219,17,8673,18,74244,99,82917,117,0,185,-73,773,110,10035,0,261,201,"Anderson",76978,636.545506508353,0.190255220417633,151.991478084648,48.065681103692,1004.18301332848,19.0255220417633
2021-09-08,11034,41,7805,31,3229,10,8705,32,74351,107,83056,139,0,185,-56,717,97,10132,2,263,204,"Anderson",76978,649.536231130973,0.192219679633867,180.57107225441,53.2619709527397,931.434955441815,19.2219679633867
2021-09-09,11092,58,7826,21,3266,37,8723,18,74557,206,83280,224,0,185,-42,675,100,10232,1,264,207,"Anderson",76978,648.237158668711,0.176438653637351,290.992231546676,75.3462028111928,876.873912026813,17.6438653637351
2021-09-10,11244,152,7899,73,3345,79,8804,81,74850,293,83654,374,1,186,65,740,86,10318,2,266,208,"Anderson",76978,808.02307152693,0.182588235294118,485.853100885967,197.459014263816,961.313622073839,18.2588235294118
2021-09-11,11359,115,7961,62,3398,53,8873,69,75196,346,84069,415,0,186,82,822,33,10351,1,267,208,"Anderson",76978,818.415651225025,0.177788147456836,539.115071838707,149.393333160124,1067.83756397932,17.7788147456836
2021-09-12,11397,38,7993,32,3404,6,8908,35,75339,143,84247,178,0,186,5,827,33,10384,4,271,209,"Anderson",76978,722.284289017641,0.175167439464194,231.234898282626,49.3647535659539,1074.33292629063,17.5167439464194
2021-09-13,11485,88,8027,34,3458,54,8942,34,75469,130,84411,164,4,190,-48,779,132,10516,3,274,209,"Anderson",76978,687.209332536569,0.178150217256363,213.047883810959,114.318376679051,1011.97744810206,17.8150217256363
2021-09-14,11545,60,8057,30,3488,30,8977,35,75628,159,84605,194,1,191,-47,732,106,10622,1,275,209,"Anderson",76978,717.087999168594,0.180094786729858,252.020057678817,77.9443477357167,950.921042375744,18.0094786729858
2021-09-15,11585,40,8073,16,3512,24,8991,14,75689,61,84680,75,0,191,-42,690,82,10704,1,276,210,"Anderson",76978,715.788926706332,0.176108374384236,97.4304346696459,51.9628984904778,896.359998960742,17.6108374384236
2021-09-16,11671,86,8127,54,3544,32,9047,56,75911,222,84958,278,0,191,26,716,60,10764,1,277,210,"Anderson",76978,752.162955649666,0.193087008343266,361.142144508821,111.720231754527,930.135882979553,19.3087008343266
2021-09-17,11744,73,8169,42,3575,31,9084,37,76074,163,85158,200,0,191,14,730,59,10823,1,278,214,"Anderson",76978,649.536231130973,0.186170212765957,259.814492452389,94.832289745122,948.32289745122,18.6170212765957
2021-09-18,11796,52,8199,30,3597,22,9117,33,76228,154,85345,187,0,191,7,737,45,10868,1,279,215,"Anderson",76978,567.69466600847,0.191222570532915,242.926550442984,67.5517680376211,957.416404687054,19.1222570532915
2021-09-19,11819,23,8208,9,3611,14,9127,10,76296,68,85423,78,0,191,-18,719,41,10909,0,279,215,"Anderson",76978,548.208579074541,0.186224489795918,101.327652056432,29.8786666320247,934.033100366338,18.6224489795918
2021-09-20,11882,63,8243,35,3639,28,9163,36,76482,186,85645,222,0,191,23,742,40,10949,3,282,215,"Anderson",76978,515.731767517992,0.179092382495948,288.394086622152,81.8415651225025,963.911766998363,17.9092382495948
2021-09-21,11936,54,8269,26,3667,28,9187,24,76600,118,85787,142,0,191,-56,686,110,11059,1,283,216,"Anderson",76978,507.93733274442,0.177664974619289,184.468289641196,70.149912962145,891.163709111694,17.7664974619289
2021-09-22,11987,51,8303,34,3684,17,9227,40,76872,272,86099,312,0,191,-39,647,90,11149,0,283,218,"Anderson",76978,522.227129829302,0.16631430584919,405.310608225727,66.2526955753592,840.499883083478,16.631430584919
2021-09-23,12062,75,8351,48,3711,27,9278,51,77080,208,86358,259,2,193,-10,637,83,11232,1,284,218,"Anderson",76978,507.93733274442,0.165,336.459767725844,97.4304346696459,827.509158460859,16.5
2021-09-24,12103,41,8373,22,3730,19,9303,25,77220,140,86523,165,2,195,-18,619,57,11289,1,285,221,"Anderson",76978,466.367013952038,0.16043956043956,214.346956273221,53.2619709527397,804.125854140144,16.043956043956
2021-09-25,12113,10,8377,4,3736,6,9309,6,77315,95,86624,101,0,195,-36,583,46,11335,0,285,221,"Anderson",76978,411.805970537037,0.150117279124316,131.206318688456,12.9907246226195,757.359245498714,15.0117279124316
2021-09-26,12131,18,8392,15,3739,3,9327,18,77452,137,86779,155,1,196,-12,571,29,11364,0,285,221,"Anderson",76978,405.310608225727,0.147492625368732,201.356231650601,23.383304320715,741.770375951571,14.7492625368732
2021-09-27,12181,50,8413,21,3768,29,9349,22,77538,86,86887,108,1,197,-43,528,92,11456,1,286,222,"Anderson",76978,388.422666216322,0.14975845410628,140.29982592429,64.9536231130973,685.910260074307,14.975845410628
2021-09-28,12230,49,8437,24,3793,25,9376,27,77633,95,87009,122,0,197,-29,499,78,11534,1,287,222,"Anderson",76978,381.927303905012,0.154664484451718,158.486840395957,63.6545506508353,648.237158668711,15.4664484451718
2021-09-29,12266,36,8453,16,3813,20,9393,17,77824,191,87217,208,2,199,-37,462,71,11605,0,287,224,"Anderson",76978,362.441216971083,0.148479427549195,270.207072150485,46.76660864143,600.171477565019,14.8479427549195
2021-09-30,12328,62,8491,38,3837,24,9433,40,77996,172,87429,212,0,199,2,464,60,11665,1,288,225,"Anderson",76978,345.553274961677,0.144724556489262,275.403361999532,80.5424926602406,602.769622489542,14.4724556489262
2021-10-01,12379,51,8518,27,3861,24,9462,29,78147,151,87609,180,0,199,-10,454,61,11726,1,289,226,"Anderson",76978,358.543999584297,0.146408839779006,233.83304320715,66.2526955753592,589.778897866923,14.6408839779006
2021-10-02,12396,17,8525,7,3871,10,9468,6,78227,80,87695,86,1,200,-10,444,26,11752,0,289,228,"Anderson",76978,367.63750682013,0.148459383753501,111.720231754527,22.0842318584531,576.788173244304,14.8459383753501
2021-10-03,12409,13,8534,9,3875,4,9477,9,78325,98,87802,107,4,204,-10,434,19,11771,0,289,228,"Anderson",76978,361.142144508821,0.146627565982405,139.000753462028,16.8879420094053,563.797448621684,14.6627565982405
2021-10-04,12453,44,8557,23,3896,21,9503,26,78445,120,87948,146,1,205,-22,412,65,11836,0,289,230,"Anderson",76978,353.347709735249,0.145146088595664,189.664579490244,57.1591883395256,535.217854451921,14.5146088595664
2021-10-05,12506,53,8586,29,3920,24,9533,30,78573,128,88106,158,2,207,-15,397,66,11902,0,289,231,"Anderson",76978,358.543999584297,0.143117593436645,205.253449037387,68.8508404998831,515.731767517992,14.3117593436645
2021-10-06,12536,30,8609,23,3927,7,9559,26,78738,165,88297,191,1,208,-5,392,34,11936,0,289,232,"Anderson",76978,350.749564810725,0.153703703703704,248.122840292031,38.9721738678584,509.236405206682,15.3703703703704
2021-10-07,12568,32,8631,22,3937,10,9584,25,78877,139,88461,164,0,208,-10,382,42,11978,0,289,234,"Anderson",76978,311.777390942867,0.146317829457364,213.047883810959,41.5703187923822,496.245680584063,14.6317829457364
2021-10-08,12585,17,8636,5,3949,12,9594,10,79007,130,88601,140,1,209,-13,369,29,12007,1,290,234,"Anderson",76978,267.608927225961,0.133064516129032,181.870144716672,22.0842318584531,479.357738574658,13.3064516129032
2021-10-09,12600,15,8639,3,3961,12,9601,7,79069,62,88670,69,0,209,-12,357,27,12034,0,290,235,"Anderson",76978,265.010782301437,0.136410256410256,89.6359998960742,19.4860869339292,463.768869027514,13.6410256410256
2021-10-10,12610,10,8647,8,3963,2,9610,9,79156,87,88766,96,0,209,-15,342,25,12059,0,290,235,"Anderson",76978,261.113564914651,0.137966804979253,124.710956377147,12.9907246226195,444.282782093585,13.7966804979253
2021-10-11,12650,40,8661,14,3989,26,9623,13,79257,101,88880,114,0,209,-12,330,52,12111,1,291,235,"Anderson",76978,255.917275065603,0.128755364806867,148.094260697862,51.9628984904778,428.693912546442,12.8755364806867
2021-10-12,12685,35,8685,24,4000,11,9645,22,79356,99,89001,121,2,211,-9,321,42,12153,3,294,235,"Anderson",76978,232.533970744888,0.125139664804469,157.187767933695,45.4675361791681,417.002260386084,12.5139664804469
2021-10-13,12711,26,8699,14,4012,12,9663,18,79468,112,89131,130,0,211,-15,306,41,12194,1,295,238,"Anderson",76978,227.33768089584,0.124700239808153,168.879420094053,33.7758840188106,397.516173452155,12.4700239808153
2021-10-14,12730,19,8709,10,4021,9,9677,14,79571,103,89248,117,1,212,-21,285,39,12233,0,295,238,"Anderson",76978,210.449738886435,0.118170266836086,151.991478084648,24.682376782977,370.235651744654,11.8170266836086
2021-10-15,12753,23,8721,12,4032,11,9690,13,79693,122,89383,135,0,212,-15,270,38,12271,1,296,238,"Anderson",76978,218.244173660007,0.122762148337596,175.374782405363,29.8786666320247,350.749564810725,12.2762148337596
2021-10-16,12761,8,8726,5,4035,3,9697,7,79748,55,89445,62,0,212,-15,255,23,12294,1,297,238,"Anderson",76978,209.150666424173,0.123870967741935,80.5424926602406,10.3925796980956,331.263477876796,12.3870967741935
2021-10-17,12763,2,8727,1,4036,1,9698,1,79799,51,89497,52,0,212,-11,244,13,12307,0,297,238,"Anderson",76978,198.758086726078,0.120383036935705,67.5517680376211,2.59814492452389,316.973680791915,12.0383036935705
2021-10-18,12787,24,8737,10,4050,14,9709,11,79867,68,89576,79,1,213,-26,218,49,12356,1,298,238,"Anderson",76978,177.972927329886,0.123563218390805,102.626724518694,31.1777390942867,283.197796773104,12.3563218390805
2021-10-19,12816,29,8750,13,4066,16,9720,11,79978,111,89698,122,2,215,-17,201,44,12400,0,298,238,"Anderson",76978,170.178492556315,0.107604017216643,158.486840395957,37.6731014055964,261.113564914651,10.7604017216643
2021-10-20,12851,35,8776,26,4075,9,9749,29,80089,111,89838,140,0,215,12,213,23,12423,1,299,239,"Anderson",76978,181.870144716672,0.121640735502122,181.870144716672,45.4675361791681,276.702434461794,12.1640735502122
2021-10-21,12883,32,8794,18,4089,14,9767,18,80182,93,89949,111,0,215,11,224,21,12444,1,300,240,"Anderson",76978,198.758086726078,0.128388017118402,144.197043311076,41.5703187923822,290.992231546676,12.8388017118402
2021-10-22,12892,9,8800,6,4092,3,9775,8,80258,76,90033,84,0,215,-22,202,31,12475,1,301,240,"Anderson",76978,180.57107225441,0.130769230769231,109.122086830003,11.6916521603575,262.412637376913,13.0769230769231
2021-10-23,12909,17,8804,4,4105,13,9779,4,80311,53,90090,57,0,215,3,205,14,12489,1,302,240,"Anderson",76978,192.262724414768,0.127131782945736,74.0471303489309,22.0842318584531,266.309854763699,12.7131782945736
2021-10-24,12915,6,8809,5,4106,1,9786,7,80363,52,90149,59,0,215,-10,195,16,12505,0,302,241,"Anderson",76978,197.459014263816,0.134969325153374,76.6452752734548,7.79443477357167,253.319130141079,13.4969325153374
2021-10-25,12939,24,8822,13,4117,11,9800,14,80434,71,90234,85,1,216,-8,187,31,12536,2,304,241,"Anderson",76978,197.459014263816,0.138297872340426,110.421159292265,31.1777390942867,242.926550442984,13.8297872340426
2021-10-26,12951,12,8828,6,4123,6,9806,6,80498,64,90304,70,0,216,-9,178,21,12557,0,304,242,"Anderson",76978,175.374782405363,0.141914191419142,90.9350723583361,15.5888695471433,231.234898282626,14.1914191419142
2021-10-27,12968,17,8838,10,4130,7,9819,13,80619,121,90438,134,1,217,-5,173,21,12578,2,306,244,"Anderson",76978,151.991478084648,0.116666666666667,174.075709943101,22.0842318584531,224.739535971316,11.6666666666667
2021-10-28,12990,22,8852,14,4138,8,9836,17,80701,82,90537,99,1,218,7,180,14,12592,0,306,245,"Anderson",76978,139.000753462028,0.11734693877551,128.608173763933,28.5795941697628,233.83304320715,11.734693877551
2021-10-29,13011,21,8863,11,4148,10,9848,12,80815,114,90663,126,0,218,7,187,14,12606,1,307,245,"Anderson",76978,154.589623009171,0.115873015873016,163.683130245005,27.2805217075008,242.926550442984,11.5873015873016
2021-10-30,13023,12,8867,4,4156,8,9853,5,80902,87,90755,92,0,218,0,187,12,12618,1,308,245,"Anderson",76978,148.094260697862,0.111278195488722,119.514666528099,15.5888695471433,242.926550442984,11.1278195488722
2021-10-31,13026,3,8869,2,4157,1,9856,3,80941,39,90797,42,0,218,-8,179,11,12629,0,308,245,"Anderson",76978,144.197043311076,0.108024691358025,54.5610434150017,3.89721738678583,232.533970744888,10.8024691358025
2021-11-01,13053,27,8874,5,4179,22,9860,4,81029,88,90889,92,1,219,-15,164,41,12670,1,309,246,"Anderson",76978,148.094260697862,0.0916030534351145,119.514666528099,35.0749564810725,213.047883810959,9.16030534351145
2021-11-02,13073,20,8879,5,4194,15,9865,5,81105,76,90970,81,2,221,-6,158,24,12694,1,310,246,"Anderson",76978,158.486840395957,0.0885885885885886,105.224869443218,25.9814492452389,205.253449037387,8.85885885885886
2021-11-03,13103,30,8897,18,4206,12,9883,18,81305,200,91188,218,1,222,11,169,18,12712,0,310,246,"Anderson",76978,175.374782405363,0.0853333333333333,283.197796773104,38.9721738678584,219.543246122269,8.53333333333333
2021-11-04,13125,22,8912,15,4213,7,9899,16,81438,133,91337,149,0,222,6,175,16,12728,0,310,246,"Anderson",76978,175.374782405363,0.07875,193.56179687703,28.5795941697628,227.33768089584,7.875
2021-11-05,13135,10,8915,3,4220,7,9900,1,81560,122,91460,123,0,222,3,178,7,12735,0,310,246,"Anderson",76978,161.084985320481,0.0652446675031368,159.785912858219,12.9907246226195,231.234898282626,6.52446675031368
2021-11-06,13144,9,8919,4,4225,5,9905,5,81647,87,91552,92,0,222,-4,174,13,12748,3,313,247,"Anderson",76978,157.187767933695,0.0652446675031368,119.514666528099,11.6916521603575,226.038608433578,6.52446675031368
2021-11-07,13150,6,8924,5,4226,1,9911,6,81695,48,91606,54,0,222,-4,170,10,12758,0,313,247,"Anderson",76978,161.084985320481,0.0679851668726823,70.149912962145,7.79443477357167,220.842318584531,6.79851668726823
2021-11-08,13175,25,8935,11,4240,14,9924,13,81783,88,91707,101,1,223,-1,169,25,12783,0,313,247,"Anderson",76978,158.486840395957,0.078239608801956,131.206318688456,32.4768115565486,219.543246122269,7.8239608801956
2021-11-09,13198,23,8942,7,4256,16,9930,6,81941,158,91871,164,1,224,6,175,16,12799,0,313,248,"Anderson",76978,162.384057782743,0.072142064372919,213.047883810959,29.8786666320247,227.33768089584,7.2142064372919
2021-11-10,13216,18,8954,12,4262,6,9943,13,82057,116,92000,129,0,224,4,179,14,12813,1,314,250,"Anderson",76978,146.7951882356,0.0738916256157636,167.580347631791,23.383304320715,232.533970744888,7.38916256157635
2021-11-11,13239,23,8972,18,4267,5,9961,18,82247,190,92208,208,0,224,2,181,21,12834,0,314,251,"Anderson",76978,148.094260697862,0.0711825487944891,270.207072150485,29.8786666320247,235.132115669412,7.11825487944891
2021-11-12,13252,13,8980,8,4272,5,9969,8,82380,133,92349,141,0,224,1,182,12,12846,1,315,251,"Anderson",76978,151.991478084648,0.077615298087739,183.169217178934,16.8879420094053,236.431188131674,7.7615298087739
2021-11-13,13259,7,8984,4,4275,3,9973,4,82431,51,92404,55,3,227,-10,172,14,12860,1,316,252,"Anderson",76978,149.393333160124,0.07981220657277,71.448985424407,9.09350723583361,223.440463509055,7.981220657277
2021-11-14,13261,2,8986,2,4275,0,9976,3,82510,79,92486,82,0,227,-4,168,6,12866,0,316,252,"Anderson",76978,144.197043311076,0.0738636363636364,106.523941905479,2.59814492452389,218.244173660007,7.38636363636364
2021-11-15,13293,32,9000,14,4293,18,9990,14,82595,85,92585,99,0,227,5,173,27,12893,0,316,253,"Anderson",76978,153.29055054691,0.0751708428246014,128.608173763933,41.5703187923822,224.739535971316,7.51708428246014
2021-11-16,13318,25,9013,13,4305,12,10003,13,82721,126,92724,139,1,228,-2,171,26,12919,0,316,254,"Anderson",76978,155.888695471433,0.0855803048065651,180.57107225441,32.4768115565486,222.141391046793,8.55803048065651
2021-11-17,13335,17,9022,9,4313,8,10012,9,82835,114,92847,123,0,228,-3,168,20,12939,2,318,256,"Anderson",76978,154.589623009171,0.0814639905548996,159.785912858219,22.0842318584531,218.244173660007,8.14639905548996
2021-11-18,13358,23,9036,14,4322,9,10030,18,82970,135,93000,153,4,232,4,172,15,12954,0,318,258,"Anderson",76978,154.589623009171,0.0871212121212121,198.758086726078,29.8786666320247,223.440463509055,8.71212121212121
2021-11-19,13372,14,9042,6,4330,8,10037,7,83079,109,93116,116,1,233,2,174,11,12965,0,318,258,"Anderson",76978,155.888695471433,0.0886571056062582,150.692405622386,18.1870144716672,226.038608433578,8.86571056062582
2021-11-20,13381,9,9047,5,4334,4,10042,5,83172,93,93214,98,0,233,-9,165,18,12983,0,318,259,"Anderson",76978,158.486840395957,0.0851851851851852,127.309101301671,11.6916521603575,214.346956273221,8.51851851851852
2021-11-21,13393,12,9053,6,4340,6,10048,6,83212,40,93260,46,0,233,4,169,8,12991,0,318,259,"Anderson",76978,171.477565018577,0.0930232558139535,59.7573332640495,15.5888695471433,219.543246122269,9.30232558139535
2021-11-22,13421,28,9070,17,4351,11,10066,18,83334,122,93400,140,1,234,6,175,21,13012,0,318,259,"Anderson",76978,166.281275169529,0.0932515337423313,181.870144716672,36.3740289433345,227.33768089584,9.32515337423313
2021-11-23,13438,17,9076,6,4362,11,10071,5,83431,97,93502,102,0,234,-4,171,21,13033,1,319,261,"Anderson",76978,155.888695471433,0.0874035989717224,132.505391150718,22.0842318584531,222.141391046793,8.74035989717224
2021-11-24,13463,25,9092,16,4371,9,10083,12,83541,110,93624,122,1,235,6,177,18,13051,1,320,261,"Anderson",76978,166.281275169529,0.0913770913770914,158.486840395957,32.4768115565486,229.935825820364,9.13770913770914
2021-11-25,13468,5,9094,2,4374,3,10084,1,83586,45,93670,46,0,235,-12,165,17,13068,2,322,261,"Anderson",76978,142.897970848814,0.0805970149253731,59.7573332640495,6.49536231130973,214.346956273221,8.05970149253731
2021-11-26,13475,7,9100,6,4375,1,10093,9,83629,43,93722,52,0,235,-7,158,14,13082,0,322,262,"Anderson",76978,133.80446361298,0.0924092409240924,67.5517680376211,9.09350723583361,205.253449037387,9.24092409240924
2021-11-27,13480,5,9102,2,4378,3,10095,2,83665,36,93760,38,0,235,-8,150,13,13095,0,322,262,"Anderson",76978,128.608173763933,0.0970695970695971,49.3647535659539,6.49536231130973,194.860869339292,9.70695970695971
2021-11-28,13490,10,9103,1,4387,9,10096,1,83703,38,93799,39,0,235,-10,140,20,13115,0,322,262,"Anderson",76978,126.010028839409,0.0890538033395176,50.6638260282159,12.9907246226195,181.870144716672,8.90538033395176
2021-11-29,13517,27,9118,15,4399,12,10112,16,83782,79,93894,95,0,235,13,153,14,13129,0,322,262,"Anderson",76978,124.710956377147,0.0931174089068826,123.411883914885,35.0749564810725,198.758086726078,9.31174089068826
2021-11-30,13544,27,9132,14,4412,13,10124,12,83884,102,94008,114,0,235,14,167,13,13142,1,323,262,"Anderson",76978,137.701680999766,0.104743083003953,148.094260697862,35.0749564810725,216.945101197745,10.4743083003953
2021-12-01,13575,31,9150,18,4425,13,10142,18,83991,107,94133,125,0,235,15,182,16,13158,2,325,262,"Anderson",76978,145.496115773338,0.115913555992141,162.384057782743,40.2712463301203,236.431188131674,11.5913555992141
2021-12-02,13617,42,9174,24,4443,18,10168,26,84129,138,94297,164,0,235,23,205,19,13177,0,325,265,"Anderson",76978,193.56179687703,0.133971291866029,213.047883810959,54.5610434150017,266.309854763699,13.3971291866029
2021-12-03,13648,31,9192,18,4456,13,10187,19,84316,187,94503,206,1,236,18,223,12,13189,1,326,265,"Anderson",76978,224.739535971316,0.120358514724712,267.608927225961,40.2712463301203,289.693159084414,12.0358514724712
2021-12-04,13668,20,9205,13,4463,7,10201,14,84385,69,94586,83,0,236,8,231,12,13201,0,326,265,"Anderson",76978,244.225622905246,0.128329297820823,107.823014367741,25.9814492452389,300.085738782509,12.8329297820823
2021-12-05,13681,13,9207,2,4474,11,10203,2,84427,42,94630,44,0,236,0,231,13,13214,0,326,265,"Anderson",76978,248.122840292031,0.128760529482551,57.1591883395256,16.8879420094053,300.085738782509,12.8760529482551
2021-12-06,13716,35,9227,20,4489,15,10225,22,84529,102,94754,124,2,238,7,238,26,13240,1,327,265,"Anderson",76978,258.515419990127,0.131395348837209,161.084985320481,45.4675361791681,309.179246018343,13.1395348837209
2021-12-07,13745,29,9242,15,4503,14,10241,16,84624,95,94865,111,0,238,18,256,11,13251,0,327,265,"Anderson",76978,261.113564914651,0.136522753792299,144.197043311076,37.6731014055964,332.562550339058,13.6522753792299
2021-12-08,13772,27,9263,21,4509,6,10261,20,84745,121,95006,141,0,238,17,273,10,13261,2,329,265,"Anderson",76978,255.917275065603,0.13631156930126,183.169217178934,35.0749564810725,354.646782197511,13.631156930126
2021-12-09,13800,28,9279,16,4521,12,10278,17,84955,210,95233,227,0,238,12,285,16,13277,1,330,265,"Anderson",76978,237.730260593936,0.117521367521368,294.889448933461,36.3740289433345,370.235651744654,11.7521367521368
2021-12-10,13829,29,9296,17,4533,12,10295,17,85108,153,95403,170,0,238,10,295,19,13296,2,332,265,"Anderson",76978,235.132115669412,0.12,220.842318584531,37.6731014055964,383.226376367274,12
2021-12-11,13839,10,9301,5,4538,5,10301,6,85183,75,95484,81,0,238,-2,293,12,13308,0,332,266,"Anderson",76978,222.141391046793,0.111358574610245,105.224869443218,12.9907246226195,380.62823144275,11.1358574610245
2021-12-12,13859,20,9312,11,4547,9,10313,12,85253,70,95566,82,0,238,2,295,18,13326,0,332,266,"Anderson",76978,231.234898282626,0.117521367521368,106.523941905479,25.9814492452389,383.226376367274,11.7521367521368
2021-12-13,13888,29,9318,6,4570,23,10320,7,85328,75,95648,82,0,238,-9,286,38,13364,0,332,269,"Anderson",76978,223.440463509055,0.106263982102908,106.523941905479,37.6731014055964,371.534724206916,10.6263982102908
2021-12-14,13902,14,9323,5,4579,9,10326,6,85407,79,95733,85,3,241,-10,276,21,13385,1,333,269,"Anderson",76978,203.954376575125,0.097926267281106,110.421159292265,18.1870144716672,358.543999584297,9.7926267281106
2021-12-15,13928,26,9337,14,4591,12,10341,15,85536,129,95877,144,0,241,-2,274,28,13413,0,333,270,"Anderson",76978,202.655304112863,0.0918484500574053,187.06643456572,33.7758840188106,355.945854659773,9.18484500574053
2021-12-16,13956,28,9347,10,4609,18,10356,15,85631,95,95987,110,0,241,5,279,23,13436,2,335,270,"Anderson",76978,202.655304112863,0.103448275862069,142.897970848814,36.3740289433345,362.441216971083,10.3448275862069
2021-12-17,13987,31,9370,23,4617,8,10378,22,85786,155,96164,177,1,242,0,279,30,13466,0,335,271,"Anderson",76978,205.253449037387,0.109067017082786,229.935825820364,40.2712463301203,362.441216971083,10.9067017082786
2021-12-18,13998,11,9379,9,4619,2,10388,10,85868,82,96256,92,0,242,1,280,10,13476,0,335,271,"Anderson",76978,206.552521499649,0.112694300518135,119.514666528099,14.2897970848814,363.740289433345,11.2694300518135
2021-12-19,14012,14,9387,8,4625,6,10399,11,85948,80,96347,91,0,242,-9,271,23,13499,0,335,271,"Anderson",76978,198.758086726078,0.1101152368758,118.215594065837,18.1870144716672,352.048637272987,11.01152368758
2021-12-20,14036,24,9403,16,4633,8,10413,14,86034,86,96447,100,0,242,-5,266,29,13528,0,335,272,"Anderson",76978,192.262724414768,0.11639549436796,129.907246226195,31.1777390942867,345.553274961677,11.639549436796
2021-12-21,14064,28,9411,8,4653,20,10424,11,86115,81,96539,92,0,242,2,268,26,13554,0,335,272,"Anderson",76978,210.449738886435,0.121588089330025,119.514666528099,36.3740289433345,348.151419886201,12.1588089330025
2021-12-22,14112,48,9425,14,4687,34,10435,11,86230,115,96665,126,19,261,1,269,28,13582,1,336,273,"Anderson",76978,239.029333056198,0.119289340101523,163.683130245005,62.3554781885734,349.450492348463,11.9289340101523
2021-12-23,14139,27,9440,15,4699,12,10452,17,86330,100,96782,117,-1,260,3,272,25,13607,1,337,274,"Anderson",76978,237.730260593936,0.120754716981132,151.991478084648,35.0749564810725,353.347709735249,12.0754716981132
2021-12-24,14165,26,9455,15,4710,11,10469,17,86417,87,96886,104,0,260,6,278,20,13627,1,338,274,"Anderson",76978,231.234898282626,0.126038781163435,135.103536075242,33.7758840188106,361.142144508821,12.6038781163435
2021-12-25,14179,14,9462,7,4717,7,10479,10,86475,58,96954,68,1,261,-3,275,16,13643,0,338,275,"Anderson",76978,235.132115669412,0.130372492836676,88.3369274338123,18.1870144716672,357.244927122035,13.0372492836676
2021-12-26,14190,11,9466,4,4724,7,10485,6,86519,44,97004,50,1,262,-8,267,18,13661,0,338,275,"Anderson",76978,231.234898282626,0.13089802130898,64.9536231130973,14.2897970848814,346.852347423939,13.089802130898
2021-12-27,14237,47,9485,19,4752,28,10505,20,86623,104,97128,124,1,263,18,285,28,13689,2,340,276,"Anderson",76978,261.113564914651,0.135095447870778,161.084985320481,61.0564057263114,370.235651744654,13.5095447870778
2021-12-28,14324,87,9521,36,4803,51,10541,36,86732,109,97273,145,0,263,67,352,20,13709,0,340,276,"Anderson",76978,337.758840188106,0.159400544959128,188.365507027982,113.019304216789,457.273506716205,15.9400544959128
2021-12-29,14405,81,9565,44,4840,37,10588,47,86890,158,97478,205,2,265,50,402,29,13738,0,340,276,"Anderson",76978,380.62823144275,0.188191881918819,266.309854763699,105.224869443218,522.227129829302,18.8191881918819
2021-12-30,14497,92,9607,42,4890,50,10626,38,87009,119,97635,157,1,266,70,472,21,13759,0,340,276,"Anderson",76978,465.067941489776,0.203985932004689,203.954376575125,119.514666528099,613.162202187638,20.3985932004689
2021-12-31,14565,68,9648,41,4917,27,10671,45,87126,117,97797,162,0,266,48,520,20,13779,0,340,277,"Anderson",76978,519.628984904778,0.221734357848518,210.449738886435,88.3369274338123,675.517680376211,22.1734357848518
2022-01-01,14626,61,9682,34,4944,27,10708,37,87225,99,97933,136,0,266,48,568,13,13792,0,340,277,"Anderson",76978,580.685390631089,0.23391215526047,176.673854867625,79.2434201979787,737.873158564785,23.391215526047
2022-01-02,14658,32,9705,23,4953,9,10741,33,87341,116,98082,149,0,266,12,580,20,13812,0,340,278,"Anderson",76978,607.96591233859,0.23747680890538,193.56179687703,41.5703187923822,753.462028111928,23.747680890538
2022-01-03,14719,61,9726,21,4993,40,10764,23,87417,76,98181,99,1,267,34,614,26,13838,0,340,278,"Anderson",76978,626.152926810257,0.245963912630579,128.608173763933,79.2434201979787,797.630491828834,24.5963912630579
2022-01-04,14845,126,9791,65,5054,61,10827,63,87591,174,98418,237,1,268,72,686,53,13891,0,340,279,"Anderson",76978,676.816752838473,0.249781659388646,307.880173556081,163.683130245005,891.163709111694,24.9781659388646
2022-01-05,15012,167,9877,86,5135,81,10913,86,87737,146,98650,232,1,269,135,821,31,13922,0,340,280,"Anderson",76978,788.536984593001,0.277303754266212,301.384811244771,216.945101197745,1066.53849151706,27.7303754266212
2022-01-06,15155,143,9949,72,5206,71,10984,71,87857,120,98841,191,1,270,116,937,26,13948,1,341,280,"Anderson",76978,854.78968016836,0.296849087893864,248.122840292031,185.767362103458,1217.23089713944,29.6849087893864
2022-01-07,15296,141,10021,72,5275,69,11062,78,87997,140,99059,218,0,270,115,1052,26,13974,1,342,280,"Anderson",76978,949.621969913482,0.309825673534073,283.197796773104,183.169217178934,1366.62423029957,30.9825673534073
2022-01-08,15399,103,10063,42,5336,61,11107,45,88072,75,99179,120,0,270,81,1133,22,13996,1,343,282,"Anderson",76978,1004.18301332848,0.320224719101124,155.888695471433,133.80446361298,1471.84909974278,32.0224719101124
2022-01-09,15484,85,10118,55,5366,30,11169,62,88215,143,99384,205,0,270,41,1174,44,14040,0,343,282,"Anderson",76978,1073.03385382837,0.328725038402458,266.309854763699,110.421159292265,1525.11107069552,32.8725038402458
2022-01-10,15640,156,10193,75,5447,81,11248,79,88328,113,99576,192,1,271,68,1242,87,14127,3,346,284,"Anderson",76978,1196.44573774325,0.346953405017921,249.421912754293,202.655304112863,1613.44799812934,34.6953405017921
2022-01-11,15814,174,10302,109,5512,65,11350,102,88469,141,99819,243,0,271,70,1312,104,14231,0,346,285,"Anderson",76978,1258.80121593182,0.373304782298358,315.674608329653,226.038608433578,1704.38307048767,37.3304782298358
2022-01-12,16068,254,10464,162,5604,92,11513,163,88660,191,100173,354,0,271,183,1495,71,14302,1,347,285,"Anderson",76978,1371.82052014861,0.393959290873276,459.871651640728,329.964405414534,1942.11333108161,39.3959290873276
2022-01-13,16299,231,10616,152,5683,79,11668,155,88892,232,100560,387,4,275,121,1616,106,14408,0,347,285,"Anderson",76978,1486.13889682767,0.397905759162304,502.741042895373,300.085738782509,2099.3010990153,39.7905759162304
2022-01-14,16556,257,10760,144,5796,113,11816,148,89048,156,100864,304,2,277,202,1818,53,14461,1,348,285,"Anderson",76978,1636.83130245005,0.417728531855956,394.918028527631,333.86162280132,2361.71373639222,41.7728531855956
2022-01-15,16652,96,10818,58,5834,38,11877,61,89166,118,101043,179,1,278,57,1875,38,14499,1,349,285,"Anderson",76978,1627.73779521422,0.413090128755365,232.533970744888,124.710956377147,2435.76086674115,41.3090128755365
2022-01-16,16804,152,10946,128,5858,24,12010,133,89363,197,101373,330,0,278,94,1969,58,14557,0,349,285,"Anderson",76978,1714.77565018577,0.422825540472599,428.693912546442,197.459014263816,2557.87367819377,42.2825540472599
2022-01-17,16985,181,11058,112,5927,69,12126,116,89482,119,101608,235,0,278,24,1993,157,14714,1,350,285,"Anderson",76978,1747.25246174232,0.432086614173228,305.282028631557,235.132115669412,2589.05141728806,43.2086614173228
2022-01-18,17200,215,11198,140,6002,75,12268,142,89619,137,101887,279,0,278,29,2022,186,14900,0,350,287,"Anderson",76978,1800.51443269506,0.443907156673114,362.441216971083,279.300579386318,2626.72451869365,44.3907156673114
2022-01-19,17501,301,11409,211,6092,90,12482,214,89839,220,102321,434,3,281,122,2144,176,15076,0,350,287,"Anderson",76978,1861.57083842137,0.451117318435754,563.797448621684,391.020811140845,2785.21135908961,45.1117318435754
2022-01-20,17797,296,11650,241,6147,55,12742,260,89996,157,102738,417,1,282,184,2328,111,15187,1,351,288,"Anderson",76978,1946.01054846839,0.493112947658402,541.713216763231,384.525448829536,3024.24069214581,49.3112947658402
2022-01-21,18043,246,11865,215,6178,31,12967,225,90215,219,103182,444,2,284,117,2445,127,15314,0,351,290,"Anderson",76978,1931.72075138351,0.496548748921484,576.788173244304,319.571825716438,3176.23217023046,49.6548748921484
2022-01-22,18171,128,11957,92,6214,36,13071,104,90334,119,103405,223,0,284,26,2471,102,15416,0,351,290,"Anderson",76978,1973.29107017589,0.505503810330229,289.693159084414,166.281275169529,3210.00805424927,50.5503810330229
2022-01-23,18298,127,12067,110,6231,17,13184,113,90441,107,103625,220,0,284,68,2539,59,15475,0,351,291,"Anderson",76978,1940.81425861935,0.521314387211368,285.795941697628,164.982202707267,3298.34498168308,52.1314387211368
2022-01-24,18566,268,12217,150,6349,118,13345,161,90619,178,103964,339,1,285,-5,2534,272,15747,1,352,292,"Anderson",76978,2053.83356283614,0.517402376910017,440.385564706799,348.151419886201,3291.84961937177,51.7402376910017
2022-01-25,18749,183,12350,133,6399,50,13490,145,90739,120,104229,265,1,286,-79,2455,261,16008,0,352,293,"Anderson",76978,2012.26324404375,0.521776259607173,344.254202499415,237.730260593936,3189.22289485307,52.1776259607173
2022-01-26,18954,205,12504,154,6450,51,13656,166,90891,152,104547,318,1,287,-48,2407,252,16260,1,353,293,"Anderson",76978,1887.55228766661,0.527403414195867,413.105042999298,266.309854763699,3126.8674166645,52.7403414195867
2022-01-27,19175,221,12676,172,6499,49,13834,178,91111,220,104945,398,0,287,-69,2338,290,16550,0,353,293,"Anderson",76978,1790.12185299696,0.494789306751246,517.030839980254,287.09501415989,3037.23141676843,49.4789306751246
2022-01-28,19366,191,12814,138,6552,53,13978,144,91274,163,105252,307,1,288,-135,2203,325,16875,1,354,294,"Anderson",76978,1718.67286757255,0.488405797101449,398.815245914417,248.122840292031,2861.85663436306,48.8405797101449
2022-01-29,19509,143,12914,100,6595,43,14083,105,91391,117,105474,222,0,288,-11,2192,154,17029,0,354,296,"Anderson",76978,1738.15895450648,0.489125181246979,288.394086622152,185.767362103458,2847.56683727818,48.9125181246979
2022-01-30,19576,67,12960,46,6616,21,14133,50,91482,91,105615,141,0,288,-24,2168,91,17120,1,355,297,"Anderson",76978,1660.21460677077,0.476884422110553,183.169217178934,87.0378549715503,2816.3890981839,47.6884422110553
2022-01-31,19772,196,13081,121,6691,75,14274,141,91632,150,105906,291,4,292,-92,2076,284,17404,1,356,299,"Anderson",76978,1566.68138948791,0.478372811534501,378.030086518226,254.618202603341,2696.8744316558,47.83728115345
2022-02-01,19935,163,13176,95,6759,68,14381,107,91752,120,106133,227,1,293,-238,1838,400,17804,1,357,299,"Anderson",76978,1540.69994024267,0.46796218487395,294.889448933461,211.748811348697,2387.69518563745,46.796218487395
2022-02-02,20079,144,13263,87,6816,57,14474,93,91893,141,106367,234,1,294,-232,1606,375,18179,0,357,300,"Anderson",76978,1461.45652004469,0.449450549450549,303.982956169295,187.06643456572,2086.31037439268,44.9450549450549
2022-02-03,20711,632,13354,91,7357,541,14572,98,92101,208,106673,306,2,296,344,1950,286,18465,1,358,302,"Anderson",76978,1995.37530203435,0.427083333333333,397.516173452155,821.013796149549,2533.19130141079,42.7083333333333
2022-02-04,20857,146,13464,110,7393,36,14682,110,92225,124,106907,234,0,296,-75,1875,221,18686,0,358,304,"Anderson",76978,1936.91704123256,0.425377643504532,303.982956169295,189.664579490244,2435.76086674115,42.5377643504532
2022-02-05,20906,49,13490,26,7416,23,14712,30,92301,76,107013,106,0,296,-59,1816,108,18794,0,358,304,"Anderson",76978,1814.80422977994,0.408706952566602,137.701680999766,63.6545506508353,2359.11559146769,40.8706952566602
2022-02-06,20964,58,13532,42,7432,16,14760,48,92375,74,107135,122,0,296,-19,1797,77,18871,0,358,306,"Anderson",76978,1803.11257761958,0.4125,158.486840395957,75.3462028111928,2334.43321468472,41.25
2022-02-07,21050,86,13585,53,7465,33,14818,58,92477,102,107295,160,3,299,-267,1530,350,19221,0,358,307,"Anderson",76978,1660.21460677077,0.391648668106551,207.851593961911,111.720231754527,1987.58086726078,39.1648668106551
2022-02-08,21136,86,13632,47,7504,39,14875,57,92574,97,107449,154,0,299,-204,1326,290,19511,0,358,307,"Anderson",76978,1560.1860271766,0.375379939209726,200.05715918834,111.720231754527,1722.57008495934,37.5379939209726
2022-02-09,21235,99,13696,64,7539,35,14949,74,92681,107,107630,181,0,299,-100,1226,199,19710,0,358,308,"Anderson",76978,1501.72776637481,0.376088677751386,235.132115669412,128.608173763933,1592.66283873314,37.6088677751386
2022-02-10,21323,88,13746,50,7577,38,15003,54,92807,126,107810,180,2,301,-100,1126,186,19896,0,358,309,"Anderson",76978,795.03234690431,0.379067722075638,233.83304320715,114.318376679051,1462.75559250695,37.9067722075638
2022-02-11,21382,59,13788,42,7594,17,15048,45,92909,102,107957,147,1,302,-121,1005,179,20075,0,358,309,"Anderson",76978,682.013042687521,0.348571428571429,190.963651952506,76.6452752734548,1305.56782457325,34.8571428571429
2022-02-12,21413,31,13811,23,7602,8,15073,25,92971,62,108044,87,0,302,-42,963,73,20148,1,359,309,"Anderson",76978,658.629738366806,0.350145489815713,113.019304216789,40.2712463301203,1251.00678115825,35.0145489815713
2022-02-13,21434,21,13825,14,7609,7,15088,15,93018,47,108106,62,0,302,-35,928,56,20204,0,359,309,"Anderson",76978,610.564057263114,0.337796086508754,80.5424926602406,27.2805217075008,1205.53924497908,33.7796086508754
2022-02-14,21485,51,13852,27,7633,24,15124,36,93075,57,108199,93,1,303,-140,788,190,20394,0,359,309,"Anderson",76978,565.096521083946,0.338495575221239,120.813738990361,66.2526955753592,1023.66910026241,33.8495575221239
2022-02-15,21541,56,13891,39,7650,17,15169,45,93152,77,108321,122,0,303,-100,688,156,20550,0,359,310,"Anderson",76978,526.124347216088,0.337155963302752,158.486840395957,72.7480578866689,893.761854036218,33.7155963302752
2022-02-16,21603,62,13924,33,7679,29,15200,31,93244,92,108444,123,0,303,-77,611,139,20689,0,359,310,"Anderson",76978,478.058666112396,0.308353808353808,159.785912858219,80.5424926602406,793.733274442048,30.8353808353808
2022-02-17,21651,48,13956,32,7695,16,15235,35,93338,94,108573,129,0,303,-68,543,116,20805,0,359,310,"Anderson",76978,426.095767621918,0.304062909567497,167.580347631791,62.3554781885734,705.396347008236,30.4062909567497
2022-02-18,21700,49,13988,32,7712,17,15272,37,93410,72,108682,109,0,303,-33,510,82,20887,0,359,311,"Anderson",76978,413.105042999299,0.308965517241379,141.598898386552,63.6545506508353,662.526955753592,30.8965517241379
2022-02-19,21728,28,13998,10,7730,18,15283,11,93465,55,108748,66,0,303,-7,503,35,20922,0,359,312,"Anderson",76978,409.207825612513,0.298295454545455,85.7387825092884,36.3740289433345,653.433448517758,29.8295454545455
2022-02-20,21738,10,14000,2,7738,8,15285,2,93502,37,108787,39,0,303,-20,483,30,20952,0,359,312,"Anderson",76978,394.918028527631,0.28928046989721,50.6638260282159,12.9907246226195,627.451999272519,28.928046989721
2022-02-21,21755,17,14010,10,7745,7,15295,10,93531,29,108826,39,0,303,-82,401,99,21051,2,361,313,"Anderson",76978,350.749564810725,0.272727272727273,50.6638260282159,22.0842318584531,520.92805736704,27.2727272727273
2022-02-22,21790,35,14025,15,7765,20,15313,18,93608,77,108921,95,2,305,-71,330,104,21155,0,361,313,"Anderson",76978,323.469043103224,0.24,123.411883914885,45.4675361791681,428.693912546442,24
2022-02-23,21825,35,14042,17,7783,18,15332,19,93674,66,109006,85,4,309,-35,295,66,21221,0,361,314,"Anderson",76978,288.394086622152,0.234875444839858,110.421159292265,45.4675361791681,383.226376367274,23.4875444839858
2022-02-24,21853,28,14056,14,7797,14,15349,17,93752,78,109101,95,1,310,-27,268,54,21275,0,361,315,"Anderson",76978,262.412637376913,0.215909090909091,123.411883914885,36.3740289433345,348.151419886201,21.5909090909091
2022-02-25,21866,13,14062,6,7804,7,15355,6,93819,67,109174,73,-1,309,-36,232,50,21325,0,361,315,"Anderson",76978,215.646028735483,0.16869918699187,94.832289745122,16.8879420094053,301.384811244771,16.869918699187
2022-02-26,21879,13,14067,5,7812,8,15362,7,93864,45,109226,52,0,309,-4,228,17,21342,1,362,315,"Anderson",76978,196.159941801554,0.165271966527197,67.5517680376211,16.8879420094053,296.188521395723,16.5271966527197
2022-02-27,21879,0,14067,0,7812,0,15363,1,93881,17,109244,18,0,309,-14,214,14,21356,0,362,315,"Anderson",76978,183.169217178934,0.170678336980306,23.383304320715,0,278.001506924056,17.0678336980306
2022-02-28,21897,18,14076,9,7821,9,15375,12,93938,57,109313,69,0,309,-26,188,44,21400,0,362,315,"Anderson",76978,184.468289641196,0.164271047227926,89.6359998960742,23.383304320715,244.225622905246,16.4271047227926
2022-03-01,21910,13,14083,7,7827,6,15383,8,93983,45,109366,53,-1,308,-36,152,50,21450,0,362,317,"Anderson",76978,155.888695471433,0.157303370786517,68.8508404998831,16.8879420094053,197.459014263816,15.7303370786517
2022-03-02,21920,10,14089,6,7831,4,15391,8,94036,53,109427,61,2,310,-23,129,31,21481,0,362,318,"Anderson",76978,123.411883914885,0.140142517814727,79.2434201979787,12.9907246226195,167.580347631791,14.0142517814727
2022-03-03,21931,11,14091,2,7840,9,15393,2,94080,44,109473,46,2,312,-28,101,37,21518,0,362,318,"Anderson",76978,101.327652056432,0.118279569892473,59.7573332640495,14.2897970848814,131.206318688456,11.8279569892473
2022-03-04,21940,9,14094,3,7846,6,15398,5,94144,64,109542,69,0,312,-15,86,24,21542,0,362,319,"Anderson",76978,96.1313622073839,0.116847826086957,89.6359998960742,11.6916521603575,111.720231754527,11.6847826086957
2022-03-05,21945,5,14095,1,7850,4,15399,1,94185,41,109584,42,0,312,-3,83,8,21550,0,362,319,"Anderson",76978,85.7387825092884,0.103351955307263,54.5610434150017,6.49536231130973,107.823014367741,10.3351955307263
2022-03-06,21947,2,14096,1,7851,1,15400,1,94209,24,109609,25,0,312,-4,79,6,21556,0,362,320,"Anderson",76978,88.3369274338123,0.101369863013699,32.4768115565486,2.59814492452389,102.626724518694,10.1369863013699
2022-03-07,21960,13,14098,2,7862,11,15402,2,94242,33,109644,35,1,313,-9,70,21,21577,0,362,320,"Anderson",76978,81.8415651225025,0.081570996978852,45.4675361791681,16.8879420094053,90.9350723583361,8.1570996978852
2022-03-08,22011,51,14100,2,7911,49,15405,3,94272,30,109677,33,0,313,35,105,16,21593,0,362,320,"Anderson",76978,131.206318688456,0.0707395498392283,42.8693912546442,66.2526955753592,136.402608537504,7.07395498392283
2022-03-09,22018,7,14106,6,7912,1,15410,5,94310,38,109720,43,0,313,-11,94,18,21611,0,362,320,"Anderson",76978,127.309101301671,0.0648464163822526,55.8601158772636,9.09350723583361,122.112811452623,6.48464163822526
2022-03-10,22023,5,14110,4,7913,1,15417,7,94356,46,109773,53,3,316,-11,83,13,21624,0,362,320,"Anderson",76978,119.514666528099,0.08,68.8508404998831,6.49536231130973,107.823014367741,8
2022-03-11,22029,6,14110,0,7919,6,15418,1,94395,39,109813,40,1,317,-15,68,20,21644,1,363,320,"Anderson",76978,115.617449141313,0.0738007380073801,51.9628984904778,7.79443477357167,88.3369274338123,7.38007380073801
2022-03-12,22029,0,14110,0,7919,0,15418,0,94417,22,109835,22,0,317,-6,62,6,21650,0,363,321,"Anderson",76978,109.122086830003,0.0756972111553785,28.5795941697628,0,80.5424926602406,7.56972111553785
2022-03-13,22032,3,14112,2,7920,1,15419,1,94461,44,109880,45,1,318,-1,61,3,21653,0,363,321,"Anderson",76978,110.421159292265,0.0701107011070111,58.4582608017875,3.89721738678583,79.2434201979787,7.01107011070111
2022-03-14,22039,7,14116,4,7923,3,15426,7,94487,26,109913,33,2,320,-6,55,11,21664,0,363,321,"Anderson",76978,102.626724518694,0.0892193308550186,42.8693912546442,9.09350723583361,71.448985424407,8.92193308550186
2022-03-15,22043,4,14117,1,7926,3,15426,0,94509,22,109935,22,0,320,-8,47,12,21676,0,363,321,"Anderson",76978,41.5703187923822,0.0813953488372093,28.5795941697628,5.19628984904778,61.0564057263114,8.13953488372093
2022-03-16,22045,2,14119,2,7926,0,15429,3,94533,24,109962,27,1,321,-4,43,5,21681,0,363,321,"Anderson",76978,35.0749564810725,0.0785123966942149,35.0749564810725,2.59814492452389,55.8601158772636,7.85123966942149
2022-03-17,22045,0,14119,0,7926,0,15431,2,94562,29,109993,31,0,321,-5,38,5,21686,0,363,321,"Anderson",76978,28.5795941697628,0.0636363636363636,40.2712463301203,0,49.3647535659539,6.36363636363636
2022-03-18,22047,2,14121,2,7926,0,15433,2,94606,44,110039,46,0,321,-3,35,5,21691,0,363,321,"Anderson",76978,23.383304320715,0.0663716814159292,59.7573332640495,2.59814492452389,45.4675361791681,6.63716814159292
2022-03-19,22047,0,14121,0,7926,0,15433,0,94626,20,110059,20,0,321,-3,32,3,21694,0,363,321,"Anderson",76978,23.383304320715,0.0669642857142857,25.9814492452389,0,41.5703187923822,6.69642857142857
2020-03-12,1,1,1,1,0,0,1,1,11,11,12,12,NA,NA,NA,NA,0,0,0,0,0,"East TN",2455501,NA,NA,0.488698640318208,0.040724886693184,NA,NA
2020-03-13,1,0,1,0,0,0,1,0,23,12,24,12,NA,NA,NA,NA,0,0,0,0,0,"East TN",2455501,NA,NA,0.488698640318208,0,NA,NA
2020-03-14,3,2,3,2,0,0,3,2,50,27,53,29,NA,NA,NA,NA,0,0,0,0,0,"East TN",2455501,NA,NA,1.18102171410234,0.081449773386368,NA,NA
2020-03-15,3,0,3,0,0,0,3,0,53,3,56,3,NA,NA,NA,NA,0,0,0,0,0,"East TN",2455501,NA,NA,0.122174660079552,0,NA,NA
2020-03-16,5,2,5,2,0,0,5,2,89,36,94,38,NA,NA,NA,NA,0,0,0,0,0,"East TN",2455501,NA,NA,1.54754569434099,0.081449773386368,NA,NA
2020-03-17,6,1,6,1,0,0,5,0,130,41,135,41,NA,NA,NA,NA,0,0,0,0,0,"East TN",2455501,NA,NA,1.66972035442054,0.040724886693184,NA,NA
2020-03-18,8,2,8,2,0,0,7,2,171,41,178,43,NA,NA,NA,NA,0,0,0,0,0,"East TN",2455501,0.325799093545472,0.0393258426966292,1.75117012780691,0.081449773386368,NA,3.93258426966292
2020-03-19,11,3,11,3,0,0,11,4,238,67,249,71,NA,NA,NA,NA,0,0,0,0,0,"East TN",2455501,0.40724886693184,0.0421940928270042,2.89146695521606,0.122174660079552,NA,4.21940928270042
2020-03-20,29,18,29,18,0,0,27,16,382,144,409,160,NA,NA,NA,NA,3,3,2,2,0,"East TN",2455501,1.14029682740915,0.0675324675324675,6.51598187090944,0.733047960477312,NA,6.75324675324675
2020-03-21,38,9,38,9,0,0,38,11,610,228,648,239,NA,NA,NA,NA,3,6,1,3,1,"East TN",2455501,1.42537103426144,0.0588235294117647,9.73324791967098,0.366523980238656,NA,5.88235294117647
2020-03-22,48,10,47,9,1,1,43,5,713,103,756,108,NA,NA,NA,NA,2,8,4,7,2,"East TN",2455501,1.83261990119328,0.0571428571428571,4.39828776286387,0.40724886693184,NA,5.71428571428571
2020-03-23,64,16,63,16,1,0,56,13,846,133,902,146,NA,NA,NA,NA,7,15,4,11,2,"East TN",2455501,2.40276831489786,0.0631188118811881,5.94583345720486,0.651598187090944,NA,6.31188118811881
2020-03-24,83,19,82,19,1,0,70,14,987,141,1057,155,NA,NA,NA,NA,7,22,5,16,2,"East TN",2455501,3.13581627537517,0.0704989154013015,6.31235743744352,0.773772847170496,NA,7.04989154013015
2020-03-25,116,33,115,33,1,0,99,29,1288,301,1387,330,NA,NA,NA,NA,15,37,12,28,3,"East TN",2455501,4.39828776286387,0.076095947063689,13.4392126087507,1.34392126087507,NA,7.6095947063689
2020-03-26,144,28,143,28,1,0,130,31,1774,486,1904,517,NA,NA,NA,NA,15,52,5,33,4,"East TN",2455501,5.41640993019347,0.0719033232628399,21.0547664203761,1.14029682740915,NA,7.19033232628399
2020-03-27,166,22,165,22,1,0,147,17,2171,397,2318,414,NA,NA,NA,NA,17,69,6,39,4,"East TN",2455501,5.57930947696621,0.0628601361969618,16.8601030909782,0.895947507250048,NA,6.28601361969618
2020-03-28,197,31,196,31,1,0,180,33,2608,437,2788,470,NA,NA,NA,NA,12,81,8,47,4,"East TN",2455501,6.47525698421626,0.0663551401869159,19.1406967457965,1.2624714874887,NA,6.63551401869159
2020-03-29,213,16,212,16,1,0,196,16,2795,187,2991,203,NA,NA,NA,NA,27,108,3,50,7,"East TN",2455501,6.71960630437536,0.0684563758389262,8.26715199871635,0.651598187090944,NA,6.84563758389262
2020-03-30,246,33,245,33,1,0,226,30,3345,550,3571,580,NA,NA,NA,NA,33,141,8,58,9,"East TN",2455501,7.41192937815949,0.0636942675159236,23.6204342820467,1.34392126087507,NA,6.36942675159236
2020-03-31,295,49,294,49,1,0,278,52,3645,300,3923,352,NA,NA,NA,NA,39,180,12,70,10,"East TN",2455501,8.63367597895501,0.0725750174459177,14.3351601160008,1.99551944796602,NA,7.25750174459177
2020-04-01,346,51,345,51,1,0,336,58,4243,598,4579,656,NA,NA,NA,NA,36,216,9,79,12,"East TN",2455501,9.36672393943232,0.0742481203007519,26.7155256707287,2.07696922135238,NA,7.42481203007519
2020-04-02,391,45,390,45,1,0,383,47,4839,596,5222,643,2,7,NA,134,34,250,5,84,14,"East TN",2455501,10.0590470132164,0.0762507534659433,26.1861021437173,1.83261990119328,5.45713481688666,7.62507534659433
2020-04-03,412,21,411,21,1,0,401,18,5124,285,5525,303,1,8,-13,121,33,283,2,86,17,"East TN",2455501,10.0183221265233,0.0792017461802308,12.3396406680348,0.855222620556864,4.92771128987526,7.92017461802307
2020-04-04,447,35,446,35,1,0,431,30,5716,592,6147,622,3,11,0,121,32,315,5,91,19,"East TN",2455501,10.181221673296,0.0747246204227449,25.3308795231604,1.42537103426144,4.92771128987526,7.47246204227449
2020-04-05,473,26,472,26,1,0,464,33,6093,377,6557,410,-1,10,1,122,26,341,2,93,20,"East TN",2455501,10.5884705402278,0.0751542344363432,16.6972035442054,1.05884705402278,4.96843617656845,7.51542344363432
2020-04-06,514,41,513,41,1,0,514,50,6626,533,7140,583,8,18,0,122,33,374,5,98,20,"East TN",2455501,10.9142696337733,0.080694872513309,23.7426089421263,1.66972035442054,4.96843617656845,8.06948725133091
2020-04-07,570,56,569,56,1,0,592,78,7755,1129,8347,1207,0,18,19,141,37,411,7,105,21,"East TN",2455501,11.1993438406256,0.0709764918625678,49.1549382386731,2.2805936548183,5.74220902373894,7.09764918625678
2020-04-08,607,37,606,37,1,0,632,40,8162,407,8794,447,1,19,4,145,32,443,8,113,25,"East TN",2455501,10.629195426921,0.0702253855278766,18.2040243518532,1.50682080764781,5.90510857051168,7.02253855278766
2020-04-09,633,26,632,26,1,0,662,30,8613,451,9275,481,3,22,3,148,20,463,2,115,25,"East TN",2455501,9.85542257975053,0.0688378978534419,19.5886704994215,1.05884705402278,6.02728323059123,6.88378978534419
2020-04-10,655,22,654,22,1,0,682,20,8941,328,9623,348,0,22,-7,141,29,492,4,119,25,"East TN",2455501,9.89614746644371,0.0685700341630063,14.172260569228,0.895947507250048,5.74220902373894,6.85700341630063
2020-04-11,679,24,678,24,1,0,728,46,10022,1081,10750,1127,2,24,-5,136,27,519,5,124,27,"East TN",2455501,9.44817371281869,0.0645231370845101,45.8969473032184,0.977397280636416,5.53858459027302,6.45231370845101
2020-04-12,709,30,708,30,1,0,761,33,11472,1450,12233,1483,0,24,18,154,12,531,1,125,28,"East TN",2455501,9.61107325959142,0.0523255813953488,60.3950069659919,1.22174660079552,6.27163255075034,5.23255813953488
2020-04-13,738,29,737,29,1,0,803,42,12435,963,13238,1005,0,24,-2,152,31,562,7,132,32,"East TN",2455501,9.12237461927321,0.0473925877336832,40.9285111266499,1.18102171410234,6.19018277736397,4.73925877336832
2020-04-14,749,11,748,11,1,0,823,20,12720,285,13543,305,4,28,-18,134,25,587,1,133,33,"East TN",2455501,7.28975471807994,0.0444572748267898,12.4210904414211,0.447973753625024,5.45713481688666,4.44572748267898
2020-04-15,773,24,772,24,1,0,850,27,13132,412,13982,439,2,30,-6,128,28,615,4,137,34,"East TN",2455501,6.76033119106854,0.0420200462606014,17.8782252583078,0.977397280636416,5.21278549672755,4.20200462606014
2020-04-16,801,28,800,28,1,0,886,36,13809,677,14695,713,1,31,1,129,26,641,6,143,34,"East TN",2455501,6.84178096445491,0.0413284132841328,29.0368442122402,1.14029682740915,5.25351038342074,4.13284132841328
2020-04-17,823,22,821,21,2,1,916,30,14138,329,15054,359,0,31,-1,128,23,664,4,147,35,"East TN",2455501,6.84178096445491,0.0430859878475419,14.6202343228531,0.895947507250048,5.21278549672755,4.30859878475419
2020-04-18,835,12,833,12,2,0,935,19,14919,781,15854,800,0,31,-11,117,23,687,0,147,35,"East TN",2455501,6.3530823241367,0.0405564263322884,32.5799093545472,0.488698640318208,4.76481174310253,4.05564263322884
2020-04-19,914,79,912,79,2,0,1016,81,15605,686,16621,767,1,32,66,183,12,699,1,148,35,"East TN",2455501,8.34860177210272,0.0581130355515041,31.2359880936721,3.21726604876154,7.45265426485267,5.81130355515041
2020-04-20,939,25,931,19,8,6,1033,17,16568,963,17601,980,0,32,10,193,15,714,2,150,35,"East TN",2455501,8.18570222532998,0.0527160210864084,39.9103889593203,1.0181221673296,7.85990313178451,5.27160210864084
2020-04-21,1045,106,1037,106,8,0,1154,121,19274,2706,20428,2827,0,32,83,276,23,737,6,156,36,"East TN",2455501,12.0545664611825,0.0480755265068991,115.129254681631,4.3168379894775,11.2400687273188,4.80755265068991
2020-04-22,1247,202,1237,200,10,2,1354,200,21826,2552,23180,2752,2,34,177,453,23,760,2,158,36,"East TN",2455501,19.3035962925692,0.0547945205479452,112.074888179642,8.22642711202317,18.4483736720124,5.47945205479452
2020-04-23,1492,245,1480,243,12,2,1601,247,22933,1107,24534,1354,0,34,236,689,9,769,3,161,36,"East TN",2455501,28.1408967049901,0.0726699867872751,55.1414965825711,9.97759723983008,28.0594469316038,7.26699867872751
2020-04-24,1540,48,1527,47,13,1,1655,54,25622,2689,27277,2743,0,34,22,711,26,795,4,165,36,"East TN",2455501,29.1997437590129,0.0604597889225231,111.708364199404,1.95479456127283,28.9553944388538,6.04597889225231
2020-04-25,1563,23,1546,19,17,4,1674,19,26397,775,28071,794,0,34,10,721,13,808,3,168,37,"East TN",2455501,29.6477175126379,0.0604894818695261,32.3355600343881,0.936672393943232,29.3626433057857,6.04894818695261
2020-04-26,1583,20,1565,19,18,1,1700,26,27514,1117,29214,1143,0,34,-1,720,21,829,0,168,37,"East TN",2455501,27.2449491977401,0.0543158897800365,46.5485454903093,0.81449773386368,29.3219184190925,5.43158897800365
2020-04-27,1652,69,1633,68,19,1,1772,72,28429,915,30201,987,0,34,50,770,19,848,8,176,38,"East TN",2455501,29.0368442122402,0.0586507936507936,40.1954631661726,2.8100171818297,31.3581627537517,5.86507936507936
2020-04-28,1689,37,1667,34,22,3,1812,40,30603,2174,32415,2214,2,36,19,789,16,864,1,177,39,"East TN",2455501,26.2268270304105,0.0548928005339117,90.1648991387094,1.50682080764781,32.1319356009222,5.48928005339117
2020-04-29,1752,63,1729,62,23,1,1878,66,33349,2746,35227,2812,1,37,39,828,23,887,6,183,40,"East TN",2455501,20.5660677800579,0.0434963061343073,114.518381381233,2.56566786167059,33.7202061819563,4.34963061343073
2020-04-30,1774,22,1750,21,24,1,1900,22,33898,549,35798,571,0,37,-1,827,23,910,1,184,40,"East TN",2455501,11.4844180474779,0.0265447443181818,23.2539103018081,0.895947507250048,33.6794812952632,2.65447443181818
2020-05-01,1814,40,1786,36,28,4,1929,29,35560,1662,37489,1691,0,37,-16,811,56,966,0,184,40,"East TN",2455501,11.1586189539324,0.026831179005092,68.8657833981741,1.62899546772736,33.0278831081722,2.6831179005092
2020-05-02,1835,21,1807,21,28,0,1966,37,37437,1877,39403,1914,0,37,-107,704,128,1094,3,187,40,"East TN",2455501,11.077169180546,0.0257677373808683,77.9474331307542,0.855222620556864,28.6703202320015,2.57677373808683
2020-05-03,1873,38,1840,33,33,5,2003,37,39557,2120,41560,2157,0,37,-20,684,58,1152,3,190,42,"East TN",2455501,11.8102171410234,0.0245423618985906,87.8435805971979,1.54754569434099,27.8558224981379,2.45423618985906
2020-05-04,1920,47,1884,44,36,3,2060,57,41503,1946,43563,2003,0,37,-312,372,359,1511,1,191,42,"East TN",2455501,10.9142696337733,0.0215536596317916,81.5719480464475,1.91406967457965,15.1496578498644,2.15536596317917
2020-05-05,1948,28,1911,27,37,1,2092,32,44413,2910,46505,2942,2,39,-45,327,71,1582,1,192,42,"East TN",2455501,10.5477456535347,0.0198722498225692,119.812616651347,1.14029682740915,13.3170379486712,1.98722498225692
2020-05-06,1985,37,1948,37,37,0,2135,43,45457,1044,47592,1087,1,40,7,334,29,1611,0,192,42,"East TN",2455501,9.48889859951187,0.0207844723008492,44.267951835491,1.50682080764781,13.6021121555235,2.07844723008492
2020-05-07,2028,43,1989,41,39,2,2183,48,46849,1392,49032,1440,0,40,18,352,25,1636,4,196,46,"East TN",2455501,10.3441212200687,0.0213843131328397,58.643836838185,1.75117012780691,14.3351601160008,2.13843131328397
2020-05-08,2047,19,2008,19,39,0,2219,36,48519,1670,50738,1706,1,41,-15,337,33,1669,0,196,47,"East TN",2455501,9.48889859951187,0.0218884444108989,69.4766566985719,0.773772847170496,13.724286815603,2.18884444108989
2020-05-09,2063,16,2022,14,41,2,2237,18,51337,2818,53574,2836,0,41,-32,305,48,1717,1,197,48,"East TN",2455501,9.28527416604595,0.0191235622045022,115.49577866187,0.651598187090944,12.4210904414211,1.91235622045022
2020-05-10,2079,16,2037,15,42,1,2256,19,53901,2564,56157,2583,1,42,-27,278,42,1759,3,200,48,"East TN",2455501,8.3893266587959,0.0173323285606631,105.192382328494,0.651598187090944,11.3215185007052,1.73323285606631
2020-05-11,2140,61,2097,60,43,1,2307,51,55472,1571,57779,1622,3,45,13,291,45,1804,5,205,50,"East TN",2455501,8.95947507250048,0.0173747889701744,66.0557662163444,2.48421808828422,11.8509420277165,1.73747889701745
2020-05-12,2193,53,2150,53,43,0,2373,66,59027,3555,61400,3621,3,48,30,321,20,1824,3,208,50,"East TN",2455501,9.97759723983008,0.0188653910708291,147.464814716019,2.15841899473875,13.0726886285121,1.88653910708291
2020-05-13,2247,54,2201,51,46,3,2425,52,60652,1625,63077,1677,0,48,18,339,36,1860,7,215,52,"East TN",2455501,10.6699203136142,0.0187278010978366,68.2956349844696,2.19914388143194,13.8057365889894,1.87278010978366
2020-05-14,2278,31,2232,31,46,0,2470,45,62361,1709,64831,1754,1,49,-2,337,32,1892,2,217,53,"East TN",2455501,10.181221673296,0.0181657066902969,71.4314512598447,1.2624714874887,13.724286815603,1.81657066902969
2020-05-15,2306,28,2260,28,46,0,2507,37,64680,2319,67187,2356,1,50,-21,316,48,1940,4,221,53,"East TN",2455501,10.5477456535347,0.0175086631406164,95.9478330491415,1.14029682740915,12.8690641950461,1.75086631406164
2020-05-16,2316,10,2270,10,46,0,2525,18,67449,2769,69974,2787,1,51,-28,288,37,1977,1,222,53,"East TN",2455501,10.3033963333756,0.0175609756097561,113.500259213904,0.40724886693184,11.728767367637,1.75609756097561
2020-05-17,2396,80,2350,80,46,0,2604,79,69676,2227,72280,2306,0,51,59,347,21,1998,4,226,55,"East TN",2455501,12.9097890817393,0.0215840724430937,93.9115887144823,3.25799093545472,14.1315356825348,2.15840724430937
2020-05-18,2445,49,2398,48,47,1,2665,61,71554,1878,74219,1939,0,51,8,355,41,2039,3,229,55,"East TN",2455501,12.4210904414211,0.0217761557177616,78.9655552980838,1.99551944796602,14.4573347760803,2.17761557177616
2020-05-19,2486,41,2438,40,48,1,2705,40,72678,1124,75383,1164,1,52,-6,349,46,2085,3,232,55,"East TN",2455501,11.9323918011029,0.0237431166416363,47.4037681108662,1.66972035442054,14.2129854559212,2.37431166416363
2020-05-20,2528,42,2480,42,48,0,2750,45,74418,1740,77168,1785,0,52,13,362,29,2114,3,235,55,"East TN",2455501,11.4436931607847,0.0230643673266624,72.6939227473334,1.71044524111373,14.7424089829326,2.30643673266624
2020-05-21,2769,241,2720,240,49,1,2988,238,75880,1462,78868,1700,0,52,211,573,30,2144,4,239,56,"East TN",2455501,19.9959193663533,0.0369024720381848,69.2323073784128,9.81469769305734,23.3353600751944,3.69024720381848
2020-05-22,2860,91,2808,88,52,3,3066,78,77404,1524,80470,1602,0,52,40,613,51,2195,7,246,56,"East TN",2455501,22.5615872280239,0.0420838665964014,65.2412684824808,3.70596468907974,24.9643555429218,4.20838665964014
2020-05-23,2926,66,2870,62,56,4,3157,91,79619,2215,82776,2306,2,54,36,649,28,2223,7,253,57,"East TN",2455501,24.8421808828422,0.049367286361506,93.9115887144823,2.68784252175014,26.4304514638764,4.9367286361506
2020-05-24,2978,52,2922,52,56,0,3227,70,81739,2120,84966,2190,0,54,26,675,26,2249,0,253,58,"East TN",2455501,23.7018840554331,0.0491092542960744,89.187501858073,2.11769410804557,27.4892985178992,4.91092542960744
2020-05-25,3062,84,3005,83,57,1,3321,94,84389,2650,87710,2744,1,55,42,717,41,2290,2,255,58,"East TN",2455501,25.1272550896945,0.0486250092654362,111.749089086097,3.42089048222746,29.1997437590129,4.86250092654362
2020-05-26,3123,61,3057,52,66,9,3377,56,86775,2386,90152,2442,1,56,15,732,45,2335,3,258,58,"East TN",2455501,25.9417528235582,0.0455007109486086,99.4501733047553,2.48421808828422,29.8106170594107,4.55007109486086
2020-05-27,3199,76,3130,73,69,3,3444,67,88642,1867,92086,1934,0,56,40,772,36,2371,9,267,58,"East TN",2455501,27.3263989711265,0.0465209813647942,78.7619308646179,3.09509138868198,31.439612527138,4.65209813647942
2020-05-28,3273,74,3204,74,69,0,3511,67,90041,1399,93552,1466,0,56,14,786,60,2431,1,268,58,"East TN",2455501,20.5253428933647,0.0356169980931626,59.7026838922077,3.01364161529562,32.0097609408426,3.56169980931626
2020-05-29,3348,75,3278,74,70,1,3594,83,91319,1278,94913,1361,0,56,10,796,65,2496,4,272,58,"East TN",2455501,19.8737447062738,0.0365575019040366,55.4265707894234,3.0543665019888,32.4170098077745,3.65575019040366
2020-05-30,3421,73,3350,72,71,1,3675,81,93564,2245,97239,2326,0,56,-1,795,74,2570,5,277,59,"East TN",2455501,20.1588189131261,0.0358155292816152,94.726086448346,2.97291672860243,32.3762849210813,3.58155292816152
2020-05-31,3533,112,3460,110,73,2,3769,94,96347,2783,100116,2877,0,56,71,866,41,2611,1,278,60,"East TN",2455501,22.6023121147171,0.0357755775577558,117.16549901629,4.56118730963661,35.2677518762973,3.57755775577558
2020-06-01,3629,96,3553,93,76,3,3903,134,100179,3832,104082,3966,0,56,-169,697,265,2876,5,283,60,"East TN",2455501,23.0910107550353,0.0355484974346445,161.514900625168,3.90958912254566,28.3852460251492,3.55484974346445
2020-06-02,3736,107,3658,105,78,2,4018,115,104238,4059,108256,4174,1,57,16,713,90,2966,3,286,64,"East TN",2455501,24.9643555429218,0.0354065399911622,169.98567705735,4.35756287617069,29.0368442122402,3.54065399911622
2020-06-03,3786,50,3708,50,78,0,4068,50,106169,1931,110237,1981,0,57,-65,648,115,3081,4,290,65,"East TN",2455501,23.905508488899,0.0343782711696325,80.6760005391975,2.0362443346592,26.3897265771832,3.43782711696325
2020-06-04,3837,51,3757,49,80,2,4129,61,107717,1548,111846,1609,6,63,-37,611,82,3163,5,295,66,"East TN",2455501,22.9688360949558,0.0337815677271236,65.526342689333,2.07696922135238,24.8829057695354,3.37815677271236
2020-06-05,3936,99,3852,95,84,4,4211,82,109873,2156,114084,2238,1,64,-43,568,141,3304,4,299,67,"East TN",2455501,23.9462333755922,0.0321840279588963,91.1422964193458,4.03176378262522,23.1317356417285,3.21840279588963
2020-06-06,3989,53,3902,50,87,3,4286,75,112978,3105,117264,3180,1,65,-14,554,66,3370,4,303,67,"East TN",2455501,23.1317356417285,0.0305118601747815,129.505139684325,2.15841899473875,22.5615872280239,3.05118601747815
2020-06-07,4047,58,3958,56,89,2,4367,81,116937,3959,121304,4040,0,65,-8,546,66,3436,6,309,68,"East TN",2455501,20.9325917602966,0.0282235227487257,164.528542240463,2.36204342820467,22.2357881344785,2.82235227487257
2020-06-08,4207,160,4114,156,93,4,4524,157,119888,2951,124412,3108,0,65,75,621,85,3521,6,315,68,"East TN",2455501,23.5389845086604,0.0305459911460895,126.572947842416,6.51598187090944,25.2901546364673,3.05459911460895
2020-06-09,4315,108,4221,107,94,1,4642,118,122215,2327,126857,2445,1,66,-35,586,142,3663,7,322,69,"East TN",2455501,23.5797093953535,0.0335465835170152,99.5723479648349,4.39828776286387,23.8647836022058,3.35465835170152
2020-06-10,4392,77,4295,74,97,3,4716,74,125052,2837,129768,2911,0,66,-63,523,140,3803,6,328,69,"East TN",2455501,24.6792813360695,0.0331780246787159,118.550145163859,3.13581627537517,21.2991157405352,3.31780246787159
2020-06-11,4656,264,4557,262,99,2,4996,280,127343,2291,132339,2571,1,67,149,672,114,3917,8,336,69,"East TN",2455501,33.3536822017177,0.042307129263651,104.703683688176,10.7513700870006,27.3671238578196,4.2307129263651
2020-06-12,4827,171,4727,170,100,1,5168,172,129970,2627,135138,2799,2,69,24,696,145,4062,3,339,70,"East TN",2455501,36.2858740436269,0.0454545454545455,113.988957854222,6.96395562453446,28.3445211384561,4.54545454545455
2020-06-13,4975,148,4871,144,104,4,5336,168,132161,2191,137497,2359,0,69,50,746,98,4160,4,343,71,"East TN",2455501,40.1547382794794,0.0518954183759205,96.0700077092211,6.02728323059123,30.3807654731153,5.18954183759205
2020-06-14,5091,116,4986,115,105,1,5471,135,136031,3870,141502,4005,0,69,30,776,86,4246,4,347,72,"East TN",2455501,42.5167817076841,0.0546588771165462,163.103171206202,4.72408685640934,31.6025120739108,5.46588771165462
2020-06-15,5273,182,5157,171,116,11,5650,179,139205,3174,144855,3353,0,69,58,834,124,4370,9,356,77,"East TN",2455501,43.4127292149341,0.0550799784767402,136.550545082246,7.41192937815949,33.9645555021155,5.50799784767402
2020-06-16,5427,154,5309,152,118,2,5808,158,141005,1800,146813,1958,3,72,64,898,87,4457,4,360,80,"East TN",2455501,45.2860740028206,0.0584285427941471,79.7393281452543,6.27163255075034,36.5709482504792,5.84285427941471
2020-06-17,5560,133,5439,130,121,3,5930,122,142445,1440,148375,1562,3,75,-6,892,136,4593,6,366,82,"East TN",2455501,47.5666676576389,0.0652442629118074,63.6122730147534,5.41640993019347,36.3265989303201,6.52442629118074
2020-06-18,5738,178,5616,177,122,1,6136,206,146036,3591,152172,3797,1,76,42,934,135,4728,12,378,82,"East TN",2455501,44.0643274020251,0.057479957646347,154.63239477402,7.24902983138675,38.0370441714339,5.7479957646347
2020-06-19,5873,135,5747,131,126,4,6254,118,147500,1464,153754,1582,4,80,22,956,109,4837,13,391,83,"East TN",2455501,42.5982314810705,0.0583369144821659,64.4267707486171,5.49785970357984,38.9329916786839,5.83369144821659
2020-06-20,5939,66,5812,65,127,1,6349,95,149675,2175,156024,2270,0,80,-44,912,110,4947,7,398,83,"East TN",2455501,39.2587907722294,0.0546769579532574,92.4454927935277,2.68784252175014,37.1410966641838,5.46769579532574
2020-06-21,6027,88,5899,87,128,1,6468,119,153025,3350,159493,3469,1,81,0,912,87,5034,3,401,86,"East TN",2455501,38.1184939448202,0.0554165971874826,141.274631938655,3.58379002900019,37.1410966641838,5.54165971874826
2020-06-22,6223,196,6088,189,135,7,6666,198,156436,3411,163102,3609,1,82,43,955,152,5186,7,408,87,"East TN",2455501,38.6886423585248,0.0556803858168466,146.976116075701,7.98207779186406,38.8922667919907,5.56803858168466
2020-06-23,6413,190,6272,184,141,6,6850,184,158240,1804,165090,1988,4,86,57,1012,129,5315,15,423,87,"East TN",2455501,40.1547382794794,0.0570115445642064,80.9610747460498,7.73772847170496,41.2135853335022,5.70115445642064
2020-06-24,6591,178,6448,176,143,2,7033,183,159871,1631,166904,1814,2,88,38,1050,138,5453,9,432,87,"East TN",2455501,41.9873581806727,0.0595283069782503,73.8749444614358,7.24902983138675,42.7611310278432,5.95283069782503
2020-06-25,6760,169,6608,160,152,9,7217,184,163044,3173,170261,3357,0,88,22,1072,147,5600,8,440,87,"East TN",2455501,41.620834200434,0.0597600751838134,136.713444629019,6.8825058511481,43.6570785350932,5.97600751838134
2020-06-26,6974,214,6812,204,162,10,7389,172,164633,1589,172022,1761,1,89,67,1139,146,5746,16,456,87,"East TN",2455501,44.8381002491956,0.0621305014232538,71.716525466697,8.71512575234138,46.3856459435366,6.21305014232538
2020-06-27,7048,74,6881,69,167,5,7435,46,164842,209,172277,255,-1,88,-52,1087,127,5873,5,461,89,"East TN",2455501,45.1638993427411,0.0668184335199655,10.3848461067619,3.01364161529562,44.267951835491,6.68184335199655
2020-06-28,7175,127,7006,125,169,2,7606,171,167929,3087,175535,3258,0,88,30,1117,97,5970,5,466,90,"East TN",2455501,46.7521699237752,0.0709387856875701,132.681680846393,5.17206061003437,45.4896984362865,7.09387856875701
2020-06-29,7518,343,7347,341,171,2,7946,340,173197,5268,181143,5608,1,89,147,1264,195,6165,22,488,91,"East TN",2455501,52.7387282676733,0.0709495039077657,228.385164575376,13.9686361357621,51.4762567801846,7.09495039077656
2020-06-30,7788,270,7613,266,175,4,8394,448,179483,6286,187877,6734,0,89,100,1364,170,6335,22,510,92,"East TN",2455501,55.996719203128,0.0677579321542985,274.241386991901,10.9957194071597,55.548745449503,6.77579321542985
2020-07-01,8063,275,7885,272,178,3,8728,334,182687,3204,191415,3538,0,89,66,1430,209,6544,17,527,95,"East TN",2455501,59.9470332123668,0.0691526253518828,144.084649120485,11.1993438406256,58.2365879712531,6.91526253518828
2020-07-02,8543,480,8360,475,183,5,9334,606,189070,6383,198404,6989,2,91,314,1744,164,6708,25,552,98,"East TN",2455501,72.6124729739471,0.0752229684113279,284.626233098663,19.5479456127283,71.0242023929129,7.52229684113279
2020-07-03,8769,226,8580,220,189,6,9562,228,192425,3355,201987,3583,5,96,24,1768,197,6905,14,566,99,"East TN",2455501,73.1011716142653,0.0725179375938595,145.917269021678,9.20382439265958,72.0015996735493,7.25179375938595
2020-07-04,8989,220,8798,218,191,2,9842,280,197189,4764,207031,5044,2,98,77,1845,141,7046,15,581,105,"East TN",2455501,79.0470050714701,0.0692582148817402,205.41632848042,8.95947507250048,75.1374159489245,6.92582148817402
2020-07-05,9309,320,9117,319,192,1,10210,368,201036,3847,211246,4215,2,100,163,2008,155,7201,12,593,108,"East TN",2455501,86.9069082032546,0.072918708521184,171.655397411771,13.0319637418189,81.7755724799135,7.2918708521184
2020-07-06,9543,234,9340,223,203,11,10420,210,202667,1631,213087,1841,4,104,-51,1957,281,7482,26,619,108,"East TN",2455501,82.4678955536976,0.0774480340596043,74.9745164021517,9.52962348620506,79.6986032585611,7.74480340596043
2020-07-07,9991,448,9779,439,212,9,10986,566,208945,6278,219931,6844,0,104,159,2116,289,7771,32,651,109,"East TN",2455501,89.7169253850844,0.080863542771573,278.721124528151,18.2447492385464,86.1738602427773,8.0863542771573
2020-07-08,10372,381,10150,371,222,10,11420,434,213116,4171,224536,4605,1,105,61,2177,319,8090,20,671,109,"East TN",2455501,94.0337633745619,0.0812777391986957,187.538103222112,15.5161818301031,88.6580783310616,8.12777391986957
2020-07-09,10821,449,10585,435,236,14,11892,472,219065,5949,230957,6421,1,106,149,2326,299,8389,24,695,113,"East TN",2455501,92.7712918870731,0.0785795471999508,261.494497456934,18.2854741252396,94.726086448346,7.85795471999508
2020-07-10,11288,467,11040,455,248,12,12345,453,222349,3284,234694,3737,0,106,141,2467,326,8715,29,724,115,"East TN",2455501,102.58598958013,0.0850888189072676,152.188901572429,19.0185220857169,100.468295472085,8.50888189072676
2020-07-11,11594,306,11339,299,255,7,12767,422,226827,4478,239594,4900,5,111,44,2511,257,8972,23,747,120,"East TN",2455501,106.088329835744,0.0898258759942266,199.551944796602,12.4618153281143,102.260190486585,8.98258759942266
2020-07-12,12064,470,11801,462,263,8,13400,633,232757,5930,246157,6563,1,112,222,2733,247,9219,25,772,125,"East TN",2455501,112.197062839722,0.091375211251468,267.277431367367,19.1406967457965,111.301115332472,9.1375211251468
2020-07-13,12418,354,12142,341,276,13,13743,343,236191,3434,249934,3777,3,115,-119,2614,470,9689,20,792,129,"East TN",2455501,117.084049242904,0.0901837327326512,153.817897040156,14.4166098893871,106.454853815983,9.01837327326512
2020-07-14,12933,515,12652,510,281,5,14327,584,240679,4488,255006,5072,4,119,77,2691,434,10123,34,826,133,"East TN",2455501,119.812616651347,0.0952530292230934,206.556625307829,20.9733166469898,109.590670091358,9.52530292230934
2020-07-15,13313,380,13026,374,287,6,14710,383,243776,3097,258486,3480,6,125,-106,2585,480,10603,24,850,140,"East TN",2455501,119.771891764654,0.0969072164948454,141.72260569228,15.4754569434099,105.273832101881,9.69072164948454
2020-07-16,14140,827,13838,812,302,15,15807,1097,253610,9834,269417,10931,6,131,349,2934,472,11075,44,894,142,"East TN",2455501,135.165898934678,0.101794071762871,445.163736443194,33.6794812952632,119.486817557802,10.1794071762871
2020-07-17,14608,468,14292,454,316,14,16318,511,257929,4319,274247,4830,3,134,95,3029,370,11445,24,918,147,"East TN",2455501,135.206623821371,0.100447500821682,196.701202728079,19.0592469724101,123.355681793654,10.0447500821682
2020-07-18,15117,509,14786,494,331,15,16986,668,266019,8090,283005,8758,6,140,185,3214,318,11763,27,945,150,"East TN",2455501,143.473775820087,0.0971873488286379,356.668557658905,20.7289673268307,130.889785831893,9.71873488286379
2020-07-19,15598,481,15248,462,350,19,17546,560,270873,4854,288419,5414,0,140,76,3290,405,12168,26,971,154,"East TN",2455501,143.921749573712,0.0981023141356301,220.484536556898,19.5886704994215,133.984877220575,9.81023141356301
2020-07-20,16034,436,15669,421,365,15,17957,411,273330,2457,291287,2868,2,142,-270,3020,704,12872,29,1000,158,"East TN",2455501,147.261190282553,0.101903126738084,116.798975036052,17.7560505982282,122.989157813416,10.1903126738084
2020-07-21,17035,1001,16653,984,382,17,19169,1212,281708,8378,300877,9590,1,143,381,3401,619,13491,61,1061,161,"East TN",2455501,167.053485215441,0.105556887794031,390.551663387635,40.7656115798772,138.505339643519,10.5556887794031
2020-07-22,17619,584,17221,568,398,16,19823,654,285008,3300,304831,3954,4,147,-79,3322,659,14150,29,1090,166,"East TN",2455501,175.36136210085,0.110324738375229,161.02620198485,23.7833338288195,135.288073594757,11.0324738375229
2020-07-23,18414,795,17994,773,420,22,20822,999,295211,10203,316033,11202,4,151,242,3564,549,14699,50,1140,172,"East TN",2455501,174.058165726668,0.107581088038442,456.200180737047,32.3762849210813,145.143496174508,10.7581088038442
2020-07-24,19017,603,18584,590,433,13,21506,684,301021,5810,322527,6494,2,153,7,3571,594,15293,34,1174,179,"East TN",2455501,179.556025430248,0.107456503728252,264.467414185537,24.55710667599,145.42857038136,10.7456503728252
2020-07-25,19995,978,19550,966,445,12,22708,1202,310635,9614,333343,10816,10,163,550,4121,418,15711,29,1203,187,"East TN",2455501,198.655997289352,0.1136715801184,440.480374473478,39.8289391859339,167.827258062611,11.36715801184
2020-07-26,20770,775,20310,760,460,15,23605,897,318158,7523,341763,8420,1,164,391,4512,383,16094,21,1224,194,"East TN",2455501,210.629113977148,0.113583533293341,342.903545956609,31.5617871872176,183.750688759646,11.3583533293341
2020-07-27,21416,646,20934,624,482,22,24311,706,322624,4466,346935,5172,6,170,-78,4434,718,16812,38,1262,198,"East TN",2455501,219.181340182716,0.114182001150086,210.629113977148,26.3082768037969,180.574147597578,11.4182001150086
2020-07-28,22231,815,21726,792,505,23,25283,972,330845,8221,356128,9193,7,177,170,4604,638,17450,50,1312,203,"East TN",2455501,211.606511257784,0.110658630613021,374.38388337044,33.190782654945,187.497378335419,11.0658630613021
2020-07-29,22574,343,22058,332,516,11,25599,316,332415,1570,358014,1886,5,182,-337,4267,675,18125,24,1336,212,"East TN",2455501,201.791813564727,0.108606133538913,76.807136303345,13.9686361357621,173.773091519816,10.8606133538913
2020-07-30,23762,1188,23231,1173,531,15,26980,1381,344949,12534,371929,13915,5,187,674,4941,509,18634,46,1382,219,"East TN",2455501,217.796694035148,0.110168885072277,566.686798335655,48.3811653915026,201.221665151022,11.0168885072277
2020-07-31,24384,622,23837,606,547,16,27634,654,348917,3968,376551,4622,6,193,80,5021,536,19170,27,1409,228,"East TN",2455501,218.570466882319,0.113431067673627,188.230426295896,25.3308795231604,204.479656086477,11.3431067673627
2020-08-01,24943,559,24379,542,564,17,28270,636,355892,6975,384162,7611,1,194,152,5173,406,19576,16,1425,231,"East TN",2455501,201.506739357874,0.109447253979811,309.957112621823,22.7652116614899,210.669838863841,10.9447253979811
2020-08-02,25374,431,24799,420,575,11,28754,484,359690,3798,388444,4282,4,198,50,5223,377,19953,21,1446,236,"East TN",2455501,187.497378335419,0.110301835864699,174.383964820214,17.5524261647623,212.7060831985,11.0301835864699
2020-08-03,26000,626,25407,608,593,18,29462,708,363834,4144,393296,4852,3,201,-43,5180,666,20619,39,1485,244,"East TN",2455501,186.682880601555,0.111106317810228,197.597150235329,25.4937790699332,210.954913070693,11.1106317810228
2020-08-04,26486,486,25873,466,613,20,29988,526,369205,5371,399193,5897,6,207,-218,4962,698,21317,34,1519,253,"East TN",2455501,173.284392879498,0.10925345408104,240.154656829706,19.7922949328874,202.076887771579,10.925345408104
2020-08-05,26954,468,26333,460,621,8,30509,521,373418,4213,403927,4734,9,216,-222,4740,681,21998,20,1539,259,"East TN",2455501,178.375003716146,0.106941389149043,192.791613605533,19.0592469724101,193.035962925692,10.6941389149043
2020-08-06,27685,731,27026,693,659,38,31361,852,380487,7069,411848,7921,7,223,202,4942,522,22520,37,1576,265,"East TN",2455501,159.763730497361,0.109747238157268,322.58182749671,29.7698921727175,201.262390037715,10.9747238157268
2020-08-07,28240,555,27567,541,673,14,31980,619,384457,3970,416437,4589,6,229,40,4982,509,23029,34,1610,278,"East TN",2455501,157.035163088917,0.108960537531966,186.886505035021,22.6023121147171,202.891385505443,10.8960537531966
2020-08-08,28915,675,28230,663,685,12,32780,800,394534,10077,427314,10877,8,237,290,5272,377,23406,24,1634,289,"East TN",2455501,161.759249945327,0.104514275120504,442.964592561762,27.4892985178992,214.701602646466,10.4514275120504
2020-08-09,29443,528,28746,516,697,12,33414,634,398835,4301,432249,4935,2,239,115,5387,411,23817,20,1654,296,"East TN",2455501,165.709563954566,0.106380550165506,200.977315830863,21.5027401740012,219.384964616182,10.6380550165506
2020-08-10,29746,303,29038,292,708,11,33742,328,401124,2289,434866,2617,3,242,-477,4910,777,24594,26,1680,300,"East TN",2455501,152.555425552667,0.102958864565793,106.577028476063,12.3396406680348,199.959193663533,10.2958864565793
2020-08-11,30358,612,29633,595,725,17,34427,685,407224,6100,441651,6785,17,259,-7,4903,602,25196,28,1708,305,"East TN",2455501,157.686761276008,0.104550379198267,276.318356213253,24.9236306562286,199.674119456681,10.4550379198267
2020-08-12,30803,445,30057,424,746,21,34901,474,410972,3748,445873,4222,6,265,-251,4652,690,25886,25,1733,310,"East TN",2455501,156.750088882065,0.104706050636533,171.940471618623,18.1225745784669,189.452172896692,10.4706050636533
2020-08-13,31620,817,30861,804,759,13,36018,1117,419535,8563,455553,9680,6,271,202,4854,609,26495,44,1777,318,"East TN",2455501,160.252429137679,0.106555314037295,394.216903190021,33.2722324283313,197.678600008715,10.6555314037295
2020-08-14,32081,461,31293,432,788,29,36552,534,424191,4656,460743,5190,4,275,-142,4712,599,27094,18,1795,325,"East TN",2455501,156.42428978852,0.103191441339773,211.362161937625,18.7741727655578,191.895666098283,10.3191441339773
2020-08-15,32731,650,31931,638,800,12,37429,877,431124,6933,468553,7810,4,279,216,4928,430,27524,17,1812,334,"East TN",2455501,155.40616762119,0.11273309246102,318.061365073767,26.4711763505696,200.692241624011,11.273309246102
2020-08-16,33205,474,32394,463,811,11,38022,593,436589,5465,474611,6058,2,281,110,5038,362,27886,10,1822,343,"East TN",2455501,153.207023739758,0.108776733865257,246.711363587309,19.3035962925692,205.171979160261,10.8776733865257
2020-08-17,33478,273,32597,203,881,70,38249,227,438061,1472,476310,1699,8,289,-397,4641,662,28548,12,1834,349,"East TN",2455501,151.985277138963,0.108749155486922,69.1915824917196,11.1178940672392,189.004199143067,10.8749155486922
2020-08-18,34108,630,33162,565,946,65,39061,812,448658,10597,487719,11409,8,297,52,4693,570,29118,22,1856,352,"East TN",2455501,152.71832509944,0.10059043153599,464.630232282536,25.6566786167059,191.121893251113,10.059043153599
2020-08-19,34563,455,33596,434,967,21,39558,497,453442,4784,493000,5281,7,304,-113,4580,561,29679,22,1878,359,"East TN",2455501,153.125573966372,0.0988180872960299,215.068126626705,18.5298234453987,186.519981054783,9.88180872960299
2020-08-20,35341,778,34353,757,988,21,40432,874,464981,11539,505413,12413,6,310,265,4845,507,30186,27,1905,367,"East TN",2455501,151.537303385338,0.088527878058564,505.518018522493,31.6839618472971,197.312076028476,8.8527878058564
2020-08-21,35550,209,34550,197,1000,12,40645,213,467432,2451,508077,2664,17,327,-321,4524,513,30699,17,1922,374,"East TN",2455501,141.274631938655,0.0864706130899565,108.491098150642,8.51150131887546,184.239387399964,8.64706130899565
2020-08-22,36419,869,35407,857,1012,12,41617,972,480799,13367,522416,14339,2,329,453,4977,414,31113,20,1942,381,"East TN",2455501,150.193382124463,0.077752817332863,583.954150293565,35.3899265363769,202.687761071977,7.7752817332863
2020-08-23,36672,253,35649,242,1023,11,41871,254,485904,5105,527775,5359,0,329,-94,4883,347,31460,20,1962,386,"East TN",2455501,141.193182165269,0.0723986156045444,218.244667788773,10.3033963333756,198.859621722817,7.23986156045444
2020-08-24,36864,192,35824,175,1040,17,42069,198,487247,1343,529316,1541,8,337,-485,4398,669,32129,15,1977,396,"East TN",2455501,137.894466343121,0.0720673131343622,62.7570503941965,7.81917824509133,179.108051676623,7.20673131343622
2020-08-25,37478,614,36413,589,1065,25,42754,685,496981,9734,539735,10419,16,353,119,4517,479,32608,23,2000,405,"East TN",2455501,137.24286815603,0.0709973854198708,424.312594456284,25.005080429615,183.954313193112,7.09973854198708
2020-08-26,37823,345,36733,320,1090,25,43138,384,500943,3962,544081,4346,6,359,-208,4309,547,33155,11,2011,413,"East TN",2455501,132.76313061978,0.0700847673303185,176.990357568578,14.0500859091485,175.48353676093,7.00847673303185
2020-08-27,38684,861,37577,844,1107,17,44114,976,511235,10292,555349,11268,8,367,387,4696,466,33621,29,2040,420,"East TN",2455501,136.143296215314,0.0737343800064082,458.888023258797,35.0641274428314,191.244067911192,7.37343800064082
2020-08-28,39018,334,37891,314,1127,20,44452,338,513844,2609,558296,2947,12,379,-182,4514,504,34125,10,2050,426,"East TN",2455501,141.233907051962,0.0758079611302495,120.016241084813,13.6021121555235,183.832138533033,7.58079611302495
2020-08-29,39469,451,38326,435,1143,16,44980,528,520363,6519,565343,7047,8,387,61,4575,382,34507,16,2066,435,"East TN",2455501,124.210904414211,0.0783423020476623,286.988276526868,18.366923898626,186.316356621317,7.83423020476623
2020-08-30,39732,263,38578,252,1154,11,45247,267,522244,1881,567491,2148,8,395,-55,4520,310,34817,14,2080,438,"East TN",2455501,124.618153281143,0.0850035250276966,87.4770566169592,10.7106452003074,184.076487853192,8.50035250276967
2020-08-31,40139,407,38956,378,1183,29,45697,450,525731,3487,571428,3937,2,397,-133,4387,538,35355,17,2097,443,"East TN",2455501,133.374003920178,0.0861512158054711,160.333878911065,16.5750288841259,178.660077922998,8.61512158054711
2020-09-01,40746,607,39521,565,1225,42,46371,674,531396,5665,577767,6339,6,403,105,4492,496,35851,28,2125,452,"East TN",2455501,133.088929713325,0.0951041228439209,258.155056748093,24.7200062227627,182.936191025783,9.51041228439209
2020-09-02,41234,488,39980,459,1254,29,46824,453,536189,4793,583013,5246,7,410,23,4515,458,36309,22,2147,459,"East TN",2455501,138.912588510451,0.0946778999280797,213.642755592443,19.8737447062738,183.872863419726,9.46778999280797
2020-09-03,41789,555,40502,522,1287,33,47471,647,544445,8256,591916,8903,6,416,-39,4476,588,36897,22,2169,462,"East TN",2455501,126.450773182336,0.0918040856509968,362.573666229417,22.6023121147171,182.284592838692,9.18040856509968
2020-09-04,42146,357,40845,343,1301,14,47819,348,547777,3332,595596,3680,7,423,-40,4436,390,37287,11,2180,463,"East TN",2455501,127.38744557628,0.0902680965147453,149.867583030917,14.5387845494667,180.655597370964,9.02680965147453
2020-09-05,43144,998,41828,983,1316,15,48909,1090,557096,9319,606005,10409,1,424,640,5076,357,37644,26,2206,469,"East TN",2455501,149.663958597451,0.0966258423097733,423.905345589352,40.6434369197976,206.719524854602,9.66258423097733
2020-09-06,43407,263,42075,247,1332,16,49177,268,559723,2627,608900,2895,0,424,-51,5025,314,37958,9,2215,483,"East TN",2455501,149.663958597451,0.0949069042961675,117.898546976768,10.7106452003074,204.64255563325,9.49069042961675
2020-09-07,43611,204,42272,197,1339,7,49414,237,561059,1336,610473,1573,3,427,-342,4683,543,38501,13,2228,487,"East TN",2455501,141.396806598735,0.095197848636189,64.0602467683784,8.30787688540954,190.714644384181,9.5197848636189
2020-09-08,43922,311,42561,289,1361,22,49734,320,564485,3426,614219,3746,7,434,-302,4381,606,39107,24,2252,494,"East TN",2455501,129.342240137552,0.0922583123011083,152.555425552667,12.6654397615802,178.415728602839,9.22583123011083
2020-09-09,44255,333,42877,316,1378,17,50109,375,569631,5146,619740,5521,6,440,-161,4220,488,39595,16,2268,501,"East TN",2455501,123.029882700109,0.0894437334930705,224.842099433069,13.5613872688303,171.859021845236,8.94437334930705
2020-09-10,44930,675,43515,638,1415,37,50816,707,577441,7810,628257,8517,18,458,194,4414,463,40058,39,2307,512,"East TN",2455501,127.916869103291,0.0920447978866845,346.853859965848,27.4892985178992,179.759649863714,9.20447978866845
2020-09-11,45256,326,43818,303,1438,23,51171,355,581601,4160,632772,4515,17,475,-205,4209,514,40572,26,2333,523,"East TN",2455501,126.654397615802,0.0901656982999785,183.872863419726,13.276313061978,171.411048091611,9.01656982999785
2020-09-12,45675,419,44219,401,1456,18,51683,512,588587,6986,640270,7498,10,485,92,4301,317,40889,15,2348,534,"East TN",2455501,103.074688220449,0.0809572450021888,305.355200425494,17.0637275244441,175.157737667384,8.09572450021888
2020-09-13,46115,440,44639,420,1476,20,52185,502,594161,5574,646346,6076,2,487,48,4349,390,41279,21,2369,539,"East TN",2455501,110.282993165142,0.0803290071035625,247.444411547786,17.918950145001,177.112532228657,8.03290071035625
2020-09-14,46559,444,45068,429,1491,15,52670,485,599133,4972,651803,5457,9,496,-151,4198,586,41865,25,2394,549,"East TN",2455501,120.056965971506,0.0787805468182918,222.235706684705,18.0818496917737,170.963074337986,7.87805468182918
2020-09-15,47052,493,45524,456,1528,37,53210,540,607308,8175,660518,8715,7,503,-66,4132,552,42417,20,2414,552,"East TN",2455501,127.468895349666,0.0750772154906153,354.917387531099,20.0773691397397,168.275231816236,7.50772154906153
2020-09-16,47405,353,45834,310,1571,43,53604,394,610722,3414,664326,3808,6,509,-175,3957,522,42939,17,2431,561,"East TN",2455501,128.28339308353,0.0783878347463329,155.080368527645,14.375885002694,161.148376644929,7.83878347463329
2020-09-17,47956,551,46353,519,1603,32,54181,577,617897,7175,672078,7752,8,517,119,4076,424,43363,21,2452,572,"East TN",2455501,123.233507133575,0.0767896670546085,315.699321645562,22.4394125679444,165.994638161418,7.67896670546085
2020-09-18,48490,534,46839,486,1651,48,54747,566,626011,8114,680758,8680,17,534,-29,4047,546,43909,30,2482,578,"East TN",2455501,131.704283565757,0.0745217355061893,353.492016496837,21.7470894941603,164.813616447316,7.45217355061893
2020-09-19,48998,508,47324,485,1674,23,55320,573,634365,8354,689685,8927,3,537,193,4240,312,44221,30,2512,580,"East TN",2455501,135.32879848145,0.0736011332591318,363.551063510054,20.6882424401375,172.6735195791,7.36011332591318
2020-09-20,49304,306,47605,281,1699,25,55649,329,639323,4958,694972,5287,1,538,-19,4221,324,44545,13,2525,591,"East TN",2455501,129.871663664564,0.071237609509316,215.312475946864,12.4618153281143,171.89974673193,7.1237609509316
2020-09-21,49467,163,47738,133,1729,30,55801,152,640840,1517,696641,1669,3,541,-208,4013,368,44913,9,2534,596,"East TN",2455501,118.427970503779,0.0698291627637272,67.9698358909241,6.63815653098899,163.428970299747,6.98291627637272
2020-09-22,49927,460,48140,402,1787,58,56291,490,646989,6149,703280,6639,6,547,-55,3958,509,45422,29,2563,603,"East TN",2455501,117.084049242904,0.072049950890978,270.372522756049,18.7334478788646,161.189101531622,7.2049950890978
2020-09-23,50221,294,48394,254,1827,40,56573,282,649082,2093,705655,2375,8,555,-217,3741,503,45925,13,2576,612,"East TN",2455501,114.681280928006,0.0718381765830289,96.721605896312,11.9731166877961,152.351801119201,7.18381765830289
2020-09-24,50684,463,48836,442,1848,21,57054,481,655975,6893,713029,7374,11,566,-36,3705,488,46413,28,2604,617,"East TN",2455501,111.097490899006,0.0701570169226637,300.305314475539,18.8556225389442,150.885705198247,7.01570169226637
2020-09-25,51138,454,49266,430,1872,24,57540,486,662648,6673,720188,7159,11,577,14,3719,429,46842,18,2622,624,"East TN",2455501,107.839499963551,0.0708343900583312,291.549463836504,18.4890985587055,151.455853611951,7.08343900583312
2020-09-26,51696,558,49800,534,1896,24,58178,638,673204,10556,731382,11194,5,582,194,3913,359,47201,29,2651,631,"East TN",2455501,109.87574429821,0.068542101350217,455.874381643502,22.7244867747967,159.356481630429,6.8542101350217
2020-09-27,52089,393,50165,365,1924,28,58585,407,679222,6018,737807,6425,3,585,91,4004,299,47500,30,2681,638,"East TN",2455501,113.418809440517,0.0685420800747053,261.657397003707,16.0048804704213,163.062446319509,6.85420800747053
2020-09-28,52323,234,50360,195,1963,39,58810,225,680909,1687,739719,1912,4,589,-315,3689,545,48045,15,2696,645,"East TN",2455501,116.310276395733,0.0698500394632991,77.8659833573678,9.52962348620506,150.234107011156,6.98500394632991
2020-09-29,52706,383,50700,340,2006,43,59207,397,686718,5809,745925,6206,9,598,-44,3645,418,48463,33,2729,647,"East TN",2455501,113.174460120358,0.0683784734435456,252.7386468179,15.5976316034895,148.442211996656,6.83784734435456
2020-09-30,53188,482,51150,450,2038,32,59683,476,690156,3438,749839,3914,6,604,80,3725,396,48859,23,2752,651,"East TN",2455501,120.830738818677,0.0703874705775846,159.397206517122,19.6293953861147,151.70020293211,7.03874705775846
2020-10-01,53576,388,51499,349,2077,39,60062,379,693436,3280,753498,3659,11,615,0,3725,377,49236,31,2783,656,"East TN",2455501,117.776372316688,0.0743284983567669,149.01236041036,15.8012560369554,151.70020293211,7.43284983567669
2020-10-02,54041,465,51936,437,2105,28,60525,463,697057,3621,757582,4084,2,617,24,3749,439,49675,17,2800,660,"East TN",2455501,118.224346070313,0.0798256404770819,166.320437254963,18.9370723123306,152.677600212747,7.98256404770819
2020-10-03,54446,405,52324,388,2122,17,61008,483,704517,7460,765525,7943,12,629,83,3832,310,49985,22,2822,666,"East TN",2455501,111.993438406256,0.0828866824825001,323.477775003961,16.4935791107395,156.057765808281,8.28866824825001
2020-10-04,54901,455,52749,425,2152,30,61547,539,714639,10122,776186,10661,4,633,144,3976,307,50292,27,2849,679,"East TN",2455501,114.518381381233,0.0771776231793429,434.168017036035,18.5298234453987,161.9221494921,7.71776231793429
2020-10-05,55572,671,53361,612,2211,59,62298,751,721887,7248,784185,7999,5,638,151,4127,515,50807,42,2891,688,"East TN",2455501,132.315156866155,0.078441955651509,325.758368658779,27.3263989711265,168.07160738277,7.8441955651509
2020-10-06,56322,750,54027,666,2295,84,63037,739,728527,6640,791564,7379,8,646,302,4429,440,51247,46,2937,697,"East TN",2455501,147.261190282553,0.0839194548522097,300.508938909005,30.543665019888,180.370523164112,8.39194548522097
2020-10-07,57059,737,54686,659,2373,78,63745,708,735280,6753,799025,7461,3,649,293,4722,441,51688,38,2975,703,"East TN",2455501,157.646036389315,0.082584475257187,303.848379617846,30.0142414928766,192.302914965215,8.2584475257187
2020-10-08,57777,718,55343,657,2434,61,64423,678,741741,6461,806164,7139,10,659,266,4988,442,52130,32,3007,709,"East TN",2455501,171.085248998066,0.0828048456309574,290.734966102641,29.2404686457061,203.135734825602,8.28048456309574
2020-10-09,58318,541,55842,499,2476,42,64983,560,747220,5479,812203,6039,4,663,123,5111,414,52544,20,3027,716,"East TN",2455501,174.180340386748,0.0816169605096941,245.937590740138,22.0321637010125,208.144895888863,8.16169605096941
2020-10-10,58936,618,56430,588,2506,30,65652,669,755646,8426,821298,9095,12,675,252,5363,354,52898,20,3047,730,"East TN",2455501,182.854741252396,0.0832660964983056,370.392844474508,25.1679799763877,218.407567335546,8.32660964983056
2020-10-11,59879,943,57342,912,2537,31,66681,1029,766073,10427,832754,11456,1,676,586,5949,356,53254,37,3084,737,"East TN",2455501,202.72848595867,0.0907580257389337,466.544301957116,38.4035681516725,242.272350937752,9.07580257389337
2020-10-12,60235,356,57627,285,2608,71,66998,317,768994,2921,835992,3238,6,682,-337,5612,687,53941,19,3103,748,"East TN",2455501,189.900146650317,0.0907213310942537,131.86718311253,14.4980596627735,228.548064122149,9.07213310942537
2020-10-13,60740,505,58080,453,2660,52,67482,484,773379,4385,840861,4869,9,691,7,5619,489,54430,24,3127,755,"East TN",2455501,179.922549410487,0.0901677586871412,198.289473309113,20.5660677800579,228.833138329001,9.01677586871412
2020-10-14,61614,874,58892,812,2722,62,68330,848,779563,6184,847893,7032,1,692,328,5947,545,54975,44,3171,762,"East TN",2455501,185.501858887453,0.0938241794221167,286.37740322647,35.5935509698428,242.190901164365,9.38241794221167
2020-10-15,62123,509,59332,440,2791,69,68795,465,783717,4154,852512,4619,14,706,-67,5880,562,55537,19,3190,771,"East TN",2455501,176.990357568578,0.0943298524208164,188.108251635817,20.7289673268307,239.462333755922,9.43298524208164
2020-10-16,62762,639,59928,596,2834,43,69379,584,787806,4089,857185,4673,2,708,-135,5745,772,56309,22,3212,783,"East TN",2455501,180.98139646451,0.0977279800809213,190.307395517249,26.0232025969446,233.964474052342,9.77279800809213
2020-10-17,63480,718,60609,681,2871,37,70239,860,796590,8784,866829,9644,6,714,237,5982,475,56784,37,3249,790,"East TN",2455501,185.053885133828,0.100744547670818,392.750807269066,29.2404686457061,243.616272198627,10.0744547670818
2020-10-18,64285,805,61368,759,2917,46,71110,871,804700,8110,875810,8981,3,717,348,6330,454,57238,39,3288,798,"East TN",2455501,179.433850770169,0.102866034931252,365.750207391485,32.7835337880131,257.788532767855,10.2866034931252
2020-10-19,65033,748,62053,685,2980,63,71869,759,809599,4899,881468,5658,3,720,-19,6311,764,58002,67,3355,809,"East TN",2455501,195.398006353897,0.107111443398716,230.421408910035,30.4622152465016,257.014759920684,10.7111443398716
2020-10-20,65719,686,62662,609,3057,77,72560,691,813214,3615,885774,4306,15,735,34,6345,637,58639,32,3387,822,"East TN",2455501,202.769210845363,0.113063032974863,175.36136210085,27.9372722715242,258.399406068252,11.3063032974863
2020-10-21,66313,594,63215,553,3098,41,73177,617,816958,3744,890135,4361,5,740,-128,6217,717,59356,27,3414,836,"East TN",2455501,191.366242571272,0.114743620093746,177.601230868975,24.1905826957513,253.186620571525,11.4743620093746
2020-10-22,67443,1130,64251,1036,3192,94,74278,1101,825524,8566,899802,9667,10,750,440,6657,680,60036,43,3457,851,"East TN",2455501,216.656397207739,0.115944174244026,393.68747966301,46.0191219632979,271.105570716526,11.5944174244026
2020-10-23,68414,971,65155,904,3259,67,75248,970,832640,7116,907888,8086,19,769,290,6947,662,60698,39,3496,859,"East TN",2455501,230.177059589876,0.115752519574779,329.301433801086,39.5438649790817,282.915787857549,11.5752519574779
2020-10-24,69651,1237,66330,1175,3321,62,76575,1327,843165,10525,919740,11852,12,781,644,7591,581,61279,50,3546,876,"East TN",2455501,251.313275783638,0.119748256506209,482.671357087617,50.3766848394686,309.14261488796,11.9748256506209
2020-10-25,70580,929,67202,872,3378,57,77622,1047,851042,7877,928664,8924,9,790,437,8028,483,61762,43,3589,887,"East TN",2455501,256.363161733593,0.123207325840996,363.428888849974,37.8334197379679,326.939390372881,12.3207325840996
2020-10-26,71042,462,67608,406,3434,56,78056,434,853797,2755,931853,3189,6,796,-449,7579,905,62667,21,3610,900,"East TN",2455501,244.715844139343,0.122794482484867,129.871663664564,18.814897652251,308.653916247642,12.2794482484867
2020-10-27,71884,842,68320,712,3564,130,78839,783,858182,4385,937021,5168,12,808,80,7659,750,63417,54,3664,924,"East TN",2455501,251.068926463479,0.122524245321677,210.466214430375,34.2903545956609,311.911907183096,12.2524245321677
2020-10-28,72881,997,69231,911,3650,86,79809,970,865399,7217,945208,8187,13,821,200,7859,784,64201,41,3705,938,"East TN",2455501,267.481055800833,0.120421985364879,333.414647357097,40.6027120331044,320.056884521733,12.0421985364879
2020-10-29,73789,908,70024,793,3765,115,80643,834,871902,6503,952545,7337,11,832,151,8010,746,64947,40,3745,950,"East TN",2455501,258.440130954946,0.120679521453084,298.798493667891,36.9781971174111,326.206342412404,12.0679521453084
2020-10-30,74689,900,70831,807,3858,93,81483,840,876759,4857,958242,5697,28,860,50,8060,822,65769,39,3784,966,"East TN",2455501,255.54866399973,0.12382333081781,232.009679491069,36.6523980238656,328.242586747063,12.382333081781
2020-10-31,74703,14,70845,14,3858,0,81499,16,876780,21,958279,37,5,865,-603,7457,612,66381,0,3784,977,"East TN",2455501,205.742127573966,0.127766677910688,1.50682080764781,0.570148413704576,303.685480071073,12.7766677910688
2020-11-01,75210,507,71235,390,3975,117,81969,470,883344,6564,965313,7034,0,865,-137,7320,644,67025,27,3811,993,"East TN",2455501,188.556225389442,0.118611694725641,286.458852999856,20.6475175534443,298.106170594107,11.8611694725641
2020-11-02,76022,812,71979,744,4043,68,82746,777,887572,4228,970318,5005,11,876,-228,7092,1029,68054,38,3849,1007,"East TN",2455501,202.809935732056,0.121929026387625,203.828057899386,33.0686079948654,288.820896428061,12.1929026387625
2020-11-03,77062,1040,72939,960,4123,80,83822,1076,894436,6864,978258,7940,31,907,30,7122,979,69033,29,3878,1020,"East TN",2455501,210.873463297307,0.120838082304726,323.355600343881,42.3538821609114,290.042643028856,12.0838082304726
2020-11-04,77973,911,73751,812,4222,99,84669,847,899321,4885,983990,5732,6,913,-5,7117,910,69943,35,3913,1044,"East TN",2455501,207.371123041693,0.125315868186272,233.435050525331,37.1003717774906,289.839018595391,12.5315868186272
2020-11-05,78551,578,74235,484,4316,94,85170,501,901983,2662,987153,3163,17,930,-365,6752,926,70869,27,3940,1058,"East TN",2455501,193.931910432942,0.130807905686546,128.812816610541,23.5389845086603,274.974434952378,13.0807905686546
2020-11-06,79517,966,75084,849,4433,117,86097,927,908393,6410,994490,7337,10,940,43,6795,913,71782,37,3977,1082,"East TN",2455501,196.619752954692,0.127289781505186,298.798493667891,39.3402405456157,276.725605080185,12.7289781505186
2020-11-07,80844,1327,76325,1241,4519,86,87516,1419,919314,10921,1006830,12340,21,961,649,7444,657,72439,52,4029,1092,"East TN",2455501,250.091529182843,0.123931535910692,502.54510179389,54.0419246418552,303.156056544062,12.3931535910692
2020-11-08,82401,1557,77764,1439,4637,118,89183,1667,932215,12901,1021398,14568,3,964,889,8333,665,73104,52,4081,1109,"East TN",2455501,292.852660210686,0.128626192386556,593.280149346304,63.4086485812875,339.360480814302,12.8626192386556
2020-11-09,83020,619,78303,539,4717,80,89763,580,935667,3452,1025430,4032,9,973,-467,7866,1077,74181,19,4100,1120,"East TN",2455501,284.992757078902,0.127322543184787,164.202743146918,25.2087048630809,320.341958728585,12.7322543184787
2020-11-10,83959,939,79153,850,4806,89,90686,923,940669,5002,1031355,5925,27,1000,7,7873,905,75086,44,4144,1138,"East TN",2455501,280.87954352289,0.129272840273462,241.294953657115,38.2406686048998,320.627032935438,12.9272840273462
2020-11-11,85263,1304,80253,1100,5010,204,91855,1169,947216,6547,1039071,7716,26,1026,383,8256,895,75981,59,4203,1152,"East TN",2455501,296.884423993311,0.130462409905412,314.233225724608,53.1052522479119,336.224664538927,13.0462409905412
2020-11-12,86100,837,80958,705,5142,132,92619,764,951432,4216,1044051,4980,15,1041,8,8264,814,76795,34,4237,1170,"East TN",2455501,307.432169646846,0.130918485711273,202.809935732056,34.086730162195,336.550463632473,13.0918485711273
2020-11-13,87559,1459,82246,1288,5313,171,93919,1300,957294,5862,1051213,7162,27,1068,526,8790,906,77701,47,4284,1186,"East TN",2455501,327.509538786586,0.137898207076495,291.671638496584,59.4176096853555,357.971754033087,13.7898207076495
2020-11-14,89034,1475,83637,1391,5397,84,95454,1535,966191,8897,1061645,10432,7,1075,917,9707,551,78252,52,4336,1215,"East TN",2455501,333.536822017177,0.144814375627109,424.842017983295,60.0692078724464,395.316475130737,14.4814375627109
2020-11-15,90986,1952,85370,1733,5616,219,97415,1961,977364,11173,1074779,13134,7,1082,1339,11046,606,78858,56,4392,1232,"East TN",2455501,349.623152260985,0.154212172870497,534.880661828279,79.4949788250952,449.84709841291,15.4212172870497
2020-11-16,92511,1525,86769,1399,5742,126,98952,1537,984984,7620,1083936,9157,10,1092,172,11218,1343,80201,41,4433,1251,"East TN",2455501,386.519899605009,0.157060814275459,372.917787449486,62.1054522071056,456.851778924138,15.7060814275459
2020-11-17,93723,1212,87888,1119,5835,93,100173,1221,990128,5144,1090301,6365,31,1123,89,11307,1092,81293,46,4479,1278,"East TN",2455501,397.637793672249,0.16094391476945,259.213903802116,49.358562672139,460.476293839831,16.094391476945
2020-11-18,94920,1197,88843,955,6077,242,101206,1033,995269,5141,1096475,6174,14,1137,56,11363,1127,82420,53,4532,1293,"East TN",2455501,393.280230796078,0.162898055884607,251.435450443718,48.7476893717412,462.75688749465,16.2898055884607
2020-11-19,96000,1080,89723,880,6277,200,102065,859,999930,4661,1101995,5520,45,1182,-243,11120,1278,83698,52,4584,1313,"East TN",2455501,403.176378262522,0.163019467071655,224.801374546376,43.9828776286387,452.860740028206,16.3019467071655
2020-11-20,97126,1126,90686,963,6440,163,103088,1023,1004830,4900,1107918,5923,28,1210,-126,10994,1224,84922,36,4620,1339,"East TN",2455501,389.614990993691,0.161696499426858,241.213503883729,45.8562224165252,447.729404304865,16.1696499426858
2020-11-21,98344,1218,91750,1064,6594,154,104187,1099,1011236,6406,1115423,7505,3,1213,362,11356,853,85775,47,4667,1363,"East TN",2455501,379.148695113543,0.162389824835435,305.640274632346,49.6029119922981,462.471813287797,16.2389824835435
2020-11-22,99930,1586,93179,1429,6751,157,105853,1666,1020836,9600,1126689,11266,17,1230,803,12159,766,86541,57,4724,1390,"East TN",2455501,364.243386583838,0.162550568291273,458.806573485411,64.5896702953898,495.173897302424,16.2550568291273
2020-11-23,100821,891,93937,758,6884,133,106555,702,1023952,3116,1130507,3818,18,1248,-1158,11001,2031,88572,35,4759,1417,"East TN",2455501,338.423808420359,0.163256103583775,155.487617394577,36.2858740436269,448.014478511717,16.3256103583775
2020-11-24,101732,911,94670,733,7062,178,107260,705,1026979,3027,1134239,3732,13,1261,-735,10266,1633,90205,57,4816,1445,"East TN",2455501,326.165617525711,0.161295461787064,151.985277138963,37.1003717774906,418.081686792227,16.1295461787064
2020-11-25,102639,907,95356,686,7283,221,107805,545,1029287,2308,1137092,2853,38,1299,-494,9772,1363,91568,56,4872,1470,"East TN",2455501,314.355400384687,0.162468916955954,116.188101735654,36.9374722307179,397.963592765794,16.2468916955954
2020-11-26,104105,1466,96743,1387,7362,79,109475,1670,1037653,8366,1147128,10036,18,1317,-441,9331,1889,93457,25,4897,1489,"East TN",2455501,330.075206648256,0.164181419360557,408.714962852795,59.7026838922077,380.0039177341,16.4181419360557
2020-11-27,105809,1704,98310,1567,7499,137,111225,1750,1045193,7540,1156418,9290,5,1322,161,9492,1538,94995,50,4947,1517,"East TN",2455501,353.614191156917,0.167773195876289,378.334197379679,69.3952069251855,386.560624491703,16.7773195876289
2020-11-28,107435,1626,99692,1382,7743,244,112719,1494,1052726,7533,1165445,9027,2,1324,569,10061,1055,96050,45,4992,1545,"East TN",2455501,370.229944927736,0.170564951421375,367.623552179372,66.2186657631172,409.733085020124,17.0564951421375
2020-11-29,109723,2288,101813,2121,7910,167,115045,2326,1063422,10696,1178467,13022,4,1328,1279,11340,1005,97055,51,5043,1570,"East TN",2455501,398.818815386351,0.177527135076674,530.319474518642,93.178540754005,461.820215100707,17.7527135076674
2020-11-30,111961,2238,103822,2009,8139,229,117266,2221,1072873,9451,1190139,11672,15,1343,-107,11233,2330,99385,53,5096,1601,"East TN",2455501,453.67523776207,0.179618325731151,475.340877482844,91.1422964193458,457.462652224536,17.9618325731151
2020-12-01,114224,2263,105830,2008,8394,255,119404,2138,1081710,8837,1201114,10975,20,1363,422,11655,1821,101206,63,5159,1629,"East TN",2455501,508.735284571255,0.181592523364486,446.955631457694,92.1604185866754,474.648554409059,18.1592523364486
2020-12-02,115281,1057,106743,913,8538,144,120280,876,1084620,2910,1204900,3786,15,1378,-688,10967,1730,102936,42,5201,1662,"East TN",2455501,514.844017575232,0.18397534214252,154.184421020395,43.0462052346955,446.629832364149,18.397534214252
2020-12-03,117090,1809,108313,1570,8777,239,122002,1722,1090610,5990,1212612,7712,33,1411,318,11285,1458,104394,45,5246,1683,"East TN",2455501,528.812653710994,0.191298637835196,314.070326177835,73.6713200279699,459.580346332581,19.1298637835196
2020-12-04,118818,1728,109700,1387,9118,341,123459,1457,1096132,5522,1219591,6979,37,1448,-302,10983,1993,106387,36,5282,1718,"East TN",2455501,529.790050991631,0.193658683298245,284.218984231731,70.3726042058219,447.28143055124,19.3658683298245
2020-12-05,119951,1133,110609,909,9342,224,124388,929,1099194,3062,1223582,3991,5,1453,123,11106,1005,107392,24,5306,1744,"East TN",2455501,509.712681851891,0.200715551198032,162.533022792497,46.1412966233775,452.290591614501,20.0715551198032
2020-12-06,121420,1469,111872,1263,9548,206,125630,1242,1103685,4491,1229315,5733,20,1473,484,11590,965,108357,40,5346,1780,"East TN",2455501,476.358999650173,0.208169446192574,233.475775412024,59.8248585522873,472.001436774003,20.8169446192574
2020-12-07,124143,2723,114277,2405,9866,318,128201,2571,1113231,9546,1241432,12117,31,1504,-211,11379,2903,111260,51,5397,1802,"East TN",2455501,496.110569696367,0.213186984578792,493.46345206131,110.89386646554,463.408485681741,21.3186984578792
2020-12-08,126908,2765,116640,2363,10268,402,130732,2531,1121592,8361,1252324,10892,45,1549,719,12098,2001,113261,71,5468,1826,"East TN",2455501,516.554462816346,0.221206795547745,443.57546586216,112.604311706654,492.68967921414,22.1206795547745
2020-12-09,129554,2646,119025,2385,10529,261,133310,2578,1128690,7098,1262000,9676,21,1570,578,12676,2047,115308,56,5524,1849,"East TN",2455501,581.266307771815,0.228196147110333,394.054003643248,107.758050190165,516.2286637228,22.8196147110333
2020-12-10,132629,3075,121707,2682,10922,393,136260,2950,1140160,11470,1276420,14420,30,1600,2512,15188,533,115841,74,5598,1886,"East TN",2455501,632.824014325386,0.223451604814443,587.252866115713,125.229026581541,618.529579096079,22.3451604814443
2020-12-11,134615,1986,123457,1750,11158,236,138050,1790,1147333,7173,1285383,8963,35,1635,441,15629,1510,117351,50,5648,1911,"East TN",2455501,643.331035092228,0.22177468385214,365.017159431008,80.8796249726634,636.489254127773,22.177468385214
2020-12-12,137876,3261,126184,2727,11692,534,141024,2974,1158565,11232,1299589,14206,21,1656,1878,17507,1362,118713,73,5721,1936,"East TN",2455501,729.993593975323,0.218874577341561,578.537740363372,132.803855506473,712.970591337572,21.8874577341561
2020-12-13,142168,4292,130045,3861,12123,431,145390,4366,1175849,17284,1321239,21650,15,1671,2959,20466,1318,120031,62,5783,1970,"East TN",2455501,844.959949110182,0.214960184500239,881.693796907433,174.791213687146,833.475531062704,21.4960184500239
2020-12-14,145027,2859,132502,2457,12525,402,148063,2673,1185128,9279,1333191,11952,37,1708,-1085,19381,3907,123938,72,5855,2004,"East TN",2455501,850.498533700455,0.216458331062893,486.743845756935,116.432451055813,789.289029000599,21.6458331062893
2020-12-15,149154,4127,136043,3541,13111,586,151926,3863,1200149,15021,1352075,18884,34,1742,1613,20994,2480,126418,94,5949,2035,"East TN",2455501,905.965829376571,0.212469047929344,769.048760314087,168.07160738277,854.978271236705,21.2469047929344
2020-12-16,152372,3218,138300,2257,14072,961,154312,2386,1208044,7895,1362356,10281,19,1761,664,21658,2535,128953,60,6009,2077,"East TN",2455501,929.260464565072,0.2092749810674,418.692560092625,131.052685378666,882.019596000979,20.92749810674
2020-12-17,156440,4068,141673,3373,14767,695,157921,3609,1218744,10700,1376665,14309,58,1819,1450,23108,2560,131513,75,6084,2116,"East TN",2455501,969.700277051404,0.216080602523817,582.73240369277,165.668839067872,941.070681706096,21.6080602523817
2020-12-18,159647,3207,144409,2736,15238,471,160800,2879,1227434,8690,1388234,11569,43,1862,850,23958,2314,133827,62,6146,2146,"East TN",2455501,1019.42536370378,0.221193765738787,471.146214153446,130.604711625041,975.686835395302,22.1193765738787
2020-12-19,162287,2640,146651,2242,15636,398,163268,2468,1235799,8365,1399067,10833,27,1889,1270,25228,1343,135170,41,6187,2183,"East TN",2455501,994.135209067315,0.223607229739239,441.172697547262,107.513700870006,1027.40744149565,22.3607229739239
2020-12-20,165918,3631,149617,2966,16301,665,166586,3318,1249742,13943,1416328,17261,16,1905,2279,27507,1336,136506,55,6242,2217,"East TN",2455501,967.21605896312,0.222906960847206,702.952269211049,147.872063582951,1120.21945826941,22.2906960847206
2020-12-21,168232,2314,151359,1742,16873,572,168489,1903,1256658,6916,1425147,8819,14,1919,-1322,26185,3622,140128,35,6277,2252,"East TN",2455501,945.020995715335,0.222127974248554,359.15277574719,94.2373878080278,1066.38115806102,22.2127974248554
2020-12-22,170887,2655,153061,1702,17826,953,170290,1801,1261711,5053,1432001,6854,62,1981,-292,25893,2885,143013,60,6337,2297,"East TN",2455501,885.073962502968,0.229762530340565,279.128373395083,108.124574170404,1054.48949114661,22.9762530340565
2020-12-23,173105,2218,154507,1446,18598,772,171832,1542,1267488,5777,1439320,7319,41,2022,-557,25336,2734,145747,35,6372,2337,"East TN",2455501,844.349075809784,0.227638896107271,298.065445707414,90.3277986854821,1031.80572925851,22.7638896107271
2020-12-24,175196,2091,155964,1457,19232,634,173429,1597,1273778,6290,1447207,7887,15,2037,-578,24758,2654,148401,30,6402,2375,"East TN",2455501,763.835974817359,0.219840662300473,321.197181349142,85.1557380754477,1008.26674474985,21.9840662300473
2020-12-25,177562,2366,157943,1979,19619,387,175595,2166,1282326,8548,1457921,10714,3,2040,-297,24461,2660,151061,27,6429,2411,"East TN",2455501,729.586345108391,0.212306456010447,436.326436030773,96.3550819160733,996.171453401974,21.2306456010447
2020-12-26,179502,1940,159411,1468,20091,472,177208,1613,1287980,5654,1465188,7267,2,2042,417,24878,1521,152582,43,6472,2449,"East TN",2455501,701.078924423163,0.210825607598191,295.947751599368,79.006280184777,1013.15373115303,21.0825607598191
2020-12-27,180797,1295,160320,909,20477,386,178198,990,1290773,2793,1468971,3783,27,2069,-191,24687,1459,154041,41,6513,2480,"East TN",2455501,605.945589107885,0.220580134110898,154.062246360315,52.7387282676733,1005.37527779463,22.0580134110898
2020-12-28,182193,1396,161298,978,20895,418,179218,1020,1292592,1819,1471810,2839,25,2094,-2414,22273,3785,157826,42,6555,2517,"East TN",2455501,568.560143123542,0.229925208409232,115.617953321949,56.8519418236849,907.065401317287,22.9925208409232
2020-12-29,185099,2906,163025,1727,22074,1179,180997,1779,1296681,4089,1477678,5868,50,2144,-109,22164,2965,160791,64,6619,2559,"East TN",2455501,578.782089683531,0.2344068130569,238.973635115604,118.346520730393,902.62638866773,23.44068130569
2020-12-30,187427,2328,164641,1616,22786,712,182678,1681,1301161,4480,1483839,6161,40,2184,-532,21632,2820,163611,44,6663,2597,"East TN",2455501,583.261827219781,0.243626316853478,250.906026916707,94.8075362217323,880.960748946956,24.3626316853478
2020-12-31,190871,3444,167320,2679,23551,765,185573,2895,1308282,7121,1493855,10016,52,2236,595,22227,2797,166408,30,6693,2640,"East TN",2455501,638.362598915659,0.260332704510376,407.900465118931,140.256509771326,905.192056529401,26.0332704510376
2021-01-01,193111,2240,169036,1716,24075,524,187429,1856,1314484,6202,1501913,8058,24,2260,-443,21784,2659,169067,30,6723,2679,"East TN",2455501,633.231263192318,0.269003455173668,328.161136973677,91.2237461927322,887.15093172432,26.9003455173668
2021-01-02,195834,2723,171145,2109,24689,614,189680,2251,1321045,6561,1510725,8812,4,2264,1166,22950,1553,170620,63,6786,2715,"East TN",2455501,665.118849473081,0.273887168676022,358.867701540337,110.89386646554,934.636149608573,27.3887168676022
2021-01-03,197148,1314,172049,904,25099,410,190617,937,1324416,3371,1515033,4308,15,2279,-187,22763,1486,172106,26,6812,2759,"East TN",2455501,665.892622320252,0.269614866918501,175.442811874237,53.5125011148438,927.020595796947,26.9614866918501
2021-01-04,198704,1556,173174,1125,25530,431,191797,1180,1326781,2365,1518578,3545,46,2325,-1566,21197,3076,175182,34,6846,2809,"East TN",2455501,672.408604191161,0.268965959630517,144.369723327337,63.3679236945943,863.245423235421,26.8965959630517
2021-01-05,201607,2903,174913,1739,26694,1164,193626,1829,1332053,5272,1525679,7101,43,2368,-427,20770,3287,178469,60,6906,2853,"East TN",2455501,672.286429531081,0.263098685444053,289.1874204083,118.224346070313,845.855896617432,26.3098685444053
2021-01-06,204152,2545,176706,1793,27446,752,195529,1903,1337637,5584,1533166,7487,52,2420,61,20831,2432,180901,62,6968,2896,"East TN",2455501,681.123729943502,0.260526689237132,304.907226671869,103.644836634153,848.340114705716,26.0526689237132
2021-01-07,206664,2512,178845,2139,27819,373,197851,2322,1344746,7109,1542597,9431,33,2453,975,21806,1504,182405,44,7012,2928,"East TN",2455501,643.168135545455,0.251897747322638,384.076406403418,102.300915373278,888.04687923157,25.1897747322638
2021-01-08,209014,2350,180705,1860,28309,490,199842,1991,1352091,7345,1551933,9336,50,2503,1668,23474,632,183037,47,7059,2983,"East TN",2455501,647.647873081705,0.248160735705718,380.207542167566,95.7034837289824,955.975990235801,24.8160735705718
2021-01-09,211590,2576,182707,2002,28883,574,202021,2179,1360282,8191,1562303,10370,27,2530,754,24228,1795,184832,33,7092,3011,"East TN",2455501,641.661314737807,0.239268680445151,422.317075008318,104.907308121642,986.682554802462,23.9268680445151
2021-01-10,213257,1667,183840,1133,29417,534,203272,1251,1366088,5806,1569360,7057,36,2566,-12,24216,1643,186475,41,7133,3051,"East TN",2455501,656.037199740501,0.232941263092017,287.395525393799,67.8883861175377,986.193856162144,23.2941263092017
2021-01-11,214681,1424,184853,1013,29828,411,204369,1097,1369361,3273,1573730,4370,28,2594,-2168,22048,3564,190039,40,7173,3091,"East TN",2455501,650.661514697001,0.227951842181607,177.967754849214,57.992238651094,897.902301811321,22.7951842181607
2021-01-12,216500,1819,185990,1137,30510,682,205564,1195,1373565,4204,1579129,5399,60,2654,-2136,19912,3895,193934,39,7212,3130,"East TN",2455501,606.515737521589,0.223348924228251,219.8736632565,74.0785688949017,810.91394383468,22.3348924228251
2021-01-13,218029,1529,187068,1078,30961,451,206700,1136,1378303,4738,1585003,5874,49,2703,-1334,18578,2814,196748,33,7245,3157,"East TN",2455501,565.139252641314,0.215502440341841,239.217984435763,62.2683517538783,756.586944985972,21.5502440341841
2021-01-14,220280,2251,188849,1781,31431,470,208666,1966,1386828,8525,1595494,10491,38,2741,-199,18379,2412,199160,50,7295,3199,"East TN",2455501,554.510057214393,0.204453938786699,427.244786298193,91.6717199463572,748.482692534029,20.4453938786699
2021-01-15,221245,965,189521,672,31724,293,209360,694,1389886,3058,1599246,3752,23,2764,-381,17998,1323,200483,30,7325,3240,"East TN",2455501,498.106089144333,0.201170925538436,152.799774872826,39.2995156589226,732.966510703926,20.1170925538436
2021-01-16,223678,2433,191272,1751,32406,682,211363,2003,1400777,10891,1612140,12894,13,2777,353,18351,2067,202550,54,7379,3283,"East TN",2455501,492.282430347208,0.18745109055521,525.106689021914,99.0836493245167,747.34239570662,18.745109055521
2021-01-17,224534,856,191878,606,32656,250,212035,672,1404396,3619,1616431,4291,13,2790,-849,17502,1692,204242,24,7403,3317,"East TN",2455501,459.254547239036,0.186165579656264,174.750488800453,34.8605030093655,712.766966904106,18.6165579656264
2021-01-18,225096,562,192197,319,32899,243,212389,354,1406480,2084,1618869,2438,13,2803,-2468,15034,3017,207259,21,7424,3348,"East TN",2455501,424.149694909511,0.177673408803917,99.2872737579826,22.8873863215694,612.257946545328,17.7673408803917
2021-01-19,226774,1678,193167,970,33607,708,213454,1065,1410688,4208,1624142,5273,21,2824,-1171,13863,2828,210087,52,7476,3387,"East TN",2455501,418.407485885772,0.175282696110013,214.742327533159,68.3363598711627,564.56910422761,17.5282696110013
2021-01-20,227758,984,193825,658,33933,326,214150,696,1414684,3996,1628834,4692,32,2856,-1012,12851,1964,212051,29,7505,3427,"East TN",2455501,396.212422637987,0.169971025073578,191.081168364419,40.073288506093,523.355518894107,16.9971025073578
2021-01-21,229324,1566,194967,1142,34357,424,215431,1281,1421617,6933,1637048,8214,65,2921,-763,12088,2264,214315,37,7542,3473,"East TN",2455501,368.315875253156,0.162800211772633,334.514219297813,63.7751725615261,492.282430347208,16.2800211772633
2021-01-22,230312,988,195674,707,34638,281,216248,817,1427061,5444,1643309,6261,32,2953,-730,11358,1686,216001,31,7573,3505,"East TN",2455501,369.252547647099,0.156321630392847,254.978515586025,40.2361880528658,462.553263061184,15.6321630392847
2021-01-23,231743,1431,196642,968,35101,463,217348,1100,1435343,8282,1652691,9382,19,2972,203,11561,1209,217210,41,7614,3530,"East TN",2455501,328.446211180529,0.147591921284309,382.080886955452,58.2773128579463,470.8204150599,14.7591921284309
2021-01-24,232368,625,197133,491,35235,134,217891,543,1438719,3376,1656610,3919,19,2991,-601,10960,1207,218417,20,7634,3557,"East TN",2455501,319.038762354403,0.145747778690361,159.600830950588,25.45305418324,446.344758157297,14.5747778690361
2021-01-25,233108,740,197644,511,35464,229,218440,549,1440476,1757,1658916,2306,44,3035,-1147,9813,1843,220260,20,7654,3588,"East TN",2455501,326.28779218579,0.151097460483931,93.9115887144823,30.1364161529562,399.633313120215,15.1097460483931
2021-01-26,234139,1031,198372,728,35767,303,219224,784,1444942,4466,1664166,5250,63,3098,-917,8896,1885,222145,25,7679,3611,"East TN",2455501,299.9387904953,0.144163501898861,213.805655139216,41.9873581806727,362.288592022565,14.4163501898861
2021-01-27,235092,953,199076,704,36016,249,219979,755,1449464,4522,1669443,5277,55,3153,-390,8506,1288,223433,27,7706,3634,"East TN",2455501,298.676319007811,0.143539609446182,214.905227079932,38.8108170186043,346.405886212223,14.3539609446182
2021-01-28,236420,1328,199790,714,36630,614,220775,796,1453895,4431,1674670,5227,46,3199,-178,8328,1460,224893,28,7734,3661,"East TN",2455501,288.983795974834,0.14204454840253,212.868982745273,54.0826495285484,339.156856380836,14.204454840253
2021-01-29,237014,594,200141,351,36873,243,221172,397,1456562,2667,1677734,3064,17,3216,-683,7645,1260,226153,17,7751,3682,"East TN",2455501,272.938190617719,0.143035584604212,124.781052827916,24.1905826957513,311.341758769392,14.3035584604212
2021-01-30,238168,1154,201107,966,37061,188,222269,1097,1465612,9050,1687881,10147,44,3260,237,7882,873,227026,29,7780,3702,"East TN",2455501,261.657397003707,0.139840863881785,413.235425275738,46.9965192439343,320.993556915676,13.9840863881785
2021-01-31,238849,681,201549,442,37300,239,222760,491,1469537,3925,1692297,4416,29,3289,-82,7800,734,227760,30,7810,3721,"East TN",2455501,263.937990658526,0.136436237285286,179.841099637101,27.7336478380583,317.654116206835,13.6436237285286
2021-02-01,239542,693,201956,407,37586,286,223201,441,1471233,1696,1694434,2137,39,3328,-542,7258,1196,228956,10,7820,3748,"East TN",2455501,262.023920983946,0.134044709724647,87.0290828633342,28.2223464783765,295.581227619129,13.4044709724647
2021-02-02,240080,538,202305,349,37775,189,223564,363,1472292,1059,1695856,1422,57,3385,-840,6418,1321,230277,12,7832,3764,"East TN",2455501,241.946551844206,0.136951719785421,57.9107888777077,21.909989040933,261.372322796855,13.6951719785421
2021-02-03,241191,1111,203063,758,38128,353,224391,827,1478297,6005,1702688,6832,46,3431,35,6453,1030,231307,39,7871,3777,"East TN",2455501,248.381083941729,0.132711685967815,278.232425887833,45.2453491161274,262.797693831116,13.2711685967815
2021-02-04,242285,1094,203842,779,38443,315,225257,866,1486011,7714,1711268,8580,58,3489,-6,6447,1042,232349,36,7907,3796,"East TN",2455501,238.851460455524,0.122465708508662,349.419527827519,44.5530260423433,262.553344510957,12.2465708508662
2021-02-05,243102,817,204401,559,38701,258,225863,606,1489817,3806,1715680,4412,67,3556,-150,6297,900,233249,28,7935,3810,"East TN",2455501,247.933110188104,0.123623043272018,179.678200090328,33.2722324283313,256.44461150698,12.3623043272018
2021-02-06,244335,1233,205223,822,39112,411,226824,961,1498472,8655,1725296,9616,27,3583,500,6797,706,233955,22,7957,3840,"East TN",2455501,251.150376236866,0.121742616597621,391.610510441657,50.2137852926959,276.807054853572,12.1742616597621
2021-02-07,244852,517,205576,353,39276,164,227230,406,1501556,3084,1728786,3490,2,3585,-129,6668,644,234599,9,7966,3857,"East TN",2455501,244.471494819184,0.122502672038148,142.129854559212,21.0547664203761,271.553544470151,12.2502672038148
2021-02-08,245364,512,205875,299,39489,213,227550,320,1502919,1363,1730469,1683,32,3617,-627,6041,1107,235706,9,7975,3873,"East TN",2455501,237.100290327717,0.120688219786319,68.5399843046287,20.8511419869102,246.019040513525,12.0688219786319
2021-02-09,246392,1028,206507,632,39885,396,228218,668,1507152,4233,1735370,4901,16,3633,-60,5981,1072,236778,38,8013,3884,"East TN",2455501,257.055484807377,0.117781039631523,199.592669683295,41.8651835205931,243.575547311933,11.7781039631523
2021-02-10,247241,849,207090,583,40151,266,228855,637,1513139,5987,1741994,6624,39,3672,-29,5952,839,237617,30,8043,3897,"East TN",2455501,246.385564493763,0.11357044725996,269.761649455651,34.5754288025132,242.394525597831,11.357044725996
2021-02-11,248108,867,207673,583,40435,284,229506,651,1518713,5574,1748219,6225,37,3709,-99,5853,929,238546,31,8074,3915,"East TN",2455501,237.14101521441,0.11499012205353,253.51241966507,35.3084767629905,238.362761815206,11.499012205353
2021-02-12,248940,832,208266,593,40674,239,230155,649,1524224,5511,1754379,6160,34,3743,57,5910,741,239287,11,8085,3924,"East TN",2455501,237.751888514808,0.110907258585493,250.865302030013,33.8831057287291,240.684080356717,11.0907258585493
2021-02-13,249534,594,208639,373,40895,221,230589,434,1528651,4427,1759240,4861,12,3755,-25,5885,607,239894,17,8102,3936,"East TN",2455501,211.728685917864,0.11091798255951,197.963674215567,24.1905826957513,239.665958189388,11.091798255951
2021-02-14,250074,540,209053,414,41021,126,231041,452,1531619,2968,1762660,3420,15,3770,-52,5833,577,240471,15,8117,3949,"East TN",2455501,212.665358311807,0.112505166204168,139.279112490689,21.9914388143194,237.548264081342,11.2505166204168
2021-02-15,250452,378,209262,209,41190,169,231269,228,1532943,1324,1764212,1552,5,3775,-575,5258,948,241419,10,8127,3960,"East TN",2455501,207.20822349492,0.110215452093768,63.2050241478216,15.3940071700236,214.131454232761,11.0215452093768
2021-02-16,251218,766,209690,428,41528,338,231741,472,1536352,3409,1768093,3881,8,3783,-39,5219,797,242216,25,8152,3970,"East TN",2455501,196.538303181306,0.107661278000183,158.053285256247,31.1952632069789,212.543183651727,10.7661278000183
2021-02-17,251839,621,210109,419,41730,202,232192,451,1539606,3254,1771798,3705,11,3794,-90,5129,700,242916,11,8163,3987,"East TN",2455501,187.25302901526,0.11196483693464,150.885705198247,25.2901546364673,208.877943849341,11.196483693464
2021-02-18,252633,794,210660,551,41973,243,232798,606,1545326,5720,1778124,6326,42,3836,23,5152,729,243645,20,8183,4004,"East TN",2455501,184.280112286658,0.110081926099314,257.625633221082,32.3355600343881,209.814616243284,11.0081926099315
2021-02-19,253112,479,210964,304,42148,175,233143,345,1548034,2708,1781177,3053,5,3841,-222,4930,696,244341,11,8194,4013,"East TN",2455501,169.904227283964,0.111500858273005,124.333079074291,19.5072207260351,200.773691397397,11.1500858273005
2021-02-20,253734,622,211411,447,42323,175,233648,505,1553261,5227,1786909,5732,18,3859,74,5004,530,244871,18,8212,4023,"East TN",2455501,171.044524111373,0.110556940980881,233.435050525331,25.3308795231604,203.787333012693,11.0556940980881
2021-02-21,254082,348,211638,227,42444,121,233911,263,1555395,2134,1789306,2397,7,3866,-83,4921,424,245295,12,8224,4041,"East TN",2455501,163.225345866281,0.107708474067402,97.617553403562,14.172260569228,200.407167417158,10.7708474067402
2021-02-22,254440,358,211834,196,42606,162,234139,228,1556777,1382,1790916,1610,7,3873,-481,4440,832,246127,22,8246,4057,"East TN",2455501,162.410848132418,0.10747453565009,65.5670675760262,14.5795094361599,180.818496917737,10.747453565009
2021-02-23,255083,643,212183,349,42900,294,234507,368,1559724,2947,1794231,3315,26,3899,-143,4297,760,246887,27,8273,4064,"East TN",2455501,157.401687069156,0.105822939781162,135.002999387905,26.1861021437173,174.994838120612,10.5822939781162
2021-02-24,255824,741,212732,549,43092,192,235117,610,1565926,6202,1801043,6812,19,3918,56,4353,666,247553,23,8296,4071,"East TN",2455501,162.288673472338,0.100017096939648,277.417928153969,30.1771410396493,177.27543177543,10.0017096939648
2021-02-25,256459,635,213177,445,43282,190,235612,495,1570694,4768,1806306,5263,21,3939,-95,4258,709,248262,16,8312,4080,"East TN",2455501,155.813416488122,0.0998509687034277,214.335078666227,25.8603030501718,173.406567539577,9.98509687034277
2021-02-26,256921,462,213501,324,43420,138,235980,368,1573817,3123,1809797,3491,14,3953,-183,4075,631,248893,11,8323,4085,"East TN",2455501,155.121093414338,0.0991264849755416,142.170579445905,18.814897652251,165.953913274725,9.91264849755416
2021-02-27,257360,439,213726,225,43634,214,236254,274,1577912,4095,1814166,4369,7,3960,10,4085,422,249315,16,8339,4094,"East TN",2455501,147.668439149485,0.0956084675496203,177.927029962521,17.8782252583078,166.361162141657,9.56084675496203
2021-02-28,257726,366,214000,274,43726,92,236567,313,1580472,2560,1817039,2873,5,3965,-51,4034,412,249727,11,8350,4103,"East TN",2455501,148.401487109962,0.0957703818555511,117.002599469518,14.9053085297053,164.284192920304,9.57703818555511
2021-03-01,257970,244,214148,148,43822,96,236723,156,1581251,779,1817974,935,4,3969,-410,3624,650,250377,11,8361,4112,"East TN",2455501,143.75885002694,0.0954985586517851,38.077769058127,9.9368723531369,147.586989376099,9.54985586517851
2021-03-02,258590,620,214538,390,44052,230,237170,447,1584707,3456,1821877,3903,7,3976,5,3629,608,250985,24,8385,4122,"East TN",2455501,142.822177632996,0.0963249656369818,158.949232763497,25.2494297497741,147.790613809565,9.63249656369818
2021-03-03,259073,483,214841,303,44232,180,237525,355,1588881,4174,1826406,4529,7,3983,-146,3483,622,251607,17,8402,4125,"East TN",2455501,132.315156866155,0.0949414501439104,184.44301183343,19.6701202728079,141.84478035236,9.49414501439104
2021-03-04,259681,608,215255,414,44426,194,237997,472,1593703,4822,1831700,5294,18,4001,46,3529,544,252151,20,8422,4130,"East TN",2455501,131.215584925439,0.0939198235803733,215.597550153716,24.7607311094559,143.718125140246,9.39198235803733
2021-03-05,260152,471,215566,311,44586,160,238351,354,1597384,3681,1835735,4035,15,4016,-63,3466,519,252670,16,8438,4135,"East TN",2455501,131.582108905678,0.0914102860667746,164.324917806997,19.1814216324897,141.152457278576,9.14102860667746
2021-03-06,260615,463,215889,323,44726,140,238723,372,1601660,4276,1840383,4648,1,4017,50,3516,412,253082,10,8448,4141,"East TN",2455501,132.559506186314,0.0941755349582332,189.289273349919,18.8556225389442,143.188701613235,9.41755349582332
2021-03-07,260870,255,216053,164,44817,91,238907,184,1603390,1730,1842297,1914,1,4018,-110,3406,364,253446,4,8452,4145,"East TN",2455501,128.039043763371,0.0926439147992715,77.9474331307542,10.3848461067619,138.708964076985,9.26439147992715
2021-03-08,261326,456,216345,292,44981,164,239219,312,1604971,1581,1844190,1893,3,4021,-127,3279,580,254026,9,8461,4153,"East TN",2455501,136.672719742325,0.0952090326518157,77.0922105101973,18.5705483320919,133.53690346695,9.52090326518157
2021-03-09,261864,538,216626,281,45238,257,239537,318,1607547,2576,1847084,2894,6,4027,24,3303,508,254534,21,8482,4165,"East TN",2455501,133.333279033484,0.0939024874042925,117.857822090074,21.909989040933,134.514300747587,9.39024874042924
2021-03-10,262513,649,217088,462,45425,187,240044,507,1613019,5472,1853063,5979,7,4034,173,3476,469,255003,29,8511,4175,"East TN",2455501,140.093610224553,0.0944967550737142,243.494097538547,26.4304514638764,141.559706145508,9.44967550737142
2021-03-11,263046,533,217428,340,45618,193,240409,365,1616357,3338,1856766,3703,5,4039,88,3564,440,255443,9,8520,4183,"East TN",2455501,137.039243722564,0.0962259634564749,150.80425542486,21.7063646074671,145.143496174508,9.62259634564749
2021-03-12,263509,463,217796,368,45713,95,240825,416,1619704,3347,1860529,3763,5,4044,5,3569,453,255896,12,8532,4191,"East TN",2455501,136.713444629019,0.0997822053722675,153.247748626451,18.8556225389442,145.347120607974,9.97822053722675
2021-03-13,263956,447,218012,216,45944,231,241105,280,1623343,3639,1864448,3919,2,4046,42,3611,403,256299,20,8552,4197,"East TN",2455501,136.061846441928,0.0989819239559526,159.600830950588,18.2040243518532,147.057565849087,9.89819239559526
2021-03-14,264218,262,218188,176,46030,86,241316,211,1625185,1842,1866501,2053,0,4046,-52,3559,314,256613,10,8562,4203,"East TN",2455501,136.34692064878,0.0995290034705007,83.6081923811067,10.6699203136142,144.939871741042,9.95290034705007
2021-03-15,264574,356,218373,185,46201,171,241533,217,1626381,1196,1867914,1413,4,4050,-167,3392,519,257132,15,8577,4207,"East TN",2455501,132.274431979462,0.0975383577811499,57.544264897469,14.4980596627735,138.13881566328,9.75383577811499
2021-03-16,265273,699,218824,451,46449,248,242029,496,1629648,3267,1871677,3763,4,4054,190,3582,505,257637,36,8613,4208,"East TN",2455501,138.831138737064,0.10132964664742,153.247748626451,28.4666957985356,145.876544134985,10.132964664742
2021-03-17,265698,425,219156,332,46542,93,242393,364,1633372,3724,1875765,4088,1,4055,-31,3551,455,258092,16,8629,4217,"East TN",2455501,129.708764117791,0.103471059818518,166.483336801736,17.3080768446032,144.614072647496,10.3471059818518
2021-03-18,266248,550,219505,349,46743,201,242778,385,1636663,3291,1879441,3676,6,4061,99,3650,445,258537,31,8660,4224,"East TN",2455501,130.401087191575,0.104476295479603,149.704683484144,22.3986876812512,148.645836430122,10.4476295479603
2021-03-19,267040,792,220035,530,47005,262,243341,563,1641708,5045,1885049,5608,15,4076,337,3987,440,258977,25,8685,4230,"East TN",2455501,143.799574913633,0.102610114192496,228.385164575376,32.2541102610017,162.370123245725,10.2610114192496
2021-03-20,267313,273,220201,166,47112,107,243535,194,1643829,2121,1887364,2315,1,4077,-41,3946,313,259290,15,8700,4232,"East TN",2455501,136.713444629019,0.106039448420318,94.278112694721,11.1178940672392,160.700402891304,10.6039448420318
2021-03-21,267594,281,220397,196,47197,85,243760,225,1645628,1799,1889388,2024,-11,4066,-27,3919,319,259609,8,8708,4239,"East TN",2455501,137.487217476189,0.1067855114257,82.4271706670044,11.4436931607847,159.600830950588,10.67855114257
2021-03-22,268119,525,220736,339,47383,186,244116,356,1647717,2089,1891833,2445,14,4080,-15,3904,526,260135,19,8727,4246,"East TN",2455501,144.369723327337,0.107989464442493,99.5723479648349,21.3805655139216,158.98995765019,10.7989464442493
2021-03-23,268556,437,220984,248,47572,189,244381,265,1650172,2455,1894553,2720,11,4091,-78,3826,504,260639,17,8744,4252,"East TN",2455501,133.699803013723,0.10281517747858,110.77169180546,17.7967754849214,155.813416488122,10.281517747858
2021-03-24,269153,597,221441,457,47712,140,244874,493,1654871,4699,1899745,5192,4,4095,85,3911,508,261147,26,8770,4258,"East TN",2455501,140.704483524951,0.103461217681401,211.443611711011,24.3127573558308,159.275031857043,10.3461217681401
2021-03-25,269553,400,221748,307,47805,93,245207,333,1657839,2968,1903046,3301,8,4103,-66,3845,458,261605,23,8793,4262,"East TN",2455501,134.595750520973,0.102901927557721,134.4328509742,16.2899546772736,156.587189335292,10.2901927557721
2021-03-26,269963,410,222070,322,47893,88,245553,346,1660471,2632,1906024,2978,7,4110,-63,3782,466,262071,14,8807,4272,"East TN",2455501,119.038843804177,0.105458879618594,121.278712572302,16.6972035442054,154.021521473622,10.5458879618594
2021-03-27,270166,203,222250,180,47916,23,245763,210,1662983,2512,1908746,2722,2,4112,-164,3618,365,262436,12,8819,4283,"East TN",2455501,116.188101735654,0.104199794219437,110.853141578847,8.26715199871635,147.34264005594,10.4199794219437
2021-03-28,270482,316,222469,219,48013,97,246008,245,1665055,2072,1911063,2317,5,4117,-67,3551,378,262814,17,8836,4289,"East TN",2455501,117.613472769915,0.103713956170704,94.3595624681073,12.8690641950461,144.614072647496,10.3713956170704
2021-03-29,270921,439,222706,237,48215,202,246261,253,1666910,1855,1913171,2108,18,4135,-91,3460,512,263326,18,8854,4294,"East TN",2455501,114.111132514302,0.100524885181367,85.8480611492319,17.8782252583078,140.908107958417,10.0524885181367
2021-03-30,271296,375,222964,258,48332,117,246583,322,1669387,2477,1915970,2799,5,4140,-143,3317,513,263839,20,8874,4300,"East TN",2455501,111.586189539324,0.102815520381006,113.988957854222,15.271832509944,135.084449161291,10.2815520381006
2021-03-31,271957,661,223406,442,48551,219,247071,488,1674204,4817,1921275,5305,4,4144,168,3485,489,264328,18,8892,4305,"East TN",2455501,114.192582287688,0.102043660009289,216.045523907341,26.9191501041946,141.926230125746,10.2043660009289
2021-04-01,272405,448,223727,321,48678,127,247421,350,1677032,2828,1924453,3178,1,4145,-87,3398,534,264862,18,8910,4313,"East TN",2455501,116.147376848961,0.103424113607698,129.423689910939,18.2447492385464,138.383164983439,10.3424113607698
2021-04-02,272756,351,223962,235,48794,116,247673,252,1680052,3020,1927725,3272,0,4145,-78,3320,429,265291,12,8922,4318,"East TN",2455501,113.744608534063,0.0976913506290033,133.251829260098,14.2944352293076,135.206623821371,9.76913506290033
2021-04-03,273099,343,224213,251,48886,92,247947,274,1682403,2351,1930350,2625,0,4145,-54,3266,397,265688,13,8935,4327,"East TN",2455501,119.446092671109,0.101092390298093,106.902827569608,13.9686361357621,133.007479939939,10.1092390298093
2021-04-04,273270,171,224336,123,48934,48,248088,141,1683998,1595,1932086,1736,6,4151,-179,3087,344,266032,8,8943,4331,"East TN",2455501,113.540984100597,0.0989392570042335,70.6984032993674,6.96395562453446,125.717725221859,9.89392570042335
2021-04-05,273677,407,224571,235,49106,172,248311,223,1685217,1219,1933528,1442,6,4157,-93,2994,494,266526,40,8983,4337,"East TN",2455501,112.237787726415,0.100702461069902,58.7252866115713,16.5750288841259,121.930310759393,10.0702461069902
2021-04-06,274108,431,224821,250,49287,181,248589,278,1687303,2086,1935892,2364,3,4160,-6,2988,434,266960,27,9010,4342,"East TN",2455501,114.518381381233,0.10069270153599,96.273632142687,17.5524261647623,121.685961439234,10.069270153599
2021-04-07,274740,632,225284,463,49456,169,249096,507,1691996,4693,1941092,5200,5,4165,209,3197,418,267378,24,9034,4346,"East TN",2455501,113.337359667131,0.10218499268305,211.769410804557,25.7381283900923,130.197462758109,10.218499268305
2021-04-08,275146,406,225539,255,49607,151,249385,289,1695007,3011,1944392,3300,-1,4164,48,3245,359,267737,21,9055,4351,"East TN",2455501,111.626914426017,0.0985004263002157,134.392126087507,16.5343039974327,132.152257319382,9.85004263002157
2021-04-09,275664,518,225945,406,49719,112,249835,450,1698883,3876,1948718,4326,4,4168,109,3354,405,268142,31,9086,4354,"East TN",2455501,118.427970503779,0.102986709855666,176.175859834714,21.0954913070693,136.591269968939,10.2986709855666
2021-04-10,275968,304,226160,215,49808,89,250082,247,1701664,2781,1951746,3028,1,4169,-11,3343,314,268456,15,9101,4359,"East TN",2455501,116.839699922745,0.0997850065432791,123.314956906961,12.3803655547279,136.143296215314,9.97850065432791
2021-04-11,276205,237,226323,163,49882,74,250256,174,1703377,1713,1953633,1887,2,4171,-85,3258,320,268776,10,9111,4363,"East TN",2455501,119.527542444495,0.100617255302362,76.8478611900382,9.65179814628461,132.681680846393,10.0617255302362
2021-04-12,276670,465,226646,323,50024,142,250586,330,1705140,1763,1955726,2093,3,4174,13,3271,449,269225,15,9126,4372,"East TN",2455501,121.8895858727,0.102486710514461,85.2371878488341,18.9370723123306,133.211104373405,10.2486710514461
2021-04-13,277048,378,226886,240,50162,138,250836,250,1707197,2057,1958033,2307,3,4177,-56,3215,431,269656,16,9142,4376,"East TN",2455501,119.731166877961,0.10148593107809,93.9523136011755,15.3940071700236,130.930510718587,10.148593107809
2021-04-14,277728,680,227388,502,50340,178,251393,557,1712018,4821,1963411,5378,0,4177,269,3484,411,270067,29,9171,4379,"East TN",2455501,121.685961439234,0.102916797347551,219.018440635944,27.6929229513651,141.885505239053,10.2916797347551
2021-04-15,278268,540,227754,366,50514,174,251773,380,1715163,3145,1966936,3525,2,4179,115,3599,423,270490,24,9195,4384,"East TN",2455501,127.14309625612,0.105926188786373,143.555225593474,21.9914388143194,146.568867208769,10.5926188786373
2021-04-16,279246,978,228649,895,50597,83,252878,1105,1722648,7485,1975526,8590,3,4182,634,4233,341,270831,32,9227,4387,"East TN",2455501,145.876544134985,0.113510892270964,349.826776694451,39.8289391859339,172.388445372248,11.3510892270964
2021-04-17,279448,202,228796,147,50652,55,253051,173,1724879,2231,1977930,2404,0,4182,-91,4142,293,271124,10,9237,4388,"East TN",2455501,141.72260569228,0.113389856400855,97.9026276104143,8.22642711202317,168.682480683168,11.3389856400855
2021-04-18,279666,218,228983,187,50683,31,253253,202,1726682,1803,1979935,2005,6,4188,-122,4020,334,271458,8,9245,4397,"East TN",2455501,140.94883284511,0.113945707550757,81.6533978198339,8.87802529911411,163.7140445066,11.3945707550757
2021-04-19,279994,328,229178,195,50816,133,253463,210,1728131,1449,1981594,1659,8,4196,-212,3808,532,271990,15,9260,4404,"East TN",2455501,135.369523368144,0.111218493892067,67.5625870239923,13.3577628353644,155.080368527645,11.1218493892067
2021-04-20,280347,353,229455,277,50892,76,253744,281,1730579,2448,1984323,2729,4,4200,-113,3695,462,272452,20,9280,4408,"East TN",2455501,134.351401200814,0.110612400152149,111.138215785699,14.375885002694,150.478456331315,11.0612400152149
2021-04-21,280860,513,229785,330,51075,183,254083,339,1734361,3782,1988444,4121,4,4204,30,3725,479,272931,14,9294,4414,"East TN",2455501,127.550345123052,0.10745815523509,167.827258062611,20.8918668736034,151.70020293211,10.745815523509
2021-04-22,281502,642,230183,398,51319,244,254534,451,1738613,4252,1993147,4703,3,4207,193,3918,446,273377,23,9317,4418,"East TN",2455501,131.704283565757,0.105337453740796,191.529142118044,26.1453772570241,159.560106063895,10.5337453740796
2021-04-23,281886,384,230461,278,51425,106,254842,308,1741816,3203,1996658,3511,0,4207,-9,3909,393,273770,11,9328,4423,"East TN",2455501,107.513700870006,0.0929396176414916,142.985077179769,15.6383564901827,159.193582083656,9.29396176414916
2021-04-24,282146,260,230649,188,51497,72,255051,209,1744814,2998,1999865,3207,0,4207,-132,3777,392,274162,20,9348,4430,"East TN",2455501,109.87574429821,0.0911784818782767,130.604711625041,10.5884705402278,153.817897040156,9.11784818782767
2021-04-25,282346,200,230797,148,51549,52,255210,159,1746465,1651,2001675,1810,4,4211,-113,3664,309,274471,17,9365,4435,"East TN",2455501,109.142696337733,0.0900183992640294,73.712044914663,8.1449773386368,149.215984843826,9.00183992640294
2021-04-26,282732,386,231041,244,51691,142,255462,252,1748437,1972,2003899,2224,6,4217,-143,3521,523,274994,16,9381,4443,"East TN",2455501,111.504739765938,0.0896211611746245,90.5721480056412,15.719806263569,143.392326046701,8.96211611746245
2021-04-27,283122,390,231245,204,51877,186,255680,218,1750801,2364,2006481,2582,3,4220,-48,3473,435,275429,25,9406,4449,"East TN",2455501,113.011560573586,0.0873725065439119,105.151657441801,15.8827058103418,141.437531485428,8.73725065439119
2021-04-28,283610,488,231591,346,52019,142,256061,381,1754929,4128,2010990,4509,6,4226,11,3484,471,275900,24,9430,4457,"East TN",2455501,111.993438406256,0.0877317484254413,183.628514099567,19.8737447062738,141.885505239053,8.77317484254413
2021-04-29,284002,392,231870,279,52132,113,256365,304,1757861,2932,2014226,3236,1,4227,18,3502,373,276273,22,9452,4462,"East TN",2455501,101.81221673296,0.0868637032117273,131.785733339143,15.9641555837281,142.61855319953,8.68637032117273
2021-04-30,284371,369,232097,227,52274,142,256605,240,1761128,3267,2017733,3507,0,4227,-1,3501,370,276643,18,9470,4467,"East TN",2455501,101.201343432562,0.0836536180308422,142.822177632996,15.0274831897849,142.577828312837,8.36536180308422
2021-05-01,284606,235,232279,182,52327,53,256794,189,1763619,2491,2020413,2680,-1,4226,-28,3473,264,276907,15,9485,4468,"East TN",2455501,100.183221265233,0.0848257737979365,109.142696337733,9.57034837289824,141.437531485428,8.48257737979365
2021-05-02,284781,175,232407,128,52374,47,256927,133,1765095,1476,2022022,1609,1,4227,-76,3397,250,277157,11,9496,4472,"East TN",2455501,99.165099097903,0.0843859045559542,65.526342689333,7.1268551713072,138.342440096746,8.43859045559542
2021-05-03,284993,212,232521,114,52472,98,257053,126,1766579,1484,2023632,1610,5,4232,-224,3173,431,277588,17,9513,4476,"East TN",2455501,92.078968813289,0.0806263619317894,65.5670675760262,8.63367597895501,129.220065477473,8.06263619317894
2021-05-04,285314,321,232742,221,52572,100,257298,245,1768979,2400,2026277,2645,7,4239,-80,3093,394,277982,12,9525,4484,"East TN",2455501,89.2689516314593,0.0817336835724389,107.717325303472,13.0726886285121,125.962074542018,8.17336835724389
2021-05-05,285778,464,233035,293,52743,171,257609,311,1773129,4150,2030738,4461,5,4244,127,3220,332,278314,22,9547,4489,"East TN",2455501,88.2915543508229,0.0783876848288434,181.673719538294,18.8963474256374,131.134135152052,7.83876848288434
2021-05-06,286064,286,233232,197,52832,89,257840,231,1775567,2438,2033407,2669,4,4248,-100,3120,382,278696,10,9557,4495,"East TN",2455501,83.9747163613454,0.076899014649914,108.694722584108,11.6473175942506,127.061646482734,7.6899014649914
2021-05-07,286430,366,233481,249,52949,117,258109,269,1779016,3449,2037125,3718,0,4248,16,3136,350,279046,15,9572,4500,"East TN",2455501,83.8525417012658,0.0775577557755776,151.415128725258,14.9053085297053,127.713244669825,7.75577557755776
2021-05-08,286601,171,233584,103,53017,68,258223,114,1780911,1895,2039134,2009,0,4248,-94,3042,265,279311,7,9579,4507,"East TN",2455501,81.2461489529021,0.0763313925538166,81.8162973666066,6.96395562453446,123.885105320666,7.63313925538166
2021-05-09,286747,146,233699,115,53048,31,258355,132,1782622,1711,2040977,1843,4,4252,-161,2881,303,279614,11,9590,4512,"East TN",2455501,80.0651272387997,0.0753363228699552,75.0559661755381,5.94583345720486,117.328398563063,7.53363228699552
2021-05-10,286982,235,233835,136,53147,99,258500,145,1784138,1516,2042638,1661,7,4259,-200,2681,428,280042,22,9612,4515,"East TN",2455501,81.001799632743,0.0761338524676418,67.6440367973786,9.57034837289824,109.183421224426,7.61338524676418
2021-05-11,287297,315,234063,228,53234,87,258744,244,1786816,2678,2045560,2922,1,4260,-57,2624,371,280413,19,9631,4519,"East TN",2455501,80.7574503125839,0.0749883316911269,118.998118917484,12.828339308353,106.862102682915,7.49883316911269
2021-05-12,287601,304,234280,217,53321,87,258995,251,1790882,4066,2049877,4317,3,4263,-53,2571,354,280767,16,9647,4521,"East TN",2455501,74.2414684416744,0.0724175766758974,175.809335854475,12.3803655547279,104.703683688176,7.24175766758974
2021-05-13,287811,210,234416,136,53395,74,259140,145,1793615,2733,2052755,2878,1,4264,-131,2440,340,281107,9,9656,4526,"East TN",2455501,71.1463770529924,0.067190407277238,117.206223902984,8.55222620556864,99.368723531369,6.7190407277238
2021-05-14,288112,301,234635,219,53477,82,259388,248,1796300,2685,2055688,2933,1,4265,34,2474,266,281373,21,9677,4531,"East TN",2455501,68.4992594179355,0.0689005009966061,119.446092671109,12.2581908946484,100.753369678937,6.89005009966061
2021-05-15,288220,108,234716,81,53504,27,259490,102,1798288,1988,2057778,2090,0,4265,-154,2320,262,281635,6,9683,4535,"East TN",2455501,65.9335915562649,0.0679575198455267,85.1150131887546,4.39828776286387,94.4817371281869,6.79575198455267
2021-05-16,288320,100,234790,74,53530,26,259575,85,1799737,1449,2059312,1534,3,4268,-121,2199,218,281853,4,9687,4539,"East TN",2455501,64.0602467683784,0.0665394055085901,62.4719761873443,4.0724886693184,89.5540258383116,6.65394055085901
2021-05-17,288519,199,234894,104,53625,95,259685,110,1801304,1567,2060989,1677,6,4274,-117,2082,310,282163,10,9697,4546,"East TN",2455501,62.5941508474238,0.0645741376491744,68.2956349844696,8.10425245194362,84.7892140952091,6.45741376491744
2021-05-18,288732,213,235029,135,53703,78,259831,146,1803542,2238,2063373,2384,8,4282,-100,1982,305,282468,22,9719,4552,"East TN",2455501,58.440212404719,0.0610228484814461,97.0881298765507,8.67440086564819,80.7167254258907,6.10228484814461
2021-05-19,288949,217,235193,164,53756,53,259998,167,1806812,3270,2066810,3437,1,4283,-53,1929,269,282737,21,9740,4555,"East TN",2455501,54.897147262412,0.0592334494773519,139.971435564473,8.83730041242093,78.5583064311519,5.92334494773519
2021-05-20,289127,178,235326,133,53801,45,260154,156,1820980,14168,2081134,14324,3,4286,-91,1838,266,283003,7,9747,4560,"East TN",2455501,53.5939508882301,0.0357306459001374,583.343276993168,7.24902983138675,74.8523417420722,3.57306459001374
2021-05-21,289291,164,235434,108,53857,56,260275,121,1823258,2278,2083533,2399,0,4286,-58,1780,222,283225,10,9757,4563,"East TN",2455501,48.0146414112639,0.0318549111151015,97.6990031769484,6.67888141768218,72.4902983138675,3.18549111151015
2021-05-22,289362,71,235482,48,53880,23,260337,62,1824844,1586,2085181,1648,0,4286,-105,1675,176,283401,12,9769,4564,"East TN",2455501,46.5078206036161,0.0309090245593548,67.1146132703672,2.89146695521606,68.2141852110832,3.09090245593548
2021-05-23,289436,74,235533,51,53903,23,260398,61,1825909,1065,2086307,1126,3,4289,-128,1547,199,283600,5,9774,4566,"East TN",2455501,45.4489735495933,0.0304871272457863,45.8562224165252,3.01364161529562,63.0013997143556,3.04871272457863
2021-05-24,289596,160,235644,111,53952,49,260524,126,1827833,1924,2088357,2050,0,4289,-90,1457,250,283850,7,9781,4570,"East TN",2455501,43.8607029685592,0.0306562408652441,83.4860177210272,6.51598187090944,59.3361599119691,3.06562408652441
2021-05-25,289740,144,235740,96,54000,48,260612,88,1829560,1727,2090172,1815,0,4289,-72,1385,216,284066,9,9790,4576,"East TN",2455501,41.0506857867295,0.0291428784656144,73.915669348129,5.8643836838185,56.4039680700598,2.91428784656144
2021-05-26,289924,184,235880,140,54044,44,260777,165,1832443,2883,2093220,3048,7,4296,-32,1353,209,284275,14,9804,4581,"East TN",2455501,39.7067645258544,0.0294964028776978,124.129454640825,7.49337915154586,55.100771695878,2.94964028776978
2021-05-27,290048,124,235956,76,54092,48,260916,139,1835415,2972,2096331,3111,4,4300,-81,1272,201,284476,11,9815,4585,"East TN",2455501,37.5076206444225,0.0501414752911759,126.695122502495,5.04988594995482,51.80205587373,5.01414752911759
2021-05-28,290165,117,236046,90,54119,27,261014,98,1837527,2112,2098541,2210,0,4300,-59,1213,176,284652,9,9824,4588,"East TN",2455501,35.5935509698428,0.0492404051172708,90.0019995919366,4.76481174310253,49.3992875588322,4.92404051172708
2021-05-29,290216,51,236078,32,54138,19,261051,37,1838603,1076,2099654,1113,0,4300,-88,1125,139,284791,7,9831,4591,"East TN",2455501,34.7790532359791,0.0493332412077662,45.3267988895138,2.07696922135238,45.815497529832,4.93332412077662
2021-05-30,290271,55,236118,40,54153,15,261097,46,1839690,1087,2100787,1133,0,4300,-66,1059,121,284912,7,9838,4596,"East TN",2455501,34.0052803888086,0.0482734806629834,46.1412966233775,2.23986876812512,43.1276550080819,4.82734806629834
2021-05-31,290351,80,236184,66,54167,14,261168,71,1841117,1427,2102285,1498,6,4306,-95,964,169,285081,4,9842,4601,"East TN",2455501,30.7472894533539,0.0462377943710511,61.0058802663896,3.25799093545472,39.2587907722294,4.62377943710511
2021-06-01,290481,130,236277,93,54204,37,261262,94,1842433,1316,2103695,1410,3,4309,-37,927,164,285245,11,9853,4604,"East TN",2455501,30.1771410396493,0.048066257487244,57.4220902373894,5.29423527011392,37.7519699645816,4.8066257487244
2021-06-02,290600,119,236348,71,54252,48,261335,73,1844412,1979,2105747,2052,1,4310,-19,908,137,285382,9,9862,4608,"East TN",2455501,27.5300234045924,0.0445437854234853,83.5674674944136,4.8462615164889,36.9781971174111,4.45437854234853
2021-06-03,290688,88,236404,56,54284,32,261454,119,1847579,3167,2109033,3286,1,4311,-43,865,130,285512,7,9869,4613,"East TN",2455501,26.0639274836378,0.0423555345614864,133.821977673803,3.58379002900019,35.2270269896042,4.23555345614864
2021-06-04,290779,91,236463,59,54316,32,261532,78,1849731,2152,2111263,2230,1,4312,-32,833,122,285634,7,9876,4613,"East TN",2455501,25.005080429615,0.0407168684169156,90.8164973258003,3.70596468907974,33.9238306154223,4.07168684169156
2021-06-05,290820,41,236489,26,54331,15,261562,30,1851114,1383,2112676,1413,-1,4311,-67,766,109,285743,2,9878,4618,"East TN",2455501,24.5978315626831,0.0392412839809553,57.544264897469,1.66972035442054,31.1952632069789,3.92412839809553
2021-06-06,290846,26,236505,16,54341,10,261581,19,1852030,916,2113611,935,-1,4310,-56,710,83,285826,2,9880,4621,"East TN",2455501,23.4168098485808,0.0377417342482845,38.077769058127,1.05884705402278,28.9146695521606,3.77417342482845
2021-06-07,290919,73,236540,35,54379,38,261633,52,1853300,1270,2114933,1322,3,4313,-68,642,138,285964,10,9890,4623,"East TN",2455501,23.1317356417285,0.0367647058823529,53.8383002083892,2.97291672860243,26.1453772570241,3.67647058823529
2021-06-08,291006,87,236607,67,54399,20,261703,70,1854779,1479,2116482,1549,3,4316,-29,613,113,286077,4,9894,4626,"East TN",2455501,21.3805655139216,0.0344881520294049,63.082849487742,3.54306514230701,24.9643555429218,3.44881520294049
2021-06-09,291054,48,236645,38,54409,10,261757,54,1857509,2730,2119266,2784,0,4316,-63,550,111,286188,3,9897,4629,"East TN",2455501,18.4890985587055,0.0312153265774096,113.378084553824,1.95479456127283,22.3986876812512,3.12153265774096
2021-06-10,291129,75,236702,57,54427,18,261823,66,1859294,1785,2121117,1851,4,4320,-21,529,92,286280,4,9901,4632,"East TN",2455501,17.9596750316941,0.0305362462760675,75.3817652690836,3.0543665019888,21.5434650606943,3.05362462760675
2021-06-11,291199,70,236748,46,54451,24,261879,56,1860779,1485,2122658,1541,2,4322,-4,525,72,286352,4,9905,4633,"East TN",2455501,17.1044524111373,0.0304519526107942,62.7570503941965,2.85074206852288,21.3805655139216,3.04519526107942
2021-06-12,291228,29,236770,22,54458,7,261910,31,1861973,1194,2123883,1225,3,4325,-24,501,50,286402,1,9906,4636,"East TN",2455501,16.6157537708191,0.0310520210582672,49.8879861991504,1.18102171410234,20.4031682332852,3.10520210582672
2021-06-13,291246,18,236784,14,54462,4,261931,21,1862816,843,2124747,864,1,4326,-41,460,58,286460,1,9907,4637,"East TN",2455501,16.2899546772736,0.0314295977011494,35.186302102911,0.733047960477312,18.7334478788646,3.14295977011494
2021-06-14,291299,53,236817,33,54482,20,261972,41,1864069,1253,2126041,1294,3,4329,-9,451,59,286519,3,9910,4639,"East TN",2455501,15.4754569434099,0.0305185451926539,52.6980033809801,2.15841899473875,18.366923898626,3.05185451926539
2021-06-15,291387,88,236886,69,54501,19,262060,88,1865951,1882,2128011,1970,0,4329,-7,444,95,286614,4,9914,4643,"East TN",2455501,15.5161818301031,0.0309653916211293,80.2280267855725,3.58379002900019,18.0818496917737,3.09653916211293
2021-06-16,291454,67,236926,40,54528,27,262098,38,1867857,1906,2129955,1944,2,4331,-14,430,79,286693,7,9921,4646,"East TN",2455501,16.2899546772736,0.0319019552811301,79.1691797315497,2.72856740844333,17.5117012780691,3.19019552811301
2021-06-17,291505,51,236964,38,54541,13,262144,46,1870207,2350,2132351,2396,1,4332,-7,423,57,286750,1,9922,4650,"East TN",2455501,15.3125573966372,0.0285739718711056,97.5768285168689,2.07696922135238,17.2266270712168,2.85739718711056
2021-06-18,291567,62,237015,51,54552,11,262199,55,1871935,1728,2134134,1783,2,4334,-1,422,61,286811,4,9926,4652,"East TN",2455501,14.9867583030917,0.0278842802370164,72.6124729739471,2.52494297497741,17.1859021845236,2.78842802370164
2021-06-19,291595,28,237032,17,54563,11,262217,18,1873086,1151,2135303,1169,0,4334,-16,406,44,286855,5,9931,4654,"East TN",2455501,14.9460334163985,0.0268826619964974,47.6073925443321,1.14029682740915,16.5343039974327,2.68826619964974
2021-06-20,291620,25,237053,21,54567,4,262234,17,1873840,754,2136074,771,3,4337,-13,393,35,286890,2,9933,4657,"East TN",2455501,15.2311076232508,0.0267502427827315,31.3988876404449,1.0181221673296,16.0048804704213,2.67502427827315
2021-06-21,291687,67,237093,40,54594,27,262286,52,1875111,1271,2137397,1323,6,4343,3,396,58,286948,2,9935,4659,"East TN",2455501,15.8012560369554,0.0276505811905601,53.8790250950824,2.72856740844333,16.1270551305009,2.76505811905601
2021-06-22,291780,93,237139,46,54641,47,262337,51,1876538,1427,2138875,1478,5,4348,36,432,52,287000,7,9942,4663,"East TN",2455501,16.0048804704213,0.0254970544918999,60.1913825325259,3.78741446246611,17.5931510514555,2.54970544918999
2021-06-23,291849,69,237187,48,54662,21,262392,55,1878327,1789,2140719,1844,2,4350,6,438,61,287061,5,9947,4667,"East TN",2455501,16.0863302438077,0.0273132664437012,75.0966910622313,2.8100171818297,17.8375003716146,2.73132664437012
2021-06-24,291932,83,237239,52,54693,31,262454,62,1880171,1844,2142625,1906,3,4353,27,465,53,287114,6,9953,4668,"East TN",2455501,17.3895266179896,0.0301732528713257,77.6216340372087,3.38016559553427,18.9370723123306,3.01732528713257
2021-06-25,292011,79,237295,56,54716,23,262523,69,1881977,1806,2144500,1875,0,4353,32,497,47,287161,3,9956,4670,"East TN",2455501,18.0818496917737,0.0312560293266448,76.35916254972,3.21726604876154,20.2402686865124,3.12560293266448
2021-06-26,292046,35,237313,18,54733,17,262544,21,1883161,1184,2145705,1205,0,4353,1,498,34,287195,2,9958,4672,"East TN",2455501,18.366923898626,0.0314362622572582,49.0734884652867,1.42537103426144,20.2809935732056,3.14362622572582
2021-06-27,292075,29,237333,20,54742,9,262568,24,1883875,714,2146443,738,2,4355,-9,489,36,287231,3,9961,4674,"East TN",2455501,18.5298234453987,0.0322113993634873,30.0549663795698,1.18102171410234,19.914469592967,3.22113993634873
2021-06-28,292119,44,237357,24,54762,20,262593,25,1884427,552,2147020,577,4,4359,-15,474,55,287286,3,9964,4674,"East TN",2455501,17.5931510514555,0.0319027330354359,23.4982596219672,1.7918950145001,19.3035962925692,3.19027330354359
2021-06-29,292250,131,237443,86,54807,45,262690,97,1886441,2014,2149131,2111,0,4359,79,553,52,287338,7,9971,4677,"East TN",2455501,19.1406967457965,0.0344188767550702,85.9702358093114,5.3349601568071,22.5208623413308,3.44188767550702
2021-06-30,292335,85,237506,63,54829,22,262765,75,1888085,1644,2150850,1719,3,4362,29,582,53,287391,4,9975,4677,"East TN",2455501,19.7922949328874,0.0368176882834863,70.0060802255833,3.46161536892064,23.7018840554331,3.68176882834863
2021-07-01,292441,106,237559,53,54882,53,262830,65,1890637,2552,2153467,2617,1,4363,56,638,49,287440,2,9977,4680,"East TN",2455501,20.7289673268307,0.0346799483490131,106.577028476063,4.3168379894775,25.9824777102514,3.46799483490131
2021-07-02,292523,82,237622,63,54901,19,262904,74,1892319,1682,2155223,1756,0,4363,32,670,50,287490,3,9980,4682,"East TN",2455501,20.8511419869102,0.035531101370885,71.5129010332311,3.33944070884109,27.2856740844333,3.5531101370885
2021-07-03,292571,48,237658,36,54913,12,262944,40,1893408,1089,2156352,1129,1,4364,1,671,46,287536,3,9983,4685,"East TN",2455501,21.3805655139216,0.0375692683384991,45.9783970766047,1.95479456127283,27.3263989711265,3.75692683384991
2021-07-04,292598,27,237679,21,54919,6,262969,25,1894108,700,2157077,725,0,4364,-13,658,40,287576,1,9984,4686,"East TN",2455501,21.2991157405352,0.0377092345307504,29.5255428525584,1.09957194071597,26.7969754441151,3.77092345307504
2021-07-05,292641,43,237703,24,54938,19,262994,25,1894590,482,2157584,507,0,4364,-30,628,73,287649,2,9986,4687,"East TN",2455501,21.258390853842,0.0379591063990913,20.6475175534443,1.75117012780691,25.5752288433196,3.79591063990913
2021-07-06,292803,162,237807,104,54996,58,263107,113,1895915,1325,2159022,1438,5,4369,82,710,75,287724,6,9992,4687,"East TN",2455501,22.5208623413308,0.0421595389748256,58.5623870647986,6.59743164429581,28.9146695521606,4.21595389748256
2021-07-07,292945,142,237887,80,55058,62,263195,88,1897374,1459,2160569,1547,4,4373,81,791,57,287781,6,9998,4689,"East TN",2455501,24.8421808828422,0.04424323490071,63.0013997143556,5.78293391043213,32.2133853743085,4.42432349007099
2021-07-08,293085,140,237989,102,55096,38,263312,117,1899228,1854,2162540,1971,2,4375,76,867,62,287843,3,10001,4691,"East TN",2455501,26.2268270304105,0.0531246555714758,80.2687516722657,5.70148413704576,35.3084767629905,5.31246555714758
2021-07-09,293249,164,238111,122,55138,42,263443,131,1900973,1745,2164416,1876,0,4375,100,967,64,287907,4,10005,4693,"East TN",2455501,29.5662677392516,0.0586315674970086,76.3998874364132,6.67888141768218,39.3809654323089,5.86315674970086
2021-07-10,293353,104,238184,73,55169,31,263517,74,1902029,1056,2165546,1130,0,4375,56,1023,48,287955,13,10018,4694,"East TN",2455501,31.8468613940699,0.0623232542962802,46.0191219632979,4.23538821609114,41.6615590871272,6.23232542962802
2021-07-11,293401,48,238219,35,55182,13,263560,43,1902784,755,2166344,798,2,4377,4,1027,42,287997,7,10025,4694,"East TN",2455501,32.7020840146267,0.0637746843638718,32.4984595811608,1.95479456127283,41.8244586339,6.37746843638718
2021-07-12,293574,173,238336,117,55238,56,263685,125,1904150,1366,2167835,1491,1,4378,93,1120,79,288076,14,10039,4695,"East TN",2455501,37.9963192847407,0.0674080577504634,60.7208060595373,7.04540539792083,45.6118730963661,6.74080577504634
2021-07-13,293788,214,238473,137,55315,77,263830,145,1905772,1622,2169602,1767,4,4382,149,1269,61,288137,17,10056,4699,"East TN",2455501,40.1140133927862,0.0683364839319471,71.9608747868561,8.71512575234138,51.6798812136505,6.83364839319471
2021-07-14,293961,173,238609,136,55352,37,263972,142,1907334,1562,2171306,1704,0,4382,103,1372,70,288207,12,10068,4700,"East TN",2455501,41.3764848802749,0.0723665828443699,69.3952069251855,7.04540539792083,55.8745445430484,7.23665828443699
2021-07-15,294181,220,238759,150,55422,70,264139,167,1909135,1801,2173274,1968,0,4382,118,1490,102,288309,15,10083,4700,"East TN",2455501,44.6344758157297,0.0770449040432271,80.1465770121861,8.95947507250048,60.6800811728442,7.70449040432271
2021-07-16,294411,230,238901,142,55510,88,264293,154,1910664,1529,2174957,1683,0,4382,164,1654,66,288375,10,10093,4704,"East TN",2455501,47.3223183374798,0.0806375106726117,68.5399843046287,9.36672393943232,67.3589625905263,8.06375106726117
2021-07-17,294555,144,239001,100,55554,44,264403,110,1911882,1218,2176285,1328,0,4382,54,1708,90,288465,5,10098,4706,"East TN",2455501,48.9513138052072,0.0825030263525468,54.0826495285484,5.8643836838185,69.5581064719583,8.25030263525468
2021-07-18,294699,144,239122,121,55577,23,264535,132,1913007,1125,2177542,1257,0,4382,50,1758,94,288559,6,10104,4708,"East TN",2455501,52.8609029277528,0.0870691194856224,51.1911825733323,5.8643836838185,71.5943508066175,8.70691194856224
2021-07-19,295002,303,239333,211,55669,92,264751,216,1914697,1690,2179448,1906,3,4385,165,1923,135,288694,14,10118,4709,"East TN",2455501,58.1551381978667,0.0917936794971153,77.6216340372087,12.3396406680348,78.3139571109928,9.17936794971153
2021-07-20,295358,356,239570,237,55788,119,265005,254,1916357,1660,2181362,1914,2,4387,213,2136,141,288835,22,10140,4711,"East TN",2455501,63.9380721082989,0.0999149659863946,77.9474331307542,14.4980596627735,86.988357976641,9.99149659863946
2021-07-21,295760,402,239864,294,55896,108,265315,310,1918473,2116,2183788,2426,3,4390,248,2384,151,288986,28,10168,4715,"East TN",2455501,73.264071161038,0.107594936708861,98.7985751176644,16.37140445066,97.0881298765507,10.7594936708861
2021-07-22,296234,474,240197,333,56037,141,265682,367,1920842,2369,2186524,2736,5,4395,321,2705,148,289134,21,10189,4718,"East TN",2455501,83.6081923811067,0.116452830188679,111.423289992551,19.3035962925692,110.160818505063,11.6452830188679
2021-07-23,296695,461,240517,320,56178,141,266015,333,1922745,1903,2188760,2236,1,4396,328,3033,132,289266,27,10216,4724,"East TN",2455501,93.0156412072322,0.124755487937405,91.0608466459594,18.7741727655578,123.518581340427,12.4755487937405
2021-07-24,297053,358,240767,250,56286,108,266280,265,1924496,1751,2190776,2016,0,4396,226,3259,132,289398,21,10237,4728,"East TN",2455501,101.730766959574,0.129528672969429,82.1013715734589,14.5795094361599,132.722405733087,12.9528672969429
2021-07-25,297281,228,240957,190,56324,38,266483,203,1925811,1315,2192294,1518,3,4399,97,3356,128,289526,17,10254,4733,"East TN",2455501,105.151657441801,0.13204989154013,61.8203780002533,9.28527416604595,136.672719742325,13.204989154013
2021-07-26,297948,667,241420,463,56528,204,266969,486,1927540,1729,2194509,2215,10,4409,448,3804,209,289735,36,10290,4737,"East TN",2455501,119.97551619812,0.147267777704004,90.2056240254026,27.1634994243537,154.917468980872,14.7267777704004
2021-07-27,298675,727,241910,490,56765,237,267484,515,1929861,2321,2197345,2836,2,4411,534,4338,191,289926,28,10318,4743,"East TN",2455501,135.084449161291,0.155102296189702,115.49577866187,29.6069926259448,176.664558475032,15.5102296189702
2021-07-28,299493,818,242457,547,57036,271,268097,613,1932728,2867,2200825,3480,2,4413,558,4896,258,290184,37,10355,4746,"East TN",2455501,152.026002025656,0.163291659329694,141.72260569228,33.3129573150245,199.389045249829,16.3291659329694
2021-07-29,300181,688,242912,455,57269,233,268593,496,1935156,2428,2203749,2924,3,4416,474,5370,211,290395,23,10378,4750,"East TN",2455501,160.741127777997,0.16899854862119,119.07956869087,28.0187220449106,218.692641542398,16.899854862119
2021-07-30,301180,999,243662,750,57518,249,269396,803,1936959,1803,2206355,2606,4,4420,751,6121,244,290639,41,10419,4755,"East TN",2455501,182.65111681893,0.192156862745098,106.129054722438,40.6841618064908,249.277031448979,19.2156862745098
2021-07-31,301715,535,244027,365,57688,170,269792,396,1938929,1970,2208721,2366,2,4422,319,6440,214,290853,32,10451,4765,"East TN",2455501,189.859421763624,0.195709111173029,96.3550819160733,21.7878143808534,262.268270304105,19.5709111173029
2021-08-01,302247,532,244449,422,57798,110,270253,461,1941067,2138,2211320,2599,3,4425,320,6760,209,291062,28,10479,4769,"East TN",2455501,202.239787318352,0.198149900136655,105.843980515585,21.6656397207739,275.300234045924,19.8149900136655
2021-08-02,303097,850,244987,538,58110,312,270789,536,1943402,2335,2214191,2871,9,4434,415,7175,426,291488,32,10511,4778,"East TN",2455501,209.692441583204,0.194085966873285,116.921149696131,34.6161536892064,292.201062023595,19.4085966873285
2021-08-03,304434,1337,245955,968,58479,369,271804,1015,1947177,3775,2218981,4790,4,4438,896,8071,437,291925,40,10551,4788,"East TN",2455501,234.534622466047,0.199667221297837,195.072207260351,54.449173508787,328.690560500688,19.9667221297837
2021-08-04,305521,1087,246790,835,58731,252,272690,886,1950796,3619,2223486,4505,8,4446,644,8715,435,292360,40,10591,4794,"East TN",2455501,245.489616986513,0.202683023697101,183.465614552794,44.267951835491,354.917387531099,20.2683023697101
2021-08-05,306699,1178,247681,891,59018,287,273641,951,1954762,3966,2228403,4917,10,4456,665,9380,503,292863,43,10634,4801,"East TN",2455501,265.444811466173,0.204753792488034,200.244267870386,47.9739165245707,381.999437182066,20.4753792488034
2021-08-06,308038,1339,248668,987,59370,352,274724,1083,1959390,4628,2234114,5711,3,4459,909,10289,427,293290,52,10686,4814,"East TN",2455501,279.291272941856,0.191937749918945,232.579827904774,54.5306232821734,419.01835918617,19.1937749918945
2021-08-07,308762,724,249193,525,59569,199,275307,583,1962392,3002,2237699,3585,0,4459,326,10615,398,293688,28,10714,4823,"East TN",2455501,286.988276526868,0.190316792049141,145.998718795065,29.4848179658652,432.294672248148,19.0316792049141
2021-08-08,309398,636,249645,452,59753,184,275833,526,1964507,2115,2240340,2641,5,4464,218,10833,413,294101,29,10743,4833,"East TN",2455501,291.223664742959,0.192281185389387,107.554425756699,25.901027936865,441.172697547262,19.2281185389387
2021-08-09,310767,1369,250607,962,60160,407,276840,1007,1968045,3538,2244885,4545,13,4477,573,11406,783,294884,66,10809,4845,"East TN",2455501,312.359880936721,0.197139506092396,185.094610020521,55.7523698829689,464.508057622457,19.7139506092396
2021-08-10,312094,1327,251457,850,60637,477,277757,917,1971297,3252,2249054,4169,6,4483,549,11955,772,295656,48,10857,4859,"East TN",2455501,311.952632069789,0.197951650982609,169.782052623884,54.0419246418552,486.866020417015,19.7951650982609
2021-08-11,313981,1887,252769,1312,61212,575,279141,1384,1976653,5356,2255794,6740,8,4491,1064,13019,815,296471,63,10920,4879,"East TN",2455501,344.532541424337,0.199671907886592,274.48573631206,76.8478611900382,530.197299858562,19.9671907886592
2021-08-12,315443,1462,253837,1068,61606,394,280302,1161,1981135,4482,2261437,5643,10,4501,586,13605,866,297337,45,10965,4893,"East TN",2455501,356.098409245201,0.201640733789429,229.810535609637,59.539784345435,554.062083460768,20.1640733789429
2021-08-13,317090,1647,254959,1122,62131,525,281475,1173,1986554,5419,2268029,6592,11,4512,794,14399,842,298179,30,10995,4917,"East TN",2455501,368.641674346702,0.19905646469114,268.458453081469,67.073888383674,586.397643495156,19.905646469114
2021-08-14,318620,1530,256048,1089,62572,441,282675,1200,1992029,5475,2274704,6675,1,4513,911,15310,618,298797,27,11022,4931,"East TN",2455501,401.465933021408,0.199108228617754,271.838618677003,62.3090766405715,623.498015272647,19.9108228617754
2021-08-15,319765,1145,257016,968,62749,177,283734,1059,1995838,3809,2279572,4868,11,4524,426,15736,708,299505,20,11042,4944,"East TN",2455501,422.194900348238,0.201391721044046,198.24874842242,46.6299952636957,640.846817003943,20.1391721044046
2021-08-16,321205,1440,257935,919,63270,521,284697,963,1998898,3060,2283595,4023,17,4541,178,15914,1245,300750,28,11070,4962,"East TN",2455501,425.086367303455,0.202970808576595,163.836219166679,58.643836838185,648.09584683533,20.2970808576595
2021-08-17,322942,1737,259151,1216,63791,521,286017,1320,2003757,4859,2289774,6179,10,4551,510,16424,1217,301967,25,11095,4979,"East TN",2455501,441.78357084766,0.202848722986248,251.639074877184,70.7391281860606,668.865539048854,20.2848722986248
2021-08-18,325033,2091,260541,1390,64492,701,287495,1478,2009177,5420,2296672,6898,13,4564,930,17354,1148,303115,32,11127,4994,"East TN",2455501,450.09144773307,0.20436420568521,280.920268409583,85.1557380754477,706.739683673515,20.436420568521
2021-08-19,327423,2390,262042,1501,65381,889,289073,1578,2019129,9952,2308202,11530,23,4587,1116,18470,1251,304366,43,11170,5015,"East TN",2455501,487.884142584344,0.18755479525286,469.557943572411,97.3324791967098,752.188657223109,18.755479525286
2021-08-20,329878,2455,264022,1980,65856,475,291186,2113,2026023,6894,2317209,9007,4,4591,1268,19738,1183,305549,37,11207,5048,"East TN",2455501,520.789851032437,0.197458316388776,366.809054445508,99.9795968317667,803.827813550066,19.7458316388776
2021-08-21,332803,2925,265997,1975,66806,950,293304,2118,2034952,8929,2328256,11047,0,4591,2167,21905,758,306307,57,11264,5072,"East TN",2455501,577.601067969429,0.198479982073499,449.887823299604,119.120293577563,892.078643014195,19.8479982073499
2021-08-22,334287,1484,267337,1340,66950,144,294820,1516,2040464,5512,2335284,7028,7,4598,545,22450,932,307239,17,11281,5091,"East TN",2455501,591.406804558418,0.198987650775416,286.214503679697,60.4357318526851,914.273706261981,19.8987650775416
2021-08-23,336236,1949,268466,1129,67770,820,296007,1187,2044432,3968,2340439,5155,18,4616,185,22635,1746,308985,38,11319,5112,"East TN",2455501,612.135771885249,0.198965590035888,209.936790903364,79.3728041650156,921.80781030022,19.8965590035888
2021-08-24,338219,1983,269854,1388,68365,595,297443,1436,2048211,3779,2345654,5215,15,4631,146,22781,1822,310807,25,11344,5150,"East TN",2455501,622.154094011772,0.204473872584109,212.380284104955,80.7574503125839,927.753643757425,20.4473872584109
2021-08-25,340446,2227,271067,1213,69379,1014,298689,1246,2052247,4036,2350936,5282,17,4648,613,23394,1597,312404,39,11383,5188,"East TN",2455501,627.692678602045,0.206287778269202,215.108851513398,90.6943226657208,952.717999300346,20.6287778269202
2021-08-26,343104,2658,272905,1838,70199,820,300649,1960,2059091,6844,2359740,8804,24,4672,740,24134,1894,314298,40,11423,5218,"East TN",2455501,638.606948235818,0.224610966665373,358.541902446792,108.246748830483,982.854415453303,22.4610966665373
2021-08-27,346113,3009,275184,2279,70929,730,303020,2371,2066161,7070,2369181,9441,19,4691,1307,25441,1683,315981,44,11467,5239,"East TN",2455501,661.168535463842,0.227699530516432,384.48365527035,122.541184059791,1036.08184236129,22.7699530516432
2021-08-28,348257,2144,276725,1541,71532,603,304692,1672,2072027,5866,2376719,7538,1,4692,919,26360,1224,317205,33,11500,5273,"East TN",2455501,629.362398956466,0.234983389389844,306.984195893221,87.3141570701865,1073.50801323233,23.4983389389844
2021-08-29,350592,2335,278552,1827,72040,508,306713,2021,2079021,6994,2385734,9015,9,4701,1065,27425,1261,318466,45,11545,5304,"East TN",2455501,664.019277532365,0.235738354806739,367.134853539054,95.0926104285846,1116.88001756057,23.5738354806739
2021-08-30,353835,3243,280967,2415,72868,828,309319,2606,2088063,9042,2397382,11648,21,4722,477,27902,2745,321211,70,11615,5344,"East TN",2455501,716.717280913345,0.233777637286409,474.363480202207,132.070807545996,1136.30578851322,23.3777637286409
2021-08-31,357423,3588,283379,2412,74044,1176,311929,2610,2096650,8587,2408579,11197,7,4729,912,28814,2669,323880,80,11695,5379,"East TN",2455501,782.080724055906,0.230210568136671,455.996556303581,146.120893455144,1173.4468851774,23.0210568136671
2021-09-01,358858,1435,284331,952,74527,483,312919,990,2098933,2283,2411852,3273,15,4744,-964,27850,2384,326264,31,11726,5421,"East TN",2455501,749.826613794904,0.233600367719483,133.292554146791,58.440212404719,1134.18809440517,23.3600367719483
2021-09-02,361173,2315,285826,1495,75347,820,314435,1516,2103195,4262,2417630,5778,19,4763,-585,27265,2881,329145,44,11770,5451,"East TN",2455501,735.857977659142,0.238141302470202,235.308395313217,94.278112694721,1110.36403568966,23.8141302470202
2021-09-03,362928,1755,287052,1226,75876,529,315729,1294,2107301,4106,2423030,5400,17,4780,-1005,26260,2743,331888,32,11802,5480,"East TN",2455501,684.788969745889,0.236011810804286,219.914388143194,71.4721761465379,1069.43552456301,23.6011810804286
2021-09-04,366189,3261,289396,2344,76793,917,318305,2576,2115349,8048,2433654,10624,3,4783,1512,27772,1746,333634,56,11858,5511,"East TN",2455501,730.278668182175,0.23909721612365,432.661196228387,132.803855506473,1131.01155324311,23.909721612365
2021-09-05,370646,4457,292650,3254,77996,1203,321791,3486,2127859,12510,2449650,15996,8,4791,2731,30503,1718,335352,58,11916,5565,"East TN",2455501,816.696877745112,0.235903373177295,651.435287544171,181.510819991521,1242.23121880219,23.5903373177295
2021-09-06,375560,4914,296590,3940,78970,974,326081,4290,2143497,15638,2469578,19928,11,4802,965,31468,3938,339290,102,12018,5601,"East TN",2455501,884.748163409422,0.232173527619259,811.565542021771,200.122093210306,1281.53073446111,23.2173527619259
2021-09-07,377642,2082,298048,1458,79594,624,327599,1518,2147923,4426,2475522,5944,34,4836,-1810,29658,3858,343148,64,12082,5633,"East TN",2455501,823.416484049487,0.234079739479856,242.068726504286,84.7892140952091,1207.81868954645,23.4079739479856
2021-09-08,379316,1674,299224,1176,80092,498,328860,1261,2152303,4380,2481163,5641,20,4856,-1781,27877,3435,346583,60,12142,5674,"East TN",2455501,833.149731969158,0.229992353306113,229.729085836251,68.17346032439,1135.28766634589,22.9992353306113
2021-09-09,381226,1910,300230,1006,80996,904,329937,1077,2155969,3666,2485906,4743,7,4863,-1605,26272,3508,350091,55,12197,5714,"East TN",2455501,816.656152858419,0.227049036264573,193.158137585772,77.7845335839814,1069.92422320333,22.7049036264573
2021-09-10,386719,5493,304070,3840,82649,1653,334073,4136,2168075,12106,2502148,16242,23,4886,2258,28530,3212,353303,144,12341,5749,"East TN",2455501,968.88577931754,0.231856214767815,661.453609670695,223.70180260566,1161.88101735654,23.1856214767815
2021-09-11,391002,4283,307177,3107,83825,1176,337391,3318,2179895,11820,2517286,15138,8,4894,2504,31034,1771,355074,119,12460,5793,"East TN",2455501,1010.50661351797,0.228214080734647,616.493334761419,174.424689706907,1263.85613363627,22.8214080734647
2021-09-12,392581,1579,308600,1423,83981,156,338946,1555,2185139,5244,2524085,6799,23,4917,-135,30899,1691,356765,49,12509,5837,"East TN",2455501,893.300389614991,0.23046953718009,276.888504626958,64.3045960885375,1258.35827393269,23.046953718009
2021-09-13,394934,2353,310056,1456,84878,897,340451,1505,2190262,5123,2530713,6628,63,4980,-1938,28961,4228,360993,84,12593,5887,"East TN",2455501,789.003954793747,0.235053569968103,269.924549002424,95.8256583890619,1179.4334435213,23.5053569968103
2021-09-14,397747,2813,312011,1955,85736,858,342526,2075,2196484,6222,2539010,8297,43,5023,-935,28026,3705,364698,63,12656,5930,"East TN",2455501,818.773846966464,0.235115297379032,337.894384893348,114.559106267927,1141.35567446317,23.5115297379032
2021-09-15,399540,1793,313207,1196,86333,597,343741,1215,2200259,3775,2544000,4990,23,5046,-1555,26471,3325,368023,36,12692,5969,"East TN",2455501,823.620108482953,0.236819071566116,203.217184598988,73.0197218408789,1078.02847565527,23.6819071566116
2021-09-16,402185,2645,315058,1851,87127,794,345698,1957,2206918,6659,2552616,8616,23,5069,-557,25914,3179,371202,65,12757,6006,"East TN",2455501,853.552900202443,0.236261430070454,350.885623748473,107.717325303472,1055.34471376717,23.6261430070454
2021-09-17,404866,2681,316932,1874,87934,807,347702,2004,2214122,7204,2561824,9208,23,5092,-56,25858,2714,373916,82,12839,6061,"East TN",2455501,739.03451882121,0.228383269656143,374.994756670838,109.183421224426,1053.06412011235,22.8383269656143
2021-09-18,406320,1454,318111,1179,88209,275,349039,1337,2219594,5472,2568633,6809,3,5095,-285,25573,1736,375652,39,12878,6119,"East TN",2455501,623.823814366192,0.226848696126356,277.29575349389,59.2139852518895,1041.45752740479,22.6848696126356
2021-09-19,406963,643,318557,446,88406,197,349552,513,2221671,2077,2571223,2590,17,5112,-1072,24501,1698,377350,24,12902,6162,"East TN",2455501,585.705320421372,0.224998939284654,105.477456535347,26.1861021437173,997.800448869701,22.4998939284654
2021-09-20,408944,1981,319813,1256,89131,725,350923,1371,2227308,5637,2578231,7008,48,5160,175,24676,1758,379108,70,12972,6206,"East TN",2455501,570.555662571508,0.22037964560798,285.400005945833,80.6760005391975,1004.92730404101,22.037964560798
2021-09-21,410816,1872,320915,1102,89901,770,352063,1140,2231613,4305,2583676,5445,31,5191,-2037,22639,3878,382986,61,13033,6253,"East TN",2455501,532.233544193222,0.21351811221063,221.747008044387,76.2369878896404,921.970709846993,21.351811221063
2021-09-22,412407,1591,322031,1116,90376,475,353284,1221,2236971,5358,2590255,6579,14,5205,-1342,21297,2919,385905,45,13078,6291,"East TN",2455501,524.007117081199,0.206312831045292,267.929029554458,64.7932947288557,867.31791190474,20.6312831045292
2021-09-23,414756,2349,323539,1508,91217,841,354947,1663,2243327,6356,2598274,8019,32,5237,-389,20908,2706,388611,59,13137,6329,"East TN",2455501,511.952550620016,0.202571290901923,326.572866392642,95.6627588422892,851.475930981091,20.2571290901923
2021-09-24,416295,1539,324522,983,91773,556,356046,1099,2248209,4882,2604255,5981,37,5274,-913,19995,2415,391026,40,13177,6378,"East TN",2455501,465.4447300164,0.196648676675072,243.575547311933,62.6756006208102,814.294109430214,19.6648676675072
2021-09-25,416992,697,325010,488,91982,209,356608,562,2251231,3022,2607839,3584,2,5276,-914,19081,1609,392635,21,13198,6419,"East TN",2455501,434.61599078966,0.193057185124726,145.957993908371,28.3852460251492,777.071562992644,19.3057185124726
2021-09-26,417853,861,325638,628,92215,233,357331,723,2255208,3977,2612539,4700,6,5282,-431,18650,1286,393921,26,13224,6455,"East TN",2455501,443.494016088774,0.188280569270985,191.406967457965,35.0641274428314,759.519136827882,18.8280569270985
2021-09-27,419313,1460,326470,832,92843,628,358253,922,2258799,3591,2617052,4513,46,5328,-1369,17281,2783,396704,45,13269,6488,"East TN",2455501,422.276350121625,0.188815331907988,183.791413646339,59.4583345720486,703.766766944913,18.8815331907988
2021-09-28,420607,1294,327259,789,93348,505,359116,863,2262461,3662,2621577,4525,14,5342,-1016,16265,2296,399000,34,13303,6524,"East TN",2455501,398.737365612965,0.186090076778977,184.280112286658,52.6980033809801,662.390282064638,18.6090076778977
2021-09-29,422282,1675,328268,1009,94014,666,360254,1138,2267959,5498,2628213,6636,30,5372,-383,15882,2028,401028,50,13353,6568,"East TN",2455501,402.158256095192,0.183624005479741,270.250348095969,68.2141852110832,646.792650461148,18.3624005479741
2021-09-30,423491,1209,329028,760,94463,449,361073,819,2272631,4672,2633704,5491,11,5383,-785,15097,1983,403011,40,13393,6603,"East TN",2455501,355.731885264962,0.172904318374259,223.620352832273,49.2363880120595,614.823614406999,17.2904318374259
2021-10-01,424864,1373,330003,975,94861,398,362148,1075,2277604,4973,2639752,6048,14,5397,-298,14799,1657,404668,48,13441,6632,"East TN",2455501,348.971554073894,0.171901850860636,246.304114720377,55.9152694297416,602.68759817243,17.1901850860636
2021-10-02,425418,554,330355,352,95063,202,362543,395,2280274,2670,2642817,3065,11,5408,-469,14330,1012,405680,19,13460,6670,"East TN",2455501,343.147895276768,0.169678083366688,124.821777714609,22.5615872280239,583.587626313327,16.9678083366688
2021-10-03,425957,539,330820,465,95137,74,363067,524,2283366,3092,2646433,3616,13,5421,-347,13983,873,406553,15,13475,6703,"East TN",2455501,330.034481761563,0.169233492653567,147.261190282553,21.9507139276262,569.456090630792,16.9233492653567
2021-10-04,427307,1350,331678,858,95629,492,364007,940,2287503,4137,2651510,5077,22,5443,-607,13376,1935,408488,29,13504,6726,"East TN",2455501,325.554744225313,0.166985895873237,206.760249741295,54.9785970357984,544.736084408029,16.6985895873237
2021-10-05,428571,1264,332434,756,96137,508,364822,815,2291965,4462,2656787,5277,17,5460,-451,12925,1698,410186,40,13544,6766,"East TN",2455501,324.332997624517,0.162056234024425,214.905227079932,51.4762567801846,526.369160509403,16.2056234024425
2021-10-06,429508,937,333141,707,96367,230,365602,780,2296386,4421,2661988,5201,18,5478,-408,12517,1327,411513,26,13570,6801,"East TN",2455501,294.278031244948,0.158341968911917,211.81013569125,38.1592188315134,509.753406738584,15.8341968911917
2021-10-07,430625,1117,333934,793,96691,324,366460,858,2301169,4783,2667629,5641,24,5502,-380,12137,1473,412986,26,13596,6831,"East TN",2455501,290.531341669175,0.158791451731761,229.729085836251,45.4896984362865,494.277949795174,15.8791451731761
2021-10-08,431679,1054,334521,587,97158,467,367103,643,2305416,4247,2672519,4890,9,5511,-131,12006,1176,414162,31,13627,6852,"East TN",2455501,277.540102814049,0.151219214453566,199.14469592967,42.9240305746159,488.942989638367,15.1219214453566
2021-10-09,432220,541,334876,355,97344,186,367520,417,2308225,2809,2675745,3226,4,5515,-295,11711,832,414994,32,13659,6881,"East TN",2455501,277.010679287038,0.151147959183673,131.378484472212,22.0321637010125,476.929148063878,15.1147959183673
2021-10-10,432539,319,335143,267,97396,52,367830,310,2310457,2232,2678287,2542,6,5521,-527,11184,840,415834,16,13675,6904,"East TN",2455501,268.051204214537,0.149525962202549,103.522661974074,12.9912388551257,455.46713277657,14.9525962202549
2021-10-11,433758,1219,335680,537,98078,682,368378,548,2313903,3446,2682281,3994,52,5573,-275,10909,1442,417276,33,13708,6918,"East TN",2455501,262.71624405773,0.142049332163401,162.655197452577,49.6436368789913,444.267788935944,14.2049332163401
2021-10-12,434693,935,336317,637,98376,298,369383,1005,2317547,3644,2686930,4649,29,5602,-366,10543,1272,418548,32,13740,6952,"East TN",2455501,249.317756335672,0.151312079089673,189.329998236612,38.077769058127,429.362480406239,15.1312079089673
2021-10-13,435540,847,336866,549,98674,298,370033,650,2321412,3865,2691445,4515,25,5627,-402,10141,1224,419772,37,13777,6975,"East TN",2455501,245.652516533286,0.150422649964355,183.872863419726,34.4939790291268,412.991075955579,15.0422649964355
2021-10-14,436489,949,337519,653,98970,296,370754,721,2325415,4003,2696169,4724,31,5658,-170,9971,1088,420860,33,13810,7007,"East TN",2455501,238.810735568831,0.150455501051156,192.384364738601,38.6479174718316,406.067845217738,15.0455501051156
2021-10-15,437291,802,338031,512,99260,290,371330,576,2329309,3894,2700639,4470,24,5682,-300,9671,1078,421938,30,13840,7032,"East TN",2455501,228.548064122149,0.150320056899004,182.040243518532,32.6613591279336,393.850379209782,15.0320056899004
2021-10-16,437598,307,338270,239,99328,68,371601,271,2331539,2230,2703140,2501,7,5689,-376,9295,676,422614,12,13852,7047,"East TN",2455501,219.018440635944,0.148968789925169,101.852941619653,12.5025402148075,378.537821813145,14.8968789925169
2021-10-17,437850,252,338480,210,99370,42,371849,248,2333202,1663,2705051,1911,7,5696,-452,8843,697,423311,14,13866,7063,"East TN",2455501,216.2898732275,0.150164399940218,77.8252584706746,10.2626714466824,360.130173027826,15.0164399940218
2021-10-18,438637,787,338947,467,99690,320,372365,516,2336393,3191,2708758,3707,23,5719,-468,8375,1232,424543,37,13903,7084,"East TN",2455501,198.696722176045,0.150583525323866,150.967154971633,32.0504858275358,341.070926055416,15.0583525323866
2021-10-19,439468,831,339388,441,100080,390,372839,474,2339721,3328,2712560,3802,25,5744,-275,8100,1081,425624,23,13926,7100,"East TN",2455501,194.461333959954,0.134841982052282,154.836019207486,33.8423808420359,329.87158221479,13.4841982052282
2021-10-20,440232,764,339878,490,100354,274,373380,541,2343742,4021,2717122,4562,15,5759,-208,7892,957,426581,21,13947,7119,"East TN",2455501,191.081168364419,0.130350118783347,185.786933094305,31.1138134335926,321.400805782608,13.0350118783347
2021-10-21,440861,629,340301,423,100560,206,373850,470,2347379,3637,2721229,4107,17,5776,-244,7648,856,427437,21,13968,7137,"East TN",2455501,178.0492046226,0.123543495610535,167.257109648907,25.6159537300127,311.463933429471,12.3543495610535
2021-10-22,441406,545,340641,340,100765,205,374236,386,2350483,3104,2724719,3490,6,5782,-317,7331,856,428293,18,13986,7155,"East TN",2455501,167.582908742452,0.120681063122924,142.129854559212,22.1950632477853,298.554144347732,12.0681063122924
2021-10-23,441763,357,340885,244,100878,113,374509,273,2352868,2385,2727377,2658,0,5782,-198,7133,555,428848,15,14001,7175,"East TN",2455501,169.619153077111,0.119981845938029,108.246748830483,14.5387845494667,290.490616782481,11.9981845938029
2021-10-24,442006,243,341047,162,100959,81,374705,196,2354765,1897,2729470,2093,7,5789,-304,6829,540,429388,14,14015,7187,"East TN",2455501,169.252629096873,0.116958106392563,85.2371878488341,9.89614746644371,278.110251227754,11.6958106392563
2021-10-25,442428,422,341295,248,101133,174,374976,271,2357196,2431,2732172,2702,28,5817,-485,6344,879,430267,21,14036,7198,"East TN",2455501,154.388045453861,0.111514478517127,110.038643844983,17.1859021845236,258.358681181559,11.1514478517127
2021-10-26,442954,526,341624,329,101330,197,375314,338,2359836,2640,2735150,2978,12,5829,-231,6113,745,431012,28,14064,7209,"East TN",2455501,141.966955012439,0.109561752988048,121.278712572302,21.4212904006148,248.951232355434,10.9561752988048
2021-10-27,443574,620,342018,394,101556,226,375738,424,2364033,4197,2739771,4621,10,5839,-88,6025,698,431710,21,14085,7230,"East TN",2455501,136.102571328621,0.104110556757473,188.189701409203,25.2494297497741,245.367442326434,10.4110556757473
2021-10-28,443990,416,342273,255,101717,161,376029,291,2366830,2797,2742859,3088,16,5855,-196,5829,596,432306,15,14100,7245,"East TN",2455501,127.428170462973,0.100739713361073,125.758450108552,16.9415528643645,237.38536453457,10.0739713361073
2021-10-29,444450,460,342578,305,101872,155,376362,333,2370348,3518,2746710,3851,4,5859,-154,5675,610,432916,10,14110,7262,"East TN",2455501,123.966555094052,0.0966759128734482,156.831538655452,18.7334478788646,231.113731983819,9.66759128734482
2021-10-30,444713,263,342780,202,101933,61,376591,229,2372922,2574,2749513,2803,0,5859,-149,5526,412,433328,16,14126,7276,"East TN",2455501,120.138415744893,0.0940549331405855,114.151857400995,10.7106452003074,225.045723866535,9.40549331405855
2021-10-31,444884,171,342907,127,101977,44,376737,146,2374547,1625,2751284,1771,0,5859,-225,5301,396,433724,5,14131,7287,"East TN",2455501,117.206223902984,0.0931511873109013,72.1237743336289,6.96395562453446,215.882624360568,9.31511873109013
2021-11-01,445480,596,343268,361,102212,235,377127,390,2377665,3118,2754792,3508,14,5873,-185,5116,767,434491,23,14154,7296,"East TN",2455501,124.292354187598,0.0950928381962865,142.862902519689,24.2720324691377,208.348520322329,9.50928381962865
2021-11-02,445892,412,343488,220,102404,192,377353,226,2379876,2211,2757229,2437,25,5898,-183,4933,570,435061,16,14170,7319,"East TN",2455501,119.649717104575,0.0923501970197926,99.2465488712894,16.7786533175918,200.895866057477,9.23501970197926
2021-11-03,446464,572,343867,379,102597,193,377746,393,2384454,4578,2762200,4971,6,5904,78,5011,488,435549,14,14184,7330,"East TN",2455501,117.694922543302,0.0895269517142984,202.443411751818,23.2946351885012,204.072407219545,8.95269517142984
2021-11-04,446881,417,344169,302,102712,115,378076,330,2387990,3536,2766066,3866,13,5917,-75,4936,479,436028,9,14193,7341,"East TN",2455501,117.735647429995,0.0882061446977205,157.442411955849,16.9822777510577,201.018040717556,8.82061446977205
2021-11-05,447316,435,344454,285,102862,150,378400,324,2391573,3583,2769973,3907,2,5919,21,4957,412,436440,13,14206,7347,"East TN",2455501,116.717525262665,0.0876069294587972,159.11213231027,17.715325711535,201.873263338113,8.76069294587972
2021-11-06,447549,233,344625,171,102924,62,378588,188,2393813,2240,2772401,2428,0,5919,-85,4872,318,436758,13,14219,7355,"East TN",2455501,115.49577866187,0.0872509612023768,98.8800248910507,9.48889859951187,198.411647969192,8.72509612023768
2021-11-07,447748,199,344753,128,102995,71,378742,154,2395714,1901,2774456,2055,6,5925,-130,4742,323,437081,8,14227,7367,"East TN",2455501,116.636075489279,0.0865268427412394,83.6896421544931,8.10425245194362,193.117412699079,8.65268427412394
2021-11-08,448289,541,345099,346,103190,195,379127,385,2399247,3533,2778374,3918,25,5950,-27,4715,543,437624,25,14252,7379,"East TN",2455501,114.396206721154,0.0848104486472733,159.560106063895,22.0321637010125,192.017840758363,8.48104486472733
2021-11-09,449157,868,345716,617,103441,251,379927,800,2406522,7275,2786449,8075,10,5960,425,5140,433,438057,27,14279,7394,"East TN",2455501,132.966755053246,0.0880903490759754,328.853460047461,35.3492016496837,209.325917602966,8.80903490759754
2021-11-10,449783,626,346153,437,103630,189,380429,502,2411773,5251,2792202,5753,7,5967,179,5319,440,438497,28,14307,7406,"East TN",2455501,135.165898934678,0.0894273715085661,234.290273145888,25.4937790699332,216.615672321046,8.94273715085661
2021-11-11,450287,504,346535,382,103752,122,380834,405,2416063,4290,2796897,4695,5,5972,81,5400,418,438915,10,14317,7419,"East TN",2455501,138.708964076985,0.0894554182478674,191.203343024499,20.5253428933647,219.914388143194,8.94554182478674
2021-11-12,450769,482,346857,322,103912,160,381166,332,2419513,3450,2800679,3782,2,5974,117,5517,363,439278,24,14341,7429,"East TN",2455501,140.623033751564,0.0900801146355761,154.021521473622,19.6293953861147,224.679199886296,9.00801146355761
2021-11-13,451006,237,346999,142,104007,95,381315,149,2421512,1999,2802827,2148,4,5978,-101,5416,334,439612,11,14352,7438,"East TN",2455501,140.785933298337,0.0896272924472491,87.4770566169592,9.65179814628461,220.565986330285,8.96272924472491
2021-11-14,451367,361,347315,316,104052,45,381660,345,2424491,2979,2806151,3324,1,5979,59,5475,301,439913,14,14366,7446,"East TN",2455501,147.383364942633,0.0920649944786244,135.369523368144,14.7016840962394,222.968754645182,9.20649944786244
2021-11-15,451944,577,347605,290,104339,287,381961,301,2427259,2768,2809220,3069,26,6005,-27,5448,578,440491,20,14386,7456,"East TN",2455501,148.849460863588,0.0918757699539649,124.984677261382,23.4982596219672,221.869182704466,9.18757699539649
2021-11-16,452616,672,348038,433,104578,239,382421,460,2430866,3607,2813287,4067,24,6029,178,5626,470,440961,17,14403,7466,"East TN",2455501,140.867383071723,0.0929279379983605,165.628114181179,27.3671238578196,229.118212535853,9.29279379983605
2021-11-17,453329,713,348505,467,104824,246,382930,509,2435511,4645,2818441,5154,5,6034,292,5918,416,441377,27,14430,7476,"East TN",2455501,144.41044821403,0.0953161324745608,209.89606601667,29.0368442122402,241.009879450263,9.53161324745608
2021-11-18,453955,626,348915,410,105040,216,383408,478,2440374,4863,2823782,5341,12,6046,184,6102,430,441807,19,14449,7485,"East TN",2455501,149.378884390599,0.0957411195834108,217.511619828296,25.4937790699332,248.503258601809,9.57411195834108
2021-11-19,454568,613,349358,443,105210,170,383868,460,2444848,4474,2828716,4934,7,6053,218,6320,388,442195,13,14462,7493,"East TN",2455501,154.713844547406,0.0963726504262225,200.93659094417,24.9643555429218,257.381283900923,9.63726504262225
2021-11-20,454890,322,349605,247,105285,75,384155,287,2447552,2704,2831707,2991,0,6053,21,6341,301,442496,14,14476,7500,"East TN",2455501,158.175459916327,0.0983379501385042,121.808136099313,13.1134135152052,258.23650652148,9.83379501385042
2021-11-21,455154,264,349757,152,105397,112,384319,164,2449036,1484,2833355,1648,9,6062,-93,6248,348,442844,10,14486,7511,"East TN",2455501,154.225145907088,0.0977429789736803,67.1146132703672,10.7513700870006,254.449092059014,9.77429789736803
2021-11-22,455906,752,350251,494,105655,258,384831,512,2452904,3868,2837735,4380,20,6082,152,6400,580,443424,38,14524,7516,"East TN",2455501,161.352001078395,0.100648781343153,178.375003716146,30.6251147932744,260.639274836378,10.0648781343153
2021-11-23,456582,676,350720,469,105862,207,385321,490,2456205,3301,2841526,3791,21,6103,119,6519,536,443960,19,14543,7523,"East TN",2455501,161.514900625168,0.102694854633663,154.388045453861,27.5300234045924,265.485536352866,10.2694854633663
2021-11-24,457320,738,351253,533,106067,205,385894,573,2460233,4028,2846127,4601,6,6109,253,6772,479,444439,21,14564,7533,"East TN",2455501,162.533022792497,0.107057718702593,187.37520367534,30.0549663795698,275.788932686242,10.7057718702593
2021-11-25,457606,286,351411,158,106195,128,386067,173,2461869,1636,2847936,1809,1,6110,-197,6575,482,444921,10,14574,7542,"East TN",2455501,148.686561316815,0.11008528608098,73.6713200279699,11.6473175942506,267.766130007685,11.008528608098
2021-11-26,457836,230,351613,202,106223,28,386310,243,2463546,1677,2849856,1920,1,6111,-287,6288,516,445437,15,14589,7546,"East TN",2455501,133.088929713325,0.115515610217597,78.1917824509133,9.36672393943232,256.078087526741,11.5515610217597
2021-11-27,458120,284,351841,228,106279,56,386564,254,2465141,1595,2851705,1849,0,6111,-96,6192,380,445817,14,14603,7557,"East TN",2455501,131.541384018984,0.12046204620462,75.3003154956972,11.5658678208643,252.168498404195,12.046204620462
2021-11-28,458434,314,352052,211,106382,103,386781,217,2466651,1510,2853432,1727,7,6118,-108,6084,415,446232,20,14623,7567,"East TN",2455501,133.577628353644,0.122627882651791,70.3318793191288,12.7876144216598,247.770210641331,12.2627882651791
2021-11-29,459531,1097,352764,712,106767,385,387519,738,2471198,4547,2858717,5285,19,6137,423,6507,655,446887,35,14658,7575,"East TN",2455501,147.627714262792,0.128109808407206,215.231026173477,44.6752007024228,264.996837712548,12.8109808407206
2021-11-30,460369,838,353272,508,107097,330,388024,505,2474565,3367,2862589,3872,64,6201,187,6694,587,447474,26,14684,7587,"East TN",2455501,154.225145907088,0.128329297820823,157.686761276008,34.1274550488882,272.612391524174,12.8329297820823
2021-12-01,461451,1082,354042,770,107409,312,388831,807,2479736,5171,2868567,5978,48,6249,504,7198,530,448004,32,14716,7608,"East TN",2455501,168.234506929543,0.130882352941176,243.453372651854,44.0643274020251,293.137734417538,13.0882352941176
2021-12-02,462354,903,354665,623,107689,280,389497,666,2484397,4661,2873894,5327,39,6288,280,7478,584,448588,18,14734,7625,"East TN",2455501,193.361762019238,0.132136528237923,216.941471414591,36.7745726839452,304.54070269163,13.2136528237923
2021-12-03,463373,1019,355401,736,107972,283,390279,782,2489375,4978,2879654,5760,21,6309,519,7997,479,449067,25,14759,7637,"East TN",2455501,225.49369762016,0.133196858849587,234.57534735274,41.4986595403545,325.676918885392,13.3196858849587
2021-12-04,463796,423,355734,333,108062,90,390660,381,2492127,2752,2882787,3133,3,6312,17,8014,403,449470,29,14788,7649,"East TN",2455501,231.154456870512,0.131780451708384,127.591070009745,17.2266270712168,326.369241959177,13.1780451708384
2021-12-05,464181,385,355950,216,108231,169,390891,231,2494059,1932,2884950,2163,12,6324,-31,7983,404,449874,15,14803,7657,"East TN",2455501,234.045923825728,0.1304016752332,88.087929917357,15.6790813768758,325.106770471688,13.04016752332
2021-12-06,465133,952,356595,645,108538,307,391582,691,2498243,4184,2889825,4875,69,6393,127,8110,756,450630,32,14835,7671,"East TN",2455501,228.140815255217,0.130609489520381,198.533822629272,38.7700921319112,330.278831081722,13.0609489520381
2021-12-07,465975,842,357128,533,108847,309,392123,541,2501720,3477,2893843,4018,8,6401,215,8325,619,451249,25,14860,7676,"East TN",2455501,228.303714801989,0.131151212644781,163.632594733213,34.2903545956609,339.034681720757,13.1151212644781
2021-12-08,467021,1046,357765,637,109256,409,392780,657,2506336,4616,2899116,5273,4,6405,445,8770,597,451846,29,14889,7692,"East TN",2455501,226.837618881035,0.129267733804707,214.742327533159,42.5982314810705,357.157256299224,12.9267733804707
2021-12-09,467939,918,358383,618,109556,300,393446,666,2511313,4977,2904759,5643,19,6424,521,9291,378,452224,30,14919,7706,"East TN",2455501,227.448492181433,0.12794427344889,229.810535609637,37.3854459843429,378.374922266373,12.794427344889
2021-12-10,468734,795,358931,548,109803,247,394047,601,2515823,4510,2909870,5111,5,6429,162,9453,628,452852,22,14941,7720,"East TN",2455501,218.326117562159,0.124702144559174,208.144895888863,32.3762849210813,384.972353910668,12.4702144559174
2021-12-11,469131,397,359217,286,109914,111,394372,325,2518745,2922,2913117,3247,0,6429,-176,9277,573,453425,19,14960,7729,"East TN",2455501,217.267270508137,0.122387075502803,132.233707092768,16.167780017194,377.804773852668,12.2387075502803
2021-12-12,469562,431,359480,263,110082,168,394666,294,2521264,2519,2915930,2813,9,6438,-138,9139,560,453985,18,14978,7736,"East TN",2455501,219.140615296023,0.121852808263396,114.559106267927,17.5524261647623,372.184739489009,12.1852808263396
2021-12-13,470444,882,360054,574,110390,308,395269,603,2525866,4602,2921135,5205,23,6461,-174,8965,1033,455018,24,15002,7745,"East TN",2455501,216.2898732275,0.11775790482274,211.973035238023,35.9193500633883,365.098609204395,11.775790482274
2021-12-14,471200,756,360510,456,110690,300,395752,483,2529889,4023,2925641,4506,36,6497,-132,8833,852,455870,22,15024,7753,"East TN",2455501,212.787532971886,0.114126674633625,183.506339439487,30.7880143400471,359.722924160894,11.4126674633625
2021-12-15,472071,871,361100,590,110971,281,396381,629,2534693,4804,2931074,5433,19,6516,-10,8823,862,456732,22,15046,7768,"East TN",2455501,205.660677800579,0.112679141373052,221.258309404069,35.4713763097633,359.315675293962,11.2679141373052
2021-12-16,472866,795,361611,511,111255,284,396926,545,2538513,3820,2935439,4365,19,6535,13,8836,763,457495,22,15068,7784,"East TN",2455501,200.651516737318,0.113428943937419,177.764130415748,32.3762849210813,359.845098820974,11.3428943937419
2021-12-17,473677,811,362147,536,111530,275,397511,585,2543181,4668,2940692,5253,24,6559,40,8876,747,458242,33,15101,7798,"East TN",2455501,201.303114924409,0.112387255856207,213.927829799296,33.0278831081722,361.474094288701,11.2387255856207
2021-12-18,474248,571,362527,380,111721,191,397937,426,2546526,3345,2944463,3771,0,6559,18,8894,553,458795,28,15129,7811,"East TN",2455501,208.389245209023,0.113730619536783,153.573547719997,23.2539103018081,362.207142249179,11.3730619536783
2021-12-19,474669,421,362808,281,111861,140,398248,311,2549189,2663,2947437,2974,6,6565,-193,8701,608,459403,16,15145,7820,"East TN",2455501,207.981996342091,0.113689021487289,121.115813025529,17.1451772978305,354.347239117394,11.3689021487289
2021-12-20,475603,934,363431,623,112172,311,398886,638,2553151,3962,2952037,4600,40,6605,13,8714,881,460284,31,15176,7831,"East TN",2455501,210.099690450136,0.117047440295127,187.334478788646,38.0370441714339,354.876662644405,11.7047440295127
2021-12-21,476614,1011,364088,657,112526,354,399555,669,2557534,4383,2957089,5052,30,6635,167,8881,814,461098,28,15204,7841,"East TN",2455501,220.484536556898,0.120929788857797,205.742127573966,41.172860446809,361.677718722167,12.0929788857797
2021-12-22,478100,1486,364819,731,113281,755,400303,748,2561874,4340,2962177,5088,855,7490,-133,8748,764,461862,37,15241,7857,"East TN",2455501,245.530341873206,0.126097161045558,207.20822349492,60.5171816260714,356.261308791974,12.6097161045558
2021-12-23,479268,1168,365625,806,113643,362,401167,864,2566360,4486,2967527,5350,28,7518,372,9120,768,462630,32,15273,7874,"East TN",2455501,260.720724609764,0.132167788581401,217.878143808534,47.5666676576389,371.410966641838,13.2167788581401
2021-12-24,480206,938,366273,648,113933,290,401874,707,2570197,3837,2972071,4544,0,7518,248,9368,690,463320,17,15290,7896,"East TN",2455501,265.892785219798,0.13904203448166,185.053885133828,38.1999437182066,381.510738541748,13.904203448166
2021-12-25,480686,480,366556,283,114130,197,402207,333,2572316,2119,2974523,2452,8,7526,-79,9289,551,463871,19,15309,7904,"East TN",2455501,262.186820530719,0.142049234863606,99.8574221716871,19.5479456127283,378.293472492986,14.2049234863606
2021-12-26,481029,343,366832,276,114197,67,402527,320,2574191,1875,2976718,2195,62,7588,-265,9024,546,464417,18,15327,7921,"East TN",2455501,259.01027936865,0.14613571940849,89.3911262915389,13.9686361357621,367.501377519292,14.613571940849
2021-12-27,482905,1876,368092,1260,114813,616,403837,1310,2578945,4754,2982782,6064,64,7652,928,9952,884,465301,35,15362,7938,"East TN",2455501,297.37312263363,0.161034314522687,246.955712907468,76.3998874364132,405.294072370567,16.1034314522687
2021-12-28,485332,2427,369535,1443,115797,984,405324,1487,2583324,4379,2988648,5866,18,7670,1627,11579,782,466083,26,15388,7950,"East TN",2455501,355.039562191178,0.182800468962895,238.892185342217,98.8393000043576,471.553463020377,18.2800468962895
2021-12-29,488222,2890,371462,1927,116760,963,407327,2003,2588613,5289,2995940,7292,37,7707,2086,13665,767,466850,30,15418,7965,"East TN",2455501,412.217303108408,0.208038385214584,296.965873766698,117.694922543302,556.505576662359,20.8038385214584
2021-12-30,491049,2827,373247,1785,117802,1042,409150,1823,2593076,4463,3002226,6286,14,7721,2080,15745,733,467583,33,15451,7980,"East TN",2455501,479.779890132401,0.230064266981757,255.996637753355,115.129254681631,641.213340984182,23.0064266981757
2021-12-31,493573,2524,375062,1815,118511,709,411097,1947,2597909,4833,3009006,6780,0,7721,1769,17514,755,468338,24,15475,7999,"East TN",2455501,544.36956042779,0.249708948152159,276.114731779788,102.789614013596,713.255665544425,24.9708948152159
2022-01-01,495032,1459,376291,1229,118741,230,412436,1339,2601559,3650,3013995,4989,0,7721,854,18368,605,468943,32,15507,8007,"East TN",2455501,584.239224500418,0.259145723550872,203.176459712295,59.4176096853555,748.034718780404,25.9145723550872
2022-01-02,496496,1464,377253,962,119243,502,413659,1223,2604575,3016,3018234,4239,6,7727,761,19129,697,469640,26,15533,8027,"East TN",2455501,629.891822483477,0.268137585509201,172.632794692407,59.6212341188214,779.026357553917,26.8137585509201
2022-01-03,499393,2897,379437,2184,119956,713,415885,2226,2608746,4171,3024631,6397,33,7760,1768,20897,1096,470736,36,15569,8041,"East TN",2455501,671.471931797218,0.287892183803675,260.517100176298,117.979996750154,851.027957227466,28.7892183803675
2022-01-04,503563,4170,381882,2445,121681,1725,418271,2386,2613983,5237,3032254,7623,14,7774,2977,23874,1179,471915,42,15611,8059,"East TN",2455501,742.455409303437,0.296908682291428,310.445811262142,169.822777510577,972.265944913075,29.6908682291428
2022-01-05,508499,4936,385294,3412,123205,1524,421772,3501,2619217,5234,3040989,8735,15,7789,3682,27556,1239,473154,44,15655,8084,"East TN",2455501,825.778527477692,0.320650846855646,355.731885264962,201.018040717556,1122.21497771738,32.0650846855646
2022-01-06,513669,5170,388767,3473,124902,1697,425421,3649,2624829,5612,3050250,9261,11,7800,3860,31416,1299,474453,42,15697,8104,"East TN",2455501,921.196936999822,0.338809761785774,377.153175665577,210.547664203761,1279.41304035307,33.8809761785774
2022-01-07,518046,4377,391993,3226,126053,1151,428696,3275,2629513,4684,3058209,7959,12,7812,3446,34862,919,475372,35,15732,8126,"East TN",2455501,996.660152042292,0.357681442188484,324.129373191051,178.252829056066,1419.75099989778,35.7681442188484
2022-01-08,521196,3150,394419,2426,126777,724,431301,2605,2634275,4762,3065576,7367,1,7813,2446,37308,703,476075,37,15769,8145,"East TN",2455501,1065.52593544047,0.365735445222078,300.020240268687,128.28339308353,1519.36407274931,36.5735445222078
2022-01-09,524697,3501,397099,2680,127598,821,434194,2893,2639277,5002,3073471,7895,15,7828,1849,39157,1637,477712,34,15803,8163,"East TN",2455501,1148.48252963448,0.371761681481616,321.522980442688,142.577828312837,1594.66438824501,37.1761681481616
2022-01-10,529344,4647,400170,3071,129174,1576,437438,3244,2644056,4779,3081494,8023,29,7857,1619,40776,2999,480711,53,15856,8196,"East TN",2455501,1219.75108134755,0.379033818124264,326.735765939415,189.248548463226,1660.59797980127,37.9033818124264
2022-01-11,534954,5610,404211,4041,130743,1569,441572,4134,2649245,5189,3090817,9323,30,7887,2263,43039,3317,484028,45,15901,8221,"East TN",2455501,1278.39491818574,0.397879207007838,379.678118640554,228.466614348762,1752.75839838795,39.7879207007838
2022-01-12,540636,5682,408190,3979,132446,1703,445733,4161,2654014,4769,3099747,8930,16,7903,2508,45547,3158,487186,29,15930,8243,"East TN",2455501,1308.77568365885,0.407791279485347,363.673238170133,231.398806190671,1854.89641421445,40.7791279485347
2022-01-13,547966,7330,413437,5247,134529,2083,451210,5477,2660941,6927,3112151,12404,65,7968,3811,49358,3454,490640,43,15973,8259,"East TN",2455501,1396.74143891613,0.4166168559474,505.151494542254,298.513419461039,2010.09895740218,41.66168559474
2022-01-14,554480,6514,418220,4783,136260,1731,456134,4924,2666821,5880,3122955,10804,69,8037,4381,53739,2064,492704,33,16006,8291,"East TN",2455501,1483.77052177947,0.423779075155222,439.99167583316,265.281911919401,2188.51468600501,42.3779075155222
2022-01-15,559032,4552,421616,3396,137416,1156,459745,3611,2671910,5089,3131655,8700,9,8046,3007,56746,1536,494240,31,16037,8305,"East TN",2455501,1540.86681292331,0.430454456029904,354.306514230701,185.379684227374,2310.97442029142,43.0454456029904
2022-01-16,562897,3865,424943,3327,137954,538,463240,3495,2676558,4648,3139798,8143,7,8053,1335,58081,2523,496763,27,16064,8323,"East TN",2455501,1555.69067167963,0.437921208557601,331.622752342597,157.401687069156,2365.34214402682,43.7921208557601
2022-01-17,567529,4632,428270,3327,139259,1305,466707,3467,2681293,4735,3148000,8202,15,8068,-413,57668,5030,501793,36,16100,8345,"East TN",2455501,1555.07979837923,0.440095630469431,334.025520657495,188.637675162828,2348.52276582253,44.0095630469431
2022-01-18,573486,5957,431944,3674,141542,2283,470443,3736,2684754,3461,3155197,7197,49,8117,156,57824,5752,507545,40,16140,8375,"East TN",2455501,1569.21133406177,0.448446722584654,293.097009530845,242.598150031297,2354.87584814667,44.8446722584654
2022-01-19,581793,8307,437948,6004,143845,2303,476616,6173,2690602,5848,3167218,12021,22,8139,2893,60717,5392,512937,40,16180,8407,"East TN",2455501,1676.11416163137,0.457722577107202,489.553862938765,338.301633760279,2472.69294535005,45.7722577107202
2022-01-20,590078,8285,444004,6056,146074,2229,482884,6268,2696319,5717,3179203,11985,44,8183,3927,64644,4314,517251,36,16216,8439,"East TN",2455501,1715.00642842336,0.472379645648154,488.08776701781,337.405686253029,2632.61957539419,47.2379645648154
2022-01-21,597385,7307,449616,5612,147769,1695,488766,5882,2702042,5723,3190808,11605,53,8236,3179,67823,4075,521326,25,16241,8469,"East TN",2455501,1747.30126357106,0.480921993132212,472.6123100744,297.576747067095,2762.08399019182,48.0921993132212
2022-01-22,603394,6009,454486,4870,148908,1139,493928,5162,2708129,6087,3202057,11249,0,8236,2829,70652,3180,524506,43,16284,8496,"East TN",2455501,1806.63742348303,0.485540183517514,458.114250411627,244.715844139343,2877.29469464684,48.5540183517514
2022-01-23,606996,3602,457463,2977,149533,625,497071,3143,2711399,3270,3208470,6413,6,8242,540,71192,3056,527562,24,16308,8529,"East TN",2455501,1795.92677828272,0.492646202236719,261.168698363389,146.691041868849,2899.28613346116,49.2646202236719
2022-01-24,613685,6689,462144,4681,151541,2008,502031,4960,2716779,5380,3218810,10340,37,8279,-478,70714,7130,534692,40,16348,8564,"East TN",2455501,1879.6978702106,0.498856093772066,421.095328407523,272.408767090708,2879.81963762181,49.8856093772066
2022-01-25,619392,5707,466216,4072,153176,1635,506293,4262,2721434,4655,3227727,8917,30,8309,-1454,69260,7131,541823,29,16377,8593,"East TN",2455501,1869.5166485373,0.494278229698056,363.143814643122,232.416928358001,2820.60565236992,49.4278229698056
2022-01-26,625196,5804,470640,4424,154556,1380,510968,4675,2726328,4894,3237296,9569,27,8336,-1736,67524,7513,549336,33,16410,8626,"East TN",2455501,1767.58225714426,0.490196638031907,389.696440767078,236.36724236724,2749.90724907056,49.0196638031907
2022-01-27,632455,7259,476407,5767,156048,1492,517111,6143,2733482,7154,3250593,13297,29,8365,-333,67191,7563,556899,46,16456,8669,"East TN",2455501,1725.79852339706,0.479436895923799,541.518818359268,295.621952505823,2736.34586180173,47.9436895923799
2022-01-28,637419,4964,480111,3704,157308,1260,521041,3930,2738321,4839,3259362,8769,38,8403,-2429,64762,7355,564254,36,16492,8704,"East TN",2455501,1630.38011387493,0.470796744172477,357.11653141253,202.158337544965,2637.42511202398,47.0796744172477
2022-01-29,641483,4064,483383,3272,158100,792,524587,3546,2743753,5432,3268340,8978,5,8408,212,64974,3847,568101,29,16521,8740,"East TN",2455501,1551.17020925669,0.462546957741804,365.628032731406,165.5059395211,2646.05878800294,46.2546957741804
2022-01-30,643553,2070,484893,1510,158660,560,526181,1594,2746232,2479,3272413,4073,17,8425,-1164,63810,3217,571318,23,16544,8783,"East TN",2455501,1488.77968284273,0.455249206324383,165.872463501338,84.3005154548909,2598.65501989207,45.5249206324383
2022-01-31,647460,3907,487354,2461,160106,1446,528747,2566,2749165,2933,3277912,5499,68,8493,-3042,60768,6881,578199,37,16581,8819,"East TN",2455501,1375.48304806229,0.452032080132652,223.946151925819,159.11213231027,2474.76991457141,45.2032080132652
2022-02-01,652431,4971,490876,3522,161555,1449,532652,3905,2754424,5259,3287076,9164,28,8521,-4997,55771,9940,588139,35,16616,8850,"East TN",2455501,1345.50953145611,0.444135537245783,373.202861656338,202.443411751818,2271.26765576556,44.4135537245783
2022-02-02,657149,4718,494390,3514,162759,1204,536406,3754,2759325,4901,3295731,8655,21,8542,-5033,50738,9730,597869,43,16659,8890,"East TN",2455501,1301.28230450731,0.435321297167793,352.473894329508,192.140015418442,2066.29930103877,43.5321297167793
2022-02-03,666088,8939,497065,2675,169023,6264,539230,2824,2763678,4353,3302908,7177,26,8568,362,51100,8551,606420,39,16698,8916,"East TN",2455501,1369.70011415186,0.422804167064895,292.282511796982,364.039762150372,2081.0417100217,42.2804167064895
2022-02-04,669629,3541,499587,2522,170042,1019,541976,2746,2768269,4591,3310245,7337,12,8580,-3010,48090,6539,612959,30,16728,8943,"East TN",2455501,1311.74860038746,0.411434074248767,298.798493667891,144.206823780565,1958.45980107522,41.1434074248767
2022-02-05,671307,1678,500773,1186,170534,492,543309,1333,2770894,2625,3314203,3958,3,8583,-1796,46294,3471,616430,24,16752,8982,"East TN",2455501,1214.57902073752,0.408215773063254,161.189101531622,68.3363598711627,1885.31790457426,40.8215773063254
2022-02-06,672612,1305,501717,944,170895,361,544394,1085,2773546,2652,3317940,3737,1,8584,-1965,44329,3269,619699,30,16782,9008,"East TN",2455501,1183.42448241723,0.400048322973181,152.188901572429,53.1459771346051,1805.29350222215,40.0048322973181
2022-02-07,675422,2810,503552,1835,171870,975,546367,1973,2776432,2886,3322799,4859,50,8634,-5665,38664,8425,628124,38,16820,9038,"East TN",2455501,1138.74928171481,0.392541270300978,197.882224442181,114.436931607847,1574.58701910527,39.2541270300978
2022-02-08,678091,2669,505263,1711,172828,958,548256,1889,2779099,2667,3327355,4556,21,8655,-4775,33889,7423,635547,41,16861,9070,"East TN",2455501,1045.0005925471,0.387397899649942,185.542583774146,108.694722584108,1380.12568514531,38.7397899649942
2022-02-09,681003,2912,507347,2084,173656,828,550568,2312,2782770,3671,3333338,5983,26,8681,-3079,30810,5965,641512,24,16885,9099,"East TN",2455501,971.451447179211,0.376578828409605,243.65699708532,118.590870050552,1254.733759017,37.6578828409605
2022-02-10,683515,2512,509129,1782,174386,730,552539,1971,2785979,3209,3338518,5180,28,8709,-2924,27886,5408,646920,28,16913,9131,"East TN",2455501,709.712600402118,0.373743330525133,210.954913070693,102.300915373278,1135.65419032613,37.3743330525133
2022-02-11,685817,2302,510857,1728,174960,574,554439,1900,2789343,3364,3343782,5264,31,8740,-1998,25888,4269,651189,37,16950,9157,"East TN",2455501,659.254465789263,0.371619405432806,214.375803552921,93.7486891677096,1054.28586671315,37.1619405432806
2022-02-12,686749,932,511543,686,175206,246,555219,780,2791845,2502,3347064,3282,3,8743,-1255,24633,2184,653373,17,16967,9190,"East TN",2455501,628.873700316147,0.362435714068349,133.65907812703,37.9555943980475,1003.1761339132,36.2435714068349
2022-02-13,687324,575,511958,415,175366,160,555702,483,2793247,1402,3348949,1885,35,8778,-1533,23100,2073,655446,9,16976,9209,"East TN",2455501,599.144533030123,0.364668322100035,76.7664114166518,23.4168098485808,940.74488261255,36.4668322100035
2022-02-14,689568,2244,513390,1432,176178,812,557321,1619,2796254,3007,3353575,4626,146,8924,-2793,20307,4891,660337,22,16998,9235,"East TN",2455501,576.094247161781,0.355926696126852,188.393325842669,91.3866457395049,827.000274078487,35.5926696126852
2022-02-15,691464,1896,514789,1399,176675,497,558854,1533,2799119,2865,3357973,4398,37,8961,-2290,18017,4149,664486,27,17025,9263,"East TN",2455501,544.61390974795,0.346136259716507,179.108051676623,77.2143851702769,733.740283551096,34.6136259716507
2022-02-16,693231,1767,516024,1235,177207,532,560227,1373,2802326,3207,3362553,4580,14,8975,-1715,16302,3468,667954,18,17043,9281,"East TN",2455501,497.983914484254,0.330617833304809,186.519981054783,71.9608747868561,663.897102872285,33.0617833304809
2022-02-17,695029,1798,517301,1277,177728,521,561633,1406,2805849,3523,3367482,4929,13,8988,-1380,14922,3165,671119,20,17063,9302,"East TN",2455501,468.906345385321,0.313975970169866,200.732966510704,73.2233462743448,607.696759235692,31.3975970169866
2022-02-18,696211,1182,518026,725,178185,457,562470,837,2808814,2965,3371284,3802,8,8996,-1221,13701,2395,673514,9,17072,9328,"East TN",2455501,423.294472288954,0.292015126172642,154.836019207486,48.1368160713435,557.971672583314,29.2015126172642
2022-02-19,696748,537,518368,342,178380,195,562881,411,2810916,2102,3373797,2513,1,8997,-761,12940,1297,674811,12,17084,9355,"East TN",2455501,407.208142045147,0.286612052519358,102.341640259971,21.8692641542398,526.980033809801,28.6612052519358
2022-02-20,697117,369,518600,232,178517,137,563153,272,2812352,1436,3375505,1708,8,9005,-945,11995,1306,676117,5,17089,9369,"East TN",2455501,398.818815386351,0.280576894110559,69.5581064719583,15.0274831897849,488.495015884742,28.0576894110559
2022-02-21,697847,730,519010,410,178837,320,563599,446,2813903,1551,3377502,1997,7,9012,-2023,9972,2746,678863,12,17101,9387,"East TN",2455501,337.16133693287,0.262381410122456,81.3275987262884,29.7291672860243,406.108570104431,26.2381410122456
2022-02-22,699022,1175,519662,652,179360,523,564328,729,2816254,2351,3380582,3080,44,9056,-929,9043,2060,680923,19,17120,9403,"East TN",2455501,307.798693627085,0.242115971515768,125.432651015007,47.8517418644912,368.275150366463,24.2115971515768
2022-02-23,699891,869,520134,472,179757,397,564861,533,2818851,2597,3383712,3130,80,9136,-950,8093,1739,682662,7,17127,9426,"East TN",2455501,271.227745376605,0.219008459757077,127.468895349666,35.3899265363769,329.586508007938,21.9008459757077
2022-02-24,700751,860,520624,490,180127,370,565429,568,2821353,2502,3386782,3070,50,9186,-794,7299,1604,684266,12,17139,9443,"East TN",2455501,233.027801658399,0.196683937823834,125.025402148075,35.0234025561382,297.25094797355,19.6683937823834
2022-02-25,701517,766,521078,454,180439,312,565937,508,2823730,2377,3389667,2885,5,9191,-484,6815,1245,685511,22,17161,9455,"East TN",2455501,216.086248794034,0.188598161344721,117.491298109836,31.1952632069789,277.540102814049,18.8598161344721
2022-02-26,701774,257,521260,182,180514,75,566155,218,2825467,1737,3391622,1955,0,9191,-400,6415,657,686168,5,17166,9468,"East TN",2455501,204.683280519943,0.18367461430575,79.6171534851747,10.4662958801483,261.250148136775,18.367461430575
2022-02-27,701797,23,521282,22,180515,1,566185,30,2825822,355,3392007,385,4,9195,-591,5824,610,686778,2,17168,9481,"East TN",2455501,190.592469724101,0.183735304811538,15.6790813768758,0.936672393943232,237.181740101104,18.3735304811538
2022-02-28,702664,867,521741,459,180923,408,566699,514,2828511,2689,3395210,3203,27,9222,-461,5363,1301,688079,16,17184,9497,"East TN",2455501,196.171779201067,0.175062118816354,130.441812078268,35.3084767629905,218.407567335546,17.5062118816354
2022-03-01,703432,768,522106,365,181326,403,567104,405,2830730,2219,3397834,2624,28,9250,-343,5020,1083,689162,15,17199,9504,"East TN",2455501,179.596750316941,0.16090888012984,106.862102682915,31.2767129803653,204.438931199784,16.090888012984
2022-03-02,703893,461,522374,268,181519,193,567415,311,2833043,2313,3400458,2624,8,9258,-363,4657,816,689978,8,17207,9521,"East TN",2455501,162.980996546122,0.152514033201959,106.862102682915,18.7741727655578,189.655797330158,15.2514033201959
2022-03-03,704257,364,522559,185,181698,179,567636,221,2834999,1956,3402635,2177,15,9273,-493,4164,842,690820,10,17217,9532,"East TN",2455501,142.781452746303,0.139216552072163,88.6580783310616,14.823858756319,169.578428190418,13.9216552072163
2022-03-04,704593,336,522771,212,181822,124,567900,264,2837242,2243,3405142,2507,10,9283,-306,3858,632,691452,6,17223,9537,"East TN",2455501,125.269751468234,0.126849757673667,102.097290939812,13.6835619289098,157.116612862304,12.6849757673667
2022-03-05,704734,141,522873,102,181861,39,568016,116,2838954,1712,3406970,1828,0,9283,-198,3660,339,691791,3,17226,9544,"East TN",2455501,120.545664611825,0.121253583528799,74.4450928751403,5.74220902373894,149.053085297053,12.1253583528799
2022-03-06,704833,99,522931,58,181902,41,568088,72,2840166,1212,3408254,1284,2,9285,-200,3460,297,692088,3,17229,9548,"East TN",2455501,123.640756000507,0.117129316181449,52.2907545140483,4.03176378262522,140.908107958417,11.7129316181449
2022-03-07,705099,266,523105,174,181994,92,568300,212,2841870,1704,3410170,1916,13,9298,-390,3070,643,692731,8,17237,9552,"East TN",2455501,99.165099097903,0.10701871657754,78.0288829041405,10.8328198603869,125.025402148075,10.701871657754
2022-03-08,705362,263,523202,97,182160,166,568423,123,2843622,1752,3412045,1875,27,9325,-292,2778,528,693259,5,17242,9560,"East TN",2455501,78.5990313178451,0.0928154246710295,76.35916254972,10.7106452003074,113.133735233665,9.28154246710295
2022-03-09,705656,294,523328,126,182328,168,568572,149,2845634,2012,3414206,2161,23,9348,-221,2557,492,693751,5,17247,9565,"East TN",2455501,71.7979752400834,0.084157695664824,88.0064801439706,11.9731166877961,104.133535274471,8.4157695664824
2022-03-10,705842,186,523426,98,182416,88,568701,129,2847730,2096,3416431,2225,75,9423,-323,2234,434,694185,1,17248,9570,"East TN",2455501,64.5489454086966,0.0771962887793563,90.6128728923344,7.57482892493222,90.979396872573,7.71962887793563
2022-03-11,706054,212,523516,90,182538,122,568805,104,2849920,2190,3418725,2294,79,9502,-198,2036,331,694516,3,17251,9576,"East TN",2455501,59.4990594587418,0.0666274018994331,93.4228900741641,8.63367597895501,82.9158693073226,6.66274018994331
2022-03-12,706123,69,523551,35,182572,34,568846,41,2851205,1285,3420051,1326,0,9502,-119,1917,188,694704,2,17253,9582,"East TN",2455501,56.5668676168326,0.0634508065132635,54.001199755162,2.8100171818297,78.0696077908337,6.34508065132635
2022-03-13,706216,93,523604,53,182612,40,568916,70,2852814,1609,3421730,1679,4,9506,-66,1851,155,694859,1,17254,9584,"East TN",2455501,56.3225182966735,0.0614425645592164,68.3770847578559,3.78741446246611,75.3817652690836,6.14425645592164
2022-03-14,706374,158,523688,84,182686,74,569022,106,2853899,1085,3422921,1191,69,9575,-245,1606,334,695193,0,17254,9587,"East TN",2455501,51.9242305338096,0.0566230099600031,48.5033400515821,6.43453209752307,65.4041680292535,5.66230099600031
2022-03-15,706562,188,523767,79,182795,109,569114,92,2855332,1433,3424446,1525,4,9579,-73,1533,257,695450,2,17256,9589,"East TN",2455501,48.8698640318208,0.0557213127973551,62.1054522071056,7.65627869831859,62.4312513006511,5.57213127973551
2022-03-16,706720,158,523862,95,182858,63,569224,110,2856900,1568,3426124,1678,10,9589,-86,1447,234,695684,5,17261,9592,"East TN",2455501,43.3312794415478,0.0547071656318174,68.3363598711627,6.43453209752307,58.9289110450372,5.47071656318174
2022-03-17,706865,145,523958,96,182907,49,569340,116,2858200,1300,3427540,1416,8,9597,-102,1345,239,695923,0,17261,9595,"East TN",2455501,41.6615590871272,0.0575209289765055,57.6664395575485,5.90510857051168,54.7749726023325,5.75209289765055
2022-03-18,707011,146,524046,88,182965,58,569434,94,2859691,1491,3429125,1585,2,9599,-26,1319,170,696093,0,17261,9596,"East TN",2455501,38.9737165653771,0.0604807692307692,64.5489454086966,5.94583345720486,53.7161255483097,6.04807692307692
2022-03-19,707087,76,524106,60,182981,16,569500,66,2860864,1173,3430364,1239,0,9599,-30,1289,106,696199,0,17261,9596,"East TN",2455501,39.2587907722294,0.0634151071463202,50.458134612855,3.09509138868198,52.4943789475142,6.34151071463202
