"DATE","TOTAL_CASES","NEW_CASES","TOTAL_CONFIRMED","NEW_CONFIRMED","TOTAL_PROBABLE","NEW_PROBABLE","POS_TESTS","NEW_POS_TESTS","NEG_TESTS","NEW_NEG_TESTS","TOTAL_TESTS","NEW_TESTS","NEW_DEATHS","TOTAL_DEATHS","ACTIVE_CHANGE","TOTAL_ACTIVE","NEW_INACTIVE_RECOVERED","TOTAL_INACTIVE_RECOVERED","NEW_HOSPITALIZED","TOTAL_HOSPITALIZED","TOTAL_DEATHS_BY_DOD","Region","Population","New_cases_per_100k_per_week","PositivityRate_per_week","Tests_per_100k","New_cases_per_100k","Active_cases_per_100k","PositivityPercentage_per_week"
2022-02-26,126406,46,97896,33,28510,13,105812,35,539958,275,645770,310,NA,NA,NA,NA,129,123842,0,2648,1278,"Knox County",470313,NA,NA,65.9135511882512,9.7807204989018,NA,NA
2022-02-25,126360,107,97863,67,28497,40,105777,74,539683,406,645460,480,2,1277,-107,1370,212,123713,3,2648,1278,"Knox County",470313,NA,NA,102.059692162454,22.7508063778803,291.295371380336,NA
2022-02-24,126253,144,97796,85,28457,59,105703,94,539277,463,644980,557,1,1275,-115,1477,258,123501,2,2645,1278,"Knox County",470313,NA,NA,118.43176778018,30.6179076487361,314.046177758216,NA
2022-02-23,126109,142,97711,96,28398,46,105609,115,538814,413,644423,528,6,1274,-186,1592,322,123243,1,2643,1277,"Knox County",470313,NA,NA,112.265661378699,30.1926589313925,338.497979005471,NA
2022-02-22,125967,142,97615,87,28352,55,105494,100,538401,356,643895,456,11,1268,-171,1778,302,122921,5,2642,1275,"Knox County",470313,NA,NA,96.9567075543308,30.1926589313925,378.046109718422,NA
2022-02-21,125825,74,97528,45,28297,29,105394,50,538045,290,643439,340,0,1257,-370,1949,444,122619,0,2637,1273,"Knox County",470313,NA,NA,72.2922819484046,15.7342025417116,414.404875051296,NA
2022-02-20,125751,72,97483,48,28268,24,105344,57,537755,289,643099,346,0,1257,-184,2319,256,122175,1,2637,1270,"Knox County",470313,154.577908754383,0.174013921113689,73.5680281004352,15.308953824368,493.075887759854,17.4013921113689
2022-02-19,125679,90,97435,54,28244,36,105287,68,537466,322,642753,390,0,1257,-176,2503,266,121919,1,2636,1269,"Knox County",470313,163.933380535941,0.180174362286083,82.9234998819935,19.13619228046,532.198769755461,18.0174362286083
2022-02-18,125589,142,97381,92,28208,50,105219,114,537144,498,642363,612,0,1257,-262,2679,404,121653,3,2635,1266,"Knox County",470313,171.375233089453,0.185196655311242,130.126107507128,30.1926589313925,569.620656881694,18.5196655311242
2022-02-17,125447,294,97289,231,28158,63,105105,275,536646,1208,641751,1483,1,1257,-238,2941,531,121249,2,2632,1262,"Knox County",470313,203.26888689022,0.18748495788207,315.321923910247,62.5115614495028,625.3282388537,18.748495788207
2022-02-16,125153,224,97058,144,28095,80,104830,159,535438,546,640268,705,3,1256,-380,3179,601,120718,2,2630,1262,"Knox County",470313,220.704084301306,0.189981532779317,149.900172863604,47.6278563424783,675.932836217583,18.9981532779317
2022-02-15,124929,273,96914,215,28015,58,104671,240,534892,592,639563,832,5,1253,-467,3559,735,120117,4,2628,1259,"Knox County",470313,248.557875287309,0.204545454545455,176.903466414919,58.0464499173954,756.730092512859,20.4545454545455
2022-02-14,124656,341,96699,205,27957,136,104431,245,534300,602,638731,847,19,1248,-443,4026,765,119382,7,2624,1256,"Knox County",470313,305.328579052673,0.222051773729626,180.092831794996,72.5049063070764,856.025668012579,22.2051773729626
2022-02-13,124315,120,96494,100,27821,20,104186,116,533698,283,637884,399,1,1229,-273,4469,392,118617,1,2617,1256,"Knox County",470313,315.534548268919,0.231017463933181,84.8371191100395,25.5149230406134,950.218258904177,23.1017463933181
2022-02-12,124195,154,96394,109,27801,45,104070,127,533415,414,637485,541,0,1228,-275,4742,429,118225,2,2616,1255,"Knox County",470313,329.142507223913,0.235467798486806,115.029778041432,32.7441512354538,1008.26470882157,23.5467798486806
2022-02-11,124041,341,96285,250,27756,91,103943,279,533001,631,636944,910,3,1228,-400,5017,738,117796,9,2614,1250,"Knox County",470313,371.454754599596,0.252055273744971,193.488166391318,72.5049063070764,1066.73640745631,25.2055273744971
2022-02-10,123700,425,96035,274,27665,151,103664,302,532370,555,636034,857,7,1225,-434,5417,852,117058,11,2605,1248,"Knox County",470313,399.308545585599,0.288351993714398,182.219075381714,90.3653524355057,1151.78615092502,28.8351993714398
2022-02-09,123275,438,95761,308,27514,130,103362,367,531815,606,635177,973,8,1218,-703,5851,1133,116206,4,2594,1246,"Knox County",470313,444.81015834136,0.3127449150961,206.88350098764,93.1294690982388,1244.06512258857,31.27449150961
2022-02-08,122837,457,95453,334,27384,123,102995,389,531209,462,634204,851,6,1210,-834,6554,1285,115073,7,2590,1243,"Knox County",470313,483.933040336967,0.33934548159167,180.943329229683,97.1693319130026,1393.54004673483,33.934548159167
2022-02-07,122380,589,95119,410,27261,179,102606,441,530747,625,633353,1066,10,1204,-740,7388,1319,113788,11,2583,1236,"Knox County",470313,536.663881287568,0.361086296230123,226.657566344116,125.235747257677,1570.8687618671,36.1086296230123
2022-02-06,121791,253,94709,185,27082,68,102165,215,530122,435,632287,650,0,1194,-368,8128,621,112469,14,2572,1231,"Knox County",470313,564.942920990915,0.362517099863201,138.205833136656,53.7939627439599,1728.21078728421,36.2517099863201
2022-02-05,121538,271,94524,194,27014,77,101950,220,529687,496,631637,716,0,1194,-382,8496,653,111848,5,2558,1228,"Knox County",470313,589.819970955513,0.367424871326581,152.239040808993,57.6212012000519,1806.45655127543,36.7424871326581
2022-02-04,121267,651,94330,512,26937,139,101730,578,529191,963,630921,1541,3,1194,-497,8878,1145,111195,2,2553,1218,"Knox County",470313,655.733522143764,0.377517282837391,327.65413671321,138.418457495328,1887.67905628805,37.7517282837391
2022-02-03,120616,1643,93818,501,26798,1142,101152,504,528228,741,629380,1245,1,1191,137,9375,1505,110050,12,2551,1218,"Knox County",470313,914.70999100599,0.385401874467481,264.717326546364,349.341821297731,1993.35336254792,38.5401874467481
2022-02-02,118973,719,93317,538,25656,181,100648,600,527487,904,628135,1504,7,1190,-1041,9238,1753,108545,5,2539,1217,"Knox County",470313,974.457435792759,0.389145649016242,319.787035442354,152.876913885008,1964.22382540989,38.9145649016242
2022-02-01,118254,938,92779,739,25475,199,100048,834,526583,1139,626631,1973,5,1183,-960,10279,1893,106792,10,2534,1211,"Knox County",470313,1076.72975231388,0.390109258194365,419.507859659418,199.441648434128,2185.56578278721,39.0109258194365
2022-01-31,117316,712,92040,514,25276,198,99214,519,525444,605,624658,1124,11,1178,-696,11239,1397,104899,12,2524,1203,"Knox County",470313,1102.88254843051,0.396435507825888,238.989779147079,151.388543374306,2389.68516711211,39.6435507825888
2022-01-30,116604,389,91526,319,25078,70,98695,336,524839,570,623534,906,1,1167,-252,11935,640,103502,7,2512,1201,"Knox County",470313,1131.79946120988,0.398601398601399,192.637668956631,82.7108755233217,2537.67172074767,39.8601398601399
2022-01-29,116215,679,91207,590,25008,89,98359,646,524269,912,622628,1558,0,1166,-59,12187,738,102862,5,2505,1196,"Knox County",470313,1218.55019954796,0.407775860318749,331.26875081063,144.371939538137,2591.25305913296,40.7775860318749
2022-01-28,115536,938,90617,775,24919,163,97713,834,523357,1040,621070,1874,3,1166,-411,12246,1346,102124,16,2500,1193,"Knox County",470313,1279.57339048676,0.419579732914376,398.458048150912,199.441648434128,2603.7978962946,41.9579732914375
2022-01-27,114598,1435,89842,1202,24756,233,96879,1276,522317,1472,619196,2748,7,1163,57,12657,1371,100778,12,2484,1187,"Knox County",470313,1235.34752388303,0.431676221442629,584.291737630046,305.115954694002,2691.1865077087,43.1676221442629
2022-01-26,113163,999,88640,807,24523,192,95603,854,520845,965,616448,1819,4,1156,-642,12600,1637,99407,4,2472,1179,"Knox County",470313,1294.88234431113,0.441509748375271,386.763708423964,212.411734313106,2679.0669192644,44.1509748375271
2022-01-25,112164,1025,87833,768,24331,257,94749,803,519880,931,614629,1734,7,1152,-434,13242,1452,97770,9,2468,1173,"Knox County",470313,1313.38066351557,0.44784493751594,368.690637936863,217.939967638573,2815.57175753169,44.784493751594
2022-01-24,111139,1321,87065,1082,24074,239,93946,1158,518949,1550,612895,2708,13,1145,-239,13676,1547,96318,13,2459,1167,"Knox County",470313,1442.86889794669,0.44257136435154,575.786763283175,280.876777805419,2907.85072919524,44.257136435154
2022-01-23,109818,769,85983,680,23835,89,92788,709,517399,818,610187,1527,0,1132,122,13915,647,94771,7,2446,1162,"Knox County",470313,1523.66615424196,0.449599083619702,324.677395691805,163.508131818597,2958.66795091779,44.9599083619702
2022-01-22,109049,903,85303,739,23746,164,92079,770,516581,1056,608660,1826,0,1132,186,13793,717,94124,13,2439,1152,"Knox County",470313,1571.29401058444,0.449845462208486,388.252078934667,191.999795880616,2932.72777915984,44.9845462208486
2022-01-21,108146,1517,84564,1230,23582,287,91309,1292,515525,1348,606834,2640,1,1132,577,13607,939,93407,6,2426,1149,"Knox County",470313,1694.4035142554,0.457405679242768,561.328306893494,322.551152105087,2893.17964844689,45.7405679242768
2022-01-20,106629,1409,83334,1170,23295,239,90017,1217,514177,1152,604194,2369,11,1131,477,13030,921,92468,10,2420,1143,"Knox County",470313,1688.87528092993,0.465226013813855,503.707105693442,299.587721368535,2770.49539349327,46.5226013813855
2022-01-19,105220,1675,82164,1311,23056,364,88800,1344,513025,1331,601825,2675,4,1120,366,12553,1305,91547,5,2410,1141,"Knox County",470313,1832.60934739206,0.471154467342852,568.770159447007,356.145800775228,2669.07357440683,47.1154467342852
2022-01-18,103545,1045,80853,665,22692,380,87456,692,511694,686,599150,1378,6,1116,-303,12187,1342,90242,6,2405,1139,"Knox County",470313,1836.86183456549,0.474905772664154,292.99636624971,222.192454812008,2591.25305913296,47.4905772664154
2022-01-17,102500,1088,80188,856,22312,232,86764,900,511008,1279,597772,2179,7,1110,-106,12490,1187,88900,13,2399,1135,"Knox County",470313,1787.32035899497,0.474441551322461,463.308477545805,231.335302234895,2655.67823981051,47.4441551322461
2022-01-16,101412,773,79332,693,22080,80,85864,718,509729,1073,595593,1791,0,1103,278,12596,495,87713,7,2386,1132,"Knox County",470313,1788.17085642965,0.466617310539777,380.810226381155,164.358629253285,2678.21642182972,46.6617310539777
2022-01-15,100639,751,78639,598,22000,153,85146,627,508656,816,593802,1443,1,1103,488,12318,262,87218,12,2379,1128,"Knox County",470313,1755.85195391154,0.469084628670121,306.816949563376,159.680893362505,2619.10685011896,46.9084628670121
2022-01-14,99888,1314,78041,1059,21847,255,84519,1097,507840,1188,592359,2285,6,1102,846,11830,462,86956,9,2367,1126,"Knox County",470313,1712.68920910117,0.467067988668555,485.846659565013,279.388407294717,2515.34616308714,46.7067988668555
2022-01-13,98574,1406,76982,1059,21592,347,83422,1105,506652,1402,590074,2507,6,1096,641,10984,759,86494,11,2358,1121,"Knox County",470313,1712.05133602516,0.454692102679198,533.049267190148,298.94984829252,2335.46595565081,45.4692102679198
2022-01-12,97168,1167,75923,889,21245,278,82317,935,505250,1058,587567,1993,1,1090,456,10343,710,85735,3,2347,1115,"Knox County",470313,1604.03816181989,0.447407189157336,423.760346832854,248.132626569965,2199.1737417422,44.7407189157336
2022-01-11,96001,1366,75034,1061,20967,305,81382,1096,504192,1283,585574,2379,2,1089,735,9887,629,85025,10,2344,1115,"Knox County",470313,1672.29058095354,0.444398710297043,505.83334928016,290.444873945649,2102.21703418787,44.4398710297043
2022-01-10,94635,1002,73973,685,20662,317,80286,715,502909,812,583195,1527,3,1087,415,9152,584,84396,5,2334,1112,"Knox County",470313,1654.00488610776,0.451921005385996,324.677395691805,213.049607389122,1945.93813056411,45.1921005385996
2022-01-09,93633,740,73288,627,20345,113,79571,663,502097,1205,581668,1868,5,1084,462,8737,273,83812,2,2329,1111,"Knox County",470313,1646.98828227159,0.4455077846022,397.182301998882,157.342025417116,1857.69902171533,44.55077846022
2022-01-08,92893,624,72661,477,20232,147,78908,509,500892,912,579800,1421,0,1079,526,8275,98,83539,10,2327,1109,"Knox County",470313,1619.98498872028,0.437768240343348,302.139213672597,132.67759981119,1759.46656800896,43.7768240343348
2022-01-07,92269,966,72184,748,20085,218,78399,764,499980,1091,578379,1855,0,1079,807,7749,159,83441,7,2317,1105,"Knox County",470313,1545.9917119025,0.427084870848708,394.418185336148,205.395130476938,1647.62615534761,42.7084870848709
2022-01-06,91303,1170,71436,745,19867,425,77635,781,498889,1011,576524,1792,2,1079,956,6942,212,83282,7,2310,1105,"Knox County",470313,1495.81236325596,0.425633034670822,381.022850739826,248.77049964598,1476.03829789948,42.5633034670822
2022-01-05,90133,1215,70691,904,19442,311,76854,942,497878,1255,574732,2197,1,1077,995,5986,219,83070,8,2303,1101,"Knox County",470313,1506.0183324722,0.419510698673211,467.135716001897,258.33859578621,1272.76941100926,41.9510698673211
2022-01-04,88918,925,69787,578,19131,347,75912,567,496623,1040,572535,1607,0,1076,725,4991,200,82851,5,2295,1100,"Knox County",470313,1412.25099029795,0.402787967718269,341.687344385547,196.677531771395,1061.20817413084,40.2787967718269
2022-01-03,87993,716,69209,538,18784,178,75345,505,495583,820,570928,1325,6,1076,540,4266,170,82651,6,2290,1095,"Knox County",470313,1351.44042371782,0.392125984251968,281.727275240106,152.239040808993,907.055514093806,39.2125984251969
2022-01-02,87277,290,68671,206,18606,84,74840,265,494763,651,569603,916,3,1070,181,3726,106,82481,8,2284,1093,"Knox County",470313,1255.75946231552,0.389903716368217,194.763912543349,61.6610640148157,792.238360411045,38.9903716368217
2022-01-01,86987,265,68465,215,18522,50,74575,237,494112,767,568687,1004,0,1067,170,3545,95,82375,15,2276,1089,"Knox County",470313,1179.42731755235,0.379674644727001,213.474856106465,56.3454550480212,753.753351491453,37.9674644727001
2021-12-31,86722,591,68250,429,18472,162,74338,470,493345,1008,567683,1478,0,1067,485,3375,106,82280,5,2261,1089,"Knox County",470313,1099.69318305044,0.365054753367574,314.258802116888,125.660995975021,717.607210517251,36.5054753367574
2021-12-30,86131,582,67821,403,18310,179,73868,404,492337,918,566205,1322,2,1067,472,2890,108,82174,6,2256,1086,"Knox County",470313,974.670060151431,0.344197380444715,281.089402164091,123.747376746975,614.484396561439,34.4197380444715
2021-12-29,85549,631,67418,474,18131,157,73464,502,491419,1195,564883,1697,1,1065,506,2418,124,82066,5,2250,1084,"Knox County",470313,850.497434687113,0.315541769173174,360.823536666007,134.165970321892,514.12569926836,31.5541769173174
2021-12-28,84918,429,66944,262,17974,167,72962,283,490224,979,563186,1262,1,1064,304,1912,124,81942,4,2245,1082,"Knox County",470313,745.035752785911,0.296090626388272,268.331940643784,91.2158498701928,406.53777378044,29.6090626388272
2021-12-27,84489,314,66682,234,17807,80,72679,254,489245,905,561924,1159,2,1063,201,1608,111,81818,1,2241,1082,"Knox County",470313,659.560760599856,0.273251866938221,246.431631700591,66.7640486229383,341.899968744219,27.3251866938221
2021-12-26,84175,61,66448,49,17727,12,72425,60,488340,426,560765,486,7,1061,-35,1407,89,81707,1,2240,1081,"Knox County",470313,610.869782464019,0.262844909609895,103.335438314484,12.9700858789785,299.162472651192,26.2844909609895
2021-12-25,84114,85,66399,63,17715,22,72365,74,487914,489,560279,563,1,1054,6,1442,78,81618,1,2239,1081,"Knox County",470313,572.597397903099,0.256934856282164,119.707513932211,18.0730704871011,306.604325204704,25.6934856282164
2021-12-24,84029,174,66336,122,17693,52,72291,137,487425,848,559716,985,0,1053,93,1436,81,81540,2,2238,1081,"Knox County",470313,483.933040336967,0.229328338239229,209.434993291702,36.9966384088894,305.328579052673,22.9328338239229
2021-12-23,83855,218,66214,159,17641,59,72154,166,486577,960,558731,1126,5,1053,112,1343,101,81459,5,2236,1081,"Knox County",470313,406.53777378044,0.20280296784831,239.415027864422,46.3521101904476,285.554513696198,20.280296784831
2021-12-22,83637,177,66055,102,17582,75,71988,101,485617,814,557605,915,48,1048,14,1231,115,81358,11,2231,1080,"Knox County",470313,310.006314943453,0.16548645320197,194.551288184677,37.6345114849047,261.740585524959,16.548645320197
2021-12-21,83460,176,65953,123,17507,53,71887,119,484803,912,556690,1031,3,1000,70,1217,103,81243,6,2220,1078,"Knox County",470313,256.212352199493,0.145411013567438,219.215713790603,37.421887126233,258.763844503554,14.5411013567438
2021-12-20,83284,114,65830,80,17454,34,71768,84,483891,623,555659,707,1,997,-9,1147,122,81140,3,2214,1076,"Knox County",470313,213.687480465137,0.127472905556511,150.325421580947,24.2391768885827,243.88013939653,12.7472905556511
2021-12-19,83170,70,65750,50,17420,20,71684,58,483268,557,554952,615,3,996,-18,1156,85,81018,6,2211,1075,"Knox County",470313,215.601099693183,0.124368899360485,130.763980583144,14.8837051070245,245.793758624576,12.4368899360485
2021-12-18,83100,88,65700,56,17400,32,71626,65,482711,660,554337,725,0,993,13,1174,75,80933,3,2205,1074,"Knox County",470313,216.238972769198,0.11959370904325,154.152660037039,18.7109435631165,249.620997080668,11.959370904325
2021-12-17,83012,119,65644,77,17368,42,71561,83,482051,1034,553612,1117,2,993,6,1161,111,80858,6,2202,1072,"Knox County",470313,204.544633042251,0.108402822322001,237.501408636376,25.3022986819416,246.856880417934,10.8402822322001
2021-12-16,82893,139,65567,107,17326,32,71478,108,481017,661,552495,769,2,991,34,1155,103,80747,3,2196,1070,"Knox County",470313,187.74730870718,0.105119918353461,163.508131818597,29.5547858553772,245.581134265904,10.5119918353461
2021-12-15,82754,157,65460,113,17294,44,71370,125,480356,841,551726,966,0,989,33,1121,124,80644,5,2193,1068,"Knox County",470313,183.494821533745,0.108263069139966,205.395130476938,33.3820243114692,238.351906071063,10.8263069139966
2021-12-14,82597,97,65347,59,17250,38,71245,63,479515,811,550760,874,3,989,-54,1088,148,80520,3,2188,1065,"Knox County",470313,166.697497198674,0.101507015416594,185.833689479134,20.6245627911625,231.335302234895,10.1507015416594
2021-12-13,82500,111,65288,73,17212,38,71182,79,478704,627,549886,706,4,986,-50,1142,157,80372,3,2185,1062,"Knox County",470313,166.059624122659,0.100658350658351,150.112797222275,23.6013038125674,242.817017603171,10.0658350658351
2021-12-12,82389,54,65215,29,17174,25,71103,40,478077,493,549180,533,6,982,-37,1192,85,80215,5,2182,1062,"Knox County",470313,162.65763438391,0.0989455184534271,113.328783172058,11.481715368276,253.44823553676,9.89455184534271
2021-12-11,82335,65,65186,45,17149,20,71063,51,477584,541,548647,592,0,976,-21,1229,86,80130,1,2177,1061,"Knox County",470313,157.767274134459,0.0987943134784956,125.873620333693,13.8205833136656,261.315336807615,9.87943134784956
2021-12-10,82270,84,65141,48,17129,36,71012,57,477043,856,548055,913,0,976,-13,1250,97,80044,3,2176,1058,"Knox County",470313,150.325421580947,0.0977022230524939,194.126039467333,17.8604461284294,265.780448339723,9.77022230524939
2021-12-09,82186,164,65093,96,17093,68,70955,107,476187,1017,547142,1124,3,976,101,1263,60,79947,2,2173,1056,"Knox County",470313,155.641030547742,0.0914505956552207,238.989779147079,34.8703948221716,268.544565002456,9.14505956552208
2021-12-08,82022,130,64997,67,17025,63,70848,65,475170,751,546018,816,0,973,32,1162,98,79887,7,2171,1055,"Knox County",470313,149.900172863604,0.0831234256926952,173.501476676171,27.6411666273312,247.069504776606,8.31234256926952
2021-12-07,81892,127,64930,70,16962,57,70783,76,474419,631,545202,707,2,973,17,1130,108,79789,2,2164,1054,"Knox County",470313,156.278903623757,0.0881098126507142,150.325421580947,27.0032935513158,240.265525299109,8.81098126507142
2021-12-06,81765,148,64860,106,16905,42,70707,115,473788,759,544495,874,8,971,38,1113,102,79681,4,2162,1054,"Knox County",470313,164.146004894613,0.0919230077352042,185.833689479134,31.4684050834232,236.650911201689,9.19230077352042
2021-12-05,81617,43,64754,28,16863,15,70592,33,473029,342,543621,375,2,963,-21,1075,62,79579,1,2158,1051,"Knox County",470313,161.807136949223,0.093316052582855,79.7341345019168,9.14284742288646,228.571185572162,9.3316052582855
2021-12-04,81574,69,64726,50,16848,19,70559,55,472687,499,543246,554,0,961,15,1096,54,79517,3,2157,1051,"Knox County",470313,162.65763438391,0.0947231027410032,117.793894704165,14.6710807483527,233.036297104269,9.47231027410032
2021-12-03,81505,147,64676,103,16829,44,70504,108,472188,1009,542692,1117,3,961,62,1081,82,79463,2,2154,1049,"Knox County",470313,176.052968980232,0.100413148913239,237.501408636376,31.2557807247514,229.846931724192,10.0413148913239
2021-12-02,81358,133,64573,86,16785,47,70396,85,471179,794,541575,879,0,958,31,1019,102,79381,4,2152,1047,"Knox County",470313,169.461613861407,0.100901916572717,186.896811272493,28.2790397033465,216.664221486542,10.0901916572717
2021-12-01,81225,185,64487,142,16738,43,70311,147,470385,1009,540696,1156,4,958,91,988,90,79279,7,2148,1045,"Knox County",470313,181.155953588355,0.109325326739668,245.793758624576,39.335506354279,210.072866367717,10.9325326739668
2021-11-30,81040,116,64345,66,16695,50,70164,68,469376,693,539540,761,3,954,16,897,97,79189,6,2141,1044,"Knox County",470313,178.817085642965,0.106892932120364,161.807136949223,24.6644256059263,190.724049728585,10.6892932120364
2021-11-29,80924,165,64279,128,16645,37,70096,139,468683,967,538779,1106,2,951,75,881,88,79092,5,2135,1041,"Knox County",470313,182.431699740386,0.106758574310693,235.162540690987,35.0830191808434,187.322059989837,10.6758574310693
2021-11-28,80759,33,64151,22,16608,11,69957,22,467716,270,537673,292,3,949,-24,806,54,79004,5,2130,1040,"Knox County",470313,180.305456153668,0.106393861892583,62.0863127321592,7.01660383616868,171.375233089453,10.6393861892583
2021-11-27,80726,59,64129,31,16597,28,69935,32,467446,266,537381,298,0,946,1,830,58,78950,1,2125,1039,"Knox County",470313,178.17921256695,0.107149224460688,63.3620588841899,12.5448371616349,176.478217697576,10.7149224460688
2021-11-26,80667,20,64098,18,16569,2,69903,20,467180,298,537083,318,0,946,-45,829,65,78892,4,2124,1037,"Knox County",470313,151.175919015634,0.106652806652807,67.6145460576254,4.25248717343556,176.265593338904,10.6652806652807
2021-11-25,80647,52,64080,26,16567,26,69883,29,466882,331,536765,360,0,946,-18,874,70,78827,3,2120,1036,"Knox County",470313,133.95334596322,0.106501980890235,76.5447691218401,11.0564666509325,185.833689479134,10.6501980890235
2021-11-24,80595,105,64054,66,16541,39,69854,73,466551,742,536405,815,0,946,18,892,87,78757,3,2117,1031,"Knox County",470313,116.943397269478,0.0969620253164557,173.288852317499,22.3255576605367,189.660927935226,9.69620253164557
2021-11-23,80490,99,63988,63,16502,36,69781,65,465809,674,535590,739,0,946,37,874,62,78670,2,2114,1027,"Knox County",470313,113.328783172058,0.0967413441955193,157.129401058444,21.049811508506,185.833689479134,9.67413441955193
2021-11-22,80391,107,63925,83,16466,24,69716,82,465135,740,534851,822,0,946,37,837,70,78608,3,2112,1027,"Knox County",470313,100.996570369095,0.0886388583973655,174.777222828202,22.7508063778803,177.966588208278,8.86388583973655
2021-11-21,80284,44,63842,32,16442,12,69634,37,464395,284,534029,321,0,946,-9,800,53,78538,2,2109,1027,"Knox County",470313,103.335438314484,0.0920228695888919,68.2524191336408,9.35547178155824,170.099486937423,9.20228695888919
2021-11-20,80240,54,63810,37,16430,17,69597,44,464111,537,533708,581,0,946,14,809,40,78485,1,2107,1025,"Knox County",470313,102.272316521125,0.0884732052578362,123.534752388303,11.481715368276,172.013106165469,8.84732052578362
2021-11-19,80186,112,63773,83,16413,29,69553,81,463574,825,533127,906,0,946,62,795,50,78445,0,2106,1025,"Knox County",470313,121.833757518929,0.0904489436619718,192.637668956631,23.8139281712392,169.036365144064,9.04489436619718
2021-11-18,80074,80,63690,44,16384,36,69472,49,462749,937,532221,986,3,946,18,733,59,78395,2,2106,1025,"Knox County",470313,127.787239561739,0.0833655705996132,209.647617650373,17.0099486937423,155.853654906413,8.33655705996132
2021-11-17,79994,105,63646,64,16348,41,69423,66,461812,833,531235,899,0,943,44,715,61,78336,1,2104,1025,"Knox County",470313,127.787239561739,0.0807004187285877,191.149298445929,22.3255576605367,152.026416450321,8.07004187285877
2021-11-16,79889,73,63582,51,16307,22,69357,67,460979,777,530336,844,0,943,9,671,64,78275,2,2103,1024,"Knox County",470313,122.259006236272,0.0794924426198918,179.454958718981,15.5215781830398,142.670944668763,7.94924426198918
2021-11-15,79816,84,63531,44,16285,40,69290,34,460202,460,529492,494,3,943,21,662,60,78211,0,2101,1021,"Knox County",470313,117.368645986822,0.075134168157424,105.036433183858,17.8604461284294,140.757325440717,7.5134168157424
2021-11-14,79732,72,63487,62,16245,10,69256,68,459742,624,528998,692,0,940,16,641,56,78151,2,2101,1021,"Knox County",470313,123.322128029631,0.0757126990003702,147.13605620087,15.308953824368,136.29221390861,7.57126990003702
2021-11-13,79660,29,63425,13,16235,16,69188,12,459118,317,528306,329,0,940,-14,625,43,78095,2,2099,1019,"Knox County",470313,118.006519062837,0.0732038834951456,69.953414003015,6.16610640148157,132.890224169861,7.32038834951456
2021-11-12,79631,66,63412,49,16219,17,69176,51,458801,687,527977,738,0,940,17,639,49,78052,4,2097,1019,"Knox County",470313,108.225798563935,0.069650742673625,156.916776699772,14.0332076723374,135.866965191266,6.96507426736251
2021-11-11,79565,67,63363,46,16202,21,69125,54,458114,962,527239,1016,0,940,-3,622,70,78003,0,2093,1017,"Knox County",470313,105.461681901202,0.0702314445331205,216.026348410527,14.2458320310091,132.252351093846,7.02314445331205
2021-11-10,79498,74,63317,50,16181,24,69071,69,457152,855,526223,924,1,940,7,625,66,77933,2,2093,1017,"Knox County",470313,98.8703267823768,0.0704784594004368,196.464907412723,15.7342025417116,132.890224169861,7.04784594004368
2021-11-09,79424,106,63267,76,16157,30,69002,134,456297,1174,525299,1308,1,939,34,618,71,77867,1,2091,1017,"Knox County",470313,105.886930618546,0.0767133248500273,278.112661142686,22.5381820192085,131.401853659159,7.67133248500273
2021-11-08,79318,78,63191,58,16127,20,68868,70,455123,687,523991,757,6,938,-10,584,82,77796,1,2090,1016,"Knox County",470313,104.611184466515,0.0794587092297016,160.956639514536,16.5846999763987,124.172625464318,7.94587092297016
2021-11-07,79240,31,63133,20,16107,11,68798,23,454436,390,523234,413,0,932,-20,594,51,77714,1,2089,1013,"Knox County",470313,95.8935857609719,0.0752962625341841,87.8138601314444,6.59135511882512,126.298869051036,7.52962625341841
2021-11-06,79209,41,63113,27,16096,14,68775,30,454046,453,522821,483,0,932,-2,614,43,77663,2,2088,1010,"Knox County",470313,98.4450780650333,0.0764319914878525,102.697565238469,8.7175987055429,130.551356224472,7.64319914878525
2021-11-05,79168,52,63086,32,16082,20,68745,36,453593,605,522338,641,0,932,-27,616,79,77620,2,2086,1009,"Knox County",470313,95.4683370436284,0.0750631540959942,136.29221390861,11.0564666509325,130.976604941815,7.50631540959942
2021-11-04,79116,68,63054,45,16062,23,68709,49,452988,668,521697,717,0,932,-1,643,69,77541,1,2084,1009,"Knox County",470313,95.6809614023002,0.0783902345985123,152.451665167665,14.4584563896809,136.717462625953,7.83902345985123
2021-11-03,79048,80,63009,60,16039,20,68660,66,452320,969,520980,1035,0,932,-1,644,81,77472,2,2083,1008,"Knox County",470313,96.9567075543308,0.0762047067613,220.06621122529,17.0099486937423,136.930086984625,7.62047067613
2021-11-02,78968,41,62949,19,16019,22,68594,22,451351,301,519945,323,4,932,-52,645,89,77391,1,2081,1006,"Knox County",470313,83.1361242406653,0.0677500572213321,68.6776678509843,8.7175987055429,137.142711343297,6.77500572213321
2021-11-01,78927,95,62930,71,15997,24,68572,83,451050,661,519622,744,1,928,-19,697,113,77302,3,2080,1003,"Knox County",470313,86.7507383380855,0.0709366391184573,158.192522851803,20.1993140738189,148.199177994229,7.09366391184573
2021-10-31,78832,26,62859,20,15973,6,68489,19,450389,278,518878,297,0,927,-43,716,69,77189,1,2077,1002,"Knox County",470313,85.6876165447266,0.0719339622641509,63.1494345255181,5.52823332546623,152.239040808993,7.19339622641509
2021-10-30,78806,56,62839,41,15967,15,68470,43,450111,522,518581,565,0,927,-23,759,79,77120,4,2076,1001,"Knox County",470313,88.8769819248033,0.0735770476631189,120.132762649555,11.9069640856196,161.38188823188,7.35770476631189
2021-10-29,78750,73,62798,59,15952,14,68427,66,449589,846,518016,912,1,927,-37,782,109,77041,1,2072,1001,"Knox County",470313,93.3420934569106,0.0757674722403658,193.913415108662,15.5215781830398,166.272248481331,7.57674722403658
2021-10-28,78677,54,62739,32,15938,22,68361,39,448743,561,517104,600,4,926,-52,819,102,76932,3,2071,1000,"Knox County",470313,90.3653524355057,0.0755138516532618,127.574615203067,11.481715368276,174.139349752186,7.55138516532618
2021-10-27,78623,88,62707,57,15916,31,68322,65,448182,759,516504,824,1,922,-29,871,116,76830,3,2068,998,"Knox County",470313,92.0663473048799,0.0790152403282532,175.202471545545,18.7109435631165,185.195816403119,7.90152403282532
2021-10-26,78535,96,62650,58,15885,38,68257,55,447423,554,515680,609,0,921,-18,900,114,76714,5,2065,995,"Knox County",470313,103.760687031828,0.0813008130081301,129.488234431113,20.4119384324907,191.3619228046,8.13008130081301
2021-10-25,78439,71,62592,47,15847,24,68202,54,446869,491,515071,545,6,921,-73,918,138,76600,3,2060,993,"Knox County",470313,98.6577024237051,0.0783547794117647,115.880275476119,15.0963294656962,195.189161260692,7.83547794117647
2021-10-24,78368,38,62545,20,15823,18,68148,23,446378,337,514526,360,1,915,-73,991,110,76462,5,2057,992,"Knox County",470313,101.209194727766,0.0781426953567384,76.5447691218401,8.07972562952757,210.710739443732,7.81426953567384
2021-10-23,78330,59,62525,40,15805,19,68125,42,446041,471,514166,513,0,914,-15,1064,74,76352,1,2052,989,"Knox County",470313,101.847067803782,0.0788448315379326,109.076295998622,12.5448371616349,226.232317626772,7.88448315379326
2021-10-22,78271,90,62485,55,15786,35,68083,55,445570,551,513653,606,0,914,-69,1079,159,76278,2,2051,987,"Knox County",470313,105.461681901202,0.0820803549420754,128.850361355098,19.13619228046,229.421683006849,8.20803549420754
2021-10-21,78181,124,62430,71,15751,53,68028,78,445019,712,513047,790,3,914,-22,1148,143,76119,2,2049,985,"Knox County",470313,120.345387008226,0.0875912408759124,167.973243350705,26.3654204753005,244.092763755201,8.75912408759124
2021-10-20,78057,149,62359,83,15698,66,67950,90,444307,959,512257,1049,3,911,-46,1170,192,75976,3,2047,983,"Knox County",470313,133.315472887205,0.0887745974955277,223.042952246695,31.6810294420949,248.77049964598,8.87745974955277
2021-10-19,77908,131,62276,85,15632,46,67860,92,443348,724,511208,816,4,908,-40,1216,167,75784,4,2044,981,"Knox County",470313,140.757325440717,0.0927548621500321,173.501476676171,27.8537909860029,258.551220144882,9.27548621500321
2021-10-18,77777,121,62191,90,15586,31,67768,106,442624,607,510392,713,9,904,-74,1256,186,75617,8,2040,979,"Knox County",470313,151.388543374306,0.100268207138436,151.601167732978,25.7275473992852,267.056194491753,10.0268207138436
2021-10-17,77656,63,62101,56,15555,7,67662,61,442017,303,509679,364,1,895,-65,1330,127,75431,4,2032,976,"Knox County",470313,156.7041523411,0.108018965161822,77.3952665565272,13.395334596322,282.790397033465,10.8018965161822
2021-10-16,77593,55,62045,41,15548,14,67601,44,441714,372,509315,416,0,894,-83,1395,138,75304,1,2028,974,"Knox County",470313,155.853654906413,0.110643668489693,88.4517332074597,11.6943397269478,296.610980347131,11.0643668489693
2021-10-15,77538,125,62004,89,15534,36,67557,100,441342,794,508899,894,9,894,-68,1478,184,75166,5,2027,970,"Knox County",470313,163.295507459926,0.113248710829036,190.08617665257,26.5780448339723,314.258802116888,11.3248710829036
2021-10-14,77413,192,61915,135,15498,57,67457,143,440548,699,508005,842,0,885,8,1546,184,74982,7,2022,968,"Knox County",470313,177.753963849607,0.124852767962309,179.029710001637,40.8238768649814,328.717258506569,12.4852767962309
2021-10-13,77221,121,61780,88,15441,33,67314,99,439849,764,507163,863,7,885,-78,1538,192,74798,5,2015,963,"Knox County",470313,171.800481806797,0.131418092909535,183.494821533745,25.7275473992852,327.016263637195,13.1418092909535
2021-10-12,77100,136,61692,104,15408,32,67215,109,439085,821,506300,930,4,878,-81,1616,213,74606,3,2010,962,"Knox County",470313,172.863603600156,0.131819992035046,197.740653564754,28.9169127793618,343.600963613593,13.1819992035046
2021-10-11,76964,194,61588,136,15376,58,67106,149,438264,581,505370,730,3,874,-87,1697,278,74393,12,2007,953,"Knox County",470313,188.385181783195,0.139908712046041,155.215781830398,41.249125582325,360.823536666007,13.9908712046041
2021-10-10,76770,54,61452,41,15318,13,66957,51,437683,489,504640,540,0,871,-89,1784,143,74115,4,1995,952,"Knox County",470313,186.471562555149,0.13326941514861,114.81715368276,11.481715368276,379.321855870452,13.326941514861
2021-10-09,76716,66,61411,37,15305,29,66906,48,437194,490,504100,538,0,871,-66,1873,132,73972,7,1991,949,"Knox County",470313,188.810430500539,0.1309724564362,114.391904965417,14.0332076723374,398.24542379224,13.09724564362
2021-10-08,76650,289,61374,114,15276,175,66858,123,436704,936,503562,1059,-1,871,76,1939,214,73840,5,1984,945,"Knox County",470313,223.680825322711,0.131225009087605,225.169195833413,61.4484396561439,412.278631464578,13.1225009087605
2021-10-07,76361,259,61260,170,15101,89,66735,176,435768,1106,502503,1282,6,872,-9,1863,262,73626,9,1979,941,"Knox County",470313,237.92665735372,0.127061595422417,272.58442781722,55.0697088959905,396.119180205523,12.7061595422417
2021-10-06,76102,139,61090,103,15012,36,66559,112,434662,835,501221,947,1,866,-120,1872,258,73364,4,1970,940,"Knox County",470313,241.753895809812,0.12744772651842,201.355267662174,29.5547858553772,398.032799433569,12.744772651842
2021-10-05,75963,210,60987,118,14976,92,66447,138,433827,915,500274,1053,3,865,-71,1992,278,73106,4,1966,935,"Knox County",470313,257.488098351523,0.129614571475037,223.893449681382,44.6511153210734,423.547722474182,12.9614571475037
2021-10-04,75753,316,60869,224,14884,92,66309,245,432912,829,499221,1074,3,862,-14,2063,327,72828,4,1962,931,"Knox County",470313,283.42827010948,0.137532727552749,228.35856121349,67.1892973402819,438.644051939878,13.7532727552749
2021-10-03,75437,102,60645,93,14792,9,66064,107,432083,678,498147,785,1,859,-67,2077,168,72501,6,1958,929,"Knox County",470313,293.634239325726,0.140842980112793,166.910121557346,21.6876845845214,441.620792961283,14.0842980112793
2021-10-02,75335,67,60552,43,14783,24,65957,50,431405,472,497362,522,5,858,-144,2144,206,72333,2,1952,928,"Knox County",470313,293.846863684397,0.141475751264505,110.989915226668,14.2458320310091,455.866624992292,14.1475751264505
2021-10-01,75268,225,60509,151,14759,74,65907,167,430933,965,496840,1132,0,853,-76,2288,301,72127,9,1950,924,"Knox County",470313,280.238904729404,0.146431199411332,240.690774016453,47.8404807011501,486.484532641028,14.6431199411332
2021-09-30,75043,240,60358,166,14685,74,65740,186,429968,1104,495708,1290,1,853,-112,2364,351,71826,8,1941,921,"Knox County",470313,276.19904191464,0.147728943113332,274.285422686594,51.0298460812268,502.643983900084,14.7728943113332
2021-09-29,74803,361,60192,170,14611,191,65554,192,428864,1111,494418,1303,6,852,-96,2476,451,71475,7,1933,919,"Knox County",470313,323.401649539775,0.151557480094985,277.049539349327,76.7573934805119,526.457912071323,15.1557480094985
2021-09-28,74442,348,60022,249,14420,99,65362,270,427753,778,493115,1048,2,846,-75,2572,421,71024,1,1926,916,"Knox County",470313,352.74381103648,0.170114621190942,222.830327888024,73.9932768177788,546.869850503813,17.0114621190942
2021-09-27,74094,239,59773,162,14321,77,65092,186,426975,760,492067,946,7,844,-303,2647,535,70603,12,1925,913,"Knox County",470313,336.371735418753,0.164816396242528,201.142643303502,50.817221722555,562.816677404197,16.4816396242528
2021-09-26,73855,124,59611,99,14244,25,64906,117,426215,703,491121,820,2,837,-143,2950,265,70068,1,1913,907,"Knox County",470313,341.049471309532,0.165415663503753,174.351974110858,26.3654204753005,627.241858081746,16.5415663503753
2021-09-25,73731,110,59512,90,14219,20,64789,102,425512,705,490301,807,0,835,-178,3093,288,69803,3,1912,902,"Knox County",470313,350.192318732419,0.166076776476994,171.587857448125,23.3886794538956,657.64714137181,16.6076776476994
2021-09-24,73621,244,59422,165,14199,79,64687,182,424807,939,489494,1121,13,835,-232,3271,463,69515,5,1909,895,"Knox County",470313,354.232181547182,0.168370824812543,238.351906071063,51.8803435159139,695.494277215386,16.8370824812543
2021-09-23,73377,355,59257,246,14120,109,64505,268,423868,1370,488373,1638,14,822,-222,3503,563,69052,8,1904,892,"Knox County",470313,378.683982794437,0.171417415072237,348.278699504373,75.4816473284812,744.823128427239,17.1417415072237
2021-09-22,73022,251,59011,187,14011,64,64237,202,422498,1261,486735,1463,3,808,-329,3725,577,68489,4,1896,889,"Knox County",470313,355.295303340541,0.169195460920566,311.069436736811,53.3687140266163,792.025736052374,16.9195460920566
2021-09-21,72771,397,58824,216,13947,181,64035,230,421237,996,485272,1226,10,805,-353,4054,740,67912,7,1892,880,"Knox County",470313,365.713896915458,0.160453808752026,260.6774637316,84.4118703926959,861.979150055389,16.0453808752026
2021-09-20,72374,432,58608,310,13766,122,63805,343,420241,1295,484046,1638,5,795,113,4407,314,67172,9,1885,876,"Knox County",470313,406.750398139112,0.165729369907035,348.278699504373,91.8537229462082,937.035548666526,16.5729369907035
2021-09-19,71942,120,58298,87,13644,33,63462,97,418946,432,482408,529,1,790,-176,4294,295,66858,7,1876,869,"Knox County",470313,405.899900704425,0.169080978389931,112.478285737371,25.5149230406134,913.008996136615,16.9080978389931
2021-09-18,71822,226,58211,183,13611,43,63365,197,418514,1075,481879,1272,0,789,-107,4470,333,66563,7,1869,861,"Knox County",470313,430.564326310351,0.170923821312029,270.458184230502,48.0531050598219,950.430883262848,17.0923821312029
2021-09-17,71596,547,58028,422,13568,125,63168,449,417439,1310,480607,1759,5,789,5,4577,537,66230,12,1862,848,"Knox County",470313,494.9895069879,0.18750656167979,374.006246903658,116.305524193463,973.181689640729,18.750656167979
2021-09-16,71049,588,57606,456,13443,132,62719,487,416129,1518,478848,2005,7,784,10,4572,571,65693,16,1850,843,"Knox County",470313,544.530982558424,0.202689041649818,426.311839136915,125.023122899006,972.11856784737,20.2689041649818
2021-09-15,70461,338,57150,249,13311,89,62232,267,414611,807,476843,1074,6,777,-308,4562,640,65122,5,1834,840,"Knox County",470313,563.029301762869,0.217825949700095,228.35856121349,71.867033231061,969.992324260652,21.7825949700095
2021-09-14,70123,555,56901,443,13222,112,61965,476,413804,1406,475769,1882,12,771,-160,4870,703,64482,8,1829,836,"Knox County",470313,596.62395043301,0.227975194408899,400.159043020287,118.006519062837,1035.48062673156,22.7975194408899
2021-09-13,69568,399,56458,299,13110,100,61489,333,412398,1134,473887,1467,20,759,-434,5030,813,63779,15,1821,833,"Knox County",470313,589.607346596841,0.230877052462956,311.919934171499,84.8371191100395,1069.50052411904,23.0877052462956
2021-09-12,69169,387,56159,358,13010,29,61156,376,411264,1460,472420,1836,0,739,80,5464,307,62966,5,1806,824,"Knox County",470313,646.378050362206,0.228862328463922,390.378322521385,82.2856268059781,1161.7794957826,22.8862328463922
2021-09-11,68782,865,55801,706,12981,159,60780,763,409804,2621,470584,3384,4,739,499,5384,362,62659,26,1801,816,"Knox County",470313,782.245015553472,0.235026478705154,719.520829745297,183.920070251088,1144.76954708885,23.5026478705154
2021-09-10,67917,1026,55095,749,12822,277,60017,803,407183,2513,467200,3316,1,735,481,4885,544,62297,24,1775,806,"Knox County",470313,884.092083357254,0.234228815824646,705.062373355616,218.152591997244,1038.66999211164,23.4228815824646
2021-09-09,66891,310,54346,167,12545,143,59214,173,404670,685,463884,858,1,734,-370,4404,679,61753,18,1751,799,"Knox County",470313,824.982511646499,0.230947383657813,182.431699740386,65.9135511882512,936.397675590511,23.0947383657813
2021-09-08,66581,290,54179,226,12402,64,59041,250,403985,837,463026,1087,5,733,-405,4774,690,61074,11,1733,794,"Knox County",470313,814.776542430254,0.229501084598698,231.122677876223,61.6610640148157,1015.06868829907,22.9501084598698
2021-09-07,66291,414,53953,299,12338,115,58791,311,403148,979,461939,1290,3,728,-221,5179,632,60384,13,1722,788,"Knox County",470313,784.796507857533,0.227300196404291,274.285422686594,88.0264844901162,1101.18155356114,22.7300196404291
2021-09-06,65877,991,53654,791,12223,200,58480,844,402169,3221,460649,4065,1,725,341,5400,649,59752,20,1709,787,"Knox County",470313,910.670128191226,0.222278353119475,864.318018000778,210.710739443732,1148.1715368276,22.2278353119475
2021-09-05,64886,969,52863,799,12023,170,57636,834,398948,2999,456584,3833,2,724,623,5059,344,59103,15,1689,784,"Knox County",470313,1034.4175049382,0.223069590085796,814.989166788926,206.033003552953,1075.66663052053,22.3069590085796
2021-09-04,63917,542,52064,388,11853,154,56802,407,395949,1502,452751,1909,2,722,223,4436,317,58759,10,1674,778,"Knox County",470313,965.739837087216,0.221420711578433,405.899900704425,115.242402400104,943.201655068008,22.1420711578433
2021-09-03,63375,334,51676,238,11699,96,56395,249,394447,909,450842,1158,5,720,-155,4213,484,58442,8,1664,774,"Knox County",470313,818.603780886346,0.216056338028169,246.219007341919,71.0165357963739,895.786423084201,21.6056338028169
2021-09-02,63041,323,51438,180,11603,143,56146,200,393538,681,449684,881,3,715,-158,4368,478,57958,5,1656,769,"Knox County",470313,821.367897549079,0.217605287210856,187.322059989837,68.6776678509843,928.743198678327,21.7605287210856
2021-09-01,62718,276,51258,211,11460,65,55946,226,392857,645,448803,871,3,712,-119,4526,392,57480,2,1651,766,"Knox County",470313,818.391156527674,0.219247519097594,185.195816403119,58.6843229934108,962.337847348468,21.9247519097594
2021-08-31,62442,594,51047,433,11395,161,55720,479,392212,1894,447932,2373,2,709,189,4645,403,57088,8,1649,763,"Knox County",470313,856.663541088594,0.214645460569914,504.55760312813,126.298869051036,987.640146030409,21.4645460569914
2021-08-30,61848,513,50614,403,11234,110,55241,430,390318,1630,445559,2060,9,707,96,4456,408,56685,12,1641,759,"Knox County",470313,755.029097643484,0.215896064195644,438.006178863863,109.076295998622,947.454142241443,21.5896064195644
2021-08-29,61335,483,50211,407,11124,76,54811,439,388688,1485,443499,1924,1,698,255,4360,227,56277,5,1629,753,"Knox County",470313,651.693659329,0.217430207587688,409.089266084501,102.697565238469,927.042203808953,21.7430207587688
2021-08-28,60852,397,49804,301,11048,96,54372,320,387203,1065,441575,1385,0,697,192,4105,205,56050,4,1624,746,"Knox County",470313,620.863127321592,0.219958693203154,294.484736760413,84.4118703926959,872.822992347649,21.9958693203154
2021-08-27,60455,472,49503,373,10952,99,54052,390,386138,1166,440190,1556,5,697,195,3913,272,55845,5,1620,743,"Knox County",470313,650.205288818298,0.224796380090498,330.843502093287,100.358697293079,831.999115482668,22.4796380090498
2021-08-26,59983,449,49130,347,10853,102,53662,368,384972,1426,438634,1794,5,692,154,3718,290,55573,0,1615,742,"Knox County",470313,676.995958010942,0.221683524199615,381.44809945717,95.4683370436284,790.537365541671,22.1683524199615
2021-08-25,59534,351,48783,224,10751,127,53294,238,383546,642,436840,880,2,687,92,3564,257,55283,4,1615,737,"Knox County",470313,692.942784911325,0.222519211493485,187.109435631165,74.6311498937941,757.793214306217,22.2519211493485
2021-08-24,59183,342,48559,222,10624,120,53056,237,382904,677,435960,914,4,685,75,3472,263,55026,5,1611,727,"Knox County",470313,639.361446526037,0.230381432512128,194.338663826005,72.7175306657481,738.231773308414,23.0381432512128
2021-08-23,58841,287,48337,206,10504,81,52819,227,382227,825,435046,1052,1,681,30,3397,256,54763,1,1606,727,"Knox County",470313,591.308341466215,0.233456075749605,223.680825322711,61.0231909388003,722.28494640803,23.3456075749605
2021-08-22,58554,240,48131,217,10423,23,52592,233,381402,889,433994,1122,2,680,70,3367,168,54507,0,1605,723,"Knox County",470313,539.640622308973,0.231299551878663,238.564530429735,51.0298460812268,715.906215647877,23.1299551878663
2021-08-21,58314,496,47914,373,10400,123,52359,411,380513,1904,432872,2315,0,678,381,3297,115,54339,8,1605,721,"Knox County",470313,560.690433817479,0.218415862140558,492.225390325166,105.461681901202,701.022510540853,21.8415862140558
2021-08-20,57818,425,47541,331,10277,94,51948,357,378609,1148,430557,1505,0,678,231,2916,194,54224,6,1597,718,"Knox County",470313,550.697088959905,0.216134418701732,319.999659801026,90.3653524355057,620.012629886905,21.6134418701732
2021-08-19,57393,368,47210,254,10183,114,51591,264,377461,952,429052,1216,1,678,204,2685,163,54030,6,1591,715,"Knox County",470313,533.474515907491,0.218458462905375,258.551220144882,78.2457639912144,570.896403033724,21.8458462905375
2021-08-18,57025,263,46956,191,10069,72,51327,200,376509,914,427836,1114,2,677,98,2481,163,53867,5,1585,715,"Knox County",470313,514.763572344375,0.208811431045681,236.863535560361,55.9202063306777,527.521033864682,20.8811431045681
2021-08-17,56762,263,46765,180,9997,83,51127,197,375595,1042,426722,1239,0,675,101,2383,162,53704,5,1580,715,"Knox County",470313,497.966248009304,0.197532155181428,263.441580394333,55.9202063306777,506.683846714847,19.7532155181428
2021-08-16,56499,185,46585,126,9914,59,50930,132,374553,422,425483,554,2,675,-26,2282,209,53542,5,1575,712,"Knox County",470313,476.278563424783,0.197904026475455,117.793894704165,39.335506354279,485.208786488998,19.7904026475455
2021-08-15,56314,204,46459,181,9855,23,50798,198,374131,953,424929,1151,3,673,80,2308,121,53333,6,1570,712,"Knox County",470313,468.624086512599,0.193424235759842,244.730636831217,43.3753691690427,490.737019814464,19.3424235759842
2021-08-14,56110,219,46278,147,9832,72,50600,154,373178,794,423778,948,0,670,96,2228,123,53212,4,1564,711,"Knox County",470313,409.727139160517,0.194383331176394,201.567892020846,46.5647345491194,473.727071120722,19.4383331176394
2021-08-13,55891,266,46131,205,9760,61,50446,220,372384,1470,422830,1690,1,670,124,2132,141,53089,5,1560,709,"Knox County",470313,375.919866131704,0.172522750252781,359.335166155305,56.558079406693,453.315132688231,17.2522750252781
2021-08-12,55625,222,45926,145,9699,77,50226,153,370914,643,421140,796,2,669,82,2008,138,52948,8,1555,706,"Knox County",470313,344.876709765624,0.167378537106247,169.248989502735,47.2026076251348,426.949712212931,16.7378537106247
2021-08-11,55403,316,45781,238,9622,78,50073,248,370271,989,420344,1237,1,667,183,1926,132,52810,10,1547,704,"Knox County",470313,356.145800775228,0.170978332239002,263.01633167699,67.1892973402819,409.514514801845,17.0978332239002
2021-08-10,55087,173,45543,109,9544,64,49825,121,369282,621,419107,742,1,666,56,1743,116,52678,2,1537,701,"Knox County",470313,337.009608494768,0.172239393087946,157.767274134459,36.7840140502176,370.604257164909,17.2239393087946
2021-08-09,54914,197,45434,159,9480,38,49704,167,368661,753,418365,920,1,665,75,1687,121,52562,4,1535,697,"Knox County",470313,339.56110079883,0.168492784607162,195.614409978036,41.8869986583403,358.69729307929,16.8492784607162
2021-08-08,54717,88,45275,66,9442,22,49537,75,367908,418,417445,493,1,664,22,1612,65,52441,4,1531,696,"Knox County",470313,314.896675192903,0.166715499560504,104.823808825187,18.7109435631165,342.750466178906,16.6715499560504
2021-08-07,54629,105,45209,75,9420,30,49462,80,367490,638,416952,718,0,663,44,1590,61,52376,2,1527,696,"Knox County",470313,290.657498304321,0.161309884778654,152.664289526337,22.3255576605367,338.072730288127,16.1309884778654
2021-08-06,54524,203,45134,147,9390,56,49382,163,366852,879,416234,1042,0,663,139,1546,64,52315,11,1525,696,"Knox County",470313,277.262163707999,0.169300605245461,221.554581735993,43.162744810371,328.717258506569,16.9300605245461
2021-08-05,54321,174,44987,131,9334,43,49219,147,365973,850,415192,997,2,663,102,1407,70,52251,4,1514,695,"Knox County",470313,267.056194491753,0.162790697674419,211.986485595763,36.9966384088894,299.162472651192,16.2790697674419
2021-08-04,54147,144,44856,101,9291,43,49072,104,365123,656,414195,760,1,661,70,1305,73,52181,4,1510,693,"Knox County",470313,230.484804800208,0.151093088857546,161.594512590551,30.6179076487361,277.47478806667,15.1093088857546
2021-08-03,54003,238,44755,177,9248,61,48968,183,364467,814,413435,997,0,660,161,1235,77,52108,5,1506,692,"Knox County",470313,244.305388113873,0.155053146617176,211.986485595763,50.6045973638832,262.591082959646,15.5053146617176
2021-08-02,53765,97,44578,75,9187,22,48785,82,363653,532,412438,614,2,660,-3,1074,98,52031,3,1501,689,"Knox County",470313,223.042952246695,0.148372175769436,130.551356224472,20.6245627911625,228.35856121349,14.8372175769436
2021-08-01,53668,107,44503,91,9165,16,48703,99,363121,526,411824,625,0,658,63,1077,44,51933,2,1498,689,"Knox County",470313,227.082815061459,0.149139579349904,132.890224169861,22.7508063778803,228.996434289505,14.9139579349904
2021-07-31,53561,104,44412,64,9149,40,48604,68,362595,399,411199,467,1,658,46,1014,57,51889,6,1496,687,"Knox County",470313,226.870190702787,0.153762268266085,99.2955754997204,22.1129333018649,215.601099693183,15.3762268266085
2021-07-30,53457,118,44348,83,9109,35,48536,90,362196,339,410732,429,1,657,79,968,38,51832,0,1490,687,"Knox County",470313,208.797120215686,0.158110042953569,91.2158498701928,25.0896743232698,205.820379194281,15.8110042953569
2021-07-29,53339,117,44265,65,9074,52,48446,68,361857,483,410303,551,0,656,82,889,35,51794,1,1490,686,"Knox County",470313,196.677531771395,0.156200765248706,117.15602162815,24.877049964598,189.023054859211,15.6200765248706
2021-07-28,53222,131,44200,90,9022,41,48378,95,361374,536,409752,631,0,656,80,807,51,51759,4,1489,685,"Knox County",470313,193.913415108662,0.15878535002318,134.165970321892,27.8537909860029,171.587857448125,15.878535002318
2021-07-27,53091,117,44110,78,8981,39,48283,84,360838,499,409121,583,0,656,85,727,32,51708,4,1485,685,"Knox County",470313,168.185867709377,0.15025641025641,123.960001105647,24.877049964598,154.577908754383,15.025641025641
2021-07-26,52974,97,44032,73,8942,24,48199,79,360339,371,408538,450,1,656,61,642,35,51676,4,1481,685,"Knox County",470313,168.185867709377,0.156049250535332,95.6809614023002,20.6245627911625,136.504838267282,15.6049250535332
2021-07-25,52877,51,43959,43,8918,8,48120,44,359968,320,408088,364,3,655,22,581,26,51641,5,1477,685,"Knox County",470313,156.278903623757,0.151942446043165,77.3952665565272,10.8438422922607,123.534752388303,15.1942446043165
2021-07-24,52826,64,43916,42,8910,22,48076,44,359648,348,407724,392,0,652,39,559,25,51615,1,1472,684,"Knox County",470313,147.773929276886,0.148235294117647,83.348748599337,13.6079589549938,118.857016497524,14.8235294117647
2021-07-23,52762,56,43874,31,8888,25,48032,32,359300,321,407332,353,1,652,24,520,31,51590,3,1471,682,"Knox County",470313,134.591219039236,0.134175691937425,75.0563986111377,11.9069640856196,110.564666509325,13.4175691937425
2021-07-22,52706,94,43843,69,8863,25,48000,78,358979,474,406979,552,0,651,70,496,24,51559,3,1468,681,"Knox County",470313,129.700858789785,0.137142857142857,117.368645986822,19.9866897151471,105.461681901202,13.7142857142857
2021-07-21,52612,61,43774,47,8838,14,47922,46,358505,411,406427,457,1,651,33,426,27,51535,1,1465,681,"Knox County",470313,114.81715368276,0.129165344335132,97.1693319130026,12.9700858789785,90.5779767941775,12.9165344335132
2021-07-20,52551,78,43727,43,8824,35,47876,45,358094,299,405970,344,0,650,54,393,24,51508,3,1464,681,"Knox County",470313,106.524803694561,0.126373626373626,73.1427793830917,16.5846999763987,83.5613729580088,12.6373626373626
2021-07-19,52473,48,43684,36,8789,12,47831,42,357795,348,405626,390,0,650,28,339,20,51484,0,1461,681,"Knox County",470313,96.1062101196437,0.116058906030856,82.9234998819935,10.2059692162454,72.0796575897328,11.6058906030856
2021-07-18,52425,36,43648,30,8777,6,47789,31,357447,272,405236,303,0,650,27,311,9,51464,1,1461,681,"Knox County",470313,92.9168447395671,0.113937656753852,64.4251806775488,7.65447691218401,66.126175546923,11.3937656753852
2021-07-17,52389,27,43618,20,8771,7,47758,21,357175,202,404933,223,0,650,12,284,15,51455,1,1460,680,"Knox County",470313,85.0497434687113,0.112509534706331,47.4152319838065,5.74085768413801,60.385317862785,11.2509534706331
2021-07-16,52362,37,43598,21,8764,16,47737,22,356973,291,404710,313,0,650,25,272,12,51440,1,1459,680,"Knox County",470313,81.0098806539475,0.110379550735864,66.5514242642666,7.86710127085579,57.8338255587237,11.0379550735864
2021-07-15,52325,55,43577,42,8748,13,47715,44,356682,364,404397,408,-1,650,36,247,20,51428,1,1458,680,"Knox County",470313,72.7175306657481,0.102953240360952,86.7507383380855,11.6943397269478,52.5182165919292,10.2953240360952
2021-07-14,52270,21,43535,17,8735,4,47671,16,356318,269,403989,285,0,651,8,211,13,51408,2,1457,680,"Knox County",470313,64.212556318877,0.0975286849073257,60.5979422214568,4.46511153210734,44.8637396797452,9.75286849073257
2021-07-13,52249,42,43518,26,8731,16,47655,29,356049,355,403704,384,3,651,28,203,11,51395,3,1455,680,"Knox County",470313,56.558079406693,0.0888985255854293,81.6477537299628,8.93022306421468,43.162744810371,8.88985255854293
2021-07-12,52207,27,43492,21,8715,6,47626,24,355694,270,403320,294,0,648,16,175,11,51384,1,1452,680,"Knox County",470313,52.0929678745856,0.0846153846153846,62.5115614495028,5.74085768413801,37.2092627675612,8.46153846153846
2021-07-11,52180,8,43471,3,8709,5,47602,4,355424,136,403026,140,0,648,1,159,7,51373,0,1451,679,"Knox County",470313,46.1394858317759,0.0781631656082071,29.7674102140489,1.70099486937423,33.8072730288127,7.81631656082071
2021-07-10,52172,20,43468,16,8704,4,47598,16,355288,191,402886,207,0,648,12,158,8,51366,2,1451,679,"Knox County",470313,44.6511153210734,0.0763170851797144,44.0132422450581,4.25248717343556,33.5946486701409,7.63170851797144
2021-07-09,52152,27,43452,21,8700,6,47582,21,355097,338,402679,359,0,648,12,146,15,51358,0,1449,679,"Knox County",470313,42.5248717343556,0.0741454020221473,76.3321447631684,5.74085768413801,31.0431563660796,7.41454020221473
2021-07-08,52125,19,43431,14,8694,5,47561,16,354759,317,402320,333,0,648,6,134,13,51343,0,1449,678,"Knox County",470313,34.8703948221716,0.0629370629370629,70.8039114377021,4.03986281476378,28.4916640620183,6.29370629370629
2021-07-07,52106,18,43417,5,8689,13,47545,5,354442,333,401987,338,1,648,8,128,9,51330,1,1449,676,"Knox County",470313,34.2325217461563,0.0559610705596107,71.867033231061,3.82723845609201,27.2159179099876,5.59610705596107
2021-07-06,52088,24,43412,9,8676,15,47540,14,354109,263,401649,277,0,647,14,120,10,51321,2,1448,676,"Knox County",470313,30.4052832900643,0.0513347022587269,58.8969473520825,5.10298460812268,25.5149230406134,5.13347022587269
2021-07-05,52064,10,43403,7,8661,3,47526,6,353846,105,401372,111,0,647,0,106,10,51311,1,1446,676,"Knox County",470313,26.790669192644,0.0464589235127479,23.6013038125674,2.12624358671778,22.5381820192085,4.64589235127479
2021-07-04,52054,8,43396,7,8658,1,47520,7,353741,143,401261,150,0,647,0,106,8,51301,1,1445,676,"Knox County",470313,26.790669192644,0.047887323943662,31.8936538007667,1.70099486937423,22.5381820192085,4.7887323943662
2021-07-03,52046,9,43389,7,8657,2,47513,7,353598,185,401111,192,0,647,-2,106,11,51293,1,1444,676,"Knox County",470313,24.4518012472545,0.0431818181818182,40.8238768649814,1.913619228046,22.5381820192085,4.31818181818182
2021-07-02,52037,17,43382,13,8655,4,47506,17,353413,342,400919,359,-1,647,11,108,7,51282,0,1443,676,"Knox County",470313,22.3255576605367,0.0409090909090909,76.3321447631684,3.61461409742023,22.963430736552,4.09090909090909
2021-07-01,52020,18,43369,15,8651,3,47489,17,353071,248,400560,265,-1,648,13,97,6,51275,1,1443,676,"Knox County",470313,22.1129333018649,0.0431442080378251,56.3454550480212,3.82723845609201,20.6245627911625,4.31442080378251
2021-06-30,52002,18,43354,12,8648,6,47472,11,352823,299,400295,310,0,649,9,84,9,51269,0,1442,676,"Knox County",470313,22.1129333018649,0.0474759615384615,65.9135511882512,3.82723845609201,17.8604461284294,4.74759615384615
2021-06-29,51984,21,43342,16,8642,5,47461,19,352524,438,399985,457,0,649,8,75,13,51260,1,1442,676,"Knox County",470313,21.4750602258496,0.0455531453362256,97.1693319130026,4.46511153210734,15.9468269003834,4.55531453362256
2021-06-28,51963,9,43326,2,8637,7,47442,2,352086,113,399528,115,0,649,-4,67,13,51247,0,1441,676,"Knox County",470313,21.2624358671778,0.0432900432900433,24.4518012472545,1.913619228046,14.2458320310091,4.32900432900433
2021-06-27,51954,5,43324,3,8630,2,47440,3,351973,151,399413,154,0,649,0,71,5,51234,0,1441,676,"Knox County",470313,20.6245627911625,0.041036717062635,32.7441512354538,1.06312179335889,15.0963294656962,4.1036717062635
2021-06-26,51949,3,43321,2,8628,1,47437,2,351822,206,399259,208,0,649,0,71,3,51229,0,1441,676,"Knox County",470313,19.3488166391318,0.0380085653104925,44.2258666037299,0.637873076015334,15.0963294656962,3.80085653104925
2021-06-25,51946,13,43319,9,8627,4,47435,11,351616,311,399051,322,0,649,4,71,9,51226,0,1441,676,"Knox County",470313,18.4983192044447,0.0354997269251775,68.4650434923126,2.76411666273312,15.0963294656962,3.54997269251775
2021-06-24,51933,14,43310,9,8623,5,47424,10,351305,364,398729,374,1,649,8,67,5,51217,1,1441,676,"Knox County",470313,17.6478217697576,0.0298969072164948,79.521510143245,2.97674102140489,14.2458320310091,2.98969072164948
2021-06-23,51919,13,43301,6,8618,7,47414,8,350941,282,398355,290,0,648,6,59,7,51212,0,1440,675,"Knox County",470313,16.5846999763987,0.0286458333333333,61.6610640148157,2.76411666273312,12.5448371616349,2.86458333333333
2021-06-22,51906,14,43295,5,8611,9,47406,5,350659,247,398065,252,2,648,10,53,2,51205,1,1440,674,"Knox County",470313,15.0963294656962,0.0239067055393586,53.5813383852881,2.97674102140489,11.2690910096042,2.39067055393586
2021-06-21,51892,9,43290,8,8602,1,47401,9,350412,289,397813,298,0,646,5,43,4,51203,1,1439,673,"Knox County",470313,15.0963294656962,0.0252897787144362,63.3620588841899,1.913619228046,9.14284742288646,2.52897787144363
2021-06-20,51883,3,43282,2,8601,1,47392,3,350123,161,397515,164,1,646,-2,38,4,51199,0,1438,673,"Knox County",470313,14.6710807483527,0.0251572327044025,34.8703948221716,0.637873076015334,8.07972562952757,2.51572327044025
2021-06-19,51880,3,43280,1,8600,2,47389,1,349962,191,397351,192,0,645,-3,40,6,51195,0,1438,673,"Knox County",470313,14.6710807483527,0.0248414376321353,40.8238768649814,0.637873076015334,8.50497434687113,2.48414376321353
2021-06-18,51877,5,43279,3,8598,2,47388,3,349771,283,397159,286,1,645,-7,43,11,51189,0,1438,673,"Knox County",470313,12.9700858789785,0.0210129310344828,60.8105665801286,1.06312179335889,9.14284742288646,2.10129310344828
2021-06-17,51872,12,43276,8,8596,4,47385,9,349488,515,396873,524,0,644,6,50,6,51178,0,1438,673,"Knox County",470313,12.5448371616349,0.0189431704885344,111.415163944012,2.55149230406134,10.6312179335889,1.89431704885344
2021-06-16,51860,7,43268,4,8592,3,47376,4,348973,362,396349,366,1,644,-6,44,12,51172,0,1438,672,"Knox County",470313,11.2690910096042,0.0163304514889529,77.8205152738708,1.48837051070245,9.35547178155824,1.63304514889529
2021-06-15,51853,13,43264,9,8589,4,47372,14,348611,428,395983,442,0,643,-2,50,15,51160,0,1438,672,"Knox County",470313,11.0564666509325,0.0189260563380282,93.9799665329259,2.76411666273312,10.6312179335889,1.89260563380282
2021-06-14,51840,7,43255,2,8585,5,47358,3,348183,260,395541,263,1,643,-5,52,11,51145,0,1438,672,"Knox County",470313,10.6312179335889,0.0165400089405454,55.9202063306777,1.48837051070245,11.0564666509325,1.65400089405454
2021-06-13,51833,3,43253,3,8580,0,47355,4,347923,128,395278,132,0,642,-5,57,8,51134,1,1438,672,"Knox County",470313,10.6312179335889,0.0172335600907029,28.0664153446747,0.637873076015334,12.1195884442914,1.72335600907029
2021-06-12,51830,2,43250,1,8580,1,47351,1,347795,226,395146,227,0,642,-6,62,8,51126,0,1437,672,"Knox County",470313,10.4185935749171,0.0169642857142857,48.2657294184936,0.425248717343556,13.1827102376502,1.69642857142857
2021-06-11,51828,7,43249,3,8579,4,47350,2,347569,318,394919,320,0,642,-2,68,9,51118,0,1437,671,"Knox County",470313,10.8438422922607,0.0162708883025506,68.039794774969,1.48837051070245,14.4584563896809,1.62708883025506
2021-06-10,51821,7,43246,4,8575,3,47348,5,347251,358,394599,363,0,642,-1,70,8,51109,0,1437,670,"Knox County",470313,9.7807204989018,0.0156176053005206,77.1826421978555,1.48837051070245,14.8837051070245,1.56176053005206
2021-06-09,51814,2,43242,1,8572,1,47343,1,346893,367,394236,368,1,642,-17,71,18,51101,0,1437,670,"Knox County",470313,8.7175987055429,0.0141843971631206,78.2457639912144,0.425248717343556,15.0963294656962,1.41843971631206
2021-06-08,51812,5,43241,3,8571,2,47342,4,346526,266,393868,270,1,641,-17,88,21,51083,0,1437,669,"Knox County",470313,7.01660383616868,0.0102933607822954,57.4085768413801,1.06312179335889,18.7109435631165,1.02933607822954
2021-06-07,51807,16,43238,10,8569,6,47338,10,346260,316,393598,326,0,640,-7,105,23,51062,2,1437,668,"Knox County",470313,8.93022306421468,0.0134596211365902,69.3155409269997,3.40198973874845,22.3255576605367,1.34596211365902
2021-06-06,51791,4,43228,2,8563,2,47328,2,345944,178,393272,180,0,640,-5,112,9,51039,0,1435,668,"Knox County",470313,9.14284742288646,0.0121713729308666,38.2723845609201,0.850497434687113,23.8139281712392,1.21713729308666
2021-06-05,51787,5,43226,2,8561,3,47326,3,345766,258,393092,261,0,640,-9,117,14,51030,0,1435,667,"Knox County",470313,9.7807204989018,0.0129310344827586,55.4949576133341,1.06312179335889,24.877049964598,1.29310344827586
2021-06-04,51782,7,43224,2,8558,5,47323,3,345508,325,392831,328,1,640,-9,126,15,51016,0,1435,667,"Knox County",470313,9.7807204989018,0.0133587786259542,69.7407896443432,1.48837051070245,26.790669192644,1.33587786259542
2021-06-03,51775,7,43222,4,8553,3,47320,6,345183,458,392503,464,0,639,-12,135,19,51001,0,1435,667,"Knox County",470313,9.7807204989018,0.0131998179335457,98.6577024237051,1.48837051070245,28.7042884206901,1.31998179335457
2021-06-02,51768,20,43218,7,8550,13,47314,6,344725,282,392039,288,0,639,5,147,15,50982,1,1435,667,"Knox County",470313,13.6079589549938,0.0160604629192253,61.2358152974721,4.25248717343556,31.2557807247514,1.60604629192253
2021-06-01,51748,12,43211,9,8537,3,47308,10,344443,291,391751,301,0,639,-10,142,22,50967,1,1434,667,"Knox County",470313,15.0963294656962,0.0186219739292365,63.9999319602052,2.55149230406134,30.1926589313925,1.86219739292365
2021-05-31,51736,17,43202,14,8534,3,47298,12,344152,354,391450,366,0,639,-1,152,18,50945,0,1433,667,"Knox County",470313,15.308953824368,0.0191956124314442,77.8205152738708,3.61461409742023,32.3189025181103,1.91956124314442
2021-05-30,51719,3,43188,1,8531,2,47286,1,343798,203,391084,204,0,639,-9,153,12,50927,0,1433,667,"Knox County",470313,15.0963294656962,0.0185352622061483,43.3753691690427,0.637873076015334,32.5315268767821,1.85352622061483
2021-05-29,51716,14,43187,8,8529,6,47285,6,343595,199,390880,205,0,639,-14,162,28,50915,1,1433,666,"Knox County",470313,17.0099486937423,0.0204081632653061,43.5879935277145,2.97674102140489,34.4451461048281,2.04081632653061
2021-05-28,51702,11,43179,6,8523,5,47279,10,343396,390,390675,400,0,639,-9,176,20,50887,1,1432,664,"Knox County",470313,17.8604461284294,0.0228904847396768,85.0497434687113,2.33886794538956,37.421887126233,2.28904847396768
2021-05-27,51691,23,43173,8,8518,15,47269,9,343006,341,390275,350,0,639,-5,185,28,50867,1,1431,664,"Knox County",470313,21.2624358671778,0.0255439924314096,74.4185255351224,4.8903602494509,39.335506354279,2.55439924314096
2021-05-26,51668,16,43165,8,8503,8,47260,11,342665,571,389925,582,0,639,-8,190,24,50839,0,1430,664,"Knox County",470313,20.4119384324907,0.0245016611295681,123.747376746975,3.40198973874845,40.3986281476379,2.45016611295681
2021-05-25,51652,18,43157,8,8495,10,47249,7,342094,311,389343,318,0,639,-10,198,28,50815,1,1430,664,"Knox County",470313,21.6876845845214,0.0230927835051546,67.6145460576254,3.82723845609201,42.0996230170121,2.30927835051546
2021-05-24,51634,25,43149,21,8485,4,47242,24,341783,425,389025,449,0,639,-11,208,36,50787,1,1429,664,"Knox County",470313,23.3886794538956,0.0271132376395534,95.4683370436284,5.31560896679445,44.2258666037299,2.71132376395534
2021-05-23,51609,16,43128,8,8481,8,47218,8,341358,225,388576,233,1,639,-5,219,20,50751,1,1428,663,"Knox County",470313,26.1527961166287,0.0295624753646039,49.5414755705243,3.40198973874845,46.5647345491194,2.95624753646039
2021-05-22,51593,8,43120,4,8473,4,47210,4,341133,269,388343,273,0,638,-6,224,14,50731,0,1427,662,"Knox County",470313,24.877049964598,0.0280230326295585,58.0464499173954,1.70099486937423,47.6278563424783,2.80230326295585
2021-05-21,51585,16,43116,12,8469,4,47206,14,340864,377,388070,391,0,638,-16,230,32,50717,1,1427,662,"Knox County",470313,25.9401717579569,0.0296610169491525,83.1361242406653,3.40198973874845,48.903602494509,2.96610169491525
2021-05-20,51569,34,43104,26,8465,8,47192,27,340487,594,387679,621,0,638,6,246,28,50685,1,1426,661,"Knox County",470313,28.2790397033465,0.0331356818974538,132.039726735174,7.22922819484046,52.3055922332574,3.31356818974538
2021-05-19,51535,14,43078,6,8457,8,47165,6,339893,544,387058,550,0,638,-29,240,43,50657,1,1425,660,"Knox County",470313,27.8537909860029,0.0317460317460317,116.943397269478,2.97674102140489,51.0298460812268,3.17460317460317
2021-05-18,51521,24,43072,14,8449,10,47159,14,339349,444,386508,458,1,638,-21,269,44,50614,0,1424,660,"Knox County",470313,29.1295371380336,0.0326050420168067,97.3819562716744,5.10298460812268,57.1959524827083,3.26050420168067
2021-05-17,51497,15,43058,8,8439,7,47145,8,338905,420,386050,428,0,637,-18,290,33,50570,0,1424,659,"Knox County",470313,27.0032935513158,0.0274204468517265,91.0032255115211,3.18936538007667,61.6610640148157,2.74204468517265
2021-05-16,51482,22,43050,13,8432,9,47137,12,338485,272,385622,284,1,637,-10,308,31,50537,1,1424,659,"Knox County",470313,28.2790397033465,0.0282861896838602,60.385317862785,4.67773589077912,65.4883024709077,2.82861896838602
2021-05-15,51460,23,43037,13,8423,10,47125,17,338213,336,385338,353,0,636,-8,318,31,50506,2,1423,658,"Knox County",470313,31.4684050834232,0.0317666126418152,75.0563986111377,4.8903602494509,67.6145460576254,3.17666126418152
2021-05-14,51437,36,43024,25,8413,11,47108,26,337877,498,384985,524,0,636,4,326,32,50475,4,1421,657,"Knox County",470313,35.7208922568587,0.0341827221876942,111.415163944012,7.65447691218401,69.3155409269997,3.41827221876942
2021-05-13,51401,31,42999,17,8402,14,47082,17,337379,376,384461,393,0,636,-17,322,48,50443,0,1417,657,"Knox County",470313,35.0830191808434,0.0334448160535117,83.5613729580088,6.59135511882512,68.4650434923126,3.34448160535117
2021-05-12,51370,34,42982,28,8388,6,47065,26,337003,506,384068,532,0,636,-15,339,49,50395,0,1417,657,"Knox County",470313,39.335506354279,0.0403768506056528,113.116158813386,7.22922819484046,72.0796575897328,4.03768506056528
2021-05-11,51336,36,42954,30,8382,6,47039,31,336497,555,383536,586,0,636,-11,354,47,50346,4,1417,657,"Knox County",470313,41.8869986583403,0.0441935483870968,124.597874181662,7.65447691218401,75.2690229698095,4.41935483870968
2021-05-10,51300,21,42924,14,8376,7,47008,13,335942,277,382950,290,1,636,-26,365,46,50299,1,1413,657,"Knox County",470313,43.162744810371,0.0479405806887238,61.6610640148157,4.46511153210734,77.607890915199,4.79405806887238
2021-05-09,51279,17,42910,14,8369,3,46995,17,335665,369,382660,386,0,635,-22,391,39,50253,1,1412,656,"Knox County",470313,42.0996230170121,0.047976501305483,82.0730024473064,3.61461409742023,83.1361242406653,4.7976501305483
2021-05-08,51262,20,42896,11,8366,9,46978,14,335296,307,382274,321,0,635,-18,413,38,50214,1,1411,656,"Knox County",470313,41.4617499409967,0.0474934036939314,68.2524191336408,4.25248717343556,87.8138601314444,4.74934036939314
2021-05-07,51242,43,42885,31,8357,12,46964,33,334989,576,381953,609,0,635,3,431,40,50176,0,1410,656,"Knox County",470313,42.9501204516992,0.0484440166827077,129.488234431113,9.14284742288646,91.6410985875364,4.84440166827077
2021-05-06,51199,40,42854,26,8345,14,46931,28,334413,340,381344,368,1,635,-8,428,47,50136,0,1410,656,"Knox County",470313,44.8637396797452,0.0523932729624838,78.2457639912144,8.50497434687113,91.0032255115211,5.23932729624838
2021-05-05,51159,51,42828,32,8331,19,46903,38,334073,585,380976,623,0,634,5,436,46,50089,4,1410,655,"Knox County",470313,48.4783537771654,0.0546654099905749,132.464975452518,10.8438422922607,92.7042203808953,5.46654099905749
2021-05-04,51108,50,42796,32,8312,18,46865,34,333488,536,380353,570,0,634,6,431,44,50043,0,1406,655,"Knox County",470313,51.4550947985703,0.0558888538048626,121.195884442914,10.6312179335889,91.6410985875364,5.58888538048626
2021-05-03,51058,24,42764,9,8294,15,46831,7,332952,309,379783,316,1,634,-37,425,60,49999,1,1406,655,"Knox County",470313,52.0929678745856,0.053554650798622,67.1892973402819,5.10298460812268,90.3653524355057,5.3554650798622
2021-05-02,51034,25,42755,18,8279,7,46824,20,332643,288,379467,308,0,633,-17,462,42,49939,2,1405,654,"Knox County",470313,53.7939627439599,0.0558587479935795,65.4883024709077,5.31560896679445,98.2324537063615,5.58587479935795
2021-05-01,51009,45,42737,35,8272,10,46804,38,332355,450,379159,488,0,633,7,479,38,49897,2,1403,654,"Knox County",470313,59.1095717107543,0.0603290676416819,103.760687031828,9.56809614023002,101.847067803782,6.03290676416819
2021-04-30,50964,58,42702,30,8262,28,46766,29,331905,567,378671,596,0,633,-9,472,67,49859,3,1401,654,"Knox County",470313,62.298937090831,0.0593453655552157,126.72411776838,12.3322128029631,100.358697293079,5.93453655552157
2021-04-29,50906,54,42672,34,8234,20,46737,35,331338,571,378075,606,0,633,-2,481,56,49792,2,1398,653,"Knox County",470313,65.2756781122359,0.0573139435414885,128.850361355098,11.481715368276,102.272316521125,5.73139435414885
2021-04-28,50852,47,42638,28,8214,19,46702,34,330767,543,377469,577,4,633,-38,483,81,49736,1,1396,653,"Knox County",470313,64.4251806775488,0.0569199653279399,122.684254953616,9.99334485757357,102.697565238469,5.69199653279399
2021-04-27,50805,39,42610,17,8195,22,46668,20,330224,392,376892,412,1,629,-33,521,71,49655,2,1395,651,"Knox County",470313,62.0863127321592,0.0554041780199818,87.6012357727726,8.29234998819935,110.777290867996,5.54041780199818
2021-04-26,50766,69,42593,36,8173,33,46648,40,329832,480,376480,520,1,628,2,554,66,49584,0,1393,650,"Knox County",470313,71.6544088723892,0.0615911035072712,110.564666509325,14.6710807483527,117.793894704165,6.15911035072712
2021-04-25,50697,38,42557,25,8140,13,46608,26,329352,341,375960,367,0,627,-4,552,42,49518,3,1393,648,"Knox County",470313,74.4185255351224,0.0622546270330903,78.0331396325426,8.07972562952757,117.368645986822,6.22546270330903
2021-04-24,50659,35,42532,22,8127,13,46582,28,329011,510,375593,538,0,627,-28,556,63,49476,3,1390,648,"Knox County",470313,72.2922819484046,0.0586283185840708,114.391904965417,7.44185255351224,118.219143421509,5.86283185840708
2021-04-23,50624,43,42510,31,8114,12,46554,36,328501,553,375055,589,0,627,-4,584,47,49413,2,1387,647,"Knox County",470313,69.1029165683279,0.0606816292601829,125.235747257677,9.14284742288646,124.172625464318,6.06816292601829
2021-04-22,50581,79,42479,62,8102,17,46518,65,327948,787,374466,852,1,627,15,588,63,49366,1,1385,646,"Knox County",470313,74.4185255351224,0.064591439688716,181.155953588355,16.7973243350705,125.023122899006,6.4591439688716
2021-04-21,50502,62,42417,34,8085,28,46453,35,327161,479,373614,514,1,626,-2,573,63,49303,1,1384,645,"Knox County",470313,77.607890915199,0.0659282700421941,109.288920357294,13.1827102376502,121.833757518929,6.59282700421941
2021-04-20,50440,38,42383,34,8057,4,46418,39,326682,474,373100,513,1,625,-32,575,69,49240,1,1383,644,"Knox County",470313,77.3952665565272,0.0690983817107629,109.076295998622,8.07972562952757,122.259006236272,6.90983817107629
2021-04-19,50402,65,42349,41,8053,24,46379,39,326208,336,372587,375,0,624,-3,607,68,49171,0,1382,643,"Knox County",470313,76.5447691218401,0.0715048025613661,79.7341345019168,13.8205833136656,129.062985713769,7.15048025613661
2021-04-18,50337,38,42308,27,8029,11,46340,32,325872,364,372212,396,0,624,-12,610,50,49103,1,1382,643,"Knox County",470313,76.5447691218401,0.0725443473656341,84.1992460340241,8.07972562952757,129.700858789785,7.25443473656341
2021-04-17,50299,37,42281,18,8018,19,46308,23,325508,335,371816,358,0,624,-23,622,60,49053,1,1381,642,"Knox County",470313,76.9700178391837,0.0747845426744509,76.1195204044966,7.86710127085579,132.252351093846,7.47845426744509
2021-04-16,50262,346,42263,330,7999,16,46285,369,325173,2088,371458,2457,1,624,279,645,66,48993,4,1380,642,"Knox County",470313,141.395198516732,0.110155535224154,522.418049256559,73.5680281004352,137.142711343297,11.0155535224154
2021-04-15,49916,86,41933,54,7983,32,45916,55,323085,577,369001,632,1,623,12,366,73,48927,0,1376,641,"Knox County",470313,142.883569027435,0.112869399428027,134.378594680564,18.2856948457729,77.8205152738708,11.2869399428027
2021-04-14,49830,85,41879,60,7951,25,45861,62,322508,684,368369,746,0,622,-1,354,86,48854,3,1376,640,"Knox County",470313,147.773929276886,0.113018075588826,158.617771569146,18.0730704871011,75.2690229698095,11.3018075588826
2021-04-13,49745,68,41819,38,7926,30,45799,43,321824,339,367623,382,-5,622,-8,355,81,48768,1,1373,640,"Knox County",470313,154.152660037039,0.116535727646839,81.2225050126193,14.4584563896809,75.4816473284812,11.6535727646839
2021-04-12,49677,63,41781,43,7896,20,45756,50,321485,360,367241,410,1,627,-24,363,86,48687,0,1372,640,"Knox County",470313,153.727411319696,0.11782196617729,87.175987055429,13.395334596322,77.1826421978555,11.782196617729
2021-04-11,49614,26,41738,14,7876,12,45706,14,321125,296,366831,310,2,626,-26,387,50,48601,0,1372,639,"Knox County",470313,151.175919015634,0.116336166194523,65.9135511882512,5.52823332546623,82.2856268059781,11.6336166194523
2021-04-10,49588,50,41724,33,7864,17,45692,41,320829,571,366521,612,0,624,6,413,44,48551,1,1372,639,"Knox County",470313,153.940035678367,0.114254820688412,130.126107507128,10.6312179335889,87.8138601314444,11.4254820688412
2021-04-09,49538,82,41691,62,7847,20,45651,71,320258,620,365909,691,5,624,11,407,66,48507,2,1371,638,"Knox County",470313,97.8072049890179,0.0888183980967486,146.923431842199,17.4351974110858,86.5381139794137,8.88183980967486
2021-04-08,49456,49,41629,26,7827,23,45580,26,319638,465,365218,491,-6,619,-23,396,78,48441,0,1369,638,"Knox County",470313,89.9401037181622,0.0842943437671609,104.398560107843,10.4185935749171,84.1992460340241,8.42943437671609
2021-04-07,49407,77,41603,54,7804,23,45554,57,319173,768,364727,825,2,625,9,419,66,48363,1,1369,637,"Knox County",470313,88.2391088487879,0.0811609782316582,175.415095904217,16.3720756177269,89.089606283475,8.11609782316582
2021-04-06,49330,75,41549,41,7781,34,45497,45,318405,421,363902,466,2,623,-4,410,77,48297,0,1368,637,"Knox County",470313,89.7274793594904,0.0798948751642576,99.0829511410486,15.9468269003834,87.175987055429,7.98948751642576
2021-04-05,49255,44,41508,32,7747,12,45452,35,317984,266,363436,301,0,621,-60,414,104,48220,3,1368,637,"Knox County",470313,85.6876165447266,0.0781926406926407,63.9999319602052,9.35547178155824,88.0264844901162,7.81926406926407
2021-04-04,49211,49,41476,31,7735,18,45417,40,317718,341,363135,381,3,621,-27,474,73,48116,0,1365,635,"Knox County",470313,90.5779767941775,0.0836209185027874,81.0098806539475,10.4185935749171,100.783946010423,8.36209185027874
2021-04-03,49162,81,41445,64,7717,17,45377,71,317377,593,362754,664,0,618,6,501,75,48043,0,1365,634,"Knox County",470313,97.1693319130026,0.0903377847604085,141.182574158061,17.222573052414,106.524803694561,9.03377847604085
2021-04-02,49081,76,41381,45,7700,31,45306,45,316784,529,362090,574,0,618,6,495,70,47968,2,1365,631,"Knox County",470313,95.8935857609719,0.0861696380334954,122.046381877601,16.1594512590551,105.24905754253,8.61696380334954
2021-04-01,49005,75,41336,63,7669,12,45261,67,316255,580,361516,647,1,618,-20,489,94,47898,1,1363,629,"Knox County",470313,101.421819086438,0.0933125972006221,137.56796006064,15.9468269003834,103.9733113905,9.33125972006221
2021-03-31,48930,87,41273,66,7657,21,45194,72,315675,765,360869,837,3,617,-16,509,100,47804,2,1362,629,"Knox County",470313,103.548062673156,0.0968992248062016,177.966588208278,18.4983192044447,108.225798563935,9.68992248062016
2021-03-30,48843,57,41207,33,7636,24,45122,38,314910,460,360032,498,1,614,-25,525,81,47704,2,1360,627,"Knox County",470313,99.7208242170639,0.0943106099436187,105.886930618546,12.1195884442914,111.627788302684,9.43106099436187
2021-03-29,48786,43,41174,21,7612,22,45084,22,314450,399,359534,421,5,613,-58,550,96,47623,0,1358,625,"Knox County",470313,99.5081998583922,0.0882645450024863,89.5148550008186,9.14284742288646,116.943397269478,8.82645450024863
2021-03-28,48743,80,41153,46,7590,34,45062,49,314051,484,359113,533,2,608,13,608,65,47527,5,1358,624,"Knox County",470313,106.099554977217,0.0872065165309056,113.328783172058,17.0099486937423,129.275610072441,8.72065165309056
2021-03-27,48663,42,41107,39,7556,3,45013,42,313567,442,358580,484,0,606,-16,595,58,47462,2,1353,623,"Knox County",470313,97.8072049890179,0.0838758137205809,102.910189597141,8.93022306421468,126.511493409708,8.38758137205809
2021-03-26,48621,79,41068,54,7553,25,44971,60,313125,416,358096,476,0,606,1,611,78,47404,2,1351,621,"Knox County",470313,98.4450780650333,0.0898357289527721,101.209194727766,16.7973243350705,129.913483148456,8.98357289527721
2021-03-25,48542,88,41014,64,7528,24,44911,67,312709,570,357620,637,0,606,6,610,82,47326,4,1349,619,"Knox County",470313,101.209194727766,0.0900669068450849,135.441716473923,18.7109435631165,129.700858789785,9.00669068450849
2021-03-24,48454,123,40950,91,7504,32,44844,95,312139,780,356983,875,1,606,39,604,83,47244,3,1345,618,"Knox County",470313,108.86367163995,0.0950560652395515,186.046313837806,26.1527961166287,128.425112637754,9.50560652395515
2021-03-23,48331,87,40859,57,7472,30,44749,63,311359,530,356108,593,1,605,16,565,70,47161,3,1342,617,"Knox County",470313,115.242402400104,0.0990296093555611,126.086244692364,18.4983192044447,120.132762649555,9.90296093555611
2021-03-22,48244,115,40802,78,7442,37,44686,81,310829,517,355515,598,2,604,31,549,82,47091,1,1339,616,"Knox County",470313,130.551356224472,0.108913250714967,127.149366485723,24.4518012472545,116.730772910806,10.8913250714967
2021-03-21,48129,50,40724,33,7405,17,44605,34,310312,330,354917,364,0,602,4,518,46,47009,1,1338,616,"Knox County",470313,124.172625464318,0.109759125900174,77.3952665565272,10.6312179335889,110.139417791981,10.9759125900174
2021-03-20,48079,59,40691,29,7388,30,44571,33,309982,315,354553,348,0,602,3,514,56,46963,4,1337,615,"Knox County",470313,127.787239561739,0.111282446671807,73.9932768177788,12.5448371616349,109.288920357294,11.1282446671807
2021-03-19,48020,146,40662,102,7358,44,44538,117,309667,955,354205,1072,3,602,51,511,92,46907,3,1333,615,"Knox County",470313,142.033071592748,0.109204368174727,227.933312496146,31.0431563660796,108.651047281279,10.9204368174727
2021-03-18,47874,68,40560,50,7314,18,44421,66,308712,627,353133,693,2,599,-16,460,82,46815,1,1330,614,"Knox County",470313,137.780584419312,0.107638124587277,147.348680559542,14.4584563896809,97.8072049890179,10.7638124587277
2021-03-17,47806,46,40510,36,7296,10,44355,41,308085,498,352440,539,1,597,-40,476,85,46733,3,1329,614,"Knox County",470313,121.408508801585,0.103399096743523,114.604529324088,9.7807204989018,101.209194727766,10.3399096743523
2021-03-16,47760,128,40474,84,7286,44,44314,100,307587,698,351901,798,0,596,47,516,81,46648,3,1326,612,"Knox County",470313,130.126107507128,0.106980961015413,169.674238220079,27.2159179099876,109.714169074638,10.6980961015413
2021-03-15,47632,44,40390,28,7242,16,44214,40,306889,290,351103,330,1,596,-65,469,108,46567,1,1323,611,"Knox County",470313,115.029778041432,0.104005791505792,70.1660383616868,9.35547178155824,99.7208242170639,10.4005791505792
2021-03-14,47588,60,40362,38,7226,22,44174,46,306599,405,350773,451,0,595,-13,534,73,46459,0,1322,610,"Knox County",470313,117.15602162815,0.104703379815646,95.893585760972,12.7574615203067,113.54140753073,10.4703379815646
2021-03-13,47528,71,40324,34,7204,37,44128,41,306194,623,350322,664,1,595,-11,547,81,46386,1,1322,610,"Knox County",470313,119.707513932211,0.0991862766659336,141.182574158061,15.0963294656962,116.305524193463,9.91862766659336
2021-03-12,47457,63,40290,60,7167,3,44087,67,305571,691,349658,758,0,594,-52,558,115,46305,1,1321,608,"Knox County",470313,102.059692162454,0.0947318686510749,161.169263873208,13.395334596322,118.644392138852,9.47318686510749
2021-03-11,47394,83,40230,56,7164,27,44020,66,304880,627,348900,693,2,594,-22,610,103,46190,0,1320,606,"Knox County",470313,105.24905754253,0.0947318686510749,147.348680559542,17.6478217697576,129.700858789785,9.47318686510749
2021-03-10,47311,95,40174,72,7137,23,43954,82,304253,1001,348207,1083,2,592,26,632,67,46087,1,1320,605,"Knox County",470313,115.667651117447,0.0925266903914591,230.272180441536,20.1993140738189,134.378594680564,9.25266903914591
2021-03-09,47216,80,40102,50,7114,30,43872,55,303252,597,347124,652,0,590,-5,606,85,46020,2,1319,605,"Knox County",470313,105.461681901202,0.085726624919024,138.631081853999,17.0099486937423,128.850361355098,8.5726624919024
2021-03-08,47136,85,40052,57,7084,28,43817,63,302655,411,346472,474,1,590,-30,611,114,45935,0,1317,600,"Knox County",470313,114.179280606745,0.0879581151832461,100.783946010423,18.0730704871011,129.913483148456,8.79581151832461
2021-03-07,47051,64,39995,40,7056,24,43754,42,302244,327,345998,369,0,589,-5,641,69,45821,0,1317,598,"Knox County",470313,115.029778041432,0.0886426592797784,78.4583883498861,13.6079589549938,136.29221390861,8.86426592797784
2021-03-06,46987,125,39955,87,7032,38,43712,95,301917,848,345629,943,0,589,40,646,85,45752,1,1317,598,"Knox County",470313,126.511493409708,0.0945293644408689,200.504770227487,26.5780448339723,137.355335701969,9.45293644408689
2021-03-05,46862,70,39868,44,6994,26,43617,49,301069,520,344686,569,2,589,-19,606,87,45667,2,1316,598,"Knox County",470313,127.99986392041,0.0945013589797198,120.983260084242,14.8837051070245,128.850361355098,9.45013589797198
2021-03-04,46792,112,39824,85,6968,27,43568,100,300549,1094,344117,1194,5,587,-1,625,108,45580,1,1314,596,"Knox County",470313,134.165970321892,0.0919757759273278,253.873484254103,23.8139281712392,132.890224169861,9.19757759273278
2021-03-03,46680,74,39739,33,6941,41,43468,40,299455,497,342923,537,1,582,-49,626,122,45472,4,1313,594,"Knox County",470313,129.700858789785,0.0937104263402279,114.179280606745,15.7342025417116,133.102848528533,9.37104263402279
2021-03-02,46606,133,39706,91,6900,42,43428,99,298958,807,342386,906,-1,581,9,675,125,45350,2,1309,593,"Knox County",470313,140.969949799389,0.0977564102564103,192.637668956631,28.2790397033465,143.52144210345,9.77564102564103
2021-03-01,46473,59,39615,33,6858,26,43329,35,298151,165,341480,200,1,582,-58,666,116,45225,1,1307,588,"Knox County",470313,135.441716473923,0.0974989402289105,42.5248717343556,12.5448371616349,141.607822875404,9.74989402289106
2021-02-28,46414,77,39582,53,6832,24,43294,63,297986,563,341280,626,2,581,-18,724,93,45109,2,1306,588,"Knox County",470313,138.205833136656,0.0966834170854271,133.102848528533,16.3720756177269,153.940035678367,9.66834170854271
2021-02-27,46337,82,39529,47,6808,35,43231,58,297423,670,340654,728,1,579,-33,742,114,45016,3,1304,587,"Knox County",470313,129.062985713769,0.0932773109243697,154.790533113054,17.4351974110858,157.767274134459,9.32773109243698
2021-02-26,46255,107,39482,70,6773,37,43173,80,296753,506,339926,586,5,578,-17,775,119,44902,1,1301,586,"Knox County",470313,136.930086984625,0.0994347917102784,124.597874181662,22.7508063778803,164.783877970628,9.94347917102784
2021-02-25,46148,131,39412,92,6736,39,43093,97,296247,1029,339340,1126,2,573,-7,792,136,44783,5,1300,586,"Knox County",470313,140.969949799389,0.100233595243151,239.415027864422,27.8537909860029,168.398492068048,10.0233595243151
2021-02-24,46017,102,39320,72,6697,30,42996,80,295218,969,338214,1049,2,571,-30,799,130,44647,2,1295,585,"Knox County",470313,146.923431842199,0.0980655046925876,223.042952246695,21.6876845845214,169.886862578751,9.80655046925876
2021-02-23,45915,122,39248,68,6667,54,42916,75,294249,758,337165,833,5,569,-32,829,149,44517,6,1293,584,"Knox County",470313,144.584563896809,0.0947940947940948,177.116090773591,25.9401717579569,176.265593338904,9.47940947940948
2021-02-22,45793,62,39180,33,6613,29,42841,38,293491,306,336332,344,3,564,-110,861,169,44368,3,1287,582,"Knox County",470313,145.222436972824,0.0927815570672714,73.1427793830917,13.1827102376502,183.069572816401,9.27815570672714
2021-02-21,45731,82,39147,41,6584,41,42803,45,293185,499,335988,544,2,561,-31,971,111,44199,3,1284,580,"Knox County",470313,146.285558766183,0.0907869481765835,115.667651117447,17.4351974110858,206.458252270297,9.07869481765835
2021-02-20,45649,137,39106,98,6543,39,42758,115,292686,1007,335444,1122,1,559,8,1002,128,44088,2,1281,577,"Knox County",470313,157.979898493131,0.0945753033547466,238.564530429735,29.1295371380336,213.049607389122,9.45753033547466
2021-02-19,45512,95,39008,43,6504,52,42643,48,291679,274,334322,322,1,558,-83,994,177,43960,2,1279,576,"Knox County",470313,155.42840618907,0.0932584269662921,68.4650434923126,20.1993140738189,211.348612519747,9.32584269662921
2021-02-18,45417,155,38965,111,6452,44,42595,119,291405,987,334000,1106,4,557,-37,1077,188,43783,6,1277,574,"Knox County",470313,160.531390797193,0.0977443609022556,235.162540690987,32.9567755941256,228.996434289505,9.77443609022556
2021-02-17,45262,114,38854,68,6408,46,42476,76,290418,892,332894,968,1,553,-50,1114,163,43595,4,1271,568,"Knox County",470313,163.082883101254,0.098492078640962,205.820379194281,24.2391768885827,236.863535560361,9.8492078640962
2021-02-16,45148,146,38786,90,6362,56,42400,101,289526,818,331926,919,2,552,-41,1164,185,43432,4,1267,565,"Knox County",470313,168.185867709377,0.101784037558685,195.401785619364,31.0431563660796,247.49475349395,10.1784037558685
2021-02-15,45002,76,38696,36,6306,40,42299,43,288708,312,331007,355,2,550,-140,1205,214,43247,1,1263,565,"Knox County",470313,171.162608730781,0.102511244377811,75.4816473284812,16.1594512590551,256.212352199493,10.2511244377811
2021-02-14,44926,164,38660,134,6266,30,42256,134,288396,706,330652,840,2,548,19,1345,143,43033,5,1262,564,"Knox County",470313,188.597806141867,0.112926136363636,178.604461284294,34.8703948221716,285.979762413542,11.2926136363636
2021-02-13,44762,135,38526,91,6236,44,42122,106,287690,870,329812,976,4,546,-9,1326,140,42890,7,1257,563,"Knox County",470313,188.172557424524,0.114290922347794,207.521374063655,28.7042884206901,281.939899598778,11.4290922347794
2021-02-12,44627,179,38435,114,6192,65,42016,124,286820,995,328836,1119,3,542,13,1335,163,42750,3,1250,559,"Knox County",470313,206.033003552953,0.111889224892567,237.92665735372,38.0597602022483,283.853518826824,11.1889224892567
2021-02-11,44448,162,38321,112,6127,50,41892,118,285825,1133,327717,1251,5,539,-34,1322,191,42587,5,1247,558,"Knox County",470313,207.521374063655,0.109209707529558,265.993072698394,34.4451461048281,281.089402164091,10.9209707529558
2021-02-10,44286,148,38209,106,6077,42,41774,112,284692,1032,326466,1144,7,534,-48,1356,189,42396,6,1242,556,"Knox County",470313,214.750602258496,0.111750454270139,243.242266320514,31.4684050834232,288.318630358931,11.1750454270139
2021-02-09,44138,209,38103,154,6035,55,41662,165,283660,1022,325322,1187,0,527,12,1404,197,42207,6,1236,554,"Knox County",470313,228.145936854818,0.116705471478463,252.385113743401,44.4384909624016,298.524599575177,11.6705471478463
2021-02-08,43929,107,37949,72,5980,35,41497,76,282638,371,324135,447,4,527,-159,1392,262,42010,2,1230,549,"Knox County",470313,234.737291973643,0.119902354968409,95.0430883262848,22.7508063778803,295.973107271115,11.9902354968409
2021-02-07,43822,108,37877,75,5945,33,41421,83,282267,716,323688,799,1,523,-28,1551,135,41748,2,1228,546,"Knox County",470313,222.830327888024,0.11324570273003,169.886862578751,22.963430736552,329.780380299928,11.324570273003
2021-02-06,43714,304,37802,176,5912,128,41338,197,281551,1396,322889,1593,2,522,136,1579,166,41613,6,1226,545,"Knox County",470313,258.763844503554,0.11604774535809,338.710603364143,64.6378050362206,335.733862342738,11.604774535809
2021-02-05,43410,177,37626,131,5784,46,41141,143,280155,727,321296,870,8,520,-5,1443,174,41447,4,1220,541,"Knox County",470313,258.33859578621,0.122616924975998,184.983192044447,37.6345114849047,306.816949563376,12.2616924975998
2021-02-04,43233,199,37495,148,5738,51,40998,161,279428,1581,320426,1742,2,512,-1,1448,198,41273,7,1216,538,"Knox County",470313,266.205697057066,0.120406065278849,370.391632806238,42.3122473756839,307.880071356735,12.0406065278849
2021-02-03,43034,230,37347,165,5687,65,40837,172,277847,1634,318684,1806,5,510,-9,1449,234,41075,7,1209,530,"Knox County",470313,283.640894468152,0.118072003789673,383.999591761231,48.903602494509,308.092695715407,11.8072003789673
2021-02-02,42804,91,37182,70,5622,21,40665,77,276213,291,316878,368,7,505,-159,1458,243,40841,1,1202,530,"Knox County",470313,258.551220144882,0.119213114754098,78.2457639912144,19.3488166391318,310.006314943453,11.9213114754098
2021-02-01,42713,153,37112,82,5601,71,40588,97,275922,425,316510,522,4,498,-125,1617,274,40598,2,1201,528,"Knox County",470313,268.331940643784,0.120779220779221,110.989915226668,32.5315268767821,343.813587972265,12.0779220779221
2021-01-31,42560,174,37030,120,5530,54,40491,129,275497,939,315988,1068,7,494,13,1742,154,40324,4,1199,525,"Knox County",470313,282.365148316121,0.122474589032501,227.082815061459,36.9966384088894,370.391632806238,12.2474589032501
2021-01-30,42386,277,36910,233,5476,44,40362,250,274558,1518,314920,1768,7,487,92,1729,178,40170,9,1195,523,"Knox County",470313,276.624290631983,0.12635068762279,375.919866131704,58.8969473520825,367.627516143504,12.635068762279
2021-01-29,42109,101,36677,52,5432,49,40112,62,273040,376,313152,438,4,480,-140,1637,237,39992,1,1186,517,"Knox County",470313,260.464839372928,0.122925311203319,93.1294690982388,21.4750602258496,348.066075145701,12.2925311203319
2021-01-28,42008,157,36625,116,5383,41,40050,129,272664,656,312714,785,9,476,-75,1777,223,39755,5,1185,512,"Knox County",470313,251.534616308714,0.13560325684678,166.910121557346,33.3820243114692,377.83348535975,13.560325684678
2021-01-27,41851,168,36509,123,5342,45,39921,125,272008,893,311929,1018,12,467,-73,1852,229,39532,2,1180,508,"Knox County",470313,238.351906071063,0.14563432210491,216.45159712787,35.7208922568587,393.780312260133,14.563432210491
2021-01-26,41683,234,36386,173,5297,61,39796,193,271115,1041,310911,1234,3,455,-26,1925,257,39303,7,1178,504,"Knox County",470313,268.757189361128,0.144153373335285,262.378458600974,49.7540999291961,409.301890443173,14.4153373335285
2021-01-25,41449,157,36213,105,5236,52,39603,115,270074,415,309677,530,9,452,-201,1951,349,39046,1,1171,497,"Knox County",470313,269.607686795815,0.146615991814062,112.690910096042,33.3820243114692,414.830123768639,14.6615991814062
2021-01-24,41292,157,36108,104,5184,53,39488,111,269659,791,309147,902,4,443,-98,2152,251,38697,2,1170,493,"Knox County",470313,265.993072698394,0.147565543071161,191.787171521944,33.3820243114692,457.567619861667,14.7565543071161
2021-01-23,41135,309,36004,222,5131,87,39377,232,268868,1492,308245,1724,7,439,63,2250,239,38446,7,1168,487,"Knox County",470313,272.797052175891,0.145830191524657,366.564394350146,65.7009268295794,478.404807011501,14.5830191524657
2021-01-22,40826,178,35782,143,5044,35,39145,176,267376,1173,306521,1349,3,432,-151,2187,326,38207,8,1161,483,"Knox County",470313,289.169127793618,0.143330681516839,286.830259848229,37.8471358435765,465.009472415179,14.3330681516839
2021-01-21,40648,268,35639,195,5009,73,38969,203,266203,1080,305172,1283,11,429,-124,2338,381,37881,6,1153,475,"Knox County",470313,312.770431606186,0.14365671641791,272.797052175891,56.9833281240365,497.115750574617,14.365671641791
2021-01-20,40380,192,35444,131,4936,61,38766,130,265123,736,303889,866,10,418,-156,2462,338,37500,8,1147,469,"Knox County",470313,317.873416214308,0.147058823529412,184.13269460976,40.8238768649814,523.481171049918,14.7058823529412
2021-01-19,40188,310,35313,195,4875,115,38636,219,264387,957,303023,1176,8,408,-86,2618,388,37162,14,1139,459,"Knox County",470313,334.032867473363,0.1514687100894,250.046245798011,65.9135511882512,556.650571002715,15.14687100894
2021-01-18,39878,129,35118,80,4760,49,38417,87,263430,472,301847,559,7,400,-365,2704,487,36774,4,1125,456,"Knox County",470313,328.079385430554,0.147346990711286,118.857016497524,27.4285422686594,574.936265848488,14.7346990711286
2021-01-17,39749,181,35038,138,4711,43,38330,151,262958,690,301288,841,3,393,-208,3069,386,36287,8,1121,447,"Knox County",470313,333.182370038676,0.153629135675814,178.817085642965,38.4850089195918,652.544156763687,15.3629135675814
2021-01-16,39568,421,34900,340,4668,81,38179,389,262268,1757,300447,2146,1,390,7,3277,413,35901,7,1113,441,"Knox County",470313,356.996298209916,0.164841849148418,456.291873709636,89.5148550008186,696.770023367417,16.4841849148418
2021-01-15,39147,187,34560,149,4587,38,37790,153,260511,755,298301,908,0,389,-94,3270,281,35488,4,1106,433,"Knox County",470313,358.909917437962,0.171230235248747,193.062917673975,39.7607550716225,695.281652856715,17.1230235248747
2021-01-14,38960,338,34411,267,4549,71,37637,290,259756,1479,297393,1769,6,389,-92,3364,424,35207,8,1102,423,"Knox County",470313,373.793622544986,0.171687840290381,376.132490490376,71.867033231061,715.268342571862,17.1687840290381
2021-01-13,38622,249,34144,201,4478,48,37347,206,258277,946,295624,1152,12,383,-249,3456,486,34783,6,1094,416,"Knox County",470313,385.913210989277,0.174833352824231,244.943261189888,52.9434653092728,734.829783569665,17.4833352824231
2021-01-12,38373,332,33943,261,4430,71,37141,283,257331,1181,294472,1464,10,371,-176,3705,498,34297,6,1088,414,"Knox County",470313,390.590946880056,0.176377418259984,311.282061095483,70.5912870790304,787.773248878938,17.6377418259984
2021-01-11,38041,244,33682,197,4359,47,36858,228,256150,726,293008,954,4,361,-396,3881,636,33799,5,1082,409,"Knox County",470313,415.042748127311,0.184102230885857,202.843638172876,51.8803435159139,825.195136005171,18.4102230885857
2021-01-10,37797,328,33485,205,4312,123,36630,222,255424,1013,292054,1235,5,357,-4,4277,327,33163,17,1077,403,"Knox County",470313,446.298528852062,0.183942667220607,262.591082959646,69.7407896443432,909.394382039195,18.3942667220607
2021-01-09,37469,475,33280,393,4189,82,36408,426,254411,1384,290819,1810,5,352,101,4281,369,32836,12,1060,397,"Knox County",470313,457.780244220338,0.194575979337064,384.850089195918,100.996570369095,910.244879473882,19.4575979337064
2021-01-08,36994,459,32887,371,4107,88,35982,392,253027,1432,289009,1824,7,347,267,4180,185,32467,6,1048,395,"Knox County",470313,515.614069779062,0.200528996865204,387.826830217323,97.5945806303462,888.769819248033,20.0528996865204
2021-01-07,36535,389,32516,346,4019,43,35590,354,251595,1309,287185,1663,10,340,73,3913,306,32282,10,1042,387,"Knox County",470313,526.457912071323,0.208968521084934,353.594308471167,82.7108755233217,831.999115482668,20.8968521084934
2021-01-06,36146,496,32170,362,3976,134,35236,378,250286,1187,285522,1565,9,330,58,3840,429,31976,15,1032,384,"Knox County",470313,578.976128663252,0.217118402282454,332.757121321333,105.461681901202,816.477537299628,21.7118402282454
2021-01-05,35650,520,31808,328,3842,192,34858,345,249099,1193,283957,1538,14,321,32,3782,474,31547,14,1017,375,"Knox County",470313,618.949508093546,0.221456228161299,327.016263637195,110.564666509325,804.145324496665,22.1456228161299
2021-01-04,35130,322,31480,228,3650,94,34513,249,247906,654,282419,903,6,307,-222,3750,538,31073,6,1003,369,"Knox County",470313,635.534208069945,0.224520781932055,191.999795880616,68.4650434923126,797.341345019168,22.4520781932055
2021-01-03,34808,285,31252,182,3556,103,34264,195,247252,608,281516,803,2,301,-15,3972,298,30535,10,997,361,"Knox County",470313,626.391360647058,0.231446665347318,170.737360013438,60.5979422214568,844.543952644303,23.1446665347318
2021-01-02,34523,422,31070,319,3453,103,34069,345,246644,1095,280713,1440,0,299,105,3987,317,30237,22,987,352,"Knox County",470313,615.122269637454,0.231922760887428,306.179076487361,89.7274793594904,847.73331802438,23.1922760887428
2021-01-01,34101,419,30751,349,3350,70,33724,374,245549,1297,279273,1671,2,299,2,3882,415,29920,8,965,348,"Knox County",470313,606.617295290583,0.233747260774288,355.295303340541,89.089606283475,825.407760363843,23.3747260774288
2020-12-31,33682,448,30402,311,3280,137,33350,322,244252,929,277602,1251,12,297,0,3880,436,29505,8,957,342,"Knox County",470313,619.162132452218,0.240758913967942,265.993072698394,95.2557126849566,824.982511646499,24.0758913967942
2020-12-30,33234,363,30091,248,3143,115,33028,271,243323,931,276351,1202,6,285,-146,3880,503,29069,9,949,339,"Knox County",470313,590.883092748871,0.238533151680291,255.574479123477,77.1826421978555,824.982511646499,23.8533151680291
2020-12-29,32871,590,29843,398,3028,192,32757,420,242392,1081,275149,1501,7,279,111,4026,472,28566,14,940,335,"Knox County",470313,605.766797855896,0.248090297571543,319.149162366339,125.448371616349,856.025668012579,24.8090297571543
2020-12-28,32281,252,29445,174,2836,78,32337,185,241311,565,273648,750,4,272,-331,3915,579,28094,4,926,327,"Knox County",470313,590.883092748871,0.245068461359944,159.468269003834,53.5813383852881,832.424364200011,24.5068461359944
2020-12-27,32029,230,29271,156,2758,74,32152,172,240746,489,272898,661,3,268,-74,4246,301,27515,8,922,322,"Knox County",470313,579.188753021924,0.246460594620104,140.544701082045,48.903602494509,902.80302692037,24.6460594620104
2020-12-26,31799,358,29115,288,2684,70,31980,328,240257,1064,272237,1392,0,265,59,4320,299,27214,10,914,315,"Knox County",470313,565.58079406693,0.245847176079734,295.973107271115,76.1195204044966,918.537229462082,24.5847176079734
2020-12-25,31441,353,28827,287,2614,66,31652,308,239193,1070,270845,1378,1,265,-101,4261,453,26915,5,904,309,"Knox County",470313,551.547586394592,0.246588813767671,292.99636624971,75.0563986111377,905.992392300447,24.6588813767671
2020-12-24,31088,351,28540,277,2548,74,31344,311,238123,1273,269467,1584,5,264,-111,4362,457,26462,8,899,302,"Knox County",470313,530.92302360343,0.235592820028342,336.796984136097,74.6311498937941,927.467452526296,23.5592820028342
2020-12-23,30737,472,28263,351,2474,121,31033,371,236850,1411,267883,1782,6,259,-14,4473,480,26005,9,891,295,"Knox County",470313,554.099078698654,0.231542882404951,378.896607153109,100.358697293079,951.068756338864,23.1542882404951
2020-12-22,30265,530,27912,392,2353,138,30662,432,235439,1470,266101,1902,7,253,-26,4487,549,25525,15,882,289,"Knox County",470313,541.341617178347,0.222986559424278,404.411530193722,112.690910096042,954.045497360269,22.2986559424278
2020-12-21,29735,442,27520,361,2215,81,30230,391,233969,1423,264199,1814,2,246,-136,4513,576,24976,5,867,283,"Knox County",470313,581.740245325985,0.22001331684581,385.700586630606,93.9799665329259,959.573730685735,22.001331684581
2020-12-20,29293,514,27159,431,2134,83,29839,478,232546,2245,262385,2723,2,244,235,4649,277,24400,7,862,280,"Knox County",470313,642.12556318877,0.208270377733598,578.976128663252,109.288920357294,988.490643465097,20.8270377733598
2020-12-19,28779,525,26728,441,2051,84,29361,489,230301,1445,259662,1934,6,242,252,4414,267,24123,14,855,274,"Knox County",470313,677.633831086957,0.211938705496684,411.215509671219,111.627788302684,938.523919177229,21.1938705496684
2020-12-18,28254,480,26287,420,1967,60,28872,430,228856,1358,257728,1788,4,236,98,4162,378,23856,11,841,267,"Knox County",470313,704.637124638273,0.214533895172618,380.172353305139,102.059692162454,884.942580791941,21.4533895172618
2020-12-17,27774,733,25867,635,1907,98,28442,663,227498,1898,255940,2561,11,232,288,4064,434,23478,11,830,261,"Knox County",470313,785.859629650892,0.224351902923331,544.530982558424,155.853654906413,864.105393642106,22.4351902923332
2020-12-16,27041,564,25232,453,1809,111,27779,472,225600,1729,253379,2201,8,221,99,3776,457,23044,11,819,257,"Knox County",470313,805.421070648696,0.224820746498693,467.986213436584,119.920138290883,802.869578344634,22.4820746498693
2020-12-15,26477,765,24779,675,1698,90,27307,716,223871,2415,251178,3131,2,213,324,3677,439,22587,15,808,253,"Knox County",470313,855.387794936564,0.225297176820208,665.726867001337,162.65763438391,781.819766836128,22.5297176820208
2020-12-14,25712,472,24104,411,1608,61,26591,461,221456,1624,248047,2085,6,211,-11,3353,477,22148,7,793,245,"Knox County",470313,861.766525696717,0.225841807221579,443.321787830657,100.358697293079,712.929474626472,22.5841807221579
2020-12-13,25240,628,23693,572,1547,56,26130,754,219832,2935,245962,3689,2,205,400,3364,226,21671,10,786,237,"Knox County",470313,886.0057025853,0.229167864742078,784.37125914019,133.528097245877,715.268342571862,22.9167864742078
2020-12-12,24612,464,23121,392,1491,72,25376,454,216897,2171,242273,2625,3,203,182,2964,279,21445,19,776,231,"Knox County",470313,873.035616706321,0.218473451327434,558.138941513418,98.6577024237051,630.21859910315,21.8473451327434
2020-12-11,24148,557,22729,523,1419,34,24922,429,214726,1407,239648,1836,6,200,281,2782,270,21166,10,757,227,"Knox County",470313,889.407692324048,0.217839805825243,390.378322521385,118.43176778018,591.520965824887,21.7839805825243
2020-12-10,23591,473,22206,415,1385,58,24493,538,213319,1910,237812,2448,8,194,325,2501,140,20896,9,747,225,"Knox County",470313,834.125359069386,0.212267554815432,520.504430028513,100.571321651751,531.773521038117,21.2267554815432
2020-12-09,23118,407,21791,337,1327,70,23955,359,211409,924,235364,1283,2,186,77,2176,328,20756,13,738,215,"Knox County",470313,800.743334757917,0.217055623793648,272.797052175891,86.5381139794137,462.670604469789,21.7055623793648
2020-12-08,22711,491,21454,446,1257,45,23596,538,210485,2077,234081,2615,9,184,126,2099,356,20428,10,725,212,"Knox County",470313,742.484260481849,0.213075206561727,556.0126979267,104.398560107843,446.298528852062,21.3075206561727
2020-12-07,22220,323,21008,271,1212,52,23058,317,208408,1135,231466,1452,3,175,-128,1973,448,20072,6,715,210,"Knox County",470313,710.803231039754,0.212503135189365,308.730568791422,68.6776678509843,419.507859659418,21.2503135189365
2020-12-06,21897,332,20737,291,1160,41,22741,187,207273,668,230014,855,6,172,103,2101,223,19624,6,709,207,"Knox County",470313,647.866420872908,0.215189873417722,181.79382666437,70.5912870790304,446.723777569406,21.5189873417722
2020-12-05,21565,289,20446,263,1119,26,22554,213,206605,714,229159,927,2,166,55,1998,232,19401,8,703,203,"Knox County",470313,610.657158105347,0.226086194814296,197.102780488738,61.4484396561439,424.823468626213,22.6086194814296
2020-12-04,21276,354,20183,322,1093,32,22341,297,205891,1091,228232,1388,5,164,17,1943,332,19169,11,695,201,"Knox County",470313,567.494413294976,0.223285922684172,295.122609836428,75.2690229698095,413.129128899265,22.3285922684172
2020-12-03,20922,441,19861,424,1061,17,22044,448,204800,1215,226844,1663,2,159,180,1926,259,18837,10,684,196,"Knox County",470313,560.690433817479,0.231660610821958,353.594308471167,93.7673421742542,409.514514801845,23.1660610821958
2020-12-02,20481,192,19437,170,1044,22,21596,185,203585,575,225181,760,2,157,-144,1746,334,18578,7,674,194,"Knox County",470313,514.976196703047,0.226190476190476,161.594512590551,40.8238768649814,371.242130240925,22.6190476190476
2020-12-01,20289,403,19267,380,1022,23,21411,409,203010,1832,224421,2241,5,155,89,1890,309,18244,7,667,189,"Knox County",470313,496.26525313993,0.221408572043937,476.491187783455,85.6876165447266,401.860037889661,22.1408572043937
2020-11-30,19886,385,18887,371,999,14,21002,436,201178,1815,222180,2251,1,150,24,1801,360,17935,3,660,186,"Knox County",470313,509.44796337758,0.215666831928607,478.617431370173,81.8603780886346,382.936469967872,21.5666831928607
2020-11-29,19501,226,18516,218,985,8,20566,261,199363,1465,219929,1726,0,149,41,1777,185,17575,5,657,183,"Knox County",470313,486.909781358372,0.205275648046732,366.989643067489,48.0531050598219,377.83348535975,20.5275648046732
2020-11-28,19275,271,18298,257,977,14,20305,299,197898,1967,218203,2266,0,149,72,1736,199,17390,8,652,177,"Knox County",470313,483.08254290228,0.189914599430663,481.806796750249,57.6212012000519,369.115886654207,18.9914599430663
2020-11-27,19004,235,18041,215,963,20,20006,249,195931,1247,215937,1496,3,149,-6,1664,238,17191,12,644,173,"Knox County",470313,457.780244220338,0.184390873175845,318.08604057298,49.9667242878679,353.806932829839,18.4390873175845
2020-11-26,18769,344,17826,341,943,3,19757,441,194684,1429,214441,1870,4,146,48,1670,292,16953,5,632,170,"Knox County",470313,437.155681429176,0.18080888183981,397.607550716225,73.1427793830917,355.08267898187,18.080888183981
2020-11-25,18425,219,17485,193,940,26,19316,123,193255,325,212571,448,0,142,-58,1622,277,16661,3,627,164,"Knox County",470313,442.896539113314,0.180354529191738,95.2557126849566,46.5647345491194,344.876709765624,18.0354529191738
2020-11-24,18206,153,17292,130,914,23,19193,116,192930,673,212123,789,2,142,-111,1680,262,16384,6,624,162,"Knox County",470313,389.740449445369,0.177484787018256,167.760618992033,32.5315268767821,357.208922568587,17.7484787018256
2020-11-23,18053,167,17162,147,891,20,19077,100,192257,391,211334,491,3,140,-97,1791,261,16122,7,618,160,"Knox County",470313,343.388339254922,0.174884437596302,104.398560107843,35.508267898187,380.810226381155,17.4884437596302
2020-11-22,17886,220,17015,212,871,8,18977,258,191866,1804,210843,2062,2,137,86,1888,132,15861,5,611,153,"Knox County",470313,342.112593102891,0.168329441732116,438.431427581207,46.7773589077912,401.434789172317,16.8329441732116
2020-11-21,17666,173,16803,169,863,4,18719,198,190062,1465,208781,1663,0,135,2,1802,171,15729,4,606,151,"Knox County",470313,321.275405953057,0.168386438371697,353.594308471167,36.7840140502176,383.149094326544,16.8386438371697
2020-11-20,17493,178,16634,169,859,9,18521,163,188597,791,207118,954,7,135,-17,1800,188,15558,5,602,149,"Knox County",470313,309.155817508765,0.169022592726833,202.843638172876,37.8471358435765,382.723845609201,16.9022592726833
2020-11-19,17315,166,16465,148,850,18,18358,128,187806,663,206164,791,2,128,-28,1817,192,15370,4,597,145,"Knox County",470313,271.308681665189,0.15087524312309,168.185867709377,35.2956435395152,386.338459706621,15.087524312309
2020-11-18,17149,168,16317,163,832,5,18230,179,187143,874,205373,1053,0,126,-9,1845,177,15178,7,593,140,"Knox County",470313,260.464839372928,0.146353966423171,223.893449681382,35.7208922568587,392.291941749431,14.6353966423171
2020-11-17,16981,248,16154,240,827,8,18051,260,186269,1033,204320,1293,9,126,86,1854,153,15001,7,586,138,"Knox County",470313,280.664153446747,0.154809197062718,274.923295762609,52.730840950601,394.205560977477,15.4809197062718
2020-11-16,16733,272,15914,261,819,11,17791,286,185236,1409,203027,1695,2,117,79,1768,191,14848,6,579,137,"Knox County",470313,302.989711107284,0.154768163179476,360.398287948664,57.8338255587237,375.919866131704,15.4768163179476
2020-11-15,16461,274,15653,247,808,27,17505,295,183827,2278,201332,2573,2,115,162,1689,110,14657,3,573,135,"Knox County",470313,314.47142647556,0.150568748752744,547.082474862485,58.2590742760672,359.122541796633,15.0568748752744
2020-11-14,16187,306,15406,293,781,13,17210,321,181549,1699,198759,2020,0,113,188,1527,118,14547,7,570,131,"Knox County",470313,342.750466178906,0.157240581944311,429.501204516992,65.0630537535641,324.677395691805,15.7240581944311
2020-11-13,15881,219,15113,200,768,19,16889,190,179850,965,196739,1155,4,113,73,1339,142,14429,6,563,128,"Knox County",470313,351.468064884449,0.156805293005671,245.581134265904,46.5647345491194,284.704016261511,15.6805293005671
2020-11-12,15662,143,14913,130,749,13,16699,136,178885,955,195584,1091,1,109,-3,1266,145,14287,3,557,127,"Knox County",470313,346.577704634998,0.153216911764706,231.97317531091,30.4052832900643,269.182438078471,15.3216911764706
2020-11-11,15519,191,14783,177,736,14,16563,191,177930,1229,194493,1420,3,108,23,1269,165,14142,7,554,125,"Knox County",470313,351.468064884449,0.149284253578732,301.926589313925,40.6112525063096,269.820311154486,14.9284253578732
2020-11-10,15328,168,14606,163,722,5,16372,186,176701,1131,193073,1317,2,105,24,1246,142,13977,4,547,123,"Knox County",470313,334.458116190707,0.142400851743412,280.026280370732,35.7208922568587,264.929950905036,14.2400851743412
2020-11-09,15160,135,14443,121,717,14,16186,131,175570,490,191756,621,1,103,-15,1222,149,13835,2,543,121,"Knox County",470313,305.328579052673,0.142198685888006,132.039726735174,28.7042884206901,259.826966296913,14.2198685888006
2020-11-08,15025,215,14322,203,703,12,16055,252,175080,2625,191135,2877,1,102,94,1237,120,13686,3,541,119,"Knox County",470313,292.783741891039,0.133987239310542,611.720279898706,45.7142371144323,263.01633167699,13.3987239310542
2020-11-07,14810,169,14119,161,691,8,15803,187,172455,1918,188258,2105,1,101,59,1143,109,13566,5,538,114,"Knox County",470313,263.654204753005,0.120253164556962,447.574275004093,35.9335166155305,243.029641961842,12.0253164556962
2020-11-06,14641,155,13958,138,683,17,15616,160,170537,1236,186153,1396,0,100,24,1084,131,13457,5,533,114,"Knox County",470313,250.046245798011,0.114805578645978,296.823604705802,32.9567755941256,230.484804800208,11.4805578645978
2020-11-05,14486,158,13820,142,666,16,15456,151,169301,613,184757,764,1,100,34,1060,123,13326,6,528,111,"Knox County",470313,253.235611178088,0.119809523809524,162.445010025239,33.5946486701409,225.381820192085,11.9809523809524
2020-11-04,14328,145,13678,133,650,12,15305,148,168688,934,183993,1082,-1,99,20,1026,126,13203,5,522,110,"Knox County",470313,243.454890679186,0.119563078134226,230.059556082864,30.8305320074078,218.152591997244,11.9563078134226
2020-11-03,14183,196,13545,183,638,13,15157,195,167754,836,182911,1031,3,100,44,1006,149,13077,5,517,108,"Knox County",470313,249.408372721996,0.123936816524909,219.215713790603,41.6743742996685,213.900104823809,12.3936816524909
2020-11-02,13987,116,13362,110,625,6,14962,115,166918,807,181880,922,1,97,-36,962,151,12928,2,512,107,"Knox County",470313,245.368509907232,0.118699027218237,196.039658695379,24.6644256059263,204.544633042251,11.8699027218237
2020-11-01,13871,124,13252,116,619,8,14847,131,166111,1273,180958,1404,0,96,15,998,109,12777,3,510,105,"Knox County",470313,226.0196932681,0.124885110294118,298.524599575177,26.3654204753005,212.199109954435,12.4885110294118
2020-10-31,13747,5,13136,5,611,0,14716,7,164838,4,179554,11,0,96,-99,983,104,12668,0,507,103,"Knox County",470313,191.149298445929,0.137216338880484,2.33886794538956,1.06312179335889,209.009744574358,13.7216338880484
2020-10-30,13742,156,13131,146,611,10,14709,148,164834,853,179543,1001,1,96,27,1082,128,12564,4,507,102,"Knox County",470313,191.3619228046,0.144006436041834,212.83698303045,33.1693999527974,230.059556082864,14.4006436041834
2020-10-29,13586,152,12985,138,601,14,14561,136,163981,1569,178542,1705,0,95,49,1055,103,12436,4,503,102,"Knox County",470313,190.08617665257,0.122973728339855,362.524531535382,32.3189025181103,224.318698398726,12.2973728339855
2020-10-28,13434,103,12847,96,587,7,14425,102,162412,1055,176837,1157,3,95,-47,1006,147,12333,8,499,101,"Knox County",470313,181.155953588355,0.115336744571982,246.006382983247,21.9003089431931,213.900104823809,11.5336744571982
2020-10-27,13331,119,12751,113,580,6,14323,127,161357,799,175680,926,1,92,-6,1053,124,12186,3,491,100,"Knox County",470313,164.783877970628,0.107493685096829,196.890156130067,25.3022986819416,223.893449681382,10.7493685096829
2020-10-26,13212,81,12638,74,574,7,14196,73,160558,372,174754,445,2,91,-72,1059,151,12062,2,488,98,"Knox County",470313,157.342025417116,0.108888554669875,94.6178396089413,17.222573052414,225.169195833413,10.8888554669875
2020-10-25,13131,132,12564,121,567,11,14123,151,160186,1365,174309,1516,0,89,53,1131,79,11911,3,486,98,"Knox County",470313,159.04302028649,0.110042893063156,322.338527746416,28.0664153446747,240.478149657781,11.0042893063156
2020-10-24,12999,172,12443,167,556,5,13972,202,158821,1789,172793,1991,0,89,56,1078,116,11832,5,483,97,"Knox County",470313,194.551288184677,0.107424779773481,423.33509811551,36.5713896915458,229.209058648177,10.7424779773481
2020-10-23,12827,159,12276,148,551,11,13770,172,157032,1239,170802,1411,1,89,40,1022,118,11716,5,478,96,"Knox County",470313,195.189161260692,0.105234400611955,300.012970085879,33.8072730288127,217.302094562557,10.5234400611955
2020-10-22,12668,182,12128,168,540,14,13598,169,155793,1607,169391,1776,1,88,59,982,122,11598,5,473,96,"Knox County",470313,201.567892020846,0.108002602472349,377.620861001078,38.6976332782636,208.797120215686,10.8002602472349
2020-10-21,12486,72,11960,68,526,4,13429,74,154186,682,167615,756,0,87,-32,923,104,11476,1,468,96,"Knox County",470313,194.976536902021,0.109738124929146,160.744015155864,15.308953824368,196.252283054051,10.9738124929146
2020-10-20,12414,127,11892,121,522,6,13355,150,153504,739,166859,889,0,87,13,955,114,11372,7,467,95,"Knox County",470313,196.677531771395,0.112818761384335,189.023054859211,27.0032935513158,203.056262531548,11.2818761384335
2020-10-19,12287,112,11771,107,516,5,13205,117,152765,939,165970,1056,1,87,-9,942,120,11258,6,460,94,"Knox County",470313,203.26888689022,0.110164981373071,224.531322757398,23.8139281712392,200.292145868815,11.0164981373071
2020-10-18,12175,140,11664,135,511,5,13088,168,151826,1431,164914,1599,0,86,51,951,89,11138,7,454,94,"Knox County",470313,204.969881759594,0.11099388056552,339.986349516173,29.7674102140489,202.205765096861,11.099388056552
2020-10-17,12035,128,11529,125,506,3,12920,154,150395,1458,163315,1612,1,86,42,900,85,11049,3,447,93,"Knox County",470313,195.614409978036,0.110341795801736,342.750466178906,27.2159179099876,191.3619228046,11.0341795801736
2020-10-16,11907,72,11404,71,503,1,12766,61,148937,390,161703,451,1,85,-26,858,97,10964,3,444,92,"Knox County",470313,177.116090773591,0.109718638653397,95.893585760972,15.308953824368,182.431699740386,10.9718638653397
2020-10-15,11835,74,11333,62,502,12,12705,66,148547,941,161252,1007,1,84,-56,884,129,10867,3,441,90,"Knox County",470313,154.152660037039,0.10719131614654,214.112729182481,15.7342025417116,187.959933065852,10.719131614654
2020-10-14,11761,149,11271,143,490,6,12639,150,147606,1086,160245,1236,0,83,57,940,92,10738,5,438,88,"Knox County",470313,170.524735654766,0.11031847133758,262.803707318318,31.6810294420949,199.866897151471,11.031847133758
2020-10-13,11612,71,11128,68,484,3,12489,63,146520,581,159009,644,1,83,-36,883,106,10646,6,433,88,"Knox County",470313,158.617771569146,0.102432610124918,136.930086984625,15.0963294656962,187.74730870718,10.2432610124918
2020-10-12,11541,79,11060,66,481,13,12426,87,145939,806,158365,893,0,82,-42,919,121,10540,5,427,87,"Knox County",470313,151.601167732978,0.100644987906477,189.873552293898,16.7973243350705,195.401785619364,10.0644987906477
2020-10-11,11462,170,10994,163,468,7,12339,179,145133,1612,157472,1791,0,82,94,961,76,10419,8,422,85,"Knox County",470313,157.979898493131,0.0995546240503013,380.810226381155,36.1461409742023,204.332008683579,9.95546240503013
2020-10-10,11292,130,10831,122,461,8,12160,132,143521,1393,155681,1525,0,82,46,867,84,10343,3,414,85,"Knox County",470313,158.405147210475,0.0977872002120048,324.252146974462,27.6411666273312,184.345318968432,9.77872002120048
2020-10-09,11162,120,10709,118,453,2,12028,134,142128,1336,154156,1470,0,82,34,821,86,10259,3,411,85,"Knox County",470313,168.61111642672,0.0946766285314032,312.557807247514,25.5149230406134,174.56459846953,9.46766285314032
2020-10-08,11042,110,10591,102,451,8,11894,103,140792,943,152686,1046,1,82,32,787,77,10173,4,408,85,"Knox County",470313,176.265593338904,0.0985473561882626,222.40507917068,23.3886794538956,167.335370274689,9.85473561882626
2020-10-07,10932,104,10489,88,443,16,11791,95,139849,1650,151640,1745,0,81,11,755,93,10096,5,404,85,"Knox County",470313,166.697497198674,0.087008997147246,371.029505882253,22.1129333018649,160.531390797193,8.7008997147246
2020-10-06,10828,115,10401,102,427,13,11696,114,138199,1393,149895,1507,0,81,3,744,112,10003,4,399,84,"Knox County",470313,176.052968980232,0.0845945675052621,320.42490851837,24.4518012472545,158.192522851803,8.45945675052621
2020-10-05,10713,118,10299,109,414,9,11582,123,136806,1238,148388,1361,0,81,11,741,107,9891,5,395,84,"Knox County",470313,184.345318968432,0.0842508377213978,289.38175215229,25.0896743232698,157.554649775788,8.42508377213978
2020-10-04,10595,96,10190,89,405,7,11459,99,135568,1827,147027,1926,1,81,31,730,64,9784,2,390,82,"Knox County",470313,168.61111642672,0.0756143667296786,409.514514801845,20.4119384324907,155.215781830398,7.56143667296786
2020-10-03,10499,77,10101,76,398,1,11360,92,133741,1864,145101,1956,0,80,6,699,71,9720,2,388,82,"Knox County",470313,157.342025417116,0.0690218872037054,415.893245561998,16.3720756177269,148.624426711573,6.90218872037054
2020-10-02,10422,82,10025,79,397,3,11268,82,131877,602,143145,684,0,80,-17,693,99,9649,1,386,82,"Knox County",470313,149.262299787588,0.0692420537897311,145.435061331496,17.4351974110858,147.348680559542,6.92420537897311
2020-10-01,10340,71,9946,68,394,3,11186,73,131275,683,142461,756,0,80,2,710,69,9550,1,385,82,"Knox County",470313,140.969949799389,0.0682435832913941,160.744015155864,15.0963294656962,150.963294656962,6.82435832913941
2020-09-30,10269,75,9878,72,391,3,11113,70,130592,675,141705,745,1,80,-32,708,106,9481,2,384,82,"Knox County",470313,134.803843397907,0.0730833799664242,158.405147210475,15.9468269003834,150.538045939619,7.30833799664242
2020-09-29,10194,80,9806,75,388,5,11043,87,129917,1140,140960,1227,-1,79,-16,740,97,9375,2,382,82,"Knox County",470313,127.361990844395,0.0723281340265742,260.890088090272,17.0099486937423,157.342025417116,7.23281340265742
2020-09-28,10114,57,9731,51,383,6,10956,49,128777,431,139733,480,1,80,-70,756,126,9278,3,380,81,"Knox County",470313,114.391904965417,0.0710059171597633,102.059692162454,12.1195884442914,160.744015155864,7.10059171597633
2020-09-27,10057,72,9680,67,377,5,10907,79,128346,978,139253,1057,0,79,-18,826,90,9152,3,377,79,"Knox County",470313,109.288920357294,0.0770456191165822,224.74394711607,15.308953824368,175.627720262889,7.70456191165822
2020-09-26,9985,127,9613,122,372,5,10828,136,127368,2087,138196,2223,4,79,9,844,114,9062,5,374,79,"Knox County",470313,119.920138290883,0.0803123257110987,472.663949327363,27.0032935513158,179.454958718981,8.03123257110987
2020-09-25,9858,102,9491,100,367,2,10692,103,125281,1439,135973,1542,0,75,-3,835,105,8948,1,369,79,"Knox County",470313,124.172625464318,0.074346201743462,327.866761071882,21.6876845845214,177.541339490935,7.4346201743462
2020-09-24,9756,92,9391,89,365,3,10589,105,123842,1717,134431,1822,0,75,-52,838,144,8843,3,368,76,"Knox County",470313,128.637736996426,0.0691512752858399,387.40158149998,19.5614409978036,178.17921256695,6.91512752858399
2020-09-23,9664,53,9302,52,362,1,10484,49,122125,432,132609,481,2,75,-123,890,174,8699,2,365,76,"Knox County",470313,123.960001105647,0.0688405797101449,102.272316521125,11.2690910096042,189.235679217883,6.88405797101449
2020-09-22,9611,82,9250,75,361,7,10435,88,121693,1140,132128,1228,1,73,-53,1013,134,8525,3,363,76,"Knox County",470313,124.38524982299,0.0689459979621873,261.102712448944,17.4351974110858,215.388475334511,6.89459979621873
2020-09-21,9529,34,9175,30,354,4,10347,32,120553,379,130900,411,0,72,-103,1066,137,8391,2,360,76,"Knox County",470313,119.494889573539,0.0675490643541762,87.3886114141008,7.22922819484046,226.657566344116,6.75490643541762
2020-09-20,9495,97,9145,78,350,19,10315,88,120174,707,130489,795,0,72,-17,1169,114,8254,1,358,76,"Knox County",470313,124.810498540334,0.0706892495883322,169.036365144064,20.6245627911625,248.557875287309,7.06892495883322
2020-09-19,9398,132,9067,129,331,3,10227,136,119467,1466,129694,1602,1,72,31,1186,100,8140,5,357,74,"Knox County",470313,125.873620333693,0.0762593579494988,340.624222592189,28.0664153446747,252.172489384729,7.62593579494988
2020-09-18,9266,118,8938,114,328,4,10091,129,118001,1606,128092,1735,3,71,-16,1155,131,8040,3,352,74,"Knox County",470313,129.275610072441,0.0776566757493188,368.903262295535,25.0896743232698,245.581134265904,7.76566757493188
2020-09-17,9148,126,8824,119,324,7,9962,124,116395,1516,126357,1640,0,68,-15,1171,141,7909,6,349,74,"Knox County",470313,136.504838267282,0.0818550430816016,348.703948221716,26.790669192644,248.983124004652,8.18550430816016
2020-09-16,9022,99,8705,77,317,22,9838,117,114879,768,124717,885,1,68,-90,1186,188,7768,3,343,72,"Knox County",470313,146.285558766183,0.0860655737704918,188.172557424524,21.049811508506,252.172489384729,8.60655737704918
2020-09-15,8923,132,8628,126,295,6,9721,136,114111,1338,123832,1474,0,67,-65,1276,197,7580,3,340,71,"Knox County",470313,156.916776699772,0.089206274877078,313.408304682201,28.0664153446747,271.308681665189,8.9206274877078
2020-09-14,8791,127,8502,124,289,3,9585,136,112773,902,122358,1038,0,67,-68,1341,195,7383,5,337,71,"Knox County",470313,176.690842056248,0.0944486857890719,220.704084301306,27.0032935513158,285.129264978855,9.44486857890719
2020-09-13,8664,143,8378,136,286,7,9449,148,111871,1008,121320,1156,0,67,-8,1409,151,7188,0,332,71,"Knox County",470313,186.471562555149,0.0971668415529906,245.793758624576,30.4052832900643,299.587721368535,9.71668415529906
2020-09-12,8521,130,8242,123,279,7,9301,141,110863,1177,120164,1318,1,67,29,1417,100,7037,1,332,71,"Knox County",470313,186.046313837806,0.100692191217824,280.238904729404,27.6411666273312,301.28871623791,10.0692191217824
2020-09-11,8391,104,8119,95,272,9,9160,106,109686,773,118846,879,0,66,-17,1388,121,6937,5,331,69,"Knox County",470313,183.069572816401,0.108224076281287,186.896811272493,22.1129333018649,295.122609836428,10.8224076281287
2020-09-10,8287,192,8024,189,263,3,9054,192,108913,1501,117967,1693,0,66,89,1405,103,6816,5,326,67,"Knox County",470313,197.102780488738,0.115598720833827,359.97303923132,40.8238768649814,298.737223933848,11.5598720833827
2020-09-09,8095,91,7835,82,260,9,8862,93,107412,1710,116274,1803,0,66,-23,1316,114,6713,2,321,67,"Knox County",470313,195.401785619364,0.101698536481145,383.361718685216,19.3488166391318,279.81365601206,10.1698536481145
2020-09-08,8004,126,7753,124,251,2,8769,133,105702,702,114471,835,1,66,30,1339,95,6599,8,319,67,"Knox County",470313,194.126039467333,0.108805319880761,177.541339490935,26.790669192644,284.704016261511,10.8805319880761
2020-09-07,7878,95,7629,92,249,3,8636,98,105000,347,113636,445,1,65,11,1309,83,6504,0,311,67,"Knox County",470313,187.322059989837,0.112067905031369,94.6178396089413,20.1993140738189,278.325285501358,11.2067905031369
2020-09-06,7783,96,7537,92,246,4,8538,94,104653,476,113191,570,0,64,23,1298,73,6421,1,311,67,"Knox County",470313,177.328715132263,0.113615272438022,121.195884442914,20.4119384324907,275.986417555968,11.3615272438022
2020-09-05,7687,284,7445,282,242,2,8444,295,104177,1506,112621,1801,0,64,215,1275,69,6348,4,310,64,"Knox County",470313,210.072866367717,0.125965611761774,382.936469967872,60.385317862785,271.096057306517,12.5965611761774
2020-09-04,7403,93,7163,89,240,4,8149,97,102671,565,110820,662,1,64,16,1060,76,6279,0,306,64,"Knox County",470313,207.733998422327,0.12831348444103,140.757325440717,19.7740653564754,225.381820192085,12.831348444103
2020-09-03,7310,190,7074,184,236,6,8052,198,102106,1798,110158,1996,2,63,107,1044,81,6203,6,306,64,"Knox County",470313,207.308749704984,0.124260355029586,424.398219908869,40.3986281476379,221.979830453336,12.4260355029586
2020-09-02,7120,124,6890,120,230,4,7854,121,100308,1461,108162,1582,2,61,41,937,81,6122,5,300,63,"Knox County",470313,214.325353541152,0.131288810036751,336.371735418753,26.3654204753005,199.229024075456,13.1288810036751
2020-09-01,6996,153,6770,146,226,7,7733,158,98847,660,106580,818,2,59,64,896,87,6041,4,295,62,"Knox County",470313,220.06621122529,0.134747269494539,173.926725393515,32.5315268767821,190.511425369913,13.4747269494539
2020-08-31,6843,99,6624,93,219,6,7575,94,98187,431,105762,525,0,57,18,832,81,5954,3,291,59,"Knox County",470313,220.916708659978,0.132889112396279,111.627788302684,21.049811508506,176.903466414919,13.2889112396279
2020-08-30,6744,72,6531,71,213,1,7481,76,97756,423,105237,499,1,57,5,814,66,5873,1,288,59,"Knox County",470313,215.813724051855,0.131802613218318,106.099554977217,15.308953824368,173.076227958827,13.1802613218318
2020-08-29,6672,118,6460,113,212,5,7405,125,97333,1391,104738,1516,5,56,37,809,76,5807,3,287,57,"Knox County",470313,180.51808051234,0.114372203211371,322.338527746416,25.0896743232698,172.013106165469,11.4372203211371
2020-08-28,6554,89,6347,85,207,4,7280,91,95942,309,103222,400,0,51,-7,772,96,5731,3,284,57,"Knox County",470313,179.667583077653,0.117639040348964,85.0497434687113,18.9235679217883,164.146004894613,11.7639040348964
2020-08-27,6465,116,6262,112,203,4,7189,134,95633,1987,102822,2121,0,51,24,779,92,5635,2,281,57,"Knox County",470313,163.933380535941,0.107090202385739,450.976264742841,24.6644256059263,165.634375405315,10.7090202385739
2020-08-26,6349,77,6150,76,199,1,7055,86,93646,794,100701,880,0,51,-15,755,92,5543,3,279,56,"Knox County",470313,153.940035678367,0.113034472555112,187.109435631165,16.3720756177269,160.531390797193,11.3034472555112
2020-08-25,6272,87,6074,82,198,5,6969,96,92852,896,99821,992,2,51,-6,770,91,5451,3,276,55,"Knox County",470313,139.90682800603,0.101254868022501,210.923363802404,18.4983192044447,163.720756177269,10.1254868022501
2020-08-24,6185,32,5992,28,193,4,6873,29,91956,261,98829,290,0,49,-66,776,98,5360,1,273,55,"Knox County",470313,125.660995975021,0.0951030158256196,61.6610640148157,6.8039794774969,164.9965023293,9.51030158256196
2020-08-23,6153,76,5964,75,189,1,6844,74,91695,566,98539,640,0,49,13,842,63,5262,3,272,55,"Knox County",470313,126.511493409708,0.0928498318467612,136.079589549938,16.1594512590551,179.029710001637,9.28498318467612
2020-08-22,6077,136,5889,135,188,1,6770,153,91129,1892,97899,2045,0,49,69,829,67,5199,4,269,55,"Knox County",470313,130.3387318658,0.0899837133550489,434.816813483786,28.9169127793618,176.265593338904,8.99837133550489
2020-08-21,5941,30,5754,30,187,0,6617,41,89237,262,95854,303,1,49,-62,760,91,5132,1,265,55,"Knox County",470313,117.793894704165,0.0843075230367212,64.4251806775488,6.37873076015334,161.594512590551,8.43075230367212
2020-08-20,5911,119,5724,117,187,2,6576,130,88975,2068,95551,2198,3,48,24,822,92,5041,3,264,55,"Knox County",470313,118.43176778018,0.0828796951551443,467.348340360568,25.3022986819416,174.777222828202,8.28796951551443
2020-08-19,5792,46,5607,41,185,5,6446,48,86907,608,93353,656,2,45,-50,798,94,4949,4,261,55,"Knox County",470313,111.840412661355,0.0801516002245929,139.481579288686,9.7807204989018,169.674238220079,8.01516002245929
2020-08-18,5746,134,5566,132,180,2,6398,152,86299,1164,92697,1316,0,43,3,848,131,4855,4,257,55,"Knox County",470313,121.833757518929,0.0841836734693878,279.81365601206,28.4916640620183,180.305456153668,8.41836734693877
2020-08-17,5612,50,5434,42,178,8,6246,50,85135,289,91381,339,1,43,-70,845,119,4724,0,253,54,"Knox County",470313,125.660995975021,0.0864345738295318,72.0796575897328,10.6312179335889,179.667583077653,8.64345738295318
2020-08-16,5562,83,5392,78,170,5,6196,82,84846,587,91042,669,0,42,11,915,72,4605,1,253,53,"Knox County",470313,127.149366485723,0.0871644964124369,142.24569595142,17.6478217697576,194.551288184677,8.71644964124369
2020-08-15,5479,119,5314,116,165,3,6114,132,84259,1223,90373,1355,1,42,42,904,76,4533,2,252,52,"Knox County",470313,123.534752388303,0.0928905792861322,288.106006000259,25.3022986819416,192.212420239287,9.28905792861323
2020-08-14,5360,91,5198,83,162,8,5982,96,83036,1024,89018,1120,0,41,5,862,86,4457,2,250,52,"Knox County",470313,136.504838267282,0.0901607212857703,238.139281712392,19.3488166391318,183.282197175073,9.01607212857703
2020-08-13,5269,127,5115,126,154,1,5886,229,82012,1778,87898,2007,1,41,13,857,113,4371,4,248,51,"Knox County",470313,138.205833136656,0.105735727686947,426.737087854259,27.0032935513158,182.219075381714,10.5735727686947
2020-08-12,5142,79,4989,72,153,7,5657,88,80234,892,85891,980,0,40,-40,844,119,4258,1,244,50,"Knox County",470313,145.222436972824,0.106473156948369,208.371871498343,16.7973243350705,179.454958718981,10.6473156948369
2020-08-11,5063,111,4917,108,146,3,5569,117,79342,1121,84911,1238,0,40,2,884,109,4139,5,243,50,"Knox County",470313,140.332076723374,0.103009859885833,263.228956035661,23.6013038125674,187.959933065852,10.3009859885833
2020-08-10,4952,37,4809,35,143,2,5452,35,78221,365,83673,400,1,40,-94,882,130,4030,0,238,48,"Knox County",470313,137.56796006064,0.100270305058566,85.0497434687113,7.86710127085579,187.534684348508,10.0270305058566
2020-08-09,4915,85,4774,81,141,4,5417,109,77856,826,83273,935,1,39,25,976,59,3900,4,238,48,"Knox County",470313,137.993208777984,0.10031113876789,198.803775358113,18.0730704871011,207.521374063655,10.031113876789
2020-08-08,4830,157,4693,156,137,1,5308,176,77030,2284,82338,2460,1,38,96,951,60,3841,4,234,47,"Knox County",470313,146.072934407512,0.0929978118161926,523.055922332574,33.3820243114692,202.205765096861,9.29978118161926
2020-08-07,4673,50,4537,46,136,4,5132,44,74746,403,79878,447,0,37,-34,855,84,3781,0,230,45,"Knox County",470313,137.355335701969,0.0942482579426007,95.0430883262848,10.6312179335889,181.79382666437,9.42482579426007
2020-08-06,4623,113,4491,105,132,8,5088,121,74343,1463,79431,1584,-1,37,41,889,73,3697,5,230,43,"Knox County",470313,134.378594680564,0.0857782197911487,336.796984136097,24.0265525299109,189.023054859211,8.57782197911487
2020-08-05,4510,99,4386,99,124,0,4967,100,72880,1107,77847,1207,1,38,-1,848,99,3624,3,225,42,"Knox County",470313,138.631081853999,0.0848748639825898,256.637600916836,21.049811508506,180.305456153668,8.48748639825898
2020-08-04,4411,112,4287,111,124,1,4867,106,71773,1082,76640,1188,1,37,-31,849,142,3525,9,222,41,"Knox County",470313,138.843706212671,0.0840530349105948,252.597738102072,23.8139281712392,180.51808051234,8.40530349105948
2020-08-03,4299,50,4176,50,123,0,4761,81,70691,593,75452,674,2,36,-59,880,107,3383,1,213,41,"Knox County",470313,141.607822875404,0.0867569158328429,143.308817744778,10.6312179335889,187.109435631165,8.67569158328429
2020-08-02,4249,97,4126,91,123,6,4680,95,70098,692,74778,787,3,34,28,939,66,3276,2,212,40,"Knox County",470313,144.159315179466,0.0866179465676291,167.335370274689,20.6245627911625,199.6542727928,8.66179465676291
2020-08-01,4152,118,4035,110,117,8,4585,118,69406,1417,73991,1535,1,31,29,911,88,3210,1,210,40,"Knox County",470313,135.866965191266,0.0895984909727836,326.37839056118,25.0896743232698,193.70079074999,8.95984909727836
2020-07-31,4034,117,3925,114,109,3,4467,116,67989,1060,72456,1176,2,30,9,882,106,3122,1,209,39,"Knox County",470313,150.112797222275,0.0904183535762483,250.046245798011,24.877049964598,187.534684348508,9.04183535762483
2020-07-30,3917,189,3811,186,106,3,4351,227,66929,2420,71280,2647,1,28,78,873,110,3016,7,208,36,"Knox County",470313,166.272248481331,0.0914912090297374,562.816677404197,40.1860037889661,185.621065120462,9.14912090297373
2020-07-29,3728,75,3625,71,103,4,4124,60,64509,438,68633,498,0,27,-40,795,115,2906,3,201,34,"Knox County",470313,161.169263873208,0.0944150499706055,105.886930618546,15.9468269003834,169.036365144064,9.44150499706055
2020-07-28,3653,154,3554,152,99,2,4064,186,64071,1211,68135,1397,1,27,46,835,107,2791,3,198,30,"Knox County",470313,170.099486937423,0.101331191186596,297.036229064474,32.7441512354538,177.541339490935,10.1331191186596
2020-07-27,3499,83,3402,76,97,7,3878,85,62860,677,66738,762,3,26,-36,789,116,2684,2,195,30,"Knox County",470313,177.116090773591,0.100772551692797,162.019761307895,17.6478217697576,167.760618992033,10.0772551692797
2020-07-26,3416,118,3326,113,90,5,3793,132,62183,1473,65976,1605,0,23,49,825,69,2568,2,193,29,"Knox County",470313,181.581202305699,0.0960498960498961,341.262095668204,25.0896743232698,175.415095904217,9.6049896049896
2020-07-25,3298,175,3213,172,85,3,3661,197,60710,1949,64371,2146,2,23,95,776,78,2499,3,191,28,"Knox County",470313,193.70079074999,0.0980353826605415,456.291873709636,37.2092627675612,164.9965023293,9.80353826605415
2020-07-24,3123,106,3041,99,82,7,3464,113,58761,916,62225,1029,0,21,-15,681,121,2421,4,188,25,"Knox County",470313,191.3619228046,0.0991669972233241,218.79046507326,22.5381820192085,144.797188255481,9.91669972233241
2020-07-23,3017,205,2942,197,75,8,3351,254,57845,2389,61196,2643,0,21,89,696,116,2300,4,184,25,"Knox County",470313,194.763912543349,0.101884920634921,561.96617996951,43.5879935277145,147.986553635558,10.1884920634921
2020-07-22,2812,69,2745,61,67,8,3097,63,55456,437,58553,500,3,21,-68,607,134,2184,3,180,24,"Knox County",470313,193.488166391318,0.102162269390994,106.312179335889,14.6710807483527,129.062985713769,10.2162269390994
2020-07-21,2743,232,2684,228,59,4,3034,280,55019,1691,58053,1971,0,18,120,675,112,2050,12,177,24,"Knox County",470313,210.072866367717,0.10548048048048,419.082610942075,49.3288512118525,143.52144210345,10.548048048048
2020-07-20,2511,74,2456,70,55,4,2754,57,53328,364,56082,421,0,18,-59,555,133,1938,4,165,23,"Knox County",470313,208.159247139671,0.106253029568589,89.5148550008186,15.7342025417116,118.006519062837,10.6253029568589
2020-07-19,2437,84,2386,74,51,10,2697,74,52964,577,55661,651,0,18,-16,614,100,1805,0,161,22,"Knox County",470313,200.93001894483,0.110885589146459,138.418457495328,17.8604461284294,130.551356224472,11.0885589146459
2020-07-18,2353,112,2312,109,41,3,2623,146,52387,2258,55010,2404,1,18,36,630,75,1705,8,161,20,"Knox County",470313,187.534684348508,0.102609418858509,511.148958246955,23.8139281712392,133.95334596322,10.2609418858509
2020-07-17,2241,74,2203,74,38,0,2477,80,50129,347,52606,427,0,17,3,594,71,1630,6,153,19,"Knox County",470313,180.730704871011,0.105800155262282,90.7906011528493,15.7342025417116,126.298869051036,10.5800155262282
2020-07-16,2167,187,2129,185,38,2,2397,228,49782,2035,52179,2263,2,17,97,591,88,1559,3,147,17,"Knox County",470313,176.903466414919,0.107444714599977,481.168923674234,39.7607550716225,125.660995975021,10.7444714599977
2020-07-15,1980,78,1944,78,36,0,2169,80,47747,511,49916,591,3,15,-14,494,89,1471,4,144,17,"Knox County",470313,178.817085642965,0.10827222731439,125.660995975021,16.5846999763987,105.036433183858,10.827222731439
2020-07-14,1902,95,1866,95,36,0,2089,127,47236,777,49325,904,2,12,12,508,81,1382,1,140,16,"Knox County",470313,149.687548504932,0.103380759691946,192.212420239287,20.1993140738189,108.013174205263,10.3380759691946
2020-07-13,1807,94,1771,92,36,2,1962,59,46459,655,48421,714,1,10,20,496,73,1301,2,139,15,"Knox County",470313,153.940035678367,0.099823987930601,151.81379209165,19.9866897151471,105.461681901202,9.9823987930601
2020-07-12,1713,69,1679,67,34,2,1903,87,45804,916,47707,1003,0,9,27,476,42,1228,4,137,12,"Knox County",470313,150.750670298291,0.097158680471948,213.262231747793,14.6710807483527,101.209194727766,9.7158680471948
2020-07-11,1644,28,1612,27,32,1,1816,36,44888,883,46704,919,0,9,-16,449,44,1186,2,133,11,"Knox County",470313,132.890224169861,0.10218443043542,195.401785619364,5.95348204280979,95.4683370436284,10.218443043542
2020-07-10,1616,78,1585,74,31,4,1780,68,44005,418,45785,486,0,9,29,465,49,1142,6,131,10,"Knox County",470313,133.740721604548,0.0995639534883721,103.335438314484,16.5846999763987,98.8703267823768,9.95639534883721
2020-07-09,1538,70,1511,66,27,4,1712,88,43587,1652,45299,1740,0,9,23,436,47,1093,8,125,10,"Knox County",470313,108.86367163995,0.0857322636463741,369.966384088894,14.8837051070245,92.7042203808953,8.57322636463741
2020-07-08,1468,70,1445,65,23,5,1624,63,41935,594,43559,657,1,9,15,413,54,1046,5,117,10,"Knox County",470313,107.162676770576,0.0822045773003269,139.694203647358,14.8837051070245,87.8138601314444,8.2204577300327
2020-07-07,1398,79,1380,79,18,0,1561,104,41341,1304,42902,1408,0,8,38,398,41,992,7,112,10,"Knox County",470313,103.760687031828,0.0729031326692652,299.375097009864,16.7973243350705,84.6244947513677,7.29031326692652
2020-07-06,1319,35,1301,35,18,0,1457,34,40037,658,41494,692,1,8,-19,360,53,951,6,105,9,"Knox County",470313,91.2158498701928,0.0695148443157133,147.13605620087,7.44185255351224,76.5447691218401,6.95148443157133
2020-07-05,1284,77,1266,77,18,0,1423,109,39379,1080,40802,1189,2,7,34,379,41,898,6,99,9,"Knox County",470313,92.9168447395671,0.0707939641799464,252.810362460744,16.3720756177269,80.5846319366039,7.07939641799464
2020-07-04,1207,41,1189,40,18,1,1314,50,38299,1141,39613,1191,0,5,4,345,37,857,1,93,8,"Knox County",470313,95.6809614023002,0.0700801303816379,253.235611178088,8.7175987055429,73.3554037417635,7.00801303816379
2020-07-03,1166,62,1149,61,17,1,1264,49,37158,910,38422,959,0,5,27,341,35,820,4,92,6,"Knox County",470313,92.2789716635517,0.0634252169474222,203.906759966235,13.1827102376502,72.5049063070764,6.34252169474222
2020-07-02,1104,68,1088,68,16,0,1215,102,36248,1228,37463,1330,0,5,33,314,35,785,2,88,6,"Knox County",470313,91.8537229462082,0.0688122811742526,282.790397033465,14.4584563896809,66.7640486229383,6.88122811742526
2020-07-01,1036,49,1020,49,16,0,1113,34,35020,737,36133,771,0,5,25,281,24,750,4,86,6,"Knox County",470313,87.3886114141008,0.0639257294429708,163.933380535941,10.4185935749171,59.7474447867697,6.39257294429708
2020-06-30,987,40,971,39,16,1,1079,73,34283,1514,35362,1587,0,5,18,256,22,726,3,82,5,"Knox County",470313,79.0962614259015,0.0584272574167638,337.434857212112,8.50497434687113,54.4318358199752,5.84272574167638
2020-06-29,947,51,932,51,15,0,1006,79,32769,1333,33775,1412,0,5,20,238,31,704,3,79,5,"Knox County",470313,82.4982511646499,0.0587747363431686,300.225594444551,10.8438422922607,50.6045973638832,5.87747363431686
2020-06-28,896,10,881,10,15,0,927,30,31436,684,32363,714,0,5,-5,218,15,673,1,76,5,"Knox County",470313,68.2524191336408,0.0523606228026118,151.81379209165,2.12624358671778,46.3521101904476,5.23606228026117
2020-06-27,886,29,871,29,15,0,897,16,30752,111,31649,127,0,5,18,223,11,658,3,75,5,"Knox County",470313,65.7009268295794,0.0555072463768116,27.0032935513158,6.16610640148157,47.4152319838065,5.55072463768116
2020-06-26,857,37,842,37,15,0,881,14,30641,319,31522,333,0,5,17,205,20,647,8,72,5,"Knox County",470313,60.385317862785,0.0554670066942939,70.8039114377021,7.86710127085579,43.5879935277145,5.54670066942939
2020-06-25,820,32,805,32,15,0,867,52,30322,702,31189,754,0,5,13,188,19,627,1,64,5,"Knox County",470313,52.730840950601,0.0522990522990523,160.318766438521,6.8039794774969,39.9733794302943,5.22990522990523
2020-06-24,788,35,773,34,15,1,815,32,29620,272,30435,304,0,5,22,175,13,608,1,63,5,"Knox County",470313,49.7540999291961,0.0565857388644619,64.6378050362206,7.44185255351224,37.2092627675612,5.65857388644619
2020-06-23,753,27,739,24,14,3,783,25,29348,216,30131,241,0,5,18,153,9,595,4,62,5,"Knox County",470313,46.989983266463,0.0638352638352638,51.2424704398985,5.74085768413801,32.5315268767821,6.38352638352638
2020-06-22,726,36,715,36,11,0,758,31,29132,572,29890,603,0,5,20,135,16,586,0,58,5,"Knox County",470313,43.8006178863863,0.0650195058517555,128.212488279082,7.65447691218401,28.7042884206901,6.50195058517555
2020-06-21,690,31,679,31,11,0,727,37,28560,815,29287,852,0,5,16,115,15,570,1,58,5,"Knox County",470313,48.2657294184936,0.0644057249533292,181.155953588355,6.59135511882512,24.4518012472545,6.44057249533292
2020-06-20,659,17,648,17,11,0,690,9,27745,437,28435,446,0,5,11,99,6,555,2,57,5,"Knox County",470313,45.7142371144323,0.0566091140673648,94.8304639676131,3.61461409742023,21.049811508506,5.66091140673648
2020-06-19,642,30,631,28,11,2,681,10,27308,334,27989,344,0,5,8,88,22,549,1,55,5,"Knox County",470313,44.2258666037299,0.0553047404063205,73.1427793830917,6.37873076015334,18.7109435631165,5.53047404063205
2020-06-18,612,15,603,15,9,0,671,18,26974,804,27645,822,0,5,2,80,13,527,0,54,5,"Knox County",470313,40.6112525063096,0.0448504983388704,174.777222828202,3.18936538007667,17.0099486937423,4.48504983388704
2020-06-17,597,17,588,17,9,0,653,13,26170,282,26823,295,0,5,-3,78,20,514,0,54,5,"Knox County",470313,36.7840140502176,0.0396891479322787,62.7241858081746,3.61461409742023,16.5846999763987,3.96891479322787
2020-06-16,580,9,571,8,9,1,640,9,25888,178,26528,187,0,5,-2,81,11,494,0,54,5,"Knox County",470313,32.9567755941256,0.0357847280924204,39.7607550716225,1.913619228046,17.222573052414,3.57847280924204
2020-06-15,571,8,563,8,8,0,631,9,25710,218,26341,227,0,5,-5,83,13,483,0,54,5,"Knox County",470313,27.0032935513158,0.0330917113142137,48.2657294184936,1.70099486937423,17.6478217697576,3.30917113142137
2020-06-14,563,8,555,8,8,0,622,9,25492,624,26114,633,0,5,4,88,4,470,0,54,5,"Knox County",470313,22.1129333018649,0.0260663507109005,134.591219039236,1.70099486937423,18.7109435631165,2.60663507109005
2020-06-13,555,10,547,8,8,2,613,9,24868,213,25481,222,0,5,0,84,10,466,3,54,5,"Knox County",470313,20.6245627911625,0.0282051282051282,47.2026076251348,2.12624358671778,17.8604461284294,2.82051282051282
2020-06-12,545,19,539,19,6,0,604,19,24655,750,25259,769,0,5,1,84,18,456,0,51,5,"Knox County",470313,18.2856948457729,0.0272583201267829,163.508131818597,4.03986281476378,17.8604461284294,2.72583201267829
2020-06-11,526,7,520,7,6,0,585,10,23905,379,24490,389,0,5,1,83,6,438,2,51,5,"Knox County",470313,16.5846999763987,0.0286554004408523,82.7108755233217,1.48837051070245,17.6478217697576,2.86554004408523
2020-06-10,519,12,513,12,6,0,575,12,23526,706,24101,718,0,5,-6,82,18,432,0,49,5,"Knox County",470313,15.5215781830398,0.024483306836248,152.664289526337,2.55149230406134,17.4351974110858,2.4483306836248
2020-06-09,507,16,501,16,6,0,563,19,22820,508,23383,527,0,5,5,88,11,414,1,49,5,"Knox County",470313,17.0099486937423,0.0249641319942611,112.053037020027,3.40198973874845,18.7109435631165,2.49641319942611
2020-06-08,491,8,485,8,6,0,544,8,22312,336,22856,344,0,5,4,83,4,403,1,48,5,"Knox County",470313,17.0099486937423,0.0238756246529706,73.1427793830917,1.70099486937423,17.6478217697576,2.38756246529706
2020-06-07,483,7,477,7,6,0,536,8,21976,849,22512,857,0,5,0,79,7,399,1,47,5,"Knox County",470313,16.7973243350705,0.0222164140094093,182.219075381714,1.48837051070245,16.7973243350705,2.22164140094093
2020-06-06,476,11,470,11,6,0,528,12,21127,478,21655,490,0,5,5,79,6,392,0,46,5,"Knox County",470313,17.0099486937423,0.021494870542257,104.185935749171,2.33886794538956,16.7973243350705,2.1494870542257
2020-06-05,465,18,459,18,6,0,516,17,20649,518,21165,535,0,5,7,74,11,386,1,46,5,"Knox County",470313,16.7973243350705,0.022279792746114,113.754031889401,3.82723845609201,15.7342025417116,2.2279792746114
2020-06-04,447,4,441,4,6,0,499,4,20131,338,20630,342,0,5,-1,67,5,375,0,45,5,"Knox County",470313,16.1594512590551,0.02098085496984,72.7175306657481,0.850497434687113,14.2458320310091,2.098085496984
2020-06-03,443,4,437,4,6,0,495,4,19793,399,20288,403,0,5,-3,68,7,370,0,45,5,"Knox County",470313,14.4584563896809,0.0205831903945112,85.6876165447266,0.850497434687113,14.4584563896809,2.05831903945112
2020-06-02,439,26,433,25,6,1,491,24,19394,939,19885,963,0,5,21,71,5,363,2,45,5,"Knox County",470313,16.5846999763987,0.0195729537366548,204.757257400922,5.52823332546623,15.0963294656962,1.95729537366548
2020-06-01,413,17,408,17,5,0,467,20,18455,972,18922,992,0,5,4,50,13,358,0,43,5,"Knox County",470313,18.4983192044447,0.0194238323876037,210.923363802404,3.61461409742023,10.6312179335889,1.94238323876037
2020-05-31,396,7,391,7,5,0,447,7,17483,317,17930,324,0,5,3,46,4,345,0,43,5,"Knox County",470313,18.4983192044447,0.0217337614225735,68.8902922096561,1.48837051070245,9.7807204989018,2.17337614225735
2020-05-30,389,6,384,6,5,0,440,6,17166,294,17606,300,0,5,-1,43,7,341,2,43,5,"Knox County",470313,17.4351974110858,0.0212490282456595,63.7873076015334,1.27574615203067,9.14284742288646,2.12490282456595
2020-05-29,383,8,378,8,5,0,434,7,16872,205,17306,212,0,5,0,44,8,334,0,41,5,"Knox County",470313,15.308953824368,0.0203619909502262,45.076364038417,1.70099486937423,9.35547178155824,2.03619909502262
2020-05-28,375,11,370,11,5,0,427,11,16667,336,17094,347,0,5,7,44,4,326,0,41,5,"Knox County",470313,16.7973243350705,0.022310081897769,73.780652459107,2.33886794538956,9.35547178155824,2.2310081897769
2020-05-27,364,5,359,5,5,0,416,6,16331,420,16747,426,0,5,0,37,5,322,1,41,5,"Knox County",470313,17.0099486937423,0.0227272727272727,90.5779767941775,1.06312179335889,7.86710127085579,2.27272727272727
2020-05-26,359,9,354,9,5,0,410,10,15911,1142,16321,1152,0,5,7,37,2,317,0,40,5,"Knox County",470313,13.395334596322,0.0178523847588596,244.943261189888,1.913619228046,7.86710127085579,1.78523847588596
2020-05-25,350,9,345,9,5,0,400,11,14769,381,15169,392,0,5,5,30,4,315,1,40,5,"Knox County",470313,11.6943397269478,0.018395179194418,83.348748599337,1.913619228046,6.37873076015334,1.8395179194418
2020-05-24,341,2,336,2,5,0,389,3,14388,273,14777,276,0,5,1,25,1,311,0,39,5,"Knox County",470313,10.6312179335889,0.0173913043478261,58.6843229934108,0.425248717343556,5.31560896679445,1.73913043478261
2020-05-23,339,7,334,7,5,0,386,10,14115,360,14501,370,0,5,4,24,3,310,2,39,5,"Knox County",470313,10.8438422922607,0.0182677165354331,78.6710127085579,1.48837051070245,5.10298460812268,1.82677165354331
2020-05-22,332,1,327,1,5,0,376,1,13755,253,14131,254,0,5,-14,20,15,307,0,37,5,"Knox County",470313,9.35547178155824,0.0161641280696301,54.0065871026317,0.212624358671778,4.25248717343556,1.61641280696301
2020-05-21,331,0,326,0,5,0,375,0,13502,250,13877,250,0,5,-1,34,1,292,0,37,5,"Knox County",470313,7.01660383616868,0.0131410256410256,53.1560896679445,0,7.22922819484046,1.31410256410256
2020-05-20,331,7,326,7,5,0,375,7,13252,360,13627,367,0,5,4,35,3,291,0,37,5,"Knox County",470313,7.44185255351224,0.0137210062071219,78.0331396325426,1.48837051070245,7.44185255351224,1.37210062071219
2020-05-19,324,7,319,7,5,0,368,7,12892,369,13260,376,0,5,4,31,3,288,2,37,5,"Knox County",470313,7.01660383616868,0.0170678336980306,79.9467588605886,1.48837051070245,6.59135511882512,1.70678336980306
2020-05-18,317,3,312,3,5,0,361,4,12523,478,12884,482,0,5,0,27,3,285,0,35,5,"Knox County",470313,5.74085768413801,0.0134736842105263,102.484940879797,0.637873076015334,5.74085768413801,1.34736842105263
2020-05-17,314,3,309,3,5,0,357,5,12045,216,12402,221,0,5,1,27,2,282,1,35,5,"Knox County",470313,5.95348204280979,0.0146551724137931,46.989983266463,0.637873076015334,5.74085768413801,1.46551724137931
2020-05-16,311,0,306,0,5,0,352,0,11829,349,12181,349,0,5,-4,26,4,280,0,34,5,"Knox County",470313,4.46511153210734,0.0104393214441061,74.2059011764506,0,5.52823332546623,1.04393214441061
2020-05-15,311,1,306,1,5,0,352,4,11480,540,11832,544,0,5,-4,30,5,276,0,34,5,"Knox County",470313,4.46511153210734,0.0104287369640788,115.667651117447,0.212624358671778,6.37873076015334,1.04287369640788
2020-05-14,310,3,305,3,5,0,348,7,10940,458,11288,465,0,5,0,34,3,271,0,34,5,"Knox County",470313,5.10298460812268,0.0121255349500713,98.8703267823768,0.637873076015334,7.22922819484046,1.21255349500713
2020-05-13,307,7,302,7,5,0,341,5,10482,341,10823,346,0,5,1,34,6,268,0,34,5,"Knox County",470313,5.10298460812268,0.011498383039885,73.5680281004352,1.48837051070245,7.22922819484046,1.1498383039885
2020-05-12,300,6,295,6,5,0,336,8,10141,401,10477,409,0,5,3,33,3,262,0,34,5,"Knox County",470313,4.8903602494509,0.01171875,86.9633626967573,1.27574615203067,7.01660383616868,1.171875
2020-05-11,294,16,289,16,5,0,328,12,9740,254,10068,266,0,5,9,30,7,259,1,34,5,"Knox County",470313,7.65447691218401,0.0157692307692308,56.558079406693,3.40198973874845,6.37873076015334,1.57692307692308
2020-05-10,278,5,273,5,5,0,316,5,9486,221,9802,226,0,5,1,21,4,252,1,33,5,"Knox County",470313,8.07972562952757,0.0157389635316699,48.0531050598219,1.06312179335889,4.46511153210734,1.57389635316699
2020-05-09,273,2,268,2,5,0,311,4,9265,352,9576,356,0,5,-1,20,3,248,0,32,5,"Knox County",470313,8.50497434687113,0.0172281776416539,75.694271687153,0.425248717343556,4.25248717343556,1.72281776416539
2020-05-08,271,3,266,3,5,0,307,4,8913,265,9220,269,0,5,-2,21,5,245,0,32,5,"Knox County",470313,8.93022306421468,0.0192554557124519,57.1959524827083,0.637873076015334,4.46511153210734,1.92554557124519
2020-05-07,268,3,263,3,5,0,303,3,8648,220,8951,223,0,5,-2,23,5,240,0,32,5,"Knox County",470313,8.93022306421468,0.0195704057279236,47.4152319838065,0.637873076015334,4.8903602494509,1.95704057279236
2020-05-06,265,1,260,1,5,0,300,1,8428,185,8728,186,0,5,-7,25,8,235,0,32,5,"Knox County",470313,7.65447691218401,0.0191214470284238,39.5481307129507,0.212624358671778,5.31560896679445,1.91214470284238
2020-05-05,264,4,259,4,5,0,299,5,8243,305,8542,310,0,5,-1,32,5,227,0,32,5,"Knox County",470313,7.22922819484046,0.0185185185185185,65.9135511882512,0.850497434687113,6.8039794774969,1.85185185185185
2020-05-04,260,4,255,4,5,0,294,7,7938,259,8232,266,0,5,-3,33,7,222,0,32,5,"Knox County",470313,4.67773589077912,0.0157952069716776,56.558079406693,0.850497434687113,7.01660383616868,1.57952069716776
2020-05-03,256,7,251,5,5,2,287,6,7679,290,7966,296,0,5,6,36,1,215,2,32,5,"Knox County",470313,5.10298460812268,0.0157397691500525,62.9368101668463,1.48837051070245,7.65447691218401,1.57397691500525
2020-05-02,249,3,246,3,3,0,281,5,7389,308,7670,313,0,5,1,30,2,214,1,30,5,"Knox County",470313,5.31560896679445,0.0166398282340311,66.5514242642666,0.637873076015334,6.37873076015334,1.66398282340311
2020-05-01,246,9,243,8,3,1,276,7,7081,354,7357,361,0,5,4,29,5,212,0,29,5,"Knox County",470313,6.59135511882512,0.0173913043478261,76.7573934805119,1.913619228046,6.16610640148157,1.73913043478261
2020-04-30,237,4,235,4,2,0,269,3,6727,119,6996,122,0,5,-1,25,5,207,0,29,5,"Knox County",470313,6.8039794774969,0.0183387270765912,25.9401717579569,0.850497434687113,5.31560896679445,1.83387270765912
2020-04-29,233,8,231,8,2,0,266,10,6608,671,6874,681,0,5,5,26,3,202,0,29,5,"Knox County",470313,8.29234998819935,0.0183056619838229,144.797188255481,1.70099486937423,5.52823332546623,1.83056619838229
2020-04-28,225,8,223,8,2,0,256,10,5937,391,6193,401,1,5,4,21,3,199,0,29,5,"Knox County",470313,9.14284742288646,0.019672131147541,85.262367827383,1.70099486937423,4.46511153210734,1.9672131147541
2020-04-27,217,2,215,2,2,0,246,4,5546,161,5792,165,0,4,1,17,1,196,0,29,5,"Knox County",470313,8.7175987055429,0.0192389910218042,35.0830191808434,0.425248717343556,3.61461409742023,1.92389910218042
2020-04-26,215,1,213,1,2,0,242,1,5385,172,5627,173,0,4,-2,16,3,195,0,29,4,"Knox County",470313,7.44185255351224,0.0180505415162455,36.7840140502176,0.212624358671778,3.40198973874845,1.80505415162455
2020-04-25,214,0,212,0,2,0,241,0,5213,53,5454,53,0,4,-6,18,6,192,0,29,4,"Knox County",470313,6.8039794774969,0.0178936605316973,11.2690910096042,0,3.82723845609201,1.78936605316973
2020-04-24,214,8,212,8,2,0,241,10,5160,836,5401,846,0,4,5,24,3,186,1,29,4,"Knox County",470313,6.59135511882512,0.0155673904137649,179.880207436324,1.70099486937423,5.10298460812268,1.55673904137648
2020-04-23,206,1,204,1,2,0,231,2,4324,137,4555,139,0,4,0,19,1,183,0,28,4,"Knox County",470313,5.95348204280979,0.0150528885272579,29.5547858553772,0.212624358671778,4.03986281476378,1.50528885272579
2020-04-22,205,5,203,3,2,2,229,2,4187,189,4416,191,0,4,1,19,4,182,0,28,4,"Knox County",470313,5.31560896679445,0.0147357723577236,40.6112525063096,1.06312179335889,4.03986281476378,1.47357723577236
2020-04-21,200,4,200,4,0,0,227,5,3998,475,4225,480,0,4,-2,18,6,178,1,28,4,"Knox County",470313,4.46511153210734,0.0117244748412311,102.059692162454,0.850497434687113,3.82723845609201,1.17244748412311
2020-04-20,196,3,196,3,0,0,222,2,3523,175,3745,177,0,4,-1,20,4,172,1,27,4,"Knox County",470313,4.67773589077912,0.0106847984458475,37.6345114849047,0.637873076015334,4.25248717343556,1.06847984458475
2020-04-19,193,0,193,0,0,0,220,0,3348,72,3568,72,0,4,-4,21,4,168,0,26,4,"Knox County",470313,4.46511153210734,0.0107252298263534,15.308953824368,0,4.46511153210734,1.07252298263534
2020-04-18,193,0,193,0,0,0,220,1,3276,135,3496,136,0,4,-5,25,5,164,0,26,4,"Knox County",470313,4.46511153210734,0.0107790298873101,28.9169127793618,0,5.31560896679445,1.07790298873101
2020-04-17,193,2,193,2,0,0,219,3,3141,104,3360,107,0,4,-2,30,4,159,1,26,4,"Knox County",470313,3.18936538007667,0.0115207373271889,22.7508063778803,0.425248717343556,6.37873076015334,1.15207373271889
2020-04-16,191,7,191,7,0,0,216,9,3037,213,3253,222,0,4,2,32,5,155,2,25,4,"Knox County",470313,4.46511153210734,0.015884476534296,47.2026076251348,1.48837051070245,6.8039794774969,1.5884476534296
2020-04-15,184,9,184,9,0,0,207,10,2824,84,3031,94,0,4,3,30,6,150,1,23,4,"Knox County",470313,5.31560896679445,0.0232919254658385,19.9866897151471,1.913619228046,6.37873076015334,2.32919254658385
2020-04-14,175,4,175,4,0,0,197,4,2740,102,2937,106,0,4,1,27,3,144,1,22,4,"Knox County",470313,5.31560896679445,0.0317286652078775,22.5381820192085,0.850497434687113,5.74085768413801,3.17286652078775
2020-04-13,171,4,171,4,0,0,193,9,2638,242,2831,251,0,4,-2,26,6,141,1,21,4,"Knox County",470313,5.52823332546623,0.0364372469635627,53.3687140266163,0.850497434687113,5.52823332546623,3.64372469635628
2020-04-12,167,5,167,5,0,0,184,6,2396,166,2580,172,0,4,1,28,4,135,0,20,4,"Knox County",470313,6.59135511882512,0.0386029411764706,36.5713896915458,1.06312179335889,5.95348204280979,3.86029411764706
2020-04-11,162,5,162,5,0,0,178,8,2230,313,2408,321,1,4,-4,27,8,131,1,20,4,"Knox County",470313,7.65447691218401,0.0384917517674784,68.2524191336408,1.06312179335889,5.74085768413801,3.84917517674784
2020-04-10,157,4,157,4,0,0,170,5,1917,123,2087,128,0,3,0,31,4,123,0,19,4,"Knox County",470313,8.07972562952757,0.0394126738794436,27.2159179099876,0.850497434687113,6.59135511882512,3.94126738794436
2020-04-09,153,1,153,1,0,0,165,1,1794,81,1959,82,0,3,-2,31,3,119,0,19,4,"Knox County",470313,6.8039794774969,0.037261698440208,17.4351974110858,0.212624358671778,6.59135511882512,3.7261698440208
2020-04-08,152,8,152,8,0,0,164,12,1713,111,1877,123,0,3,-3,33,11,116,1,19,4,"Knox County",470313,6.59135511882512,0.0380388841927303,26.1527961166287,1.70099486937423,7.01660383616868,3.80388841927303
2020-04-07,144,20,144,20,0,0,152,25,1602,366,1754,391,0,3,11,36,9,105,2,18,3,"Knox County",470313,9.99334485757357,0.0449591280653951,83.1361242406653,4.25248717343556,7.65447691218401,4.49591280653951
2020-04-06,124,8,124,8,0,0,127,14,1236,54,1363,68,2,3,-2,25,8,96,1,16,3,"Knox County",470313,10.8438422922607,0.0552529182879377,14.4584563896809,1.70099486937423,5.31560896679445,5.52529182879377
2020-04-05,116,4,116,4,0,0,113,10,1182,75,1295,85,0,1,-2,27,6,88,0,15,3,"Knox County",470313,10.6312179335889,0.0626043405676127,18.0730704871011,0.850497434687113,5.74085768413801,6.26043405676127
2020-04-04,112,15,112,15,0,0,103,6,1107,127,1210,133,0,1,4,29,11,82,1,15,2,"Knox County",470313,12.7574615203067,0.0722772277227723,28.2790397033465,3.18936538007667,6.16610640148157,7.22772277227723
2020-04-03,97,4,97,4,0,0,97,3,980,51,1077,54,0,1,-8,25,12,71,1,14,1,"Knox County",470313,12.7574615203067,0.0758547008547008,11.481715368276,0.850497434687113,5.31560896679445,7.58547008547009
2020-04-02,93,7,93,7,0,0,94,7,929,106,1023,113,0,1,NA,33,8,59,0,13,1,"Knox County",470313,14.0332076723374,0.0796277145811789,24.0265525299109,1.48837051070245,7.01660383616868,7.96277145811789
2020-04-01,86,15,86,15,0,0,87,15,823,140,910,155,NA,NA,NA,NA,7,51,1,13,1,"Knox County",470313,15.5215781830398,0.0800800800800801,32.9567755941256,3.18936538007667,NA,8.00800800800801
2020-03-31,71,8,71,8,0,0,72,11,683,58,755,69,NA,NA,NA,NA,12,44,1,12,1,"Knox County",470313,12.9700858789785,0.0974889217134417,14.6710807483527,1.70099486937423,NA,9.74889217134417
2020-03-30,63,13,63,13,0,0,61,15,625,130,686,145,NA,NA,NA,NA,9,32,2,11,1,"Knox County",470313,14.0332076723374,0.0888594164456233,30.8305320074078,2.76411666273312,NA,8.88594164456233
2020-03-29,50,8,50,8,0,0,46,8,495,55,541,63,NA,NA,NA,NA,6,23,1,9,1,"Knox County",470313,14.8837051070245,0.0887978142076503,13.395334596322,1.70099486937423,NA,8.87978142076503
2020-03-28,42,7,42,7,0,0,38,6,440,62,478,68,NA,NA,NA,NA,1,17,1,8,0,"Knox County",470313,13.1827102376502,0.0974512743628186,14.4584563896809,1.48837051070245,NA,9.74512743628186
2020-03-27,35,2,35,2,0,0,32,2,378,54,410,56,NA,NA,NA,NA,5,16,1,7,0,"Knox County",470313,12.7574615203067,0.0956651718983558,11.9069640856196,0.425248717343556,NA,9.56651718983558
2020-03-26,33,7,33,7,0,0,30,7,324,82,354,89,NA,NA,NA,NA,3,11,2,6,0,"Knox County",470313,12.7574615203067,0.0992248062015504,18.9235679217883,1.48837051070245,NA,9.92248062015504
2020-03-25,26,6,26,6,0,0,23,7,242,68,265,75,NA,NA,NA,NA,3,8,1,4,0,"Knox County",470313,10.8438422922607,0.0991150442477876,15.9468269003834,1.27574615203067,NA,9.91150442477876
2020-03-24,20,7,20,7,0,0,16,7,174,43,190,50,NA,NA,NA,NA,2,5,0,3,0,"Knox County",470313,10.6312179335889,0.0952380952380952,10.6312179335889,1.48837051070245,NA,9.52380952380952
2020-03-23,13,4,13,4,0,0,9,4,131,22,140,26,NA,NA,NA,NA,3,3,2,3,0,"Knox County",470313,8.7175987055429,0.0960187353629977,5.52823332546623,0.850497434687113,NA,9.60187353629976
2020-03-22,9,2,9,2,0,0,5,0,109,9,114,9,NA,NA,NA,NA,0,0,1,1,0,"Knox County",470313,7.44185255351224,0.0884718498659517,1.913619228046,0.425248717343556,NA,8.84718498659517
2020-03-21,7,1,7,1,0,0,5,2,100,17,105,19,NA,NA,NA,NA,0,0,0,0,0,"Knox County",470313,6.16610640148157,0.0895061728395062,4.03986281476378,0.212624358671778,NA,8.95061728395062
2020-03-20,6,5,6,5,0,0,3,2,83,38,86,40,NA,NA,NA,NA,0,0,0,0,0,"Knox County",470313,6.8039794774969,0.0941558441558442,8.50497434687113,1.06312179335889,NA,9.41558441558442
2020-03-19,1,0,1,0,0,0,1,0,45,11,46,11,NA,NA,NA,NA,0,0,0,0,0,"Knox County",470313,5.31560896679445,0.0956521739130435,2.33886794538956,0,NA,9.56521739130435
2020-03-18,1,0,1,0,0,0,1,0,34,15,35,15,NA,NA,NA,NA,0,0,0,0,0,"Knox County",470313,4.03986281476378,0.0882352941176471,3.18936538007667,0,NA,8.82352941176471
2020-03-17,1,0,1,0,0,0,1,0,19,5,20,5,NA,NA,NA,NA,0,0,0,0,0,"Knox County",470313,2.55149230406134,0.064,1.06312179335889,0,NA,6.4
2020-03-16,1,1,1,1,0,0,1,1,14,3,15,4,NA,NA,NA,NA,0,0,0,0,0,"Knox County",470313,1.913619228046,0.0485436893203883,0.850497434687113,0.212624358671778,NA,4.85436893203883
2020-03-15,0,0,0,0,0,0,0,0,11,1,11,1,NA,NA,NA,NA,0,0,0,0,0,"Knox County",470313,1.48837051070245,0.0526315789473684,0.212624358671778,0,NA,5.26315789473684
2020-03-14,0,0,0,0,0,0,0,0,10,8,10,8,NA,NA,NA,NA,0,0,0,0,0,"Knox County",470313,1.27574615203067,0.0357142857142857,1.70099486937423,0,NA,3.57142857142857
2020-03-13,0,0,0,0,0,0,0,0,2,0,2,0,NA,NA,NA,NA,0,0,0,0,0,"Knox County",470313,0.212624358671778,0.0227272727272727,0,0,NA,2.27272727272727
2020-03-12,0,0,0,0,0,0,0,0,2,2,2,2,NA,NA,NA,NA,0,0,0,0,0,"Knox County",470313,0.212624358671778,0.0285714285714286,0.425248717343556,0,NA,2.85714285714286
2020-03-12,0,0,0,0,0,0,0,0,0,0,0,0,NA,NA,NA,NA,0,0,0,0,0,"Anderson",76978,NA,NA,0,0,NA,NA
2020-03-13,0,0,0,0,0,0,0,0,1,1,1,1,NA,NA,NA,NA,0,0,0,0,0,"Anderson",76978,NA,NA,1.29907246226194,0,NA,NA
2020-03-14,0,0,0,0,0,0,0,0,1,0,1,0,NA,NA,NA,NA,0,0,0,0,0,"Anderson",76978,NA,NA,0,0,NA,NA
2020-03-15,0,0,0,0,0,0,0,0,1,0,1,0,NA,NA,NA,NA,0,0,0,0,0,"Anderson",76978,NA,NA,0,0,NA,NA
2020-03-16,0,0,0,0,0,0,0,0,2,1,2,1,NA,NA,NA,NA,0,0,0,0,0,"Anderson",76978,NA,NA,1.29907246226194,0,NA,NA
2020-03-17,0,0,0,0,0,0,0,0,4,2,4,2,NA,NA,NA,NA,0,0,0,0,0,"Anderson",76978,NA,NA,2.59814492452389,0,NA,NA
2020-03-18,0,0,0,0,0,0,0,0,4,0,4,0,NA,NA,NA,NA,0,0,0,0,0,"Anderson",76978,0,0,0,0,NA,0
2020-03-19,1,1,1,1,0,0,2,2,5,1,7,3,NA,NA,NA,NA,0,0,0,0,0,"Anderson",76978,1.29907246226194,0.285714285714286,3.89721738678583,1.29907246226194,NA,28.5714285714286
2020-03-20,1,0,1,0,0,0,2,0,7,2,9,2,NA,NA,NA,NA,0,0,0,0,0,"Anderson",76978,1.29907246226194,0.25,2.59814492452389,0,NA,25
2020-03-21,1,0,1,0,0,0,2,0,7,0,9,0,NA,NA,NA,NA,0,0,0,0,0,"Anderson",76978,1.29907246226194,0.25,0,0,NA,25
2020-03-22,1,0,1,0,0,0,2,0,10,3,12,3,NA,NA,NA,NA,0,0,0,0,0,"Anderson",76978,1.29907246226194,0.181818181818182,3.89721738678583,0,NA,18.1818181818182
2020-03-23,1,0,1,0,0,0,2,0,15,5,17,5,NA,NA,NA,NA,0,0,0,0,0,"Anderson",76978,1.29907246226194,0.133333333333333,6.49536231130973,0,NA,13.3333333333333
2020-03-24,1,0,1,0,0,0,2,0,20,5,22,5,NA,NA,NA,NA,0,0,0,0,0,"Anderson",76978,1.29907246226194,0.111111111111111,6.49536231130973,0,NA,11.1111111111111
2020-03-25,2,1,2,1,0,0,4,2,29,9,33,11,NA,NA,NA,NA,1,1,0,0,0,"Anderson",76978,2.59814492452389,0.137931034482759,14.2897970848814,1.29907246226194,NA,13.7931034482759
2020-03-26,3,1,3,1,0,0,5,1,44,15,49,16,NA,NA,NA,NA,0,1,1,1,0,"Anderson",76978,2.59814492452389,0.0714285714285714,20.7851593961911,1.29907246226194,NA,7.14285714285714
2020-03-27,4,1,4,1,0,0,6,1,53,9,59,10,NA,NA,NA,NA,3,4,0,1,0,"Anderson",76978,3.89721738678583,0.08,12.9907246226195,1.29907246226194,NA,8
2020-03-28,7,3,7,3,0,0,9,3,72,19,81,22,NA,NA,NA,NA,0,4,1,2,0,"Anderson",76978,7.79443477357167,0.0972222222222222,28.5795941697628,3.89721738678583,NA,9.72222222222222
2020-03-29,7,0,7,0,0,0,9,0,83,11,92,11,NA,NA,NA,NA,0,4,0,2,0,"Anderson",76978,7.79443477357167,0.0875,14.2897970848814,0,NA,8.75
2020-03-30,8,1,8,1,0,0,10,1,127,44,137,45,NA,NA,NA,NA,1,5,0,2,0,"Anderson",76978,9.09350723583361,0.0666666666666667,58.4582608017875,1.29907246226194,NA,6.66666666666667
2020-03-31,9,1,9,1,0,0,11,1,142,15,153,16,NA,NA,NA,NA,1,6,0,2,0,"Anderson",76978,10.3925796980956,0.0687022900763359,20.7851593961911,1.29907246226194,NA,6.87022900763359
2020-04-01,9,0,9,0,0,0,11,0,163,21,174,21,NA,NA,NA,NA,0,6,0,2,0,"Anderson",76978,9.09350723583361,0.049645390070922,27.2805217075008,0,NA,4.9645390070922
2020-04-02,9,0,9,0,0,0,11,0,179,16,190,16,0,0,NA,3,0,6,0,2,0,"Anderson",76978,7.79443477357167,0.0425531914893617,20.7851593961911,0,3.89721738678583,4.25531914893617
2020-04-03,9,0,9,0,0,0,11,0,192,13,203,13,0,0,-2,1,2,8,0,2,0,"Anderson",76978,6.49536231130972,0.0347222222222222,16.8879420094053,0,1.29907246226194,3.47222222222222
2020-04-04,9,0,9,0,0,0,11,0,219,27,230,27,0,0,0,1,0,8,0,2,0,"Anderson",76978,2.59814492452389,0.0134228187919463,35.0749564810725,0,1.29907246226194,1.34228187919463
2020-04-05,9,0,9,0,0,0,11,0,248,29,259,29,0,0,0,1,0,8,0,2,0,"Anderson",76978,2.59814492452389,0.0119760479041916,37.6731014055964,0,1.29907246226194,1.19760479041916
2020-04-06,9,0,9,0,0,0,11,0,262,14,273,14,0,0,-1,0,1,9,0,2,0,"Anderson",76978,1.29907246226194,0.00735294117647059,18.1870144716672,0,0,0.735294117647059
2020-04-07,10,1,10,1,0,0,12,1,304,42,316,43,0,0,1,1,0,9,0,2,0,"Anderson",76978,1.29907246226194,0.00613496932515337,55.8601158772636,1.29907246226194,1.29907246226194,0.613496932515337
2020-04-08,10,0,10,0,0,0,12,0,322,18,334,18,1,1,-1,0,0,9,0,2,1,"Anderson",76978,1.29907246226194,0.00625,23.383304320715,0,0,0.625
2020-04-09,10,0,10,0,0,0,12,0,350,28,362,28,0,1,0,0,0,9,0,2,1,"Anderson",76978,1.29907246226194,0.00581395348837209,36.3740289433345,0,0,0.581395348837209
2020-04-10,10,0,10,0,0,0,12,0,366,16,378,16,0,1,0,0,0,9,0,2,1,"Anderson",76978,1.29907246226194,0.00571428571428571,20.7851593961911,0,0,0.571428571428571
2020-04-11,10,0,10,0,0,0,12,0,439,73,451,73,0,1,0,0,0,9,0,2,1,"Anderson",76978,1.29907246226194,0.00452488687782805,94.832289745122,0,0,0.452488687782805
2020-04-12,12,2,12,2,0,0,14,2,477,38,491,40,0,1,2,2,0,9,0,2,1,"Anderson",76978,3.89721738678583,0.0129310344827586,51.9628984904778,2.59814492452389,2.59814492452389,1.29310344827586
2020-04-13,13,1,13,1,0,0,15,1,514,37,529,38,0,1,0,2,1,10,0,2,1,"Anderson",76978,5.19628984904778,0.015625,49.3647535659539,1.29907246226194,2.59814492452389,1.5625
2020-04-14,13,0,13,0,0,0,15,0,526,12,541,12,0,1,0,2,0,10,0,2,1,"Anderson",76978,3.89721738678583,0.0133333333333333,15.5888695471433,0,2.59814492452389,1.33333333333333
2020-04-15,13,0,13,0,0,0,15,0,544,18,559,18,0,1,-2,0,2,12,0,2,1,"Anderson",76978,3.89721738678583,0.0133333333333333,23.383304320715,0,0,1.33333333333333
2020-04-16,13,0,13,0,0,0,15,0,566,22,581,22,0,1,0,0,0,12,0,2,1,"Anderson",76978,3.89721738678583,0.0136986301369863,28.5795941697628,0,0,1.36986301369863
2020-04-17,13,0,13,0,0,0,15,0,586,20,601,20,0,1,0,0,0,12,0,2,1,"Anderson",76978,3.89721738678583,0.0134529147982063,25.9814492452389,0,0,1.34529147982063
2020-04-18,13,0,13,0,0,0,15,0,616,30,631,30,0,1,0,0,0,12,0,2,1,"Anderson",76978,3.89721738678583,0.0166666666666667,38.9721738678584,0,0,1.66666666666667
2020-04-19,14,1,14,1,0,0,16,1,628,12,644,13,0,1,0,0,1,13,0,2,1,"Anderson",76978,2.59814492452389,0.0130718954248366,16.8879420094053,1.29907246226194,0,1.30718954248366
2020-04-20,19,5,18,4,1,1,19,3,648,20,667,23,0,1,5,5,0,13,0,2,1,"Anderson",76978,7.79443477357167,0.0289855072463768,29.8786666320247,6.49536231130973,6.49536231130973,2.89855072463768
2020-04-21,20,1,19,1,1,0,22,3,1071,423,1093,426,0,1,1,6,0,13,0,2,1,"Anderson",76978,9.09350723583361,0.0126811594202899,553.404868923589,1.29907246226194,7.79443477357167,1.26811594202899
2020-04-22,21,1,20,1,1,0,24,2,1141,70,1165,72,0,1,0,6,1,14,0,2,1,"Anderson",76978,10.3925796980956,0.0148514851485149,93.53321728286,1.29907246226194,7.79443477357167,1.48514851485149
2020-04-23,21,0,20,0,1,0,24,0,1191,50,1215,50,0,1,-1,5,1,15,0,2,1,"Anderson",76978,10.3925796980956,0.0141955835962145,64.9536231130973,0,6.49536231130973,1.41955835962145
2020-04-24,22,1,21,1,1,0,25,1,1299,108,1324,109,0,1,1,6,0,15,0,2,1,"Anderson",76978,11.6916521603575,0.0138312586445367,141.598898386552,1.29907246226194,7.79443477357167,1.38312586445367
2020-04-25,22,0,21,0,1,0,25,0,1336,37,1361,37,0,1,0,6,0,15,0,2,1,"Anderson",76978,11.6916521603575,0.0136986301369863,48.065681103692,0,7.79443477357167,1.36986301369863
2020-04-26,22,0,21,0,1,0,25,0,1372,36,1397,36,0,1,0,6,0,15,0,2,1,"Anderson",76978,10.3925796980956,0.0119521912350598,46.76660864143,0,7.79443477357167,1.19521912350598
2020-04-27,22,0,21,0,1,0,25,0,1411,39,1436,39,0,1,-1,5,1,16,0,2,1,"Anderson",76978,3.89721738678583,0.00780234070221066,50.6638260282159,0,6.49536231130973,0.780234070221066
2020-04-28,22,0,21,0,1,0,25,0,1690,279,1715,279,0,1,0,5,0,16,0,2,1,"Anderson",76978,2.59814492452389,0.00482315112540193,362.441216971083,0,6.49536231130973,0.482315112540193
2020-04-29,26,4,25,4,1,0,28,3,2070,380,2098,383,0,1,4,9,0,16,0,2,1,"Anderson",76978,6.49536231130972,0.00428724544480171,497.544753046325,5.19628984904778,11.6916521603575,0.428724544480171
2020-04-30,26,0,25,0,1,0,29,1,2102,32,2131,33,0,1,-1,8,1,17,0,2,1,"Anderson",76978,6.49536231130972,0.00545851528384279,42.8693912546442,0,10.3925796980956,0.545851528384279
2020-05-01,26,0,25,0,1,0,29,0,2154,52,2183,52,0,1,-2,6,2,19,0,2,1,"Anderson",76978,5.19628984904778,0.00465657741559953,67.5517680376211,0,7.79443477357167,0.465657741559953
2020-05-02,26,0,25,0,1,0,29,0,2221,67,2250,67,0,1,0,6,0,19,0,2,1,"Anderson",76978,5.19628984904778,0.00449943757030371,87.0378549715503,0,7.79443477357167,0.449943757030371
2020-05-03,27,1,26,1,1,0,30,1,2314,93,2344,94,0,1,1,7,0,19,0,2,1,"Anderson",76978,6.49536231130972,0.00527983104540655,122.112811452623,1.29907246226194,9.09350723583361,0.527983104540655
2020-05-04,27,0,26,0,1,0,30,0,2406,92,2436,92,0,1,-1,6,1,20,0,2,1,"Anderson",76978,6.49536231130972,0.005,119.514666528099,0,7.79443477357167,0.5
2020-05-05,28,1,27,1,1,0,30,0,2475,69,2505,69,0,1,-1,5,2,22,0,2,1,"Anderson",76978,7.79443477357167,0.00632911392405063,89.6359998960742,1.29907246226194,6.49536231130973,0.632911392405063
2020-05-06,30,2,29,2,1,0,31,1,2525,50,2556,51,0,1,2,7,0,22,0,2,1,"Anderson",76978,5.19628984904778,0.00655021834061135,66.2526955753592,2.59814492452389,9.09350723583361,0.655021834061135
2020-05-07,30,0,29,0,1,0,33,2,2597,72,2630,74,0,1,-1,6,1,23,0,2,1,"Anderson",76978,5.19628984904778,0.00801603206412826,96.1313622073839,0,7.79443477357167,0.801603206412826
2020-05-08,30,0,29,0,1,0,33,0,2652,55,2685,55,0,1,0,6,0,23,0,2,1,"Anderson",76978,5.19628984904778,0.00796812749003984,71.448985424407,0,7.79443477357167,0.796812749003984
2020-05-09,30,0,29,0,1,0,33,0,2734,82,2767,82,0,1,0,6,0,23,0,2,1,"Anderson",76978,5.19628984904778,0.00773694390715667,106.523941905479,0,7.79443477357167,0.773694390715667
2020-05-10,30,0,29,0,1,0,33,0,2827,93,2860,93,0,1,-3,3,3,26,0,2,1,"Anderson",76978,3.89721738678583,0.00581395348837209,120.813738990361,0,3.89721738678583,0.581395348837209
2020-05-11,32,2,31,2,1,0,33,0,2909,82,2942,82,0,1,2,5,0,26,0,2,1,"Anderson",76978,6.49536231130972,0.00592885375494071,106.523941905479,2.59814492452389,6.49536231130973,0.592885375494071
2020-05-12,33,1,32,1,1,0,35,2,3042,133,3077,135,0,1,1,6,0,26,0,2,1,"Anderson",76978,6.49536231130972,0.00874125874125874,175.374782405363,1.29907246226194,7.79443477357167,0.874125874125874
2020-05-13,35,2,34,2,1,0,38,3,3220,178,3258,181,0,1,1,7,1,27,1,3,1,"Anderson",76978,6.49536231130972,0.00997150997150997,235.132115669412,2.59814492452389,9.09350723583361,0.997150997150997
2020-05-14,35,0,34,0,1,0,39,1,3346,126,3385,127,0,1,-1,6,1,28,0,3,1,"Anderson",76978,6.49536231130972,0.00794701986754967,164.982202707267,0,7.79443477357167,0.794701986754967
2020-05-15,36,1,35,1,1,0,39,0,3417,71,3456,71,0,1,1,7,0,28,0,3,1,"Anderson",76978,7.79443477357167,0.00778210116731518,92.2341448205981,1.29907246226194,9.09350723583361,0.778210116731518
2020-05-16,36,0,35,0,1,0,41,2,3657,240,3698,242,0,1,-1,6,1,29,0,3,1,"Anderson",76978,7.79443477357167,0.00859291084854995,314.375535867391,0,7.79443477357167,0.859291084854995
2020-05-17,36,0,35,0,1,0,41,0,3727,70,3768,70,0,1,0,6,0,29,0,3,1,"Anderson",76978,7.79443477357167,0.00881057268722467,90.9350723583361,0,7.79443477357167,0.881057268722467
2020-05-18,37,1,36,1,1,0,42,1,3804,77,3846,78,0,1,-2,4,3,32,0,3,1,"Anderson",76978,6.49536231130972,0.00995575221238938,101.327652056432,1.29907246226194,5.19628984904778,0.995575221238938
2020-05-19,37,0,36,0,1,0,42,0,3856,52,3898,52,0,1,0,4,0,32,0,3,1,"Anderson",76978,5.19628984904778,0.00852618757612668,67.5517680376211,0,5.19628984904778,0.852618757612667
2020-05-20,37,0,36,0,1,0,43,1,3921,65,3964,66,0,1,0,4,0,32,0,3,1,"Anderson",76978,2.59814492452389,0.00708215297450425,85.7387825092884,0,5.19628984904778,0.708215297450425
2020-05-21,37,0,36,0,1,0,44,1,4001,80,4045,81,0,1,-1,3,1,33,0,3,1,"Anderson",76978,2.59814492452389,0.00757575757575758,105.224869443218,0,3.89721738678583,0.757575757575758
2020-05-22,38,1,37,1,1,0,45,1,4029,28,4074,29,0,1,-1,2,2,35,1,4,1,"Anderson",76978,2.59814492452389,0.00970873786407767,37.6731014055964,1.29907246226194,2.59814492452389,0.970873786407767
2020-05-23,38,0,37,0,1,0,46,1,4192,163,4238,164,0,1,0,2,0,35,0,4,1,"Anderson",76978,2.59814492452389,0.00925925925925926,213.047883810959,0,2.59814492452389,0.925925925925926
2020-05-24,38,0,37,0,1,0,46,0,4247,55,4293,55,0,1,0,2,0,35,0,4,1,"Anderson",76978,2.59814492452389,0.00952380952380952,71.448985424407,0,2.59814492452389,0.952380952380952
2020-05-25,38,0,37,0,1,0,47,1,4281,34,4328,35,0,1,0,2,0,35,0,4,1,"Anderson",76978,1.29907246226194,0.0103734439834025,45.4675361791681,0,2.59814492452389,1.03734439834025
2020-05-26,38,0,37,0,1,0,47,0,4412,131,4459,131,0,1,-1,1,1,36,0,4,1,"Anderson",76978,1.29907246226194,0.0089126559714795,170.178492556315,0,1.29907246226194,0.89126559714795
2020-05-27,38,0,37,0,1,0,47,0,4515,103,4562,103,0,1,0,1,0,36,0,4,1,"Anderson",76978,1.29907246226194,0.00668896321070234,133.80446361298,0,1.29907246226194,0.668896321070234
2020-05-28,38,0,37,0,1,0,47,0,4563,48,4610,48,0,1,0,1,0,36,0,4,1,"Anderson",76978,1.29907246226194,0.00530973451327434,62.3554781885734,0,1.29907246226194,0.530973451327434
2020-05-29,39,1,38,1,1,0,47,0,4613,50,4660,50,0,1,0,1,1,37,0,4,1,"Anderson",76978,1.29907246226194,0.00341296928327645,64.9536231130973,1.29907246226194,1.29907246226194,0.341296928327645
2020-05-30,39,0,38,0,1,0,48,1,4665,52,4713,53,0,1,0,1,0,37,0,4,1,"Anderson",76978,1.29907246226194,0.00421052631578947,68.8508404998831,0,1.29907246226194,0.421052631578947
2020-05-31,40,1,39,1,1,0,49,1,4731,66,4780,67,0,1,1,2,0,37,0,4,1,"Anderson",76978,2.59814492452389,0.00616016427104723,87.0378549715503,1.29907246226194,2.59814492452389,0.616016427104723
2020-06-01,40,0,39,0,1,0,49,0,4855,124,4904,124,0,1,0,2,0,37,0,4,1,"Anderson",76978,2.59814492452389,0.00347222222222222,161.084985320481,0,2.59814492452389,0.347222222222222
2020-06-02,40,0,39,0,1,0,49,0,4982,127,5031,127,0,1,0,2,0,37,0,4,1,"Anderson",76978,2.59814492452389,0.0034965034965035,164.982202707267,0,2.59814492452389,0.34965034965035
2020-06-03,41,1,40,1,1,0,50,1,5042,60,5092,61,0,1,1,3,0,37,0,4,2,"Anderson",76978,3.89721738678583,0.00566037735849057,79.2434201979787,1.29907246226194,3.89721738678583,0.566037735849057
2020-06-04,41,0,40,0,1,0,50,0,5090,48,5140,48,1,2,-2,1,1,38,0,4,2,"Anderson",76978,3.89721738678583,0.00566037735849057,62.3554781885734,0,1.29907246226194,0.566037735849057
2020-06-05,42,1,41,1,1,0,53,3,5147,57,5200,60,0,2,1,2,0,38,0,4,2,"Anderson",76978,3.89721738678583,0.0111111111111111,77.9443477357167,1.29907246226194,2.59814492452389,1.11111111111111
2020-06-06,43,1,42,1,1,0,54,1,5200,53,5254,54,0,2,1,3,0,38,0,4,2,"Anderson",76978,5.19628984904778,0.011090573012939,70.149912962145,1.29907246226194,3.89721738678583,1.1090573012939
2020-06-07,45,2,43,1,2,1,57,3,5295,95,5352,98,0,2,2,5,0,38,0,4,2,"Anderson",76978,6.49536231130972,0.013986013986014,127.309101301671,2.59814492452389,6.49536231130973,1.3986013986014
2020-06-08,46,1,44,1,2,0,57,0,5336,41,5393,41,0,2,1,6,0,38,0,4,2,"Anderson",76978,7.79443477357167,0.016359918200409,53.2619709527397,1.29907246226194,7.79443477357167,1.6359918200409
2020-06-09,47,1,45,1,2,0,60,3,5517,181,5577,184,0,2,1,7,0,38,0,4,2,"Anderson",76978,9.09350723583361,0.0201465201465201,239.029333056198,1.29907246226194,9.09350723583361,2.01465201465201
2020-06-10,52,5,50,5,2,0,63,3,5725,208,5788,211,0,2,2,9,3,41,0,4,2,"Anderson",76978,14.2897970848814,0.0186781609195402,274.10428953727,6.49536231130973,11.6916521603575,1.86781609195402
2020-06-11,55,3,53,3,2,0,66,3,5870,145,5936,148,0,2,2,11,1,42,1,5,2,"Anderson",76978,18.1870144716672,0.0201005025125628,192.262724414768,3.89721738678583,14.2897970848814,2.01005025125628
2020-06-12,57,2,55,2,2,0,70,4,5952,82,6022,86,0,2,2,13,0,42,0,5,2,"Anderson",76978,19.4860869339292,0.0206812652068127,111.720231754527,2.59814492452389,16.8879420094053,2.06812652068127
2020-06-13,58,1,55,0,3,1,70,0,5995,43,6065,43,0,2,0,13,1,43,0,5,2,"Anderson",76978,19.4860869339292,0.0197287299630086,55.8601158772636,1.29907246226194,16.8879420094053,1.97287299630086
2020-06-14,60,2,57,2,3,0,70,0,6170,175,6240,175,0,2,1,14,1,44,1,6,2,"Anderson",76978,19.4860869339292,0.0146396396396396,227.33768089584,2.59814492452389,18.1870144716672,1.46396396396396
2020-06-15,60,0,57,0,3,0,71,1,6228,58,6299,59,0,2,0,14,0,44,0,6,2,"Anderson",76978,18.1870144716672,0.0154525386313466,76.6452752734548,0,18.1870144716672,1.54525386313466
2020-06-16,64,4,61,4,3,0,75,4,6289,61,6364,65,0,2,3,17,1,45,0,6,2,"Anderson",76978,22.0842318584531,0.0190597204574333,84.4397100470264,5.19628984904778,22.0842318584531,1.90597204574333
2020-06-17,66,2,63,2,3,0,79,4,6326,37,6405,41,0,2,0,17,2,47,0,6,2,"Anderson",76978,18.1870144716672,0.0259319286871961,53.2619709527397,2.59814492452389,22.0842318584531,2.59319286871961
2020-06-18,70,4,67,4,3,0,84,5,6456,130,6540,135,0,2,2,19,2,49,0,6,2,"Anderson",76978,19.4860869339292,0.0298013245033113,175.374782405363,5.19628984904778,24.682376782977,2.98013245033113
2020-06-19,72,2,69,2,3,0,86,2,6521,65,6607,67,0,2,0,19,2,51,0,6,2,"Anderson",76978,19.4860869339292,0.0273504273504274,87.0378549715503,2.59814492452389,24.682376782977,2.73504273504274
2020-06-20,73,1,70,1,3,0,87,1,6559,38,6646,39,0,2,-1,18,2,53,0,6,2,"Anderson",76978,19.4860869339292,0.0292598967297762,50.6638260282159,1.29907246226194,23.383304320715,2.92598967297762
2020-06-21,74,1,71,1,3,0,88,1,6619,60,6707,61,0,2,-1,17,2,55,0,6,2,"Anderson",76978,18.1870144716672,0.0385438972162741,79.2434201979787,1.29907246226194,22.0842318584531,3.85438972162741
2020-06-22,76,2,73,2,3,0,90,2,6711,92,6801,94,0,2,0,17,2,57,1,7,2,"Anderson",76978,20.7851593961911,0.0378486055776892,122.112811452623,2.59814492452389,22.0842318584531,3.78486055776892
2020-06-23,76,0,73,0,3,0,90,0,6800,89,6890,89,0,2,-1,16,1,58,0,7,2,"Anderson",76978,15.5888695471433,0.0285171102661597,115.617449141313,0,20.7851593961911,2.85171102661597
2020-06-24,77,1,74,1,3,0,91,1,6831,31,6922,32,0,2,-2,14,3,61,0,7,2,"Anderson",76978,14.2897970848814,0.02321083172147,41.5703187923822,1.29907246226194,18.1870144716672,2.321083172147
2020-06-25,81,4,78,4,3,0,92,1,6944,113,7036,114,0,2,0,14,4,65,0,7,2,"Anderson",76978,14.2897970848814,0.0161290322580645,148.094260697862,5.19628984904778,18.1870144716672,1.61290322580645
2020-06-26,86,5,83,5,3,0,98,6,6972,28,7070,34,0,2,3,17,2,67,0,7,2,"Anderson",76978,18.1870144716672,0.0259179265658747,44.1684637169061,6.49536231130973,22.0842318584531,2.59179265658747
2020-06-27,87,1,83,0,4,1,98,0,6984,12,7082,12,0,2,-4,13,5,72,0,7,2,"Anderson",76978,18.1870144716672,0.0252293577981651,15.5888695471433,1.29907246226194,16.8879420094053,2.52293577981651
2020-06-28,91,4,87,4,4,0,106,8,7093,109,7199,117,0,2,3,16,1,73,0,7,2,"Anderson",76978,22.0842318584531,0.0365853658536585,151.991478084648,5.19628984904778,20.7851593961911,3.65853658536585
2020-06-29,97,6,92,5,5,1,114,8,7315,222,7429,230,0,2,3,19,3,76,1,8,2,"Anderson",76978,27.2805217075008,0.0382165605095541,298.786666320247,7.79443477357167,24.682376782977,3.82165605095541
2020-06-30,102,5,96,4,6,1,120,6,7479,164,7599,170,0,2,2,21,3,79,0,8,2,"Anderson",76978,33.7758840188106,0.0423131170662905,220.842318584531,6.49536231130973,27.2805217075008,4.23131170662905
2020-07-01,104,2,98,2,6,0,124,4,7600,121,7724,125,0,2,-2,19,4,83,0,8,2,"Anderson",76978,35.0749564810725,0.0411471321695761,162.384057782743,2.59814492452389,24.682376782977,4.11471321695761
2020-07-02,110,6,104,6,6,0,130,6,7839,239,7969,245,0,2,4,23,2,85,0,8,2,"Anderson",76978,37.6731014055964,0.0407288317256163,318.272753254177,7.79443477357167,29.8786666320247,4.07288317256163
2020-07-03,120,10,113,9,7,1,142,12,7964,125,8106,137,0,2,7,30,3,88,0,8,2,"Anderson",76978,44.1684637169061,0.0424710424710425,177.972927329886,12.9907246226195,38.9721738678584,4.24710424710425
2020-07-04,131,11,124,11,7,0,156,14,8148,184,8304,198,0,2,8,38,3,91,2,10,2,"Anderson",76978,57.1591883395256,0.0474631751227496,257.216347527865,14.2897970848814,49.3647535659539,4.74631751227496
2020-07-05,140,9,133,9,7,0,169,13,8304,156,8473,169,0,2,8,46,1,92,1,11,2,"Anderson",76978,63.6545506508353,0.0494505494505494,219.543246122269,11.6916521603575,59.7573332640495,4.94505494505495
2020-07-06,141,1,134,1,7,0,170,1,8331,27,8501,28,0,2,-4,42,5,97,0,11,2,"Anderson",76978,57.1591883395256,0.0522388059701493,36.3740289433345,1.29907246226194,54.5610434150017,5.22388059701492
2020-07-07,157,16,150,16,7,0,190,20,8564,233,8754,253,0,2,12,54,4,101,0,11,2,"Anderson",76978,71.448985424407,0.0606060606060606,328.665332952272,20.7851593961911,70.149912962145,6.06060606060606
2020-07-08,173,16,165,15,8,1,206,16,8704,140,8910,156,0,2,10,64,6,107,0,11,2,"Anderson",76978,89.6359998960742,0.0691399662731872,202.655304112863,20.7851593961911,83.1406375847645,6.91399662731872
2020-07-09,187,14,179,14,8,0,220,14,8972,268,9192,282,0,2,11,75,3,110,0,11,2,"Anderson",76978,100.02857959417,0.0735895339329518,366.338434357868,18.1870144716672,97.4304346696459,7.35895339329518
2020-07-10,193,6,185,6,8,0,227,7,9002,30,9229,37,0,2,1,76,5,115,1,12,2,"Anderson",76978,94.832289745122,0.0756901157613535,48.065681103692,7.79443477357167,98.7295071319078,7.56901157613535
2020-07-11,201,8,193,8,8,0,235,8,9171,169,9406,177,0,2,1,77,7,122,1,13,2,"Anderson",76978,90.9350723583361,0.0716878402903811,229.935825820364,10.3925796980956,100.02857959417,7.16878402903811
2020-07-12,212,11,204,11,8,0,248,13,9354,183,9602,196,0,2,6,83,5,127,0,13,2,"Anderson",76978,93.53321728286,0.0699734278122232,254.618202603341,14.2897970848814,107.823014367741,6.99734278122232
2020-07-13,218,6,209,5,9,1,255,7,9393,39,9648,46,0,2,-6,77,12,139,2,15,2,"Anderson",76978,100.02857959417,0.0741063644289451,59.7573332640495,7.79443477357167,100.02857959417,7.41063644289451
2020-07-14,229,11,219,10,10,1,266,11,9533,140,9799,151,0,2,0,77,11,150,0,15,2,"Anderson",76978,93.53321728286,0.0727272727272727,196.159941801554,14.2897970848814,100.02857959417,7.27272727272727
2020-07-15,245,16,234,15,11,1,285,19,9635,102,9920,121,0,2,0,77,16,166,0,15,2,"Anderson",76978,93.53321728286,0.0782178217821782,157.187767933695,20.7851593961911,100.02857959417,7.82178217821782
2020-07-16,263,18,252,18,11,0,308,23,9924,289,10232,312,0,2,4,81,14,180,1,16,2,"Anderson",76978,98.7295071319078,0.0846153846153846,405.310608225727,23.383304320715,105.224869443218,8.46153846153846
2020-07-17,270,7,259,7,11,0,317,9,9995,71,10312,80,0,2,-8,73,15,195,1,17,3,"Anderson",76978,100.02857959417,0.0831024930747922,103.925796980956,9.09350723583361,94.832289745122,8.31024930747922
2020-07-18,277,7,266,7,11,0,328,11,10209,214,10537,225,0,2,-4,69,11,206,0,17,3,"Anderson",76978,98.7295071319078,0.0822281167108753,292.291304008938,9.09350723583361,89.6359998960742,8.22281167108753
2020-07-19,285,8,274,8,11,0,337,9,10290,81,10627,90,0,2,-5,64,13,219,2,19,3,"Anderson",76978,94.832289745122,0.0868292682926829,116.916521603575,10.3925796980956,83.1406375847645,8.68292682926829
2020-07-20,313,28,302,28,11,0,367,30,10459,169,10826,199,1,3,9,73,18,237,0,19,3,"Anderson",76978,123.411883914885,0.0950764006791171,258.515419990127,36.3740289433345,94.832289745122,9.50764006791171
2020-07-21,336,23,324,22,12,1,391,24,10751,292,11142,316,0,3,12,85,11,248,1,20,3,"Anderson",76978,139.000753462028,0.0930752047654505,410.506898074775,29.8786666320247,110.421159292265,9.30752047654505
2020-07-22,365,29,353,29,12,0,424,33,10886,135,11310,168,0,3,13,98,16,264,0,20,3,"Anderson",76978,155.888695471433,0.1,218.244173660007,37.6731014055964,127.309101301671,10
2020-07-23,388,23,376,23,12,0,455,31,11313,427,11768,458,0,3,9,107,14,278,2,22,3,"Anderson",76978,162.384057782743,0.095703125,594.975187715971,29.8786666320247,139.000753462028,9.5703125
2020-07-24,394,6,382,6,12,0,463,8,11425,112,11888,120,0,3,-16,91,22,300,0,22,4,"Anderson",76978,161.084985320481,0.0926395939086294,155.888695471433,7.79443477357167,118.215594065837,9.26395939086294
2020-07-25,426,32,413,31,13,1,499,36,11682,257,12181,293,1,4,26,117,5,305,1,23,4,"Anderson",76978,193.56179687703,0.104014598540146,380.62823144275,41.5703187923822,151.991478084648,10.4014598540146
2020-07-26,465,39,451,38,14,1,541,42,12085,403,12626,445,0,4,31,148,8,313,2,25,4,"Anderson",76978,233.83304320715,0.102051025512756,578.087245706565,50.6638260282159,192.262724414768,10.2051025512756
2020-07-27,483,18,468,17,15,1,562,21,12265,180,12827,201,0,4,-19,129,37,350,1,26,4,"Anderson",76978,220.842318584531,0.0974512743628186,261.113564914651,23.383304320715,167.580347631791,9.74512743628186
2020-07-28,523,40,508,40,15,0,608,46,12645,380,13253,426,0,4,24,153,16,366,1,27,5,"Anderson",76978,242.926550442984,0.10279488394126,553.404868923589,51.9628984904778,198.758086726078,10.279488394126
2020-07-29,527,4,512,4,15,0,612,4,12681,36,13293,40,1,5,-15,138,18,384,0,27,5,"Anderson",76978,210.449738886435,0.0948058497226425,51.9628984904778,5.19628984904778,179.271999792148,9.48058497226425
2020-07-30,564,37,549,37,15,0,665,53,13166,485,13831,538,0,5,20,158,17,401,0,27,5,"Anderson",76978,228.636753358102,0.101793504604944,698.900984696926,48.065681103692,205.253449037387,10.1793504604944
2020-07-31,576,12,561,12,15,0,679,14,13348,182,14027,196,0,5,-8,150,20,421,0,27,5,"Anderson",76978,236.431188131674,0.100981767180926,254.618202603341,15.5888695471433,194.860869339292,10.0981767180926
2020-08-01,599,23,584,23,15,0,704,25,13757,409,14461,434,0,5,17,167,6,427,1,28,5,"Anderson",76978,224.739535971316,0.0899122807017544,563.797448621684,29.8786666320247,216.945101197745,8.99122807017544
2020-08-02,606,7,591,7,15,0,711,7,13885,128,14596,135,0,5,2,169,5,432,1,29,6,"Anderson",76978,183.169217178934,0.0862944162436548,175.374782405363,9.09350723583361,219.543246122269,8.62944162436548
2020-08-03,631,25,615,24,16,1,742,31,14112,227,14854,258,0,5,14,183,11,443,0,29,6,"Anderson",76978,192.262724414768,0.0888011840157869,335.160695263582,32.4768115565486,237.730260593936,8.88011840157869
2020-08-04,638,7,622,7,16,0,750,8,14355,243,15105,251,2,7,-19,164,24,467,0,29,6,"Anderson",76978,149.393333160124,0.0766738660907127,326.067188027748,9.09350723583361,213.047883810959,7.66738660907127
2020-08-05,653,15,637,15,16,0,769,19,14564,209,15333,228,-1,6,-1,163,17,484,0,29,6,"Anderson",76978,163.683130245005,0.0769607843137255,296.188521395723,19.4860869339292,211.748811348697,7.69607843137255
2020-08-06,675,22,659,22,16,0,799,30,14885,321,15684,351,0,6,3,166,19,503,1,30,6,"Anderson",76978,144.197043311076,0.0723151645979493,455.974434253943,28.5795941697628,215.646028735483,7.23151645979493
2020-08-07,679,4,663,4,16,0,803,4,14966,81,15769,85,0,6,-21,145,25,528,0,30,6,"Anderson",76978,133.80446361298,0.0711825487944891,110.421159292265,5.19628984904778,188.365507027982,7.11825487944891
2020-08-08,690,11,674,11,16,0,819,16,15286,320,16105,336,0,6,1,146,10,538,0,30,6,"Anderson",76978,118.215594065837,0.0699513381995134,436.488347320014,14.2897970848814,189.664579490244,6.99513381995134
2020-08-09,697,7,681,7,16,0,828,9,15423,137,16251,146,0,6,-9,137,16,554,0,30,6,"Anderson",76978,118.215594065837,0.0706948640483384,189.664579490244,9.09350723583361,177.972927329886,7.06948640483384
2020-08-10,702,5,686,5,16,0,834,6,15562,139,16396,145,0,6,-11,126,16,570,0,30,6,"Anderson",76978,92.2341448205981,0.059662775616083,188.365507027982,6.49536231130973,163.683130245005,5.9662775616083
2020-08-11,723,21,707,21,16,0,856,22,15765,203,16621,225,0,6,9,135,12,582,1,31,6,"Anderson",76978,110.421159292265,0.0699208443271768,292.291304008938,27.2805217075008,175.374782405363,6.99208443271768
2020-08-12,731,8,715,8,16,0,864,8,16004,239,16868,247,0,6,-8,127,16,598,0,31,6,"Anderson",76978,101.327652056432,0.0618892508143322,320.8708981787,10.3925796980956,164.982202707267,6.18892508143322
2020-08-13,749,18,733,18,16,0,888,24,16232,228,17120,252,1,7,3,130,14,612,2,33,6,"Anderson",76978,96.1313622073839,0.0619777158774373,327.36626049001,23.383304320715,168.879420094053,6.19777158774373
2020-08-14,766,17,749,16,17,1,910,22,16561,329,17471,351,0,7,-9,121,26,638,0,33,6,"Anderson",76978,113.019304216789,0.0628672150411281,455.974434253943,22.0842318584531,157.187767933695,6.28672150411281
2020-08-15,776,10,759,10,17,0,922,12,16784,223,17706,235,-1,6,5,126,6,644,0,33,6,"Anderson",76978,111.720231754527,0.0643347907557776,305.282028631557,12.9907246226195,163.683130245005,6.43347907557776
2020-08-16,788,12,771,12,17,0,936,14,16926,142,17862,156,0,6,7,133,5,649,0,33,7,"Anderson",76978,118.215594065837,0.0670391061452514,202.655304112863,15.5888695471433,172.776637480839,6.70391061452514
2020-08-17,792,4,775,4,17,0,939,3,16969,43,17908,46,0,6,-13,120,17,666,0,33,7,"Anderson",76978,116.916521603575,0.0694444444444444,59.7573332640495,5.19628984904778,155.888695471433,6.94444444444444
2020-08-18,806,14,789,14,17,0,956,17,17133,164,18089,181,0,6,5,125,9,675,0,33,7,"Anderson",76978,107.823014367741,0.0681198910081744,235.132115669412,18.1870144716672,162.384057782743,6.81198910081744
2020-08-19,820,14,803,14,17,0,970,14,17307,174,18277,188,0,6,0,125,14,689,0,33,7,"Anderson",76978,115.617449141313,0.0752306600425834,244.225622905246,18.1870144716672,162.384057782743,7.52306600425834
2020-08-20,835,15,818,15,17,0,986,16,17749,442,18735,458,0,6,5,130,10,699,0,33,8,"Anderson",76978,111.720231754527,0.0606811145510836,594.975187715971,19.4860869339292,168.879420094053,6.06811145510836
2020-08-21,838,3,821,3,17,0,989,3,17785,36,18774,39,1,7,-7,123,9,708,0,33,8,"Anderson",76978,93.53321728286,0.0606293169608596,50.6638260282159,3.89721738678583,159.785912858219,6.06293169608596
2020-08-22,856,18,839,18,17,0,1008,19,18329,544,19337,563,1,8,10,133,7,715,1,34,8,"Anderson",76978,103.925796980956,0.052728387492336,731.377796253475,23.383304320715,172.776637480839,5.2728387492336
2020-08-23,857,1,840,1,17,0,1009,1,18413,84,19422,85,0,8,-5,128,6,721,0,34,8,"Anderson",76978,89.6359998960742,0.0467948717948718,110.421159292265,1.29907246226194,166.281275169529,4.67948717948718
2020-08-24,858,1,840,0,18,1,1009,0,18452,39,19461,39,0,8,-19,109,20,741,0,34,8,"Anderson",76978,85.7387825092884,0.0450740502253702,50.6638260282159,1.29907246226194,141.598898386552,4.50740502253703
2020-08-25,866,8,848,8,18,0,1017,8,18604,152,19621,160,0,8,-2,107,10,751,1,35,8,"Anderson",76978,77.9443477357167,0.0398172323759791,207.851593961911,10.3925796980956,139.000753462028,3.98172323759791
2020-08-26,872,6,854,6,18,0,1023,6,18784,180,19807,186,0,8,-14,93,20,771,0,35,8,"Anderson",76978,67.5517680376211,0.034640522875817,241.627477980722,7.79443477357167,120.813738990361,3.4640522875817
2020-08-27,875,3,857,3,18,0,1026,3,19195,411,20221,414,0,8,-16,77,19,790,0,35,8,"Anderson",76978,51.9628984904778,0.0269179004037685,537.815999376445,3.89721738678583,100.02857959417,2.69179004037685
2020-08-28,875,0,857,0,18,0,1026,0,19233,38,20259,38,0,8,-20,57,20,810,0,35,8,"Anderson",76978,48.065681103692,0.0249158249158249,49.3647535659539,0,74.0471303489309,2.49158249158249
2020-08-29,884,9,865,8,19,1,1034,8,19495,262,20529,270,0,8,3,60,6,816,0,35,8,"Anderson",76978,36.3740289433345,0.0218120805369128,350.749564810725,11.6916521603575,77.9443477357167,2.18120805369128
2020-08-30,900,16,881,16,19,0,1050,16,19578,83,20628,99,0,8,8,68,8,824,0,35,8,"Anderson",76978,55.8601158772636,0.0339966832504146,128.608173763933,20.7851593961911,88.3369274338123,3.39966832504146
2020-08-31,902,2,883,2,19,0,1052,2,19636,58,20688,60,0,8,-15,53,17,841,0,35,8,"Anderson",76978,57.1591883395256,0.0350448247758761,77.9443477357167,2.59814492452389,68.8508404998831,3.50448247758761
2020-09-01,909,7,889,6,20,1,1058,6,19747,111,20805,117,0,8,0,53,7,848,0,35,8,"Anderson",76978,55.8601158772636,0.0346283783783784,151.991478084648,9.09350723583361,68.8508404998831,3.46283783783784
2020-09-02,917,8,895,6,22,2,1068,10,20063,316,21131,326,0,8,5,58,3,851,0,35,8,"Anderson",76978,58.4582608017875,0.033987915407855,423.497622697394,10.3925796980956,75.3462028111928,3.3987915407855
2020-09-03,933,16,909,14,24,2,1084,16,20387,324,21471,340,0,8,10,68,6,857,0,35,9,"Anderson",76978,75.3462028111928,0.0464,441.684637169061,20.7851593961911,88.3369274338123,4.64
2020-09-04,942,9,917,8,25,1,1094,10,20576,189,21670,199,0,8,6,74,3,860,0,35,9,"Anderson",76978,87.0378549715503,0.0481927710843374,258.515419990127,11.6916521603575,96.1313622073839,4.81927710843374
2020-09-05,961,19,936,19,25,0,1115,21,20845,269,21960,290,0,8,16,90,3,863,1,36,10,"Anderson",76978,100.02857959417,0.0566037735849057,376.731014055964,24.682376782977,116.916521603575,5.66037735849057
2020-09-06,963,2,938,2,25,0,1117,2,20901,56,22018,58,0,8,-1,89,3,866,0,36,10,"Anderson",76978,81.8415651225025,0.0482014388489209,75.3462028111928,2.59814492452389,115.617449141313,4.82014388489209
2020-09-07,966,3,941,3,25,0,1122,5,20989,88,22111,93,0,8,-8,81,11,877,0,36,10,"Anderson",76978,83.1406375847645,0.0491918482080112,120.813738990361,3.89721738678583,105.224869443218,4.91918482080112
2020-09-08,975,9,944,3,31,6,1126,4,21164,175,22290,179,1,9,4,85,4,881,0,36,10,"Anderson",76978,85.7387825092884,0.0457912457912458,232.533970744888,11.6916521603575,110.421159292265,4.57912457912458
2020-09-09,984,9,953,9,31,0,1135,9,21405,241,22540,250,0,9,-3,82,12,893,1,37,11,"Anderson",76978,87.0378549715503,0.0475514549325763,324.768115565486,11.6916521603575,106.523941905479,4.75514549325763
2020-09-10,1013,29,981,28,32,1,1165,30,21774,369,22939,399,1,10,25,107,3,896,0,37,11,"Anderson",76978,103.925796980956,0.0551771117166213,518.329912442516,37.6731014055964,139.000753462028,5.51771117166213
2020-09-11,1014,1,982,1,32,0,1167,2,21907,133,23074,135,0,10,-13,94,14,910,0,37,11,"Anderson",76978,93.53321728286,0.051994301994302,175.374782405363,1.29907246226194,122.112811452623,5.1994301994302
2020-09-12,1017,3,985,3,32,0,1172,5,22049,142,23221,147,0,10,-5,89,8,918,0,37,11,"Anderson",76978,72.7480578866689,0.0452022204599524,190.963651952506,3.89721738678583,115.617449141313,4.52022204599524
2020-09-13,1038,21,1005,20,33,1,1193,21,22293,244,23486,265,0,10,16,105,5,923,1,38,11,"Anderson",76978,97.4304346696459,0.0517711171662125,344.254202499415,27.2805217075008,136.402608537504,5.17711171662125
2020-09-14,1044,6,1010,5,34,1,1199,6,22399,106,23598,112,0,10,-7,98,13,936,1,39,11,"Anderson",76978,101.327652056432,0.0517821116341627,145.496115773338,7.79443477357167,127.309101301671,5.17821116341627
2020-09-15,1060,16,1026,16,34,0,1216,17,22639,240,23855,257,1,11,5,103,10,946,1,40,12,"Anderson",76978,110.421159292265,0.0575079872204473,333.86162280132,20.7851593961911,133.80446361298,5.75079872204473
2020-09-16,1068,8,1034,8,34,0,1228,12,22775,136,24003,148,0,11,-5,98,13,959,0,40,12,"Anderson",76978,109.122086830003,0.063568010936432,192.262724414768,10.3925796980956,127.309101301671,6.3568010936432
2020-09-17,1090,22,1054,20,36,2,1248,20,23196,421,24444,441,0,11,15,113,7,966,1,41,12,"Anderson",76978,100.02857959417,0.0551495016611296,572.890955857518,28.5795941697628,146.7951882356,5.51495016611296
2020-09-18,1109,19,1073,19,36,0,1266,18,23420,224,24686,242,0,11,6,119,13,979,0,41,12,"Anderson",76978,123.411883914885,0.0614143920595533,314.375535867391,24.682376782977,154.589623009171,6.14143920595533
2020-09-19,1124,15,1088,15,36,0,1287,21,23702,282,24989,303,0,11,9,128,6,985,1,42,12,"Anderson",76978,139.000753462028,0.0650452488687783,393.618956065369,19.4860869339292,166.281275169529,6.50452488687783
2020-09-20,1131,7,1095,7,36,0,1297,10,23854,152,25151,162,0,11,0,128,7,992,0,42,13,"Anderson",76978,120.813738990361,0.0624624624624625,210.449738886435,9.09350723583361,166.281275169529,6.24624624624625
2020-09-21,1133,2,1097,2,36,0,1299,2,23887,33,25186,35,0,11,-6,122,8,1000,0,42,13,"Anderson",76978,115.617449141313,0.0629722921914358,45.4675361791681,2.59814492452389,158.486840395957,6.29722921914358
2020-09-22,1147,14,1111,14,36,0,1316,17,24135,248,25451,265,0,11,0,122,14,1014,1,43,13,"Anderson",76978,113.019304216789,0.06265664160401,344.254202499415,18.1870144716672,158.486840395957,6.265664160401
2020-09-23,1147,0,1111,0,36,0,1316,0,24176,41,25492,41,0,11,-12,110,12,1026,0,43,13,"Anderson",76978,102.626724518694,0.0591000671591672,53.2619709527397,0,142.897970848814,5.91000671591672
2020-09-24,1160,13,1124,13,36,0,1331,15,24500,324,25831,339,1,12,0,110,12,1038,0,43,13,"Anderson",76978,90.9350723583361,0.0598413842826244,440.385564706799,16.8879420094053,142.897970848814,5.98413842826244
2020-09-25,1174,14,1137,13,37,1,1344,13,24736,236,26080,249,1,13,-2,108,15,1053,0,43,13,"Anderson",76978,84.4397100470264,0.0559540889526542,323.469043103224,18.1870144716672,140.29982592429,5.59540889526542
2020-09-26,1188,14,1151,14,37,0,1361,17,25036,300,26397,317,0,13,8,116,6,1059,0,43,13,"Anderson",76978,83.1406375847645,0.0525568181818182,411.805970537037,18.1870144716672,150.692405622386,5.25568181818182
2020-09-27,1207,19,1168,17,39,2,1377,16,25243,207,26620,223,0,13,12,128,7,1066,0,43,13,"Anderson",76978,98.7295071319078,0.0544588155207624,289.693159084414,24.682376782977,166.281275169529,5.44588155207624
2020-09-28,1210,3,1170,2,40,1,1379,2,25280,37,26659,39,0,13,-9,119,12,1078,0,43,13,"Anderson",76978,100.02857959417,0.0543109300746775,50.6638260282159,3.89721738678583,154.589623009171,5.43109300746775
2020-09-29,1221,11,1180,10,41,1,1389,10,25574,294,26963,304,0,13,-7,112,18,1096,0,43,13,"Anderson",76978,96.1313622073839,0.0482804232804233,394.918028527631,14.2897970848814,145.496115773338,4.82804232804233
2020-09-30,1233,12,1190,10,43,2,1399,10,25640,66,27039,76,0,13,3,115,9,1105,0,43,13,"Anderson",76978,111.720231754527,0.0536522301228184,98.7295071319078,15.5888695471433,149.393333160124,5.36522301228184
2020-10-01,1249,16,1204,14,45,2,1414,15,25920,280,27334,295,0,13,4,119,12,1117,0,43,13,"Anderson",76978,115.617449141313,0.0552228875582169,383.226376367274,20.7851593961911,154.589623009171,5.52228875582169
2020-10-02,1256,7,1210,6,46,1,1421,7,26002,82,27423,89,0,13,1,120,6,1123,0,43,13,"Anderson",76978,106.523941905479,0.0573343261355175,115.617449141313,9.09350723583361,155.888695471433,5.73343261355175
2020-10-03,1272,16,1226,16,46,0,1445,24,26266,264,27711,288,0,13,3,123,13,1136,0,43,13,"Anderson",76978,109.122086830003,0.0639269406392694,374.13286913144,20.7851593961911,159.785912858219,6.39269406392694
2020-10-04,1288,16,1240,14,48,2,1461,16,26603,337,28064,353,0,13,8,131,8,1144,0,43,13,"Anderson",76978,105.224869443218,0.0581717451523546,458.572579178467,20.7851593961911,170.178492556315,5.81717451523546
2020-10-05,1314,26,1265,25,49,1,1488,27,26814,211,28302,238,0,13,11,142,15,1159,1,44,13,"Anderson",76978,135.103536075242,0.0663420572124163,309.179246018343,33.7758840188106,184.468289641196,6.63420572124163
2020-10-06,1342,28,1292,27,50,1,1519,31,27151,337,28670,368,0,13,15,157,13,1172,1,45,13,"Anderson",76978,157.187767933695,0.0761570005858231,478.058666112396,36.3740289433345,203.954376575125,7.61570005858231
2020-10-07,1348,6,1298,6,50,0,1527,8,27386,235,28913,243,0,13,-3,154,9,1181,0,45,13,"Anderson",76978,149.393333160124,0.0683030949839915,315.674608329653,7.79443477357167,200.05715918834,6.83030949839915
2020-10-08,1358,10,1306,8,52,2,1536,9,27625,239,29161,248,0,13,-3,151,13,1194,1,46,13,"Anderson",76978,141.598898386552,0.066776135741653,322.169970640962,12.9907246226195,196.159941801554,6.6776135741653
2020-10-09,1373,15,1319,13,54,2,1552,16,27798,173,29350,189,0,13,-2,149,17,1211,0,46,13,"Anderson",76978,151.991478084648,0.0679813181110535,245.524695367508,19.4860869339292,193.56179687703,6.79813181110535
2020-10-10,1389,16,1335,16,54,0,1572,20,28010,212,29582,232,0,13,3,152,13,1224,1,47,14,"Anderson",76978,151.991478084648,0.0678781400320684,301.384811244771,20.7851593961911,197.459014263816,6.78781400320684
2020-10-11,1417,28,1363,28,54,0,1603,31,28299,289,29902,320,0,13,18,170,10,1234,0,47,14,"Anderson",76978,167.580347631791,0.0772578890097933,415.703187923822,36.3740289433345,220.842318584531,7.72578890097933
2020-10-12,1433,16,1378,15,55,1,1619,16,28378,79,29997,95,0,13,-11,159,27,1261,0,47,14,"Anderson",76978,154.589623009171,0.0772861356932153,123.411883914885,20.7851593961911,206.552521499649,7.72861356932153
2020-10-13,1453,20,1396,18,57,2,1637,18,28499,121,30136,139,0,13,7,166,13,1274,0,47,14,"Anderson",76978,144.197043311076,0.0804911323328786,180.57107225441,25.9814492452389,215.646028735483,8.04911323328786
2020-10-14,1475,22,1418,22,57,0,1661,24,28799,300,30460,324,0,13,12,178,10,1284,0,47,14,"Anderson",76978,164.982202707267,0.0866192630898513,420.89947777287,28.5795941697628,231.234898282626,8.66192630898513
2020-10-15,1497,22,1434,16,63,6,1675,14,28950,151,30625,165,0,13,2,180,20,1304,1,48,14,"Anderson",76978,180.57107225441,0.0949453551912568,214.346956273221,28.5795941697628,233.83304320715,9.49453551912568
2020-10-16,1504,7,1437,3,67,4,1679,4,29049,99,30728,103,0,13,-11,169,18,1322,0,48,15,"Anderson",76978,170.178492556315,0.0921625544267054,133.80446361298,9.09350723583361,219.543246122269,9.21625544267054
2020-10-17,1532,28,1464,27,68,1,1709,30,29297,248,31006,278,0,13,14,183,14,1336,2,50,15,"Anderson",76978,185.767362103458,0.0962078651685393,361.142144508821,36.3740289433345,237.730260593936,9.62078651685393
2020-10-18,1551,19,1483,19,68,0,1731,22,29536,239,31267,261,0,13,4,187,15,1351,0,50,15,"Anderson",76978,174.075709943101,0.0937728937728938,339.057912650368,24.682376782977,242.926550442984,9.37728937728938
2020-10-19,1555,4,1487,4,68,0,1736,5,29613,77,31349,82,0,13,-16,171,20,1371,1,51,15,"Anderson",76978,158.486840395957,0.0865384615384615,106.523941905479,5.19628984904778,222.141391046793,8.65384615384615
2020-10-20,1582,27,1514,27,68,0,1771,35,29812,199,31583,234,0,13,6,177,21,1392,0,51,15,"Anderson",76978,167.580347631791,0.0926053904630269,303.982956169295,35.0749564810725,229.935825820364,9.26053904630269
2020-10-21,1599,17,1531,17,68,0,1790,19,30028,216,31818,235,0,13,8,185,9,1401,1,52,15,"Anderson",76978,161.084985320481,0.0949926362297496,305.282028631557,22.0842318584531,240.32840551846,9.49926362297496
2020-10-22,1620,21,1552,21,68,0,1815,25,30360,332,32175,357,1,14,-4,181,24,1425,0,52,15,"Anderson",76978,159.785912858219,0.0903225806451613,463.768869027514,27.2805217075008,235.132115669412,9.03225806451613
2020-10-23,1635,15,1566,14,69,1,1831,16,30635,275,32466,291,0,14,-7,174,22,1447,0,52,15,"Anderson",76978,170.178492556315,0.0874568469505178,378.030086518226,19.4860869339292,226.038608433578,8.74568469505178
2020-10-24,1666,31,1596,30,70,1,1864,33,31011,376,32875,409,0,14,19,193,12,1459,2,54,17,"Anderson",76978,174.075709943101,0.0829320492241841,531.320637065136,40.2712463301203,250.720985216555,8.29320492241841
2020-10-25,1683,17,1612,16,71,1,1883,19,31207,196,33090,215,0,14,0,193,17,1476,4,58,17,"Anderson",76978,171.477565018577,0.0833790455293472,279.300579386318,22.0842318584531,250.720985216555,8.33790455293472
2020-10-26,1699,16,1627,15,72,1,1901,18,31341,134,33242,152,-1,13,-11,182,28,1504,1,59,17,"Anderson",76978,187.06643456572,0.0871632329635499,197.459014263816,20.7851593961911,236.431188131674,8.71632329635499
2020-10-27,1728,29,1651,24,77,5,1925,24,31496,155,33421,179,1,14,10,192,18,1522,2,61,17,"Anderson",76978,189.664579490244,0.0837867247007617,232.533970744888,37.6731014055964,249.421912754293,8.37867247007617
2020-10-28,1784,56,1705,54,79,2,1984,59,31930,434,33914,493,0,14,34,226,22,1544,0,61,17,"Anderson",76978,240.32840551846,0.0925572519083969,640.442723895139,72.7480578866689,293.5903764712,9.25572519083969
2020-10-29,1813,29,1726,21,87,8,2003,19,32136,206,34139,225,0,14,6,232,23,1567,2,63,17,"Anderson",76978,250.720985216555,0.0957230142566191,292.291304008938,37.6731014055964,301.384811244771,9.57230142566191
2020-10-30,1850,37,1760,34,90,3,2041,38,32287,151,34328,189,2,16,20,252,15,1582,1,64,17,"Anderson",76978,279.300579386318,0.112781954887218,245.524695367508,48.065681103692,327.36626049001,11.2781954887218
2020-10-31,1850,0,1760,0,90,0,2041,0,32288,1,34329,1,0,16,-10,242,10,1592,0,64,19,"Anderson",76978,239.029333056198,0.121733149931224,1.29907246226194,0,314.375535867391,12.1733149931224
2020-11-01,1855,5,1765,5,90,0,2049,8,32532,244,34581,252,0,16,-10,232,15,1607,0,64,19,"Anderson",76978,223.440463509055,0.111334674714956,327.36626049001,6.49536231130973,301.384811244771,11.1334674714956
2020-11-02,1888,33,1796,31,92,2,2084,35,32799,267,34883,302,0,16,8,240,25,1632,0,64,20,"Anderson",76978,245.524695367508,0.111517367458867,392.319883603107,42.8693912546442,311.777390942867,11.1517367458867
2020-11-03,1914,26,1821,25,93,1,2109,25,32979,180,35088,205,0,16,6,246,20,1652,0,64,21,"Anderson",76978,241.627477980722,0.110377924415117,266.309854763699,33.7758840188106,319.571825716438,11.0377924415117
2020-11-04,1932,18,1836,15,96,3,2127,18,33058,79,35185,97,2,18,1,247,15,1667,1,65,21,"Anderson",76978,192.262724414768,0.112509834775767,126.010028839409,23.383304320715,320.8708981787,11.2509834775767
2020-11-05,1956,24,1854,18,102,6,2147,20,33157,99,35304,119,0,18,1,248,23,1690,0,65,22,"Anderson",76978,185.767362103458,0.123605150214592,154.589623009171,31.1777390942867,322.169970640962,12.3605150214592
2020-11-06,2005,49,1900,46,105,3,2196,49,33524,367,35720,416,0,18,24,272,25,1715,2,67,23,"Anderson",76978,201.356231650601,0.111350574712644,540.414144300969,63.6545506508353,353.347709735249,11.1350574712644
2020-11-07,2085,80,1977,77,108,3,2273,77,33971,447,36244,524,0,18,50,322,30,1745,0,67,23,"Anderson",76978,305.282028631557,0.121148825065274,680.713970225259,103.925796980956,418.301332848346,12.1148825065274
2020-11-08,2139,54,2028,51,111,3,2335,62,34581,610,36916,672,0,18,39,361,15,1760,1,68,23,"Anderson",76978,368.936579282392,0.122483940042827,872.976694640027,70.149912962145,468.965158876562,12.2483940042827
2020-11-09,2147,8,2035,7,112,1,2344,9,34655,74,36999,83,0,18,-46,315,54,1814,0,68,23,"Anderson",76978,336.459767725844,0.122873345935728,107.823014367741,10.3925796980956,409.207825612513,12.2873345935728
2020-11-10,2166,19,2053,18,113,1,2366,22,34826,171,37192,193,0,18,-16,299,35,1849,1,69,23,"Anderson",76978,327.36626049001,0.122148288973384,250.720985216555,24.682376782977,388.422666216322,12.2148288973384
2020-11-11,2205,39,2089,36,116,3,2408,42,35099,273,37507,315,1,19,13,312,25,1874,1,70,23,"Anderson",76978,354.646782197511,0.121016365202412,409.207825612513,50.6638260282159,405.310608225727,12.1016365202412
2020-11-12,2212,7,2095,6,117,1,2416,8,35297,198,37713,206,0,19,-13,299,20,1894,0,70,24,"Anderson",76978,332.562550339058,0.111664591116646,267.608927225961,9.09350723583361,388.422666216322,11.1664591116646
2020-11-13,2268,56,2148,53,120,3,2475,59,35559,262,38034,321,2,21,31,330,23,1917,2,72,24,"Anderson",76978,341.656057574892,0.12057044079516,417.002260386084,72.7480578866689,428.693912546442,12.057044079516
2020-11-14,2309,41,2188,40,121,1,2520,45,35955,396,38475,441,1,22,20,350,20,1937,1,73,25,"Anderson",76978,290.992231546676,0.110712684894666,572.890955857518,53.2619709527397,454.675361791681,11.0712684894666
2020-11-15,2407,98,2286,98,121,0,2628,108,36537,582,39165,690,1,23,79,429,18,1955,1,74,25,"Anderson",76978,348.151419886201,0.130280124499778,896.359998960742,127.309101301671,557.302086310374,13.0280124499778
2020-11-16,2456,49,2315,29,141,20,2657,29,36814,277,39471,306,0,23,-6,423,55,2010,1,75,25,"Anderson",76978,401.413390838941,0.126618122977346,397.516173452155,63.6545506508353,549.507651536803,12.6618122977346
2020-11-17,2472,16,2330,15,142,1,2673,16,37020,206,39693,222,2,25,-37,386,51,2061,1,76,26,"Anderson",76978,397.516173452155,0.122750899640144,288.394086622152,20.7851593961911,501.441970433111,12.2750899640144
2020-11-18,2502,30,2356,26,146,4,2699,26,37314,294,40013,320,0,25,-5,381,35,2096,0,76,27,"Anderson",76978,385.824521291798,0.116121308858739,415.703187923822,38.9721738678584,494.946608121801,11.6121308858739
2020-11-19,2560,58,2410,54,150,4,2761,62,37730,416,40491,478,0,25,19,400,39,2135,1,77,27,"Anderson",76978,452.077216867157,0.124190064794816,620.95663696121,75.3462028111928,519.628984904778,12.4190064794816
2020-11-20,2590,30,2437,27,153,3,2792,31,37843,113,40635,144,0,25,-10,390,40,2175,0,77,28,"Anderson",76978,418.301332848346,0.121876201460977,187.06643456572,38.9721738678584,506.638260282159,12.1876201460977
2020-11-21,2647,57,2486,49,161,8,2840,48,38187,344,41027,392,0,25,33,423,24,2199,1,78,28,"Anderson",76978,439.086492244537,0.125391849529781,509.236405206682,74.0471303489309,549.507651536803,12.5391849529781
2020-11-22,2703,56,2535,49,168,7,2897,57,38670,483,41567,540,0,25,42,465,14,2213,1,79,31,"Anderson",76978,384.525448829536,0.111990008326395,701.49912962145,72.7480578866689,604.068694951804,11.1990008326395
2020-11-23,2710,7,2541,6,169,1,2903,6,38692,22,41595,28,0,25,-64,401,71,2284,0,79,32,"Anderson",76978,329.964405414534,0.115819209039548,36.3740289433345,9.09350723583361,520.92805736704,11.5819209039548
2020-11-24,2723,13,2553,12,170,1,2915,12,38849,157,41764,169,2,27,-35,366,46,2330,0,79,32,"Anderson",76978,326.067188027748,0.116851762433607,219.543246122269,16.8879420094053,475.460521187872,11.6851762433607
2020-11-25,2751,28,2574,21,177,7,2936,21,38886,37,41822,58,1,28,-11,355,38,2368,0,79,32,"Anderson",76978,323.469043103224,0.131011608623549,75.3462028111928,36.3740289433345,461.170724102991,13.1011608623549
2020-11-26,2796,45,2616,42,180,3,2981,45,39236,350,42217,395,0,28,-30,325,75,2443,1,80,33,"Anderson",76978,306.581101093819,0.127462340672074,513.133622593468,58.4582608017875,422.198550235132,12.7462340672074
2020-11-27,2895,99,2706,90,189,9,3076,95,39662,426,42738,521,0,28,56,381,43,2486,3,83,35,"Anderson",76978,396.217100989893,0.135045173561579,676.816752838473,128.608173763933,494.946608121801,13.5045173561579
2020-11-28,2926,31,2731,25,195,6,3106,30,39805,143,42911,173,1,29,5,386,25,2511,2,85,35,"Anderson",76978,362.441216971083,0.141188959660297,224.739535971316,40.2712463301203,501.441970433111,14.1188959660297
2020-11-29,3017,91,2820,89,197,2,3202,96,40242,437,43444,533,0,29,65,451,26,2537,1,86,35,"Anderson",76978,407.908753150251,0.162493340436867,692.405622385617,118.215594065837,585.881680480137,16.2493340436867
2020-11-30,3087,70,2886,66,201,4,3275,73,40494,252,43769,325,0,29,1,452,69,2606,0,86,37,"Anderson",76978,489.750318272753,0.171113155473781,422.198550235132,90.9350723583361,587.180752942399,17.1113155473781
2020-12-01,3163,76,2952,66,211,10,3347,72,40925,431,44272,503,1,30,14,466,61,2667,6,92,38,"Anderson",76978,571.591883395256,0.172248803827751,653.433448517758,98.7295071319078,605.367767414066,17.2248803827751
2020-12-02,3178,15,2966,14,212,1,3363,16,41033,108,44396,124,0,30,-40,426,55,2722,0,92,38,"Anderson",76978,554.70394138585,0.165889665889666,161.084985320481,19.4860869339292,553.404868923589,16.5889665889666
2020-12-03,3219,41,2995,29,224,12,3396,33,41257,224,44653,257,1,31,-14,412,54,2776,1,93,39,"Anderson",76978,549.507651536803,0.170361247947455,333.86162280132,53.2619709527397,535.217854451921,17.0361247947455
2020-12-04,3286,67,3055,60,231,7,3459,63,41415,158,44874,221,1,32,-25,387,91,2867,0,93,39,"Anderson",76978,507.93733274442,0.179307116104869,287.09501415989,87.0378549715503,502.741042895373,17.9307116104869
2020-12-05,3317,31,3074,19,243,12,3477,18,41482,67,44959,85,0,32,1,388,30,2897,0,93,39,"Anderson",76978,507.93733274442,0.18115234375,110.421159292265,40.2712463301203,504.040115357635,18.115234375
2020-12-06,3353,36,3103,29,250,7,3505,28,41690,208,45195,236,0,32,12,400,24,2921,2,95,40,"Anderson",76978,436.488347320014,0.173043974871502,306.581101093819,46.76660864143,519.628984904778,17.3043974871502
2020-12-07,3493,140,3227,124,266,16,3641,136,42283,593,45924,729,2,34,28,428,110,3031,4,99,41,"Anderson",76978,527.42341967835,0.169837587006961,947.023824988958,181.870144716672,556.003013848112,16.9837587006961
2020-12-08,3564,71,3276,49,288,22,3693,52,42581,298,46274,350,1,35,-8,420,78,3109,2,101,43,"Anderson",76978,520.92805736704,0.172827172827173,454.675361791681,92.2341448205981,545.610434150017,17.2827172827173
2020-12-09,3669,105,3367,91,302,14,3797,104,42842,261,46639,365,0,35,46,466,59,3168,3,104,44,"Anderson",76978,637.844578970615,0.193490860454748,474.16144872561,136.402608537504,605.367767414066,19.3490860454748
2020-12-10,3763,94,3445,78,318,16,3884,87,43374,532,47258,619,3,38,81,547,10,3178,3,107,45,"Anderson",76978,706.695419470498,0.187332053742802,804.125854140144,122.112811452623,710.592636857284,18.7332053742802
2020-12-11,3836,73,3498,53,338,20,3935,51,43540,166,47475,217,1,39,30,577,42,3220,2,109,45,"Anderson",76978,714.48985424407,0.183006535947712,281.898724310842,94.832289745122,749.564810725142,18.3006535947712
2020-12-12,3924,88,3559,61,365,27,4000,65,44053,513,48053,578,0,39,55,632,33,3253,2,111,45,"Anderson",76978,788.536984593001,0.169036845507434,750.863883187404,114.318376679051,821.013796149549,16.9036845507434
2020-12-13,4156,232,3742,183,414,49,4204,204,44925,872,49129,1076,1,40,188,820,43,3296,0,111,47,"Anderson",76978,1043.15518719634,0.177681748856126,1397.80196939385,301.384811244771,1065.23941905479,17.7681748856126
2020-12-14,4271,115,3828,86,443,29,4303,99,45216,291,49519,390,0,40,-37,783,152,3448,1,112,48,"Anderson",76978,1010.67837563979,0.184144645340751,506.638260282159,149.393333160124,1017.1737379511,18.4144645340751
2020-12-15,4406,135,3913,85,493,50,4399,96,45743,527,50142,623,1,41,42,825,92,3540,6,118,51,"Anderson",76978,1093.81901322456,0.182523267838676,809.322143989192,175.374782405363,1071.7347813661,18.2523267838676
2020-12-16,4475,69,3943,30,532,39,4435,36,46066,323,50501,359,2,43,-17,808,84,3624,4,122,52,"Anderson",76978,1047.05240458313,0.165199378560331,466.367013952038,89.6359998960742,1049.65054950765,16.5199378560331
2020-12-17,4676,201,4117,174,559,27,4629,194,46594,528,51223,722,2,45,114,922,85,3709,2,124,54,"Anderson",76978,1186.05315804516,0.187894073139975,937.930317753124,261.113564914651,1197.74481020551,18.7894073139975
2020-12-18,4774,98,4193,76,581,22,4716,87,46960,366,51676,453,1,46,23,945,74,3783,2,126,54,"Anderson",76978,1218.5299696017,0.185908117114973,588.479825404661,127.309101301671,1227.62347683754,18.5908117114973
2020-12-19,4879,105,4274,81,605,24,4803,87,47218,258,52021,345,0,46,74,1019,31,3814,1,127,55,"Anderson",76978,1240.61420146016,0.202368951612903,448.179999480371,136.402608537504,1323.75483904492,20.2368951612903
2020-12-20,5019,140,4396,122,623,18,4940,137,47682,464,52622,601,2,48,84,1103,54,3868,3,130,56,"Anderson",76978,1121.09953493206,0.2107071285428,780.742549819429,181.870144716672,1432.87692587493,21.07071285428
2020-12-21,5067,48,4414,18,653,30,4963,23,47902,220,52865,243,3,51,-83,1020,128,3996,2,132,59,"Anderson",76978,1034.06167996051,0.197250448296473,315.674608329653,62.3554781885734,1325.05391150718,19.7250448296473
2020-12-22,5137,70,4458,44,679,26,5010,47,48008,106,53018,153,1,52,-31,989,100,4096,2,134,64,"Anderson",76978,949.621969913482,0.212447844228095,198.758086726078,90.9350723583361,1284.78266517706,21.2447844228095
2020-12-23,5211,74,4500,42,711,32,5053,43,48324,316,53377,359,2,54,-8,981,80,4176,2,136,66,"Anderson",76978,956.117332224792,0.214881780250348,466.367013952038,96.1313622073839,1274.39008547897,21.4881780250348
2020-12-24,5269,58,4524,24,745,34,5080,27,48476,152,53556,179,1,55,-47,934,104,4280,1,137,71,"Anderson",76978,770.349970121333,0.193313330475782,232.533970744888,75.3462028111928,1213.33367975266,19.3313330475782
2020-12-25,5362,93,4601,77,761,16,5172,92,48885,409,54057,501,0,55,-16,918,109,4389,1,138,72,"Anderson",76978,763.854607810024,0.191516169676606,650.835303593234,120.813738990361,1192.54852035647,19.1516169676606
2020-12-26,5418,56,4630,29,788,27,5200,28,49004,119,54204,147,0,55,6,924,50,4439,3,141,74,"Anderson",76978,700.200057159188,0.181859825927623,190.963651952506,72.7480578866689,1200.34295513004,18.1859825927623
2020-12-27,5478,60,4667,37,811,23,5236,36,49140,136,54376,172,1,56,30,954,29,4468,6,147,75,"Anderson",76978,596.274260178233,0.168757126567845,223.440463509055,77.9443477357167,1239.3151289979,16.8757126567845
2020-12-28,5525,47,4688,21,837,26,5256,20,49209,69,54465,89,2,58,-85,869,130,4598,4,151,82,"Anderson",76978,594.975187715971,0.183125,115.617449141313,61.0564057263114,1128.89396970563,18.3125
2020-12-29,5621,96,4740,52,881,44,5304,48,49304,95,54608,143,2,60,-34,835,128,4726,5,156,85,"Anderson",76978,628.751071734781,0.184905660377358,185.767362103458,124.710956377147,1084.72550598872,18.4905660377358
2020-12-30,5656,35,4758,18,898,17,5321,17,49432,128,54753,145,6,66,-89,746,118,4844,1,157,88,"Anderson",76978,578.087245706566,0.194767441860465,188.365507027982,45.4675361791681,969.108056847411,19.4767441860465
2020-12-31,5819,163,4858,100,961,63,5423,102,49736,304,55159,406,6,72,63,809,94,4938,1,158,93,"Anderson",76978,714.48985424407,0.213973799126638,527.42341967835,211.748811348697,1050.94962196991,21.3973799126638
2021-01-01,5884,65,4900,42,984,23,5478,55,50012,276,55490,331,0,72,-25,784,90,5028,2,160,94,"Anderson",76978,678.115825300735,0.213538032100488,429.992985008704,84.4397100470264,1018.47281041336,21.3538032100488
2021-01-02,5977,93,4941,41,1036,52,5519,41,50297,285,55816,326,0,72,49,833,44,5072,2,162,96,"Anderson",76978,726.181506404427,0.197890818858561,423.497622697394,120.813738990361,1082.1273610642,19.7890818858561
2021-01-03,6002,25,4953,12,1049,13,5535,16,50349,52,55884,68,0,72,-9,824,34,5106,1,163,99,"Anderson",76978,680.713970225259,0.198275862068966,88.3369274338123,32.4768115565486,1070.43570890384,19.8275862068966
2021-01-04,6039,37,4977,24,1062,13,5566,31,50456,107,56022,138,1,73,-57,767,93,5199,0,163,104,"Anderson",76978,667.72324560264,0.199100834938985,179.271999792148,48.065681103692,996.388578554912,19.9100834938985
2021-01-05,6111,72,5008,31,1103,41,5597,31,50574,118,56171,149,2,75,-47,720,117,5316,2,165,107,"Anderson",76978,636.545506508353,0.187460012795905,193.56179687703,93.53321728286,935.3321728286,18.7460012795905
2021-01-06,6185,74,5048,40,1137,34,5640,43,50735,161,56375,204,5,80,-12,708,81,5397,2,167,109,"Anderson",76978,687.209332536569,0.196670776818742,265.010782301437,96.1313622073839,919.743303281457,19.6670776818742
2021-01-07,6290,105,5128,80,1162,25,5732,92,50956,221,56688,313,1,81,65,773,39,5436,1,168,112,"Anderson",76978,611.863129725376,0.202092871157619,406.609680687989,136.402608537504,1004.18301332848,20.2092871157619
2021-01-08,6372,82,5178,50,1194,32,5784,52,51155,199,56939,251,5,86,61,834,16,5452,2,170,115,"Anderson",76978,633.947361583829,0.211180124223602,326.067188027748,106.523941905479,1083.42643352646,21.1180124223602
2021-01-09,6482,110,5247,69,1235,41,5859,75,51586,431,57445,506,2,88,45,879,63,5515,0,170,117,"Anderson",76978,656.031593442282,0.208717004297115,657.330665904544,142.897970848814,1141.88469432825,20.8717004297115
2021-01-10,6542,60,5272,25,1270,35,5884,25,51680,94,57564,119,2,90,28,907,30,5545,3,173,118,"Anderson",76978,701.49912962145,0.207738095238095,154.589623009171,77.9443477357167,1178.25872327158,20.7738095238095
2021-01-11,6575,33,5282,10,1293,23,5897,13,51751,71,57648,84,1,91,-93,814,125,5670,1,174,120,"Anderson",76978,696.302839772403,0.203567035670357,109.122086830003,42.8693912546442,1057.44498428122,20.3567035670357
2021-01-12,6628,53,5316,34,1312,19,5935,38,51923,172,57858,210,2,93,-100,714,151,5821,1,175,120,"Anderson",76978,671.620462989426,0.200355660936574,272.805217075008,68.8508404998831,927.537738055029,20.0355660936574
2021-01-13,6654,26,5333,17,1321,9,5954,19,52013,90,57967,109,3,96,-44,670,67,5888,0,175,121,"Anderson",76978,609.264984800852,0.197236180904523,141.598898386552,33.7758840188106,870.378549715503,19.7236180904523
2021-01-14,6751,97,5395,62,1356,35,6028,74,52420,407,58448,481,5,101,9,679,83,5971,2,177,123,"Anderson",76978,598.872405102757,0.168181818181818,624.853854347995,126.010028839409,882.070201875861,16.8181818181818
2021-01-15,6785,34,5415,20,1370,14,6052,24,52575,155,58627,179,0,101,-16,663,50,6021,1,178,126,"Anderson",76978,536.516926914183,0.158767772511848,232.533970744888,44.1684637169061,861.285042479669,15.8767772511848
2021-01-16,6849,64,5445,30,1404,34,6085,33,52819,244,58904,277,1,102,2,665,61,6082,1,179,129,"Anderson",76978,476.759593650134,0.154900616860864,359.843072046559,83.1406375847645,863.883187404193,15.4900616860864
2021-01-17,6886,37,5465,20,1421,17,6108,23,52923,104,59031,127,0,102,-7,658,44,6126,0,179,131,"Anderson",76978,446.880927018109,0.152692569870484,164.982202707267,48.065681103692,854.78968016836,15.2692569870484
2021-01-18,6905,19,5473,8,1432,11,6118,10,53019,96,59137,106,1,103,-68,590,86,6212,0,179,132,"Anderson",76978,428.693912546442,0.148421759570181,137.701680999766,24.682376782977,766.452752734548,14.8421759570181
2021-01-19,6947,42,5490,17,1457,25,6138,20,53131,112,59269,132,1,104,-78,512,119,6331,0,179,134,"Anderson",76978,414.40411546156,0.143869596031184,171.477565018577,54.5610434150017,665.125100678116,14.3869596031184
2021-01-20,6975,28,5506,16,1469,12,6157,19,53283,152,59440,171,3,107,-29,483,54,6385,0,179,137,"Anderson",76978,417.002260386084,0.137813985064494,222.141391046793,36.3740289433345,627.451999272519,13.7813985064494
2021-01-21,7031,56,5546,40,1485,16,6196,39,53524,241,59720,280,5,112,-43,440,94,6479,2,181,138,"Anderson",76978,363.740289433345,0.132075471698113,363.740289433345,72.7480578866689,571.591883395256,13.2075471698113
2021-01-22,7069,38,5564,18,1505,20,6218,22,53669,145,59887,167,2,114,-16,424,52,6531,0,181,141,"Anderson",76978,368.936579282392,0.131746031746032,216.945101197745,49.3647535659539,550.806723999065,13.1746031746032
2021-01-23,7107,38,5578,14,1529,24,6231,13,53929,260,60160,273,0,114,8,432,30,6561,1,182,141,"Anderson",76978,335.160695263582,0.116242038216561,354.646782197511,49.3647535659539,561.19930369716,11.6242038216561
2021-01-24,7120,13,5590,12,1530,1,6245,14,53996,67,60241,81,0,114,-21,411,34,6595,0,182,143,"Anderson",76978,303.982956169295,0.113223140495868,105.224869443218,16.8879420094053,533.918781989659,11.3223140495868
2021-01-25,7137,17,5601,11,1536,6,6256,11,54056,60,60312,71,2,116,-47,364,62,6657,1,183,145,"Anderson",76978,301.384811244771,0.117446808510638,92.2341448205981,22.0842318584531,472.862376263348,11.7446808510638
2021-01-26,7164,27,5622,21,1542,6,6281,25,54219,163,60500,188,0,116,-36,328,63,6720,1,184,148,"Anderson",76978,281.898724310842,0.116165718927701,244.225622905246,35.0749564810725,426.095767621918,11.6165718927701
2021-01-27,7181,17,5630,8,1551,9,6290,9,54305,86,60595,95,4,120,-17,311,30,6750,0,184,150,"Anderson",76978,267.608927225961,0.115151515151515,123.411883914885,22.0842318584531,404.011535763465,11.5151515151515
2021-01-28,7268,87,5670,40,1598,47,6337,47,54531,226,60868,273,4,124,24,335,59,6809,0,184,151,"Anderson",76978,307.880173556081,0.122822299651568,354.646782197511,113.019304216789,435.189274857752,12.2822299651568
2021-01-29,7281,13,5674,4,1607,9,6342,5,54576,45,60918,50,1,125,-34,301,46,6855,1,185,151,"Anderson",76978,275.403361999532,0.120271580989331,64.9536231130973,16.8879420094053,391.020811140845,12.0271580989331
2021-01-30,7321,40,5709,35,1612,5,6378,36,54835,259,61213,295,2,127,1,302,37,6892,2,187,152,"Anderson",76978,278.001506924056,0.13960113960114,383.226376367274,51.9628984904778,392.319883603107,13.960113960114
2021-01-31,7337,16,5716,7,1621,9,6389,11,55004,169,61393,180,1,128,-4,298,19,6911,0,187,154,"Anderson",76978,281.898724310842,0.125,233.83304320715,20.7851593961911,387.12359375406,12.5
2021-02-01,7357,20,5728,12,1629,8,6402,13,55057,53,61459,66,1,129,-26,272,45,6956,1,188,156,"Anderson",76978,285.795941697628,0.127288578901482,85.7387825092884,25.9814492452389,353.347709735249,12.7288578901482
2021-02-02,7364,7,5734,6,1630,1,6408,6,55126,69,61534,75,5,134,-45,227,47,7003,0,188,157,"Anderson",76978,259.814492452389,0.122823984526112,97.4304346696459,9.09350723583361,294.889448933461,12.2823984526112
2021-02-03,7386,22,5740,6,1646,16,6418,10,55318,192,61736,202,4,138,1,228,17,7020,0,188,158,"Anderson",76978,266.309854763699,0.112182296231376,262.412637376913,28.5795941697628,296.188521395723,11.2182296231376
2021-02-04,7416,30,5754,14,1662,16,6435,17,55642,324,62077,341,2,140,-5,223,33,7053,0,188,158,"Anderson",76978,192.262724414768,0.0810587262200165,442.983709631323,38.9721738678584,289.693159084414,8.10587262200166
2021-02-05,7434,18,5765,11,1669,7,6452,17,55799,157,62251,174,2,142,-13,210,29,7082,0,188,159,"Anderson",76978,198.758086726078,0.0825206301575394,226.038608433578,23.383304320715,272.805217075008,8.25206301575394
2021-02-06,7460,26,5781,16,1679,10,6472,20,56021,222,62493,242,1,143,8,218,17,7099,1,189,159,"Anderson",76978,180.57107225441,0.0734375,314.375535867391,33.7758840188106,283.197796773104,7.34375
2021-02-07,7473,13,5788,7,1685,6,6480,8,56128,107,62608,115,0,143,-10,208,23,7122,0,189,159,"Anderson",76978,176.673854867625,0.0748971193415638,149.393333160124,16.8879420094053,270.207072150485,7.48971193415638
2021-02-08,7498,25,5794,6,1704,19,6485,5,56150,22,62635,27,2,145,-12,196,35,7157,0,189,159,"Anderson",76978,183.169217178934,0.070578231292517,35.0749564810725,32.4768115565486,254.618202603341,7.0578231292517
2021-02-09,7522,24,5804,10,1718,14,6496,11,56319,169,62815,180,2,147,-24,172,46,7203,2,191,159,"Anderson",76978,205.253449037387,0.068696330991413,233.83304320715,31.1777390942867,223.440463509055,6.8696330991413
2021-02-10,7547,25,5819,15,1728,10,6515,19,56514,195,63029,214,1,148,8,180,16,7219,1,192,159,"Anderson",76978,209.150666424173,0.0750193348801237,278.001506924056,32.4768115565486,233.83304320715,7.50193348801237
2021-02-11,7560,13,5827,8,1733,5,6527,12,56694,180,63221,192,-1,147,-16,164,30,7249,0,192,160,"Anderson",76978,187.06643456572,0.0804195804195804,249.421912754293,16.8879420094053,213.047883810959,8.04195804195804
2021-02-12,7587,27,5842,15,1745,12,6542,15,56888,194,63430,209,0,147,13,177,14,7263,0,192,160,"Anderson",76978,198.758086726078,0.0763358778625954,271.506144612746,35.0749564810725,229.935825820364,7.63358778625954
2021-02-13,7613,26,5852,10,1761,16,6552,10,57077,189,63629,199,0,147,11,188,15,7278,0,192,160,"Anderson",76978,198.758086726078,0.0704225352112676,258.515419990127,33.7758840188106,244.225622905246,7.04225352112676
2021-02-14,7627,14,5862,10,1765,4,6563,11,57138,61,63701,72,2,149,1,189,11,7289,0,192,160,"Anderson",76978,200.05715918834,0.0759377859103385,93.53321728286,18.1870144716672,245.524695367508,7.59377859103385
2021-02-15,7643,16,5870,8,1773,8,6572,9,57211,73,63783,82,0,149,-6,183,22,7311,1,193,161,"Anderson",76978,188.365507027982,0.0757839721254355,106.523941905479,20.7851593961911,237.730260593936,7.57839721254355
2021-02-16,7672,29,5884,14,1788,15,6589,17,57295,84,63884,101,0,149,11,194,18,7329,0,193,161,"Anderson",76978,194.860869339292,0.0869971936389149,131.206318688456,37.6731014055964,252.020057678817,8.69971936389149
2021-02-17,7691,19,5896,12,1795,7,6601,12,57403,108,64004,120,0,149,-8,186,27,7356,0,193,163,"Anderson",76978,187.06643456572,0.0882051282051282,155.888695471433,24.682376782977,241.627477980722,8.82051282051282
2021-02-18,7715,24,5918,22,1797,2,6627,26,57559,156,64186,182,0,149,9,195,15,7371,0,193,163,"Anderson",76978,201.356231650601,0.103626943005181,236.431188131674,31.1777390942867,253.319130141079,10.3626943005181
2021-02-19,7728,13,5929,11,1799,2,6642,15,57605,46,64247,61,0,149,0,195,13,7384,0,193,164,"Anderson",76978,183.169217178934,0.122399020807834,79.2434201979787,16.8879420094053,253.319130141079,12.2399020807834
2021-02-20,7747,19,5936,7,1811,12,6651,9,57727,122,64378,131,1,150,3,198,15,7399,0,193,165,"Anderson",76978,174.075709943101,0.132176234979973,170.178492556315,24.682376782977,257.216347527865,13.2176234979973
2021-02-21,7759,12,5943,7,1816,5,6658,7,57791,64,64449,71,2,152,-1,197,11,7410,1,194,165,"Anderson",76978,171.477565018577,0.127005347593583,92.2341448205981,15.5888695471433,255.917275065603,12.7005347593583
2021-02-22,7764,5,5945,2,1819,3,6664,6,57828,37,64492,43,1,153,-17,180,21,7431,0,194,166,"Anderson",76978,157.187767933695,0.129760225669958,55.8601158772636,6.49536231130973,233.83304320715,12.9760225669958
2021-02-23,7788,24,5954,9,1834,15,6672,8,57971,143,64643,151,2,155,-2,178,24,7455,0,194,168,"Anderson",76978,150.692405622386,0.10935441370224,196.159941801554,31.1777390942867,231.234898282626,10.935441370224
2021-02-24,7820,32,5973,19,1847,13,6695,23,58145,174,64840,197,0,155,15,193,17,7472,0,194,168,"Anderson",76978,167.580347631791,0.11244019138756,255.917275065603,41.5703187923822,250.720985216555,11.244019138756
2021-02-25,7837,17,5981,8,1856,9,6706,11,58272,127,64978,138,1,156,-3,190,19,7491,0,194,168,"Anderson",76978,158.486840395957,0.0997474747474748,179.271999792148,22.0842318584531,246.82376782977,9.97474747474748
2021-02-26,7849,12,5989,8,1860,4,6715,9,58371,99,65086,108,0,156,-17,173,29,7520,0,194,168,"Anderson",76978,157.187767933695,0.0870083432657926,140.29982592429,15.5888695471433,224.739535971316,8.70083432657926
2021-02-27,7858,9,5996,7,1862,2,6721,6,58463,92,65184,98,0,156,-6,167,15,7535,0,194,168,"Anderson",76978,144.197043311076,0.086848635235732,127.309101301671,11.6916521603575,216.945101197745,8.6848635235732
2021-02-28,7872,14,6006,10,1866,4,6732,11,58534,71,65266,82,0,156,0,167,14,7549,0,194,168,"Anderson",76978,146.7951882356,0.0905752753977968,106.523941905479,18.1870144716672,216.945101197745,9.05752753977968
2021-03-01,7880,8,6011,5,1869,3,6739,7,58569,35,65308,42,0,156,-11,156,19,7568,0,194,169,"Anderson",76978,150.692405622386,0.0919117647058824,54.5610434150017,10.3925796980956,202.655304112863,9.19117647058824
2021-03-02,7903,23,6022,11,1881,12,6749,10,58685,116,65434,126,1,157,-2,154,24,7592,1,195,169,"Anderson",76978,149.393333160124,0.0973451327433628,163.683130245005,29.8786666320247,200.05715918834,9.73451327433628
2021-03-03,7936,33,6043,21,1893,12,6774,25,58801,116,65575,141,1,158,13,167,19,7611,0,195,170,"Anderson",76978,150.692405622386,0.107482993197279,183.169217178934,42.8693912546442,216.945101197745,10.7482993197279
2021-03-04,7961,25,6056,13,1905,12,6791,17,58964,163,65755,180,0,158,13,180,12,7623,0,195,170,"Anderson",76978,161.084985320481,0.109395109395109,233.83304320715,32.4768115565486,233.83304320715,10.9395109395109
2021-03-05,7994,33,6073,17,1921,16,6813,22,59098,134,65911,156,0,158,18,198,15,7638,2,197,170,"Anderson",76978,188.365507027982,0.118787878787879,202.655304112863,42.8693912546442,257.216347527865,11.8787878787879
2021-03-06,8004,10,6078,5,1926,5,6821,8,59187,89,66008,97,0,158,-1,197,11,7649,0,197,170,"Anderson",76978,189.664579490244,0.121359223300971,126.010028839409,12.9907246226195,255.917275065603,12.1359223300971
2021-03-07,8010,6,6081,3,1929,3,6824,3,59226,39,66050,42,0,158,-10,187,16,7665,0,197,170,"Anderson",76978,179.271999792148,0.11734693877551,54.5610434150017,7.79443477357167,242.926550442984,11.734693877551
2021-03-08,8026,16,6088,7,1938,9,6833,9,59303,77,66136,86,1,159,-4,183,19,7684,0,197,170,"Anderson",76978,189.664579490244,0.113526570048309,111.720231754527,20.7851593961911,237.730260593936,11.3526570048309
2021-03-09,8047,21,6096,8,1951,13,6841,8,59368,65,66209,73,0,159,3,186,18,7702,3,200,171,"Anderson",76978,187.06643456572,0.118709677419355,94.832289745122,27.2805217075008,241.627477980722,11.8709677419355
2021-03-10,8069,22,6109,13,1960,9,6857,16,59525,157,66382,173,0,159,11,197,11,7713,1,201,171,"Anderson",76978,172.776637480839,0.102850061957869,224.739535971316,28.5795941697628,255.917275065603,10.2850061957869
2021-03-11,8092,23,6119,10,1973,13,6867,10,59622,97,66489,107,0,159,1,198,22,7735,1,202,172,"Anderson",76978,170.178492556315,0.103542234332425,139.000753462028,29.8786666320247,257.216347527865,10.3542234332425
2021-03-12,8112,20,6136,17,1976,3,6887,20,59728,106,66615,126,0,159,8,206,12,7747,0,202,172,"Anderson",76978,153.29055054691,0.105113636363636,163.683130245005,25.9814492452389,267.608927225961,10.5113636363636
2021-03-13,8123,11,6140,4,1983,7,6891,4,59804,76,66695,80,0,159,2,208,9,7756,1,203,172,"Anderson",76978,154.589623009171,0.101892285298399,103.925796980956,14.2897970848814,270.207072150485,10.1892285298399
2021-03-14,8129,6,6144,4,1985,2,6897,6,59840,36,66737,42,0,159,-13,195,19,7775,1,204,172,"Anderson",76978,154.589623009171,0.106259097525473,54.5610434150017,7.79443477357167,253.319130141079,10.6259097525473
2021-03-15,8147,18,6150,6,1997,12,6903,6,59873,33,66776,39,0,159,-9,186,27,7802,1,205,172,"Anderson",76978,157.187767933695,0.109375,50.6638260282159,23.383304320715,241.627477980722,10.9375
2021-03-16,8180,33,6163,13,2017,20,6918,15,59966,93,66884,108,0,159,-2,184,35,7837,2,207,172,"Anderson",76978,172.776637480839,0.114074074074074,140.29982592429,42.8693912546442,239.029333056198,11.4074074074074
2021-03-17,8197,17,6174,11,2023,6,6931,13,60053,87,66984,100,0,159,-5,179,22,7859,0,207,173,"Anderson",76978,166.281275169529,0.122923588039867,129.907246226195,22.0842318584531,232.533970744888,12.2923588039867
2021-03-18,8213,16,6186,12,2027,4,6946,15,60134,81,67080,96,1,160,-1,178,16,7875,0,207,173,"Anderson",76978,157.187767933695,0.133671742808799,124.710956377147,20.7851593961911,231.234898282626,13.3671742808799
2021-03-19,8237,24,6200,14,2037,10,6959,13,60253,119,67212,132,0,160,13,191,11,7886,1,208,173,"Anderson",76978,162.384057782743,0.120603015075377,171.477565018577,31.1777390942867,248.122840292031,12.0603015075377
2021-03-20,8249,12,6206,6,2043,6,6967,8,60292,39,67259,47,0,160,3,194,9,7895,1,209,173,"Anderson",76978,163.683130245005,0.134751773049645,61.0564057263114,15.5888695471433,252.020057678817,13.4751773049645
2021-03-21,8259,10,6212,6,2047,4,6974,7,60354,62,67328,69,-1,159,-5,189,16,7911,0,209,173,"Anderson",76978,168.879420094053,0.130287648054146,89.6359998960742,12.9907246226195,245.524695367508,13.0287648054146
2021-03-22,8265,6,6213,1,2052,5,6975,1,60420,66,67395,67,0,159,-9,180,15,7926,1,210,173,"Anderson",76978,153.29055054691,0.116316639741519,87.0378549715503,7.79443477357167,233.83304320715,11.6316639741519
2021-03-23,8271,6,6214,1,2057,5,6976,1,60463,43,67439,44,0,159,-15,165,21,7947,0,210,174,"Anderson",76978,118.215594065837,0.104504504504505,57.1591883395256,7.79443477357167,214.346956273221,10.4504504504505
2021-03-24,8279,8,6221,7,2058,1,6983,7,60584,121,67567,128,1,160,-11,154,18,7965,0,210,174,"Anderson",76978,106.523941905479,0.0891938250428816,166.281275169529,10.3925796980956,200.05715918834,8.91938250428817
2021-03-25,8289,10,6226,5,2063,5,6989,6,60685,101,67674,107,0,160,-10,144,20,7985,0,210,174,"Anderson",76978,98.7295071319078,0.0723905723905724,139.000753462028,12.9907246226195,187.06643456572,7.23905723905724
2021-03-26,8306,17,6238,12,2068,5,7000,11,60751,66,67751,77,0,160,2,146,15,8000,0,210,175,"Anderson",76978,89.6359998960742,0.0760667903525046,100.02857959417,22.0842318584531,189.664579490244,7.60667903525046
2021-03-27,8310,4,6242,4,2068,0,7006,6,60815,64,67821,70,1,161,-12,134,15,8015,2,212,175,"Anderson",76978,79.2434201979786,0.0693950177935943,90.9350723583361,5.19628984904778,174.075709943101,6.93950177935943
2021-03-28,8313,3,6242,0,2071,3,7006,0,60844,29,67850,29,1,162,-12,122,14,8029,0,212,176,"Anderson",76978,70.149912962145,0.0613026819923372,37.6731014055964,3.89721738678583,158.486840395957,6.13026819923372
2021-03-29,8328,15,6246,4,2082,11,7010,4,60930,86,67940,90,1,163,-16,106,30,8059,0,212,177,"Anderson",76978,81.8415651225025,0.0642201834862385,116.916521603575,19.4860869339292,137.701680999766,6.42201834862385
2021-03-30,8333,5,6249,3,2084,2,7013,3,60988,58,68001,61,1,164,-12,94,16,8075,0,212,177,"Anderson",76978,80.5424926602406,0.0658362989323843,79.2434201979787,6.49536231130973,122.112811452623,6.58362989323843
2021-03-31,8356,23,6263,14,2093,9,7029,16,61152,164,68181,180,1,165,10,104,12,8087,1,213,177,"Anderson",76978,100.02857959417,0.0749185667752443,233.83304320715,29.8786666320247,135.103536075242,7.49185667752443
2021-04-01,8365,9,6267,4,2098,5,7033,4,61209,57,68242,61,0,165,-8,96,17,8104,0,213,177,"Anderson",76978,98.7295071319078,0.0774647887323944,79.2434201979787,11.6916521603575,124.710956377147,7.74647887323944
2021-04-02,8374,9,6274,7,2100,2,7040,7,61279,70,68319,77,0,165,-1,95,10,8114,0,213,177,"Anderson",76978,88.3369274338123,0.0704225352112676,100.02857959417,11.6916521603575,123.411883914885,7.04225352112676
2021-04-03,8380,6,6279,5,2101,1,7046,6,61329,50,68375,56,0,165,-8,87,14,8128,0,213,177,"Anderson",76978,90.9350723583361,0.0722021660649819,72.7480578866689,7.79443477357167,113.019304216789,7.22021660649819
2021-04-04,8382,2,6281,2,2101,0,7048,2,61367,38,68415,40,0,165,-5,82,7,8135,0,213,177,"Anderson",76978,89.6359998960742,0.0743362831858407,51.9628984904778,2.59814492452389,106.523941905479,7.43362831858407
2021-04-05,8396,14,6284,3,2112,11,7050,2,61425,58,68475,60,0,165,4,86,10,8145,2,215,177,"Anderson",76978,88.3369274338123,0.0747663551401869,77.9443477357167,18.1870144716672,111.720231754527,7.47663551401869
2021-04-06,8401,5,6288,4,2113,1,7056,6,61467,42,68523,48,0,165,3,89,2,8147,0,215,177,"Anderson",76978,88.3369274338123,0.0823754789272031,62.3554781885734,6.49536231130973,115.617449141313,8.23754789272031
2021-04-07,8421,20,6301,13,2120,7,7070,14,61626,159,68696,173,0,165,10,99,10,8157,2,217,177,"Anderson",76978,84.4397100470264,0.0796116504854369,224.739535971316,25.9814492452389,128.608173763933,7.96116504854369
2021-04-08,8424,3,6303,2,2121,1,7073,3,61717,91,68790,94,5,170,-17,82,15,8172,1,218,177,"Anderson",76978,76.6452752734548,0.072992700729927,122.112811452623,3.89721738678583,106.523941905479,7.2992700729927
2021-04-09,8432,8,6309,6,2123,2,7082,9,61804,87,68886,96,-4,166,8,90,4,8176,0,218,177,"Anderson",76978,75.3462028111928,0.0740740740740741,124.710956377147,10.3925796980956,116.916521603575,7.40740740740741
2021-04-10,8437,5,6314,5,2123,0,7087,5,61875,71,68962,76,0,166,-6,84,11,8187,0,218,177,"Anderson",76978,74.0471303489309,0.0698466780238501,98.7295071319078,6.49536231130973,109.122086830003,6.98466780238501
2021-04-11,8444,7,6319,5,2125,2,7092,5,61919,44,69011,49,-1,165,0,84,8,8195,0,218,177,"Anderson",76978,80.5424926602406,0.0738255033557047,63.6545506508353,9.09350723583361,109.122086830003,7.38255033557047
2021-04-12,8447,3,6322,3,2125,0,7095,3,61988,69,69083,72,0,165,-7,77,10,8205,0,218,177,"Anderson",76978,66.2526955753592,0.0740131578947368,93.53321728286,3.89721738678583,100.02857959417,7.40131578947368
2021-04-13,8457,10,6327,5,2130,5,7101,6,62049,61,69150,67,5,170,-7,70,12,8217,0,218,177,"Anderson",76978,72.7480578866689,0.0717703349282297,87.0378549715503,12.9907246226195,90.9350723583361,7.17703349282297
2021-04-14,8471,14,6336,9,2135,5,7112,11,62187,138,69299,149,0,170,7,77,7,8224,0,218,177,"Anderson",76978,64.9536231130973,0.0696517412935323,193.56179687703,18.1870144716672,100.02857959417,6.96517412935323
2021-04-15,8480,9,6341,5,2139,4,7117,5,62268,81,69385,86,0,170,6,83,3,8227,0,218,177,"Anderson",76978,72.7480578866689,0.0739495798319328,111.720231754527,11.6916521603575,107.823014367741,7.39495798319328
2021-04-16,8493,13,6352,11,2141,2,7130,13,62421,153,69551,166,0,170,6,89,7,8234,0,218,177,"Anderson",76978,79.2434201979786,0.0721804511278196,215.646028735483,16.8879420094053,115.617449141313,7.21804511278196
2021-04-17,8498,5,6355,3,2143,2,7134,4,62486,65,69620,69,0,170,0,89,5,8239,0,218,177,"Anderson",76978,79.2434201979786,0.0714285714285714,89.6359998960742,6.49536231130973,115.617449141313,7.14285714285714
2021-04-18,8505,7,6361,6,2144,1,7140,6,62531,45,69671,51,0,170,0,89,7,8246,0,218,177,"Anderson",76978,79.2434201979786,0.0727272727272727,66.2526955753592,9.09350723583361,115.617449141313,7.27272727272727
2021-04-19,8511,6,6364,3,2147,3,7143,3,62554,23,69697,26,0,170,-6,83,12,8258,0,218,178,"Anderson",76978,83.1406375847645,0.0781758957654723,33.7758840188106,7.79443477357167,107.823014367741,7.81758957654723
2021-04-20,8517,6,6367,3,2150,3,7146,3,62653,99,69799,102,0,170,-1,82,7,8265,0,218,178,"Anderson",76978,77.9443477357167,0.0693374422187981,132.505391150718,7.79443477357167,106.523941905479,6.93374422187981
2021-04-21,8529,12,6373,6,2156,6,7152,6,62808,155,69960,161,1,171,-2,80,13,8278,0,218,178,"Anderson",76978,75.3462028111928,0.0605143721633888,209.150666424173,15.5888695471433,103.925796980956,6.05143721633888
2021-04-22,8547,18,6379,6,2168,12,7159,7,62952,144,70111,151,0,171,12,92,6,8284,0,218,178,"Anderson",76978,87.0378549715503,0.0578512396694215,196.159941801554,23.383304320715,119.514666528099,5.78512396694215
2021-04-23,8557,10,6384,5,2173,5,7165,6,63118,166,70283,172,0,171,8,100,2,8286,0,218,178,"Anderson",76978,83.1406375847645,0.0478142076502732,223.440463509055,12.9907246226195,129.907246226195,4.78142076502732
2021-04-24,8569,12,6390,6,2179,6,7172,7,63185,67,70357,74,0,171,8,108,4,8290,1,219,178,"Anderson",76978,92.2341448205981,0.0515603799185889,96.1313622073839,15.5888695471433,140.29982592429,5.15603799185889
2021-04-25,8573,4,6392,2,2181,2,7174,2,63225,40,70399,42,0,171,0,108,4,8294,0,219,178,"Anderson",76978,88.3369274338123,0.0467032967032967,54.5610434150017,5.19628984904778,140.29982592429,4.67032967032967
2021-04-26,8582,9,6396,4,2186,5,7178,4,63300,75,70478,79,0,171,2,110,7,8301,0,219,179,"Anderson",76978,92.2341448205981,0.0448143405889885,102.626724518694,11.6916521603575,142.897970848814,4.48143405889885
2021-04-27,8592,10,6402,6,2190,4,7184,6,63368,68,70552,74,0,171,-3,107,13,8314,0,219,179,"Anderson",76978,97.4304346696459,0.050464807436919,96.1313622073839,12.9907246226195,139.000753462028,5.0464807436919
2021-04-28,8609,17,6414,12,2195,5,7197,13,63506,138,70703,151,0,171,1,108,16,8330,1,220,180,"Anderson",76978,103.925796980956,0.0605652759084791,196.159941801554,22.0842318584531,140.29982592429,6.05652759084791
2021-04-29,8615,6,6416,2,2199,4,7200,3,63655,149,70855,152,0,171,-1,107,7,8337,0,220,180,"Anderson",76978,88.3369274338123,0.0551075268817204,197.459014263816,7.79443477357167,139.000753462028,5.51075268817204
2021-04-30,8622,7,6419,3,2203,4,7204,4,63777,122,70981,126,0,171,-2,105,9,8346,0,220,180,"Anderson",76978,84.4397100470264,0.0558739255014327,163.683130245005,9.09350723583361,136.402608537504,5.58739255014327
2021-05-01,8627,5,6422,3,2205,2,7207,3,63840,63,71047,66,0,171,-1,104,6,8352,1,221,180,"Anderson",76978,75.3462028111928,0.0507246376811594,85.7387825092884,6.49536231130973,135.103536075242,5.07246376811594
2021-05-02,8630,3,6423,1,2207,2,7208,1,63891,51,71099,52,0,171,-7,97,10,8362,0,221,180,"Anderson",76978,74.0471303489309,0.0485714285714286,67.5517680376211,3.89721738678583,126.010028839409,4.85714285714286
2021-05-03,8640,10,6428,5,2212,5,7213,5,63997,106,71210,111,0,171,-3,94,13,8375,0,221,180,"Anderson",76978,75.3462028111928,0.0478142076502732,144.197043311076,12.9907246226195,122.112811452623,4.78142076502732
2021-05-04,8642,2,6428,0,2214,2,7214,1,64073,76,71287,77,0,171,-11,83,13,8388,0,221,180,"Anderson",76978,64.9536231130973,0.0408163265306122,100.02857959417,2.59814492452389,107.823014367741,4.08163265306122
2021-05-05,8650,8,6432,4,2218,4,7217,3,64190,117,71407,120,0,171,-3,80,11,8399,0,221,180,"Anderson",76978,53.2619709527397,0.0284090909090909,155.888695471433,10.3925796980956,103.925796980956,2.84090909090909
2021-05-06,8655,5,6435,3,2220,2,7223,6,64242,52,71465,58,0,171,-4,76,9,8408,1,222,180,"Anderson",76978,51.9628984904778,0.0377049180327869,75.3462028111928,6.49536231130973,98.7295071319078,3.77049180327869
2021-05-07,8660,5,6437,2,2223,3,7226,3,64363,121,71589,124,0,171,-4,72,9,8417,0,222,180,"Anderson",76978,49.3647535659539,0.0361842105263158,161.084985320481,6.49536231130973,93.53321728286,3.61842105263158
2021-05-08,8666,6,6440,3,2226,3,7228,2,64432,69,71660,71,0,171,-6,66,12,8429,1,223,181,"Anderson",76978,50.6638260282159,0.034257748776509,92.2341448205981,7.79443477357167,85.7387825092884,3.4257748776509
2021-05-09,8667,1,6440,0,2227,1,7229,1,64460,28,71689,29,0,171,-4,62,5,8434,0,223,181,"Anderson",76978,48.065681103692,0.0355932203389831,37.6731014055964,1.29907246226194,80.5424926602406,3.55932203389831
2021-05-10,8672,5,6440,0,2232,5,7229,0,64548,88,71777,88,0,171,-5,57,10,8444,0,223,181,"Anderson",76978,41.5703187923822,0.0282186948853616,114.318376679051,6.49536231130973,74.0471303489309,2.82186948853616
2021-05-11,8680,8,6441,1,2239,7,7231,2,64590,42,71821,44,0,171,3,60,5,8449,0,223,182,"Anderson",76978,49.3647535659539,0.0318352059925094,57.1591883395256,10.3925796980956,77.9443477357167,3.18352059925094
2021-05-12,8693,13,6448,7,2245,6,7237,6,64694,104,71931,110,0,171,8,68,5,8454,2,225,182,"Anderson",76978,55.8601158772636,0.0381679389312977,142.897970848814,16.8879420094053,88.3369274338123,3.81679389312977
2021-05-13,8697,4,6450,2,2247,2,7239,2,64797,103,72036,105,0,171,-3,65,7,8461,2,227,182,"Anderson",76978,54.5610434150017,0.0280210157618214,136.402608537504,5.19628984904778,84.4397100470264,2.80210157618214
2021-05-14,8705,8,6453,3,2252,5,7244,5,64884,87,72128,92,0,171,2,67,6,8467,0,227,182,"Anderson",76978,58.4582608017875,0.0333951762523191,119.514666528099,10.3925796980956,87.0378549715503,3.33951762523191
2021-05-15,8710,5,6455,2,2255,3,7246,2,64949,65,72195,67,0,171,1,68,4,8471,0,227,182,"Anderson",76978,57.1591883395256,0.0336448598130841,87.0378549715503,6.49536231130973,88.3369274338123,3.36448598130841
2021-05-16,8712,2,6456,1,2256,1,7247,1,64985,36,72232,37,0,171,-5,63,7,8478,0,227,182,"Anderson",76978,58.4582608017875,0.0331491712707182,48.065681103692,2.59814492452389,81.8415651225025,3.31491712707182
2021-05-17,8718,6,6461,5,2257,1,7252,5,65044,59,72296,64,1,172,0,63,5,8483,0,227,182,"Anderson",76978,59.7573332640495,0.0443159922928709,83.1406375847645,7.79443477357167,81.8415651225025,4.43159922928709
2021-05-18,8722,4,6461,0,2261,4,7252,0,65135,91,72387,91,0,172,0,63,4,8487,1,228,182,"Anderson",76978,54.5610434150017,0.0371024734982332,118.215594065837,5.19628984904778,81.8415651225025,3.71024734982332
2021-05-19,8729,7,6466,5,2263,2,7258,6,65254,119,72512,125,0,172,5,68,2,8489,0,228,182,"Anderson",76978,46.76660864143,0.036144578313253,162.384057782743,9.09350723583361,88.3369274338123,3.6144578313253
2021-05-20,8731,2,6468,2,2263,0,7260,2,65373,119,72633,121,0,172,-1,67,3,8492,0,228,182,"Anderson",76978,44.1684637169061,0.0351758793969849,157.187767933695,2.59814492452389,87.0378549715503,3.51758793969849
2021-05-21,8733,2,6468,0,2265,2,7260,0,65443,70,72703,70,0,172,-7,60,9,8501,0,228,182,"Anderson",76978,36.3740289433345,0.0278260869565217,90.9350723583361,2.59814492452389,77.9443477357167,2.78260869565217
2021-05-22,8738,5,6470,2,2268,3,7262,2,65483,40,72745,42,0,172,-3,57,8,8509,0,228,182,"Anderson",76978,36.3740289433345,0.0290909090909091,54.5610434150017,6.49536231130973,74.0471303489309,2.90909090909091
2021-05-23,8738,0,6470,0,2268,0,7262,0,65512,29,72774,29,0,172,-3,54,3,8512,0,228,182,"Anderson",76978,33.7758840188106,0.0276752767527675,37.6731014055964,0,70.149912962145,2.76752767527675
2021-05-24,8746,8,6474,4,2272,4,7265,3,65571,59,72836,62,0,172,1,55,7,8519,0,228,182,"Anderson",76978,36.3740289433345,0.0240740740740741,80.5424926602406,10.3925796980956,71.448985424407,2.40740740740741
2021-05-25,8748,2,6474,0,2274,2,7266,1,65616,45,72882,46,0,172,-10,45,12,8531,0,228,182,"Anderson",76978,33.7758840188106,0.0282828282828283,59.7573332640495,2.59814492452389,58.4582608017875,2.82828282828283
2021-05-26,8755,7,6479,5,2276,2,7272,6,65716,100,72988,106,0,172,0,45,7,8538,0,228,182,"Anderson",76978,33.7758840188106,0.0294117647058824,137.701680999766,9.09350723583361,58.4582608017875,2.94117647058824
2021-05-27,8757,2,6480,1,2277,1,7273,1,65766,50,73039,51,0,172,-1,44,3,8541,1,229,182,"Anderson",76978,33.7758840188106,0.0320197044334975,66.2526955753592,2.59814492452389,57.1591883395256,3.20197044334975
2021-05-28,8762,5,6484,4,2278,1,7278,5,65849,83,73127,88,0,172,0,44,5,8546,0,229,182,"Anderson",76978,37.6731014055964,0.0424528301886792,114.318376679051,6.49536231130973,57.1591883395256,4.24528301886792
2021-05-29,8763,1,6484,0,2279,1,7278,0,65886,37,73164,37,0,172,-5,39,6,8552,0,229,182,"Anderson",76978,32.4768115565486,0.0381861575178998,48.065681103692,1.29907246226194,50.6638260282159,3.81861575178998
2021-05-30,8766,3,6485,1,2281,2,7279,1,65936,50,73215,51,0,172,0,39,3,8555,0,229,182,"Anderson",76978,36.3740289433345,0.0385487528344671,66.2526955753592,3.89721738678583,50.6638260282159,3.85487528344671
2021-05-31,8770,4,6488,3,2282,1,7282,3,65987,51,73269,54,0,172,1,40,3,8558,0,229,182,"Anderson",76978,31.1777390942867,0.0392609699769053,70.149912962145,5.19628984904778,51.9628984904778,3.92609699769053
2021-06-01,8773,3,6490,2,2283,1,7283,1,66035,48,73318,49,0,172,1,41,2,8560,1,230,182,"Anderson",76978,32.4768115565486,0.0389908256880734,63.6545506508353,3.89721738678583,53.2619709527397,3.89908256880734
2021-06-02,8777,4,6491,1,2286,3,7285,2,66076,41,73361,43,0,172,-2,39,6,8566,0,230,182,"Anderson",76978,28.5795941697628,0.0348525469168901,55.8601158772636,5.19628984904778,50.6638260282159,3.48525469168901
2021-06-03,8778,1,6491,0,2287,1,7288,3,66166,90,73454,93,1,173,-3,36,3,8569,0,230,183,"Anderson",76978,27.2805217075008,0.036144578313253,120.813738990361,1.29907246226194,46.76660864143,3.6144578313253
2021-06-04,8779,1,6492,1,2287,0,7290,2,66219,53,73509,55,-1,172,-2,34,4,8573,0,230,183,"Anderson",76978,22.0842318584531,0.031413612565445,71.448985424407,1.29907246226194,44.1684637169061,3.1413612565445
2021-06-05,8780,1,6493,1,2287,0,7291,1,66276,57,73567,58,0,172,-3,31,4,8577,0,230,183,"Anderson",76978,22.0842318584531,0.032258064516129,75.3462028111928,1.29907246226194,40.2712463301203,3.2258064516129
2021-06-06,8780,0,6493,0,2287,0,7291,0,66301,25,73592,25,0,172,-4,27,4,8581,0,230,183,"Anderson",76978,18.1870144716672,0.0318302387267905,32.4768115565486,0,35.0749564810725,3.18302387267904
2021-06-07,8781,1,6493,0,2288,1,7291,0,66365,64,73656,64,0,172,-1,26,2,8583,0,230,183,"Anderson",76978,14.2897970848814,0.0232558139534884,83.1406375847645,1.29907246226194,33.7758840188106,2.32558139534884
2021-06-08,8782,1,6493,0,2289,1,7291,0,66402,37,73693,37,0,172,-1,25,2,8585,1,231,184,"Anderson",76978,11.6916521603575,0.0213333333333333,48.065681103692,1.29907246226194,32.4768115565486,2.13333333333333
2021-06-09,8782,0,6493,0,2289,0,7291,0,66484,82,73775,82,0,172,-4,21,4,8589,0,231,184,"Anderson",76978,6.49536231130972,0.0144927536231884,106.523941905479,0,27.2805217075008,1.44927536231884
2021-06-10,8786,4,6494,1,2292,3,7292,1,66541,57,73833,58,0,172,4,25,0,8589,0,231,184,"Anderson",76978,10.3925796980956,0.0105540897097625,75.3462028111928,5.19628984904778,32.4768115565486,1.05540897097625
2021-06-11,8787,1,6494,0,2293,1,7293,1,66596,55,73889,56,1,173,-3,22,3,8592,0,231,184,"Anderson",76978,10.3925796980956,0.00789473684210526,72.7480578866689,1.29907246226194,28.5795941697628,0.789473684210526
2021-06-12,8788,1,6494,0,2294,1,7294,1,66651,55,73945,56,2,175,-4,18,3,8595,0,231,184,"Anderson",76978,10.3925796980956,0.00793650793650794,72.7480578866689,1.29907246226194,23.383304320715,0.793650793650794
2021-06-13,8789,1,6494,0,2295,1,7295,1,66689,38,73984,39,0,175,-3,15,4,8599,0,231,184,"Anderson",76978,11.6916521603575,0.0102040816326531,50.6638260282159,1.29907246226194,19.4860869339292,1.02040816326531
2021-06-14,8791,2,6496,2,2295,0,7297,2,66775,86,74072,88,0,175,1,16,1,8600,0,231,184,"Anderson",76978,12.9907246226194,0.0144230769230769,114.318376679051,2.59814492452389,20.7851593961911,1.44230769230769
2021-06-15,8791,0,6496,0,2295,0,7298,1,66806,31,74104,32,0,175,-2,14,2,8602,0,231,184,"Anderson",76978,11.6916521603575,0.0170316301703163,41.5703187923822,0,18.1870144716672,1.70316301703163
2021-06-16,8792,1,6497,1,2295,0,7299,1,66850,44,74149,45,0,175,0,14,1,8603,0,231,184,"Anderson",76978,12.9907246226194,0.0213903743315508,58.4582608017875,1.29907246226194,18.1870144716672,2.13903743315508
2021-06-17,8792,0,6497,0,2295,0,7299,0,66936,86,74235,86,0,175,-1,13,1,8604,0,231,184,"Anderson",76978,7.79443477357167,0.0174129353233831,111.720231754527,0,16.8879420094053,1.74129353233831
2021-06-18,8794,2,6498,1,2296,1,7303,4,66986,50,74289,54,0,175,1,14,1,8605,0,231,184,"Anderson",76978,9.09350723583361,0.025,70.149912962145,2.59814492452389,18.1870144716672,2.5
2021-06-19,8794,0,6498,0,2296,0,7303,0,67034,48,74337,48,0,175,-1,13,1,8606,0,231,184,"Anderson",76978,7.79443477357167,0.0229591836734694,62.3554781885734,0,16.8879420094053,2.29591836734694
2021-06-20,8794,0,6498,0,2296,0,7304,1,67057,23,74361,24,0,175,-2,11,2,8608,0,231,184,"Anderson",76978,6.49536231130972,0.0238726790450928,31.1777390942867,0,14.2897970848814,2.38726790450928
2021-06-21,8795,1,6498,0,2297,1,7304,0,67097,40,74401,40,0,175,0,11,1,8609,0,231,184,"Anderson",76978,5.19628984904778,0.0212765957446809,51.9628984904778,1.29907246226194,14.2897970848814,2.12765957446809
2021-06-22,8799,4,6499,1,2300,3,7304,0,67139,42,74443,42,0,175,2,13,2,8611,1,232,184,"Anderson",76978,10.3925796980956,0.0176991150442478,54.5610434150017,5.19628984904778,16.8879420094053,1.76991150442478
2021-06-23,8800,1,6500,1,2300,0,7305,1,67187,48,74492,49,0,175,1,14,0,8611,0,232,184,"Anderson",76978,10.3925796980956,0.0174927113702624,63.6545506508353,1.29907246226194,18.1870144716672,1.74927113702624
2021-06-24,8800,0,6500,0,2300,0,7306,1,67232,45,74538,46,0,175,-3,11,3,8614,0,232,184,"Anderson",76978,10.3925796980956,0.0231023102310231,59.7573332640495,0,14.2897970848814,2.31023102310231
2021-06-25,8801,1,6501,1,2300,0,7307,1,67268,36,74575,37,0,175,1,12,0,8614,0,232,184,"Anderson",76978,9.09350723583361,0.013986013986014,48.065681103692,1.29907246226194,15.5888695471433,1.3986013986014
2021-06-26,8802,1,6502,1,2300,0,7308,1,67301,33,74609,34,0,175,0,12,1,8615,0,232,184,"Anderson",76978,10.3925796980956,0.0183823529411765,44.1684637169061,1.29907246226194,15.5888695471433,1.83823529411765
2021-06-27,8802,0,6502,0,2300,0,7308,0,67333,32,74641,32,0,175,0,12,0,8615,0,232,184,"Anderson",76978,10.3925796980956,0.0142857142857143,41.5703187923822,0,15.5888695471433,1.42857142857143
2021-06-28,8803,1,6502,0,2301,1,7309,1,67349,16,74658,17,0,175,1,13,0,8615,0,232,184,"Anderson",76978,10.3925796980956,0.0194552529182879,22.0842318584531,1.29907246226194,16.8879420094053,1.94552529182879
2021-06-29,8806,3,6505,3,2301,0,7312,3,67408,59,74720,62,0,175,2,15,1,8616,0,232,184,"Anderson",76978,9.09350723583361,0.0288808664259928,80.5424926602406,3.89721738678583,19.4860869339292,2.88808664259928
2021-06-30,8806,0,6505,0,2301,0,7312,0,67454,46,74766,46,0,175,-1,14,1,8617,0,232,184,"Anderson",76978,7.79443477357167,0.0255474452554745,59.7573332640495,0,18.1870144716672,2.55474452554745
2021-07-01,8807,1,6506,1,2301,0,7313,1,67491,37,74804,38,0,175,1,15,0,8617,0,232,184,"Anderson",76978,9.09350723583361,0.0263157894736842,49.3647535659539,1.29907246226194,19.4860869339292,2.63157894736842
2021-07-02,8807,0,6506,0,2301,0,7313,0,67534,43,74847,43,0,175,0,15,0,8617,0,232,184,"Anderson",76978,7.79443477357167,0.0220588235294118,55.8601158772636,0,19.4860869339292,2.20588235294118
2021-07-03,8807,0,6506,0,2301,0,7313,0,67555,21,74868,21,0,175,-1,14,1,8618,0,232,184,"Anderson",76978,6.49536231130972,0.0193050193050193,27.2805217075008,0,18.1870144716672,1.93050193050193
2021-07-04,8808,1,6506,0,2302,1,7314,1,67580,25,74894,26,0,175,0,14,1,8619,0,232,184,"Anderson",76978,7.79443477357167,0.0237154150197628,33.7758840188106,1.29907246226194,18.1870144716672,2.37154150197628
2021-07-05,8808,0,6506,0,2302,0,7315,1,67595,15,74910,16,0,175,-1,13,1,8620,0,232,184,"Anderson",76978,6.49536231130972,0.0238095238095238,20.7851593961911,0,16.8879420094053,2.38095238095238
2021-07-06,8809,1,6506,0,2303,1,7315,0,67625,30,74940,30,1,176,-3,10,3,8623,0,232,184,"Anderson",76978,3.89721738678583,0.0136363636363636,38.9721738678584,1.29907246226194,12.9907246226195,1.36363636363636
2021-07-07,8810,1,6506,0,2304,1,7315,0,67671,46,74986,46,0,176,-2,8,3,8626,0,232,184,"Anderson",76978,5.19628984904778,0.0136363636363636,59.7573332640495,1.29907246226194,10.3925796980956,1.36363636363636
2021-07-08,8811,1,6507,1,2304,0,7316,1,67712,41,75028,42,0,176,-1,7,2,8628,0,232,184,"Anderson",76978,5.19628984904778,0.0133928571428571,54.5610434150017,1.29907246226194,9.09350723583361,1.33928571428571
2021-07-09,8813,2,6508,1,2305,1,7317,1,67756,44,75073,45,0,176,1,8,1,8629,0,232,184,"Anderson",76978,7.79443477357167,0.0176991150442478,58.4582608017875,2.59814492452389,10.3925796980956,1.76991150442478
2021-07-10,8815,2,6509,1,2306,1,7318,1,67778,22,75096,23,0,176,2,10,0,8629,1,233,184,"Anderson",76978,10.3925796980956,0.0219298245614035,29.8786666320247,2.59814492452389,12.9907246226195,2.19298245614035
2021-07-11,8815,0,6509,0,2306,0,7318,0,67793,15,75111,15,0,176,0,10,0,8629,0,233,184,"Anderson",76978,9.09350723583361,0.0184331797235023,19.4860869339292,0,12.9907246226195,1.84331797235023
2021-07-12,8823,8,6513,4,2310,4,7322,4,67829,36,75151,40,0,176,7,17,1,8630,1,234,184,"Anderson",76978,19.4860869339292,0.029045643153527,51.9628984904778,10.3925796980956,22.0842318584531,2.9045643153527
2021-07-13,8824,1,6513,0,2311,1,7322,0,67850,21,75172,21,0,176,0,17,1,8631,0,234,186,"Anderson",76978,19.4860869339292,0.0301724137931034,27.2805217075008,1.29907246226194,22.0842318584531,3.01724137931034
2021-07-14,8829,5,6518,5,2311,0,7327,5,67904,54,75231,59,0,176,5,22,0,8631,1,235,186,"Anderson",76978,24.682376782977,0.0489795918367347,76.6452752734548,6.49536231130973,28.5795941697628,4.89795918367347
2021-07-15,8832,3,6521,3,2311,0,7329,2,67937,33,75266,35,0,176,3,25,0,8631,0,235,186,"Anderson",76978,27.2805217075008,0.0546218487394958,45.4675361791681,3.89721738678583,32.4768115565486,5.46218487394958
2021-07-16,8842,10,6523,2,2319,8,7330,1,67965,28,75295,29,0,176,10,35,0,8631,0,235,186,"Anderson",76978,37.6731014055964,0.0585585585585586,37.6731014055964,12.9907246226195,45.4675361791681,5.85585585585586
2021-07-17,8847,5,6524,1,2323,4,7331,1,68001,36,75332,37,0,176,4,39,1,8632,0,235,186,"Anderson",76978,41.5703187923822,0.0550847457627119,48.065681103692,6.49536231130973,50.6638260282159,5.50847457627119
2021-07-18,8850,3,6526,2,2324,1,7333,2,68021,20,75354,22,0,176,-1,38,4,8636,0,235,186,"Anderson",76978,45.4675361791681,0.0617283950617284,28.5795941697628,3.89721738678583,49.3647535659539,6.17283950617284
2021-07-19,8855,5,6530,4,2325,1,7337,4,68055,34,75392,38,1,177,2,40,2,8638,0,235,186,"Anderson",76978,41.5703187923822,0.0622406639004149,49.3647535659539,6.49536231130973,51.9628984904778,6.22406639004149
2021-07-20,8870,15,6541,11,2329,4,7348,11,68090,35,75438,46,0,177,10,50,5,8643,1,236,186,"Anderson",76978,59.7573332640495,0.0977443609022556,59.7573332640495,19.4860869339292,64.9536231130973,9.77443609022556
2021-07-21,8877,7,6545,4,2332,3,7353,5,68175,85,75528,90,0,177,5,55,2,8645,0,236,187,"Anderson",76978,62.3554781885734,0.0875420875420875,116.916521603575,9.09350723583361,71.448985424407,8.75420875420875
2021-07-22,8887,10,6550,5,2337,5,7357,4,68231,56,75588,60,0,177,9,64,1,8646,0,236,187,"Anderson",76978,71.448985424407,0.0869565217391304,77.9443477357167,12.9907246226195,83.1406375847645,8.69565217391304
2021-07-23,8897,10,6554,4,2343,6,7362,5,68302,71,75664,76,0,177,10,74,0,8646,0,236,187,"Anderson",76978,71.448985424407,0.0867208672086721,98.7295071319078,12.9907246226195,96.1313622073839,8.67208672086721
2021-07-24,8905,8,6558,4,2347,4,7366,4,68356,54,75722,58,0,177,7,81,1,8647,0,236,188,"Anderson",76978,75.3462028111928,0.0897435897435897,75.3462028111928,10.3925796980956,105.224869443218,8.97435897435897
2021-07-25,8910,5,6561,3,2349,2,7367,1,68378,22,75745,23,0,177,2,83,3,8650,0,236,188,"Anderson",76978,77.9443477357167,0.0869565217391304,29.8786666320247,6.49536231130973,107.823014367741,8.69565217391304
2021-07-26,8933,23,6570,9,2363,14,7375,8,68428,50,75803,58,2,179,13,96,8,8658,0,236,188,"Anderson",76978,101.327652056432,0.0924574209245742,75.3462028111928,29.8786666320247,124.710956377147,9.24574209245742
2021-07-27,8948,15,6575,5,2373,10,7380,5,68481,53,75861,58,0,179,12,108,3,8661,0,236,188,"Anderson",76978,101.327652056432,0.0756501182033097,75.3462028111928,19.4860869339292,140.29982592429,7.56501182033097
2021-07-28,8968,20,6583,8,2385,12,7392,12,68564,83,75956,95,0,179,14,122,6,8667,0,236,188,"Anderson",76978,118.215594065837,0.0911214953271028,123.411883914885,25.9814492452389,158.486840395957,9.11214953271028
2021-07-29,8980,12,6593,10,2387,2,7404,12,68613,49,76017,61,0,179,8,130,4,8671,0,236,188,"Anderson",76978,120.813738990361,0.10955710955711,79.2434201979787,15.5888695471433,168.879420094053,10.955710955711
2021-07-30,9011,31,6614,21,2397,10,7427,23,68662,49,76089,72,0,179,19,149,12,8683,1,237,188,"Anderson",76978,148.094260697862,0.152941176470588,93.53321728286,40.2712463301203,193.56179687703,15.2941176470588
2021-07-31,9024,13,6620,6,2404,7,7433,6,68704,42,76137,48,0,179,8,157,5,8688,0,237,188,"Anderson",76978,154.589623009171,0.16144578313253,62.3554781885734,16.8879420094053,203.954376575125,16.144578313253
2021-08-01,9043,19,6631,11,2412,8,7448,15,68743,39,76191,54,0,179,14,171,5,8693,0,237,188,"Anderson",76978,172.776637480839,0.181614349775785,70.149912962145,24.682376782977,222.141391046793,18.1614349775785
2021-08-02,9054,11,6636,5,2418,6,7453,5,68822,79,76275,84,0,179,3,174,8,8701,0,237,188,"Anderson",76978,157.187767933695,0.165254237288136,109.122086830003,14.2897970848814,226.038608433578,16.5254237288136
2021-08-03,9077,23,6647,11,2430,12,7466,13,68894,72,76360,85,0,179,14,188,9,8710,1,238,188,"Anderson",76978,167.580347631791,0.172344689378758,110.421159292265,29.8786666320247,244.225622905246,17.2344689378758
2021-08-04,9103,26,6669,22,2434,4,7487,21,68996,102,76483,123,0,179,24,212,2,8712,0,238,188,"Anderson",76978,175.374782405363,0.180265654648956,159.785912858219,33.7758840188106,275.403361999532,18.0265654648956
2021-08-05,9133,30,6685,16,2448,14,7503,16,69094,98,76597,114,0,179,13,225,17,8729,1,239,188,"Anderson",76978,198.758086726078,0.170689655172414,148.094260697862,38.9721738678584,292.291304008938,17.0689655172414
2021-08-06,9158,25,6701,16,2457,9,7521,18,69237,143,76758,161,0,179,17,242,8,8737,1,240,188,"Anderson",76978,190.963651952506,0.14050822122571,209.150666424173,32.4768115565486,314.375535867391,14.050822122571
2021-08-07,9171,13,6707,6,2464,7,7528,7,69312,75,76840,82,0,179,5,247,8,8745,0,240,188,"Anderson",76978,190.963651952506,0.135135135135135,106.523941905479,16.8879420094053,320.8708981787,13.5135135135135
2021-08-08,9185,14,6715,8,2470,6,7538,10,69364,52,76902,62,0,179,6,253,8,8753,0,240,188,"Anderson",76978,184.468289641196,0.126582278481013,80.5424926602406,18.1870144716672,328.665332952272,12.6582278481013
2021-08-09,9221,36,6734,19,2487,17,7557,19,69463,99,77020,118,0,179,16,269,20,8773,0,240,188,"Anderson",76978,216.945101197745,0.139597315436242,153.29055054691,46.76660864143,349.450492348463,13.9597315436242
2021-08-10,9260,39,6754,20,2506,19,7577,20,69563,100,77140,120,0,179,20,289,19,8792,2,242,188,"Anderson",76978,237.730260593936,0.142307692307692,155.888695471433,50.6638260282159,375.431941593702,14.2307692307692
2021-08-11,9314,54,6778,24,2536,30,7606,29,69695,132,77301,161,0,179,30,319,24,8816,1,243,188,"Anderson",76978,274.10428953727,0.145476772616137,209.150666424173,70.149912962145,414.40411546156,14.5476772616137
2021-08-12,9362,48,6814,36,2548,12,7643,37,69863,168,77506,205,0,179,27,346,21,8837,0,243,190,"Anderson",76978,297.487593857985,0.154015401540154,266.309854763699,62.3554781885734,449.479071942633,15.4015401540154
2021-08-13,9425,63,6849,35,2576,28,7681,38,69977,114,77658,152,2,181,45,391,16,8853,1,244,191,"Anderson",76978,346.852347423939,0.177777777777778,197.459014263816,81.8415651225025,507.93733274442,17.7777777777778
2021-08-14,9475,50,6884,35,2591,15,7713,32,70163,186,77876,218,0,181,29,420,21,8874,0,244,191,"Anderson",76978,394.918028527631,0.178571428571429,283.197796773104,64.9536231130973,545.610434150017,17.8571428571429
2021-08-15,9498,23,6897,13,2601,10,7728,15,70252,89,77980,104,0,181,16,436,7,8881,0,244,191,"Anderson",76978,406.609680687989,0.176252319109462,135.103536075242,29.8786666320247,566.395593546208,17.6252319109462
2021-08-16,9536,38,6921,24,2615,14,7752,24,70341,89,78093,113,0,181,11,447,27,8908,0,244,192,"Anderson",76978,409.207825612513,0.181733457595527,146.7951882356,49.3647535659539,580.685390631089,18.1733457595527
2021-08-17,9579,43,6942,21,2637,22,7776,24,70449,108,78225,132,1,182,14,461,28,8936,0,244,192,"Anderson",76978,414.40411546156,0.183410138248848,171.477565018577,55.8601158772636,598.872405102757,18.3410138248848
2021-08-18,9631,52,6969,27,2662,25,7807,31,70561,112,78368,143,0,182,15,476,37,8973,0,244,193,"Anderson",76978,411.805970537037,0.188378631677601,185.767362103458,67.5517680376211,618.358492036686,18.8378631677601
2021-08-19,9705,74,7002,33,2703,41,7842,35,70713,152,78555,187,0,182,48,524,26,8999,0,244,193,"Anderson",76978,445.581854555847,0.189704480457579,242.926550442984,96.1313622073839,680.713970225259,18.9704480457579
2021-08-20,9765,60,7044,42,2721,18,7886,44,70907,194,78793,238,0,182,26,550,34,9033,2,246,193,"Anderson",76978,441.684637169061,0.180616740088106,309.179246018343,77.9443477357167,714.48985424407,18.0616740088106
2021-08-21,9846,81,7077,33,2769,48,7920,34,71181,274,79101,308,0,182,60,610,21,9054,1,247,193,"Anderson",76978,481.955883499182,0.168979591836735,400.114318376679,105.224869443218,792.434201979786,16.8979591836735
2021-08-22,9869,23,7099,22,2770,1,7948,28,71337,156,79285,184,0,182,-2,608,25,9079,0,247,193,"Anderson",76978,481.955883499182,0.168582375478927,239.029333056198,29.8786666320247,789.836057055263,16.8582375478927
2021-08-23,9917,48,7113,14,2804,34,7965,17,71472,135,79437,152,0,182,-4,604,52,9131,2,249,194,"Anderson",76978,494.946608121801,0.158482142857143,197.459014263816,62.3554781885734,784.639767206215,15.8482142857143
2021-08-24,9961,44,7140,27,2821,17,7989,24,71558,86,79547,110,1,183,-23,581,66,9197,0,249,195,"Anderson",76978,496.245680584063,0.161119515885023,142.897970848814,57.1591883395256,754.76110057419,16.1119515885023
2021-08-25,10032,71,7166,26,2866,45,8011,22,71602,44,79613,66,0,183,15,596,56,9253,1,250,195,"Anderson",76978,520.92805736704,0.163855421686747,85.7387825092884,92.2341448205981,774.247187508119,16.3855421686747
2021-08-26,10100,68,7202,36,2898,32,8055,44,71774,172,79829,216,1,184,15,611,52,9305,2,252,196,"Anderson",76978,513.133622593468,0.167189952904239,280.59965184858,88.3369274338123,793.733274442048,16.7189952904239
2021-08-27,10175,75,7257,55,2918,20,8116,61,71951,177,80067,238,0,184,29,640,46,9351,0,252,196,"Anderson",76978,532.619709527397,0.180533751962323,309.179246018343,97.4304346696459,831.406375847645,18.0533751962323
2021-08-28,10234,59,7289,32,2945,27,8156,40,72155,204,80311,244,0,184,31,671,28,9379,0,252,196,"Anderson",76978,504.040115357635,0.19504132231405,316.973680791915,76.6452752734548,871.677622177765,19.504132231405
2021-08-29,10298,64,7338,49,2960,15,8210,54,72366,211,80576,265,0,184,40,711,24,9403,1,253,197,"Anderson",76978,557.302086310374,0.20294345468629,344.254202499415,83.1406375847645,923.640520668243,20.294345468629
2021-08-30,10369,71,7384,46,2985,25,8258,48,72592,226,80850,274,0,184,3,714,68,9471,3,256,197,"Anderson",76978,587.180752942399,0.207360226468507,355.945854659773,92.2341448205981,927.537738055029,20.7360226468507
2021-08-31,10503,134,7466,82,3037,52,8345,87,72849,257,81194,344,0,184,48,762,86,9557,0,256,198,"Anderson",76978,704.097274545974,0.216150576806314,446.880927018109,174.075709943101,989.893216243602,21.6150576806314
2021-09-01,10534,31,7488,22,3046,9,8369,24,72940,91,81309,115,0,184,-17,745,48,9605,0,256,199,"Anderson",76978,652.134376055496,0.211084905660377,149.393333160124,40.2712463301203,967.808984385149,21.1084905660377
2021-09-02,10593,59,7514,26,3079,33,8398,29,73041,101,81439,130,1,185,-9,736,67,9672,0,256,199,"Anderson",76978,640.442723895139,0.21304347826087,168.879420094053,76.6452752734548,956.117332224792,21.304347826087
2021-09-03,10622,29,7532,18,3090,11,8416,18,73114,73,81530,91,0,185,-38,698,67,9739,0,256,199,"Anderson",76978,580.685390631089,0.205058099794942,118.215594065837,37.6731014055964,906.752578658838,20.5058099794942
2021-09-04,10729,107,7602,70,3127,37,8492,76,73435,321,81927,397,0,185,77,775,30,9769,1,257,199,"Anderson",76978,643.040868819663,0.207920792079208,515.731767517992,139.000753462028,1006.78115825301,20.7920792079208
2021-09-05,10841,112,7676,74,3165,38,8568,76,73739,304,82307,380,0,185,76,851,36,9805,1,258,200,"Anderson",76978,705.396347008236,0.20681686886193,493.647535659539,145.496115773338,1105.51066538492,20.681686886193
2021-09-06,10956,115,7753,77,3203,38,8655,87,74146,407,82801,494,0,185,-4,847,119,9924,3,261,201,"Anderson",76978,762.555535347762,0.203485392106612,641.741796357401,149.393333160124,1100.31437553587,20.3485392106612
2021-09-07,10993,37,7773,20,3220,17,8673,18,74245,99,82918,117,0,185,-73,774,110,10034,0,261,201,"Anderson",76978,636.545506508353,0.190255220417633,151.991478084648,48.065681103692,1005.48208579075,19.0255220417633
2021-09-08,11034,41,7804,31,3230,10,8705,32,74352,107,83057,139,0,185,-57,717,98,10132,2,263,204,"Anderson",76978,649.536231130973,0.192219679633867,180.57107225441,53.2619709527397,931.434955441815,19.2219679633867
2021-09-09,11092,58,7825,21,3267,37,8723,18,74558,206,83281,224,0,185,-42,675,100,10232,1,264,207,"Anderson",76978,648.237158668711,0.176438653637351,290.992231546676,75.3462028111928,876.873912026813,17.6438653637351
2021-09-10,11244,152,7898,73,3346,79,8804,81,74851,293,83655,374,1,186,65,740,86,10318,2,266,208,"Anderson",76978,808.02307152693,0.182588235294118,485.853100885967,197.459014263816,961.313622073839,18.2588235294118
2021-09-11,11359,115,7960,62,3399,53,8873,69,75197,346,84070,415,0,186,82,822,33,10351,1,267,208,"Anderson",76978,818.415651225025,0.177788147456836,539.115071838707,149.393333160124,1067.83756397932,17.7788147456836
2021-09-12,11397,38,7992,32,3405,6,8908,35,75340,143,84248,178,0,186,5,827,33,10384,4,271,209,"Anderson",76978,722.284289017641,0.175167439464194,231.234898282626,49.3647535659539,1074.33292629063,17.5167439464194
2021-09-13,11485,88,8026,34,3459,54,8942,34,75470,130,84412,164,4,190,-48,779,132,10516,3,274,209,"Anderson",76978,687.209332536569,0.178150217256363,213.047883810959,114.318376679051,1011.97744810206,17.8150217256363
2021-09-14,11545,60,8056,30,3489,30,8977,35,75629,159,84606,194,1,191,-47,732,106,10622,1,275,209,"Anderson",76978,717.087999168594,0.180094786729858,252.020057678817,77.9443477357167,950.921042375744,18.0094786729858
2021-09-15,11585,40,8072,16,3513,24,8991,14,75690,61,84681,75,0,191,-42,690,82,10704,1,276,210,"Anderson",76978,715.788926706332,0.176108374384236,97.4304346696459,51.9628984904778,896.359998960742,17.6108374384236
2021-09-16,11671,86,8126,54,3545,32,9047,56,75912,222,84959,278,0,191,26,716,60,10764,1,277,210,"Anderson",76978,752.162955649666,0.193087008343266,361.142144508821,111.720231754527,930.135882979553,19.3087008343266
2021-09-17,11744,73,8168,42,3576,31,9084,37,76075,163,85159,200,0,191,15,731,58,10822,1,278,214,"Anderson",76978,649.536231130973,0.186170212765957,259.814492452389,94.832289745122,949.621969913482,18.6170212765957
2021-09-18,11796,52,8198,30,3598,22,9117,33,76229,154,85346,187,0,191,7,738,45,10867,1,279,215,"Anderson",76978,567.69466600847,0.191222570532915,242.926550442984,67.5517680376211,958.715477149315,19.1222570532915
2021-09-19,11819,23,8207,9,3612,14,9127,10,76297,68,85424,78,0,191,-18,720,41,10908,0,279,215,"Anderson",76978,548.208579074541,0.186224489795918,101.327652056432,29.8786666320247,935.3321728286,18.6224489795918
2021-09-20,11882,63,8242,35,3640,28,9163,36,76483,186,85646,222,0,191,25,745,38,10946,3,282,215,"Anderson",76978,515.731767517992,0.179092382495948,288.394086622152,81.8415651225025,967.808984385149,17.9092382495948
2021-09-21,11936,54,8268,26,3668,28,9187,24,76601,118,85788,142,0,191,-55,690,109,11055,1,283,216,"Anderson",76978,507.93733274442,0.177664974619289,184.468289641196,70.149912962145,896.359998960742,17.7664974619289
2021-09-22,11987,51,8302,34,3685,17,9227,40,76873,272,86100,312,0,191,-39,651,90,11145,0,283,218,"Anderson",76978,522.227129829302,0.16631430584919,405.310608225727,66.2526955753592,845.696172932526,16.631430584919
2021-09-23,12062,75,8350,48,3712,27,9278,51,77081,208,86359,259,2,193,-12,639,85,11230,1,284,218,"Anderson",76978,507.93733274442,0.165,336.459767725844,97.4304346696459,830.107303385383,16.5
2021-09-24,12103,41,8372,22,3731,19,9303,25,77221,140,86524,165,2,195,-18,621,57,11287,1,285,221,"Anderson",76978,466.367013952038,0.16043956043956,214.346956273221,53.2619709527397,806.723999064668,16.043956043956
2021-09-25,12113,10,8376,4,3737,6,9309,6,77316,95,86625,101,0,195,-35,586,45,11332,0,285,221,"Anderson",76978,411.805970537037,0.150117279124316,131.206318688456,12.9907246226195,761.2564628855,15.0117279124316
2021-09-26,12131,18,8391,15,3740,3,9327,18,77453,137,86780,155,1,196,-12,574,29,11361,0,285,221,"Anderson",76978,405.310608225727,0.147492625368732,201.356231650601,23.383304320715,745.667593338356,14.7492625368732
2021-09-27,12181,50,8412,21,3769,29,9349,22,77539,86,86888,108,1,197,-43,531,92,11453,1,286,222,"Anderson",76978,388.422666216322,0.14975845410628,140.29982592429,64.9536231130973,689.807477461093,14.975845410628
2021-09-28,12230,49,8436,24,3794,25,9376,27,77634,95,87010,122,0,197,-29,502,78,11531,1,287,222,"Anderson",76978,381.927303905012,0.154664484451718,158.486840395957,63.6545506508353,652.134376055496,15.4664484451718
2021-09-29,12266,36,8452,16,3814,20,9393,17,77825,191,87218,208,2,199,-38,464,72,11603,0,287,224,"Anderson",76978,362.441216971083,0.148479427549195,270.207072150485,46.76660864143,602.769622489542,14.8479427549195
2021-09-30,12328,62,8490,38,3838,24,9433,40,77997,172,87430,212,0,199,2,466,60,11663,1,288,225,"Anderson",76978,345.553274961677,0.144724556489262,275.403361999532,80.5424926602406,605.367767414066,14.4724556489262
2021-10-01,12379,51,8517,27,3862,24,9462,29,78148,151,87610,180,0,199,-10,456,61,11724,1,289,226,"Anderson",76978,358.543999584297,0.146408839779006,233.83304320715,66.2526955753592,592.377042791447,14.6408839779006
2021-10-02,12396,17,8524,7,3872,10,9468,6,78228,80,87696,86,1,200,-10,446,26,11750,0,289,228,"Anderson",76978,367.63750682013,0.148459383753501,111.720231754527,22.0842318584531,579.386318168827,14.8459383753501
2021-10-03,12409,13,8533,9,3876,4,9477,9,78326,98,87803,107,4,204,-10,436,19,11769,0,289,228,"Anderson",76978,361.142144508821,0.146627565982405,139.000753462028,16.8879420094053,566.395593546208,14.6627565982405
2021-10-04,12453,44,8556,23,3897,21,9503,26,78446,120,87949,146,1,205,-22,414,65,11834,0,289,230,"Anderson",76978,353.347709735249,0.145146088595664,189.664579490244,57.1591883395256,537.815999376445,14.5146088595664
2021-10-05,12506,53,8585,29,3921,24,9533,30,78574,128,88107,158,2,207,-15,399,66,11900,0,289,231,"Anderson",76978,358.543999584297,0.143117593436645,205.253449037387,68.8508404998831,518.329912442516,14.3117593436645
2021-10-06,12536,30,8608,23,3928,7,9559,26,78739,165,88298,191,1,208,-5,394,34,11934,0,289,232,"Anderson",76978,350.749564810725,0.153703703703704,248.122840292031,38.9721738678584,511.834550131206,15.3703703703704
2021-10-07,12568,32,8630,22,3938,10,9584,25,78878,139,88462,164,0,208,-10,384,42,11976,0,289,234,"Anderson",76978,311.777390942867,0.146317829457364,213.047883810959,41.5703187923822,498.843825508587,14.6317829457364
2021-10-08,12585,17,8635,5,3950,12,9594,10,79008,130,88602,140,1,209,-13,371,29,12005,1,290,234,"Anderson",76978,267.608927225961,0.133064516129032,181.870144716672,22.0842318584531,481.955883499182,13.3064516129032
2021-10-09,12600,15,8638,3,3962,12,9601,7,79070,62,88671,69,0,209,-12,359,27,12032,0,290,235,"Anderson",76978,265.010782301437,0.136410256410256,89.6359998960742,19.4860869339292,466.367013952038,13.6410256410256
2021-10-10,12610,10,8646,8,3964,2,9610,9,79157,87,88767,96,0,209,-15,344,25,12057,0,290,235,"Anderson",76978,261.113564914651,0.137966804979253,124.710956377147,12.9907246226195,446.880927018109,13.7966804979253
2021-10-11,12650,40,8660,14,3990,26,9623,13,79258,101,88881,114,0,209,-12,332,52,12109,1,291,235,"Anderson",76978,255.917275065603,0.128755364806867,148.094260697862,51.9628984904778,431.292057470966,12.8755364806867
2021-10-12,12685,35,8684,24,4001,11,9645,22,79357,99,89002,121,2,211,-9,323,42,12151,3,294,235,"Anderson",76978,232.533970744888,0.125139664804469,157.187767933695,45.4675361791681,419.600405310608,12.5139664804469
2021-10-13,12711,26,8698,14,4013,12,9663,18,79469,112,89132,130,0,211,-15,308,41,12192,1,295,238,"Anderson",76978,227.33768089584,0.124700239808153,168.879420094053,33.7758840188106,400.114318376679,12.4700239808153
2021-10-14,12730,19,8708,10,4022,9,9677,14,79572,103,89249,117,1,212,-21,287,39,12231,0,295,238,"Anderson",76978,210.449738886435,0.118170266836086,151.991478084648,24.682376782977,372.833796669178,11.8170266836086
2021-10-15,12753,23,8720,12,4033,11,9690,13,79694,122,89384,135,0,212,-15,272,38,12269,1,296,238,"Anderson",76978,218.244173660007,0.122762148337596,175.374782405363,29.8786666320247,353.347709735249,12.2762148337596
2021-10-16,12761,8,8725,5,4036,3,9697,7,79749,55,89446,62,0,212,-15,257,23,12292,1,297,238,"Anderson",76978,209.150666424173,0.123870967741935,80.5424926602406,10.3925796980956,333.86162280132,12.3870967741935
2021-10-17,12763,2,8726,1,4037,1,9698,1,79800,51,89498,52,0,212,-11,246,13,12305,0,297,238,"Anderson",76978,198.758086726078,0.120383036935705,67.5517680376211,2.59814492452389,319.571825716438,12.0383036935705
2021-10-18,12787,24,8736,10,4051,14,9709,11,79868,68,89577,79,1,213,-26,220,49,12354,1,298,238,"Anderson",76978,177.972927329886,0.123563218390805,102.626724518694,31.1777390942867,285.795941697628,12.3563218390805
2021-10-19,12816,29,8749,13,4067,16,9720,11,79979,111,89699,122,2,215,-17,203,44,12398,0,298,238,"Anderson",76978,170.178492556315,0.107604017216643,158.486840395957,37.6731014055964,263.711709839175,10.7604017216643
2021-10-20,12851,35,8775,26,4076,9,9749,29,80090,111,89839,140,0,215,12,215,23,12421,1,299,239,"Anderson",76978,181.870144716672,0.121640735502122,181.870144716672,45.4675361791681,279.300579386318,12.1640735502122
2021-10-21,12883,32,8793,18,4090,14,9767,18,80183,93,89950,111,0,215,11,226,21,12442,1,300,240,"Anderson",76978,198.758086726078,0.128388017118402,144.197043311076,41.5703187923822,293.5903764712,12.8388017118402
2021-10-22,12892,9,8799,6,4093,3,9775,8,80259,76,90034,84,0,215,-22,204,31,12473,1,301,240,"Anderson",76978,180.57107225441,0.130769230769231,109.122086830003,11.6916521603575,265.010782301437,13.0769230769231
2021-10-23,12909,17,8803,4,4106,13,9779,4,80312,53,90091,57,0,215,3,207,14,12487,1,302,240,"Anderson",76978,192.262724414768,0.127131782945736,74.0471303489309,22.0842318584531,268.907999688223,12.7131782945736
2021-10-24,12915,6,8808,5,4107,1,9786,7,80364,52,90150,59,0,215,-10,197,16,12503,0,302,241,"Anderson",76978,197.459014263816,0.134969325153374,76.6452752734548,7.79443477357167,255.917275065603,13.4969325153374
2021-10-25,12939,24,8821,13,4118,11,9800,14,80435,71,90235,85,1,216,-8,189,31,12534,2,304,241,"Anderson",76978,197.459014263816,0.138297872340426,110.421159292265,31.1777390942867,245.524695367508,13.8297872340426
2021-10-26,12951,12,8827,6,4124,6,9806,6,80499,64,90305,70,0,216,-9,180,21,12555,0,304,242,"Anderson",76978,175.374782405363,0.141914191419142,90.9350723583361,15.5888695471433,233.83304320715,14.1914191419142
2021-10-27,12968,17,8837,10,4131,7,9819,13,80620,121,90439,134,1,217,-5,175,21,12576,2,306,244,"Anderson",76978,151.991478084648,0.116666666666667,174.075709943101,22.0842318584531,227.33768089584,11.6666666666667
2021-10-28,12990,22,8851,14,4139,8,9836,17,80702,82,90538,99,1,218,7,182,14,12590,0,306,245,"Anderson",76978,139.000753462028,0.11734693877551,128.608173763933,28.5795941697628,236.431188131674,11.734693877551
2021-10-29,13011,21,8862,11,4149,10,9848,12,80816,114,90664,126,0,218,7,189,14,12604,1,307,245,"Anderson",76978,154.589623009171,0.115873015873016,163.683130245005,27.2805217075008,245.524695367508,11.5873015873016
2021-10-30,13023,12,8866,4,4157,8,9853,5,80903,87,90756,92,0,218,0,189,12,12616,1,308,245,"Anderson",76978,148.094260697862,0.111278195488722,119.514666528099,15.5888695471433,245.524695367508,11.1278195488722
2021-10-31,13026,3,8868,2,4158,1,9856,3,80942,39,90798,42,0,218,-8,181,11,12627,0,308,245,"Anderson",76978,144.197043311076,0.108024691358025,54.5610434150017,3.89721738678583,235.132115669412,10.8024691358025
2021-11-01,13053,27,8873,5,4180,22,9860,4,81030,88,90890,92,1,219,-15,166,41,12668,1,309,246,"Anderson",76978,148.094260697862,0.0916030534351145,119.514666528099,35.0749564810725,215.646028735483,9.16030534351145
2021-11-02,13073,20,8878,5,4195,15,9865,5,81106,76,90971,81,2,221,-6,160,24,12692,1,310,246,"Anderson",76978,158.486840395957,0.0885885885885886,105.224869443218,25.9814492452389,207.851593961911,8.85885885885886
2021-11-03,13102,29,8895,17,4207,12,9882,17,81306,200,91188,217,1,222,10,170,18,12710,0,310,246,"Anderson",76978,174.075709943101,0.0841121495327103,281.898724310842,37.6731014055964,220.842318584531,8.41121495327103
2021-11-04,13124,22,8910,15,4214,7,9898,16,81439,133,91337,149,0,222,6,176,16,12726,0,310,246,"Anderson",76978,174.075709943101,0.0775969962453066,193.56179687703,28.5795941697628,228.636753358102,7.75969962453066
2021-11-05,13134,10,8913,3,4221,7,9899,1,81561,122,91460,123,0,222,3,179,7,12733,0,310,246,"Anderson",76978,159.785912858219,0.064070351758794,159.785912858219,12.9907246226195,232.533970744888,6.4070351758794
2021-11-06,13143,9,8917,4,4226,5,9904,5,81648,87,91552,92,0,222,-4,175,13,12746,3,313,247,"Anderson",76978,155.888695471433,0.064070351758794,119.514666528099,11.6916521603575,227.33768089584,6.4070351758794
2021-11-07,13149,6,8922,5,4227,1,9910,6,81696,48,91606,54,0,222,-4,171,10,12756,0,313,247,"Anderson",76978,159.785912858219,0.0668316831683168,70.149912962145,7.79443477357167,222.141391046793,6.68316831683168
2021-11-08,13174,25,8933,11,4241,14,9923,13,81784,88,91707,101,1,223,-1,170,25,12781,0,313,247,"Anderson",76978,157.187767933695,0.0771113831089351,131.206318688456,32.4768115565486,220.842318584531,7.71113831089351
2021-11-09,13197,23,8940,7,4257,16,9929,6,81942,158,91871,164,1,224,6,176,16,12797,0,313,248,"Anderson",76978,161.084985320481,0.0711111111111111,213.047883810959,29.8786666320247,228.636753358102,7.11111111111111
2021-11-10,13216,19,8952,12,4264,7,9942,13,82058,116,92000,129,0,224,5,181,14,12811,1,314,250,"Anderson",76978,148.094260697862,0.0738916256157636,167.580347631791,24.682376782977,235.132115669412,7.38916256157635
2021-11-11,13238,22,8969,17,4269,5,9959,17,82248,190,92207,207,0,224,1,182,21,12832,0,314,251,"Anderson",76978,148.094260697862,0.0701149425287356,268.907999688223,28.5795941697628,236.431188131674,7.01149425287356
2021-11-12,13251,13,8977,8,4274,5,9967,8,82381,133,92348,141,0,224,1,183,12,12844,1,315,251,"Anderson",76978,151.991478084648,0.0765765765765766,183.169217178934,16.8879420094053,237.730260593936,7.65765765765766
2021-11-13,13258,7,8981,4,4277,3,9971,4,82432,51,92403,55,3,227,-10,173,14,12858,1,316,252,"Anderson",76978,149.393333160124,0.0787309048178613,71.448985424407,9.09350723583361,224.739535971316,7.87309048178613
2021-11-14,13260,2,8983,2,4277,0,9974,3,82511,79,92485,82,0,227,-4,169,6,12864,0,316,252,"Anderson",76978,144.197043311076,0.0728100113765643,106.523941905479,2.59814492452389,219.543246122269,7.28100113765643
2021-11-15,13292,32,8997,14,4295,18,9988,14,82596,85,92584,99,0,227,5,174,27,12891,0,316,253,"Anderson",76978,153.29055054691,0.0741163055872292,128.608173763933,41.5703187923822,226.038608433578,7.41163055872292
2021-11-16,13317,25,9010,13,4307,12,10001,13,82722,126,92723,139,1,228,-2,172,26,12917,0,316,254,"Anderson",76978,155.888695471433,0.0845070422535211,180.57107225441,32.4768115565486,223.440463509055,8.45070422535211
2021-11-17,13334,17,9019,9,4315,8,10010,9,82836,114,92846,123,0,228,-2,170,19,12936,2,318,256,"Anderson",76978,153.29055054691,0.0803782505910166,159.785912858219,22.0842318584531,220.842318584531,8.03782505910165
2021-11-18,13357,23,9033,14,4324,9,10028,18,82971,135,92999,153,4,232,4,174,15,12951,0,318,258,"Anderson",76978,154.589623009171,0.0871212121212121,198.758086726078,29.8786666320247,226.038608433578,8.71212121212121
2021-11-19,13371,14,9039,6,4332,8,10035,7,83080,109,93115,116,1,233,2,176,11,12962,0,318,258,"Anderson",76978,155.888695471433,0.0886571056062582,150.692405622386,18.1870144716672,228.636753358102,8.86571056062582
2021-11-20,13380,9,9044,5,4336,4,10040,5,83173,93,93213,98,0,233,-9,167,18,12980,0,318,259,"Anderson",76978,158.486840395957,0.0851851851851852,127.309101301671,11.6916521603575,216.945101197745,8.51851851851852
2021-11-21,13392,12,9050,6,4342,6,10046,6,83213,40,93259,46,0,233,4,171,8,12988,0,318,259,"Anderson",76978,171.477565018577,0.0930232558139535,59.7573332640495,15.5888695471433,222.141391046793,9.30232558139535
2021-11-22,13420,28,9067,17,4353,11,10064,18,83335,122,93399,140,1,234,6,177,21,13009,0,318,259,"Anderson",76978,166.281275169529,0.0932515337423313,181.870144716672,36.3740289433345,229.935825820364,9.32515337423313
2021-11-23,13437,17,9073,6,4364,11,10069,5,83432,97,93501,102,0,234,-5,172,22,13031,1,319,261,"Anderson",76978,155.888695471433,0.0874035989717224,132.505391150718,22.0842318584531,223.440463509055,8.74035989717224
2021-11-24,13462,25,9089,16,4373,9,10081,12,83542,110,93623,122,1,235,6,178,18,13049,1,320,261,"Anderson",76978,166.281275169529,0.0913770913770914,158.486840395957,32.4768115565486,231.234898282626,9.13770913770914
2021-11-25,13467,5,9091,2,4376,3,10082,1,83587,45,93669,46,0,235,-12,166,17,13066,2,322,261,"Anderson",76978,142.897970848814,0.0805970149253731,59.7573332640495,6.49536231130973,215.646028735483,8.05970149253731
2021-11-26,13474,7,9097,6,4377,1,10091,9,83630,43,93721,52,0,235,-7,159,14,13080,0,322,262,"Anderson",76978,133.80446361298,0.0924092409240924,67.5517680376211,9.09350723583361,206.552521499649,9.24092409240924
2021-11-27,13479,5,9099,2,4380,3,10093,2,83666,36,93759,38,0,235,-8,151,13,13093,0,322,262,"Anderson",76978,128.608173763933,0.0970695970695971,49.3647535659539,6.49536231130973,196.159941801554,9.70695970695971
2021-11-28,13489,10,9100,1,4389,9,10094,1,83704,38,93798,39,0,235,-10,141,20,13113,0,322,262,"Anderson",76978,126.010028839409,0.0890538033395176,50.6638260282159,12.9907246226195,183.169217178934,8.90538033395176
2021-11-29,13516,27,9115,15,4401,12,10110,16,83783,79,93893,95,0,235,13,154,14,13127,0,322,262,"Anderson",76978,124.710956377147,0.0931174089068826,123.411883914885,35.0749564810725,200.05715918834,9.31174089068826
2021-11-30,13543,27,9129,14,4414,13,10122,12,83885,102,94007,114,0,235,14,168,13,13140,1,323,262,"Anderson",76978,137.701680999766,0.104743083003953,148.094260697862,35.0749564810725,218.244173660007,10.4743083003953
2021-12-01,13574,31,9147,18,4427,13,10140,18,83992,107,94132,125,0,235,15,183,16,13156,2,325,262,"Anderson",76978,145.496115773338,0.115913555992141,162.384057782743,40.2712463301203,237.730260593936,11.5913555992141
2021-12-02,13616,42,9171,24,4445,18,10166,26,84130,138,94296,164,0,235,23,206,19,13175,0,325,265,"Anderson",76978,193.56179687703,0.133971291866029,213.047883810959,54.5610434150017,267.608927225961,13.3971291866029
2021-12-03,13647,31,9189,18,4458,13,10185,19,84317,187,94502,206,1,236,18,224,12,13187,1,326,265,"Anderson",76978,224.739535971316,0.120358514724712,267.608927225961,40.2712463301203,290.992231546676,12.0358514724712
2021-12-04,13667,20,9202,13,4465,7,10199,14,84386,69,94585,83,0,236,8,232,12,13199,0,326,265,"Anderson",76978,244.225622905246,0.128329297820823,107.823014367741,25.9814492452389,301.384811244771,12.8329297820823
2021-12-05,13680,13,9204,2,4476,11,10201,2,84428,42,94629,44,0,236,0,232,13,13212,0,326,265,"Anderson",76978,248.122840292031,0.128760529482551,57.1591883395256,16.8879420094053,301.384811244771,12.8760529482551
2021-12-06,13715,35,9224,20,4491,15,10223,22,84530,102,94753,124,2,238,7,239,26,13238,1,327,265,"Anderson",76978,258.515419990127,0.131395348837209,161.084985320481,45.4675361791681,310.478318480605,13.1395348837209
2021-12-07,13744,29,9239,15,4505,14,10239,16,84625,95,94864,111,0,238,19,258,10,13248,0,327,265,"Anderson",76978,261.113564914651,0.136522753792299,144.197043311076,37.6731014055964,335.160695263582,13.6522753792299
2021-12-08,13771,27,9260,21,4511,6,10259,20,84746,121,95005,141,0,238,17,275,10,13258,1,328,265,"Anderson",76978,255.917275065603,0.13631156930126,183.169217178934,35.0749564810725,357.244927122035,13.631156930126
2021-12-09,13799,28,9276,16,4523,12,10276,17,84956,210,95232,227,0,238,13,288,15,13273,1,329,265,"Anderson",76978,237.730260593936,0.117521367521368,294.889448933461,36.3740289433345,374.13286913144,11.7521367521368
2021-12-10,13828,29,9293,17,4535,12,10293,17,85109,153,95402,170,0,238,9,297,20,13293,1,330,265,"Anderson",76978,235.132115669412,0.12,220.842318584531,37.6731014055964,385.824521291798,12
2021-12-11,13838,10,9298,5,4540,5,10299,6,85184,75,95483,81,0,238,-2,295,12,13305,0,330,266,"Anderson",76978,222.141391046793,0.111358574610245,105.224869443218,12.9907246226195,383.226376367274,11.1358574610245
2021-12-12,13858,20,9309,11,4549,9,10311,12,85254,70,95565,82,0,238,3,298,17,13322,0,330,266,"Anderson",76978,231.234898282626,0.117521367521368,106.523941905479,25.9814492452389,387.12359375406,11.7521367521368
2021-12-13,13888,30,9315,6,4573,24,10318,7,85329,75,95647,82,0,238,-9,289,39,13361,0,330,269,"Anderson",76978,224.739535971316,0.106263982102908,106.523941905479,38.9721738678584,375.431941593702,10.6263982102908
2021-12-14,13902,14,9320,5,4582,9,10324,6,85408,79,95732,85,3,241,-10,279,21,13382,1,331,269,"Anderson",76978,205.253449037387,0.097926267281106,110.421159292265,18.1870144716672,362.441216971083,9.7926267281106
2021-12-15,13928,26,9334,14,4594,12,10339,15,85537,129,95876,144,0,241,-1,278,27,13409,0,331,270,"Anderson",76978,203.954376575125,0.0918484500574053,187.06643456572,33.7758840188106,361.142144508821,9.18484500574053
2021-12-16,13956,28,9344,10,4612,18,10354,15,85632,95,95986,110,0,241,7,285,21,13430,2,333,270,"Anderson",76978,203.954376575125,0.103448275862069,142.897970848814,36.3740289433345,370.235651744654,10.3448275862069
2021-12-17,13987,31,9367,23,4620,8,10376,22,85787,155,96163,177,1,242,0,285,30,13460,0,333,271,"Anderson",76978,206.552521499649,0.109067017082786,229.935825820364,40.2712463301203,370.235651744654,10.9067017082786
2021-12-18,13999,12,9377,10,4622,2,10386,10,85869,82,96255,92,0,242,2,287,10,13470,0,333,271,"Anderson",76978,209.150666424173,0.112694300518135,119.514666528099,15.5888695471433,372.833796669178,11.2694300518135
2021-12-19,14013,14,9385,8,4628,6,10397,11,85949,80,96346,91,0,242,-8,279,22,13492,0,333,271,"Anderson",76978,201.356231650601,0.1101152368758,118.215594065837,18.1870144716672,362.441216971083,11.01152368758
2021-12-20,14037,24,9401,16,4636,8,10411,14,86035,86,96446,100,0,242,-4,275,28,13520,0,333,272,"Anderson",76978,193.56179687703,0.11639549436796,129.907246226195,31.1777390942867,357.244927122035,11.639549436796
2021-12-21,14065,28,9409,8,4656,20,10422,11,86116,81,96538,92,0,242,3,278,25,13545,0,333,272,"Anderson",76978,211.748811348697,0.121588089330025,119.514666528099,36.3740289433345,361.142144508821,12.1588089330025
2021-12-22,14113,48,9423,14,4690,34,10433,11,86231,115,96664,126,19,261,1,279,28,13573,0,333,273,"Anderson",76978,240.32840551846,0.119289340101523,163.683130245005,62.3554781885734,362.441216971083,11.9289340101523
2021-12-23,14140,27,9438,15,4702,12,10450,17,86331,100,96781,117,-1,260,7,286,21,13594,1,334,274,"Anderson",76978,239.029333056198,0.120754716981132,151.991478084648,35.0749564810725,371.534724206916,12.0754716981132
2021-12-24,14166,26,9453,15,4713,11,10467,17,86418,87,96885,104,0,260,6,292,20,13614,1,335,274,"Anderson",76978,232.533970744888,0.126038781163435,135.103536075242,33.7758840188106,379.329158980488,12.6038781163435
2021-12-25,14180,14,9460,7,4720,7,10477,10,86476,58,96953,68,1,261,2,294,11,13625,0,335,275,"Anderson",76978,235.132115669412,0.130372492836676,88.3369274338123,18.1870144716672,381.927303905012,13.0372492836676
2021-12-26,14191,11,9464,4,4727,7,10483,6,86520,44,97003,50,1,262,-7,287,17,13642,0,335,275,"Anderson",76978,231.234898282626,0.13089802130898,64.9536231130973,14.2897970848814,372.833796669178,13.089802130898
2021-12-27,14238,47,9483,19,4755,28,10503,20,86624,104,97127,124,1,263,13,300,33,13675,1,336,276,"Anderson",76978,261.113564914651,0.135095447870778,161.084985320481,61.0564057263114,389.721738678584,13.5095447870778
2021-12-28,14325,87,9519,36,4806,51,10539,36,86733,109,97272,145,0,263,70,370,17,13692,0,336,276,"Anderson",76978,337.758840188106,0.159400544959128,188.365507027982,113.019304216789,480.65681103692,15.9400544959128
2021-12-29,14406,81,9563,44,4843,37,10586,47,86891,158,97477,205,2,265,49,419,30,13722,0,336,276,"Anderson",76978,380.62823144275,0.188191881918819,266.309854763699,105.224869443218,544.311361687755,18.8191881918819
2021-12-30,14498,92,9605,42,4893,50,10624,38,87010,119,97634,157,1,266,70,489,21,13743,0,336,276,"Anderson",76978,465.067941489776,0.203985932004689,203.954376575125,119.514666528099,635.246434046091,20.3985932004689
2021-12-31,14564,66,9645,40,4919,26,10668,44,87127,117,97795,161,0,266,49,538,17,13760,0,336,277,"Anderson",76978,517.030839980254,0.220879120879121,209.150666424173,85.7387825092884,698.900984696926,22.0879120879121
2022-01-01,14625,61,9679,34,4946,27,10705,37,87226,99,97931,136,0,266,48,586,13,13773,0,336,277,"Anderson",76978,578.087245706566,0.233128834355828,176.673854867625,79.2434201979787,761.2564628855,23.3128834355828
2022-01-02,14657,32,9702,23,4955,9,10738,33,87342,116,98080,149,0,266,16,602,16,13789,0,336,278,"Anderson",76978,605.367767414066,0.236768802228412,193.56179687703,41.5703187923822,782.041622281691,23.6768802228412
2022-01-03,14718,61,9723,21,4995,40,10761,23,87418,76,98179,99,1,267,31,633,29,13818,0,336,278,"Anderson",76978,623.554781885734,0.245247148288973,128.608173763933,79.2434201979787,822.312868611811,24.5247148288973
2022-01-04,14845,127,9788,65,5057,62,10824,63,87592,174,98416,237,1,268,73,706,53,13871,0,336,279,"Anderson",76978,675.517680376211,0.249125874125874,307.880173556081,164.982202707267,917.145158356933,24.9125874125874
2022-01-05,15012,167,9874,86,5138,81,10910,86,87738,146,98648,232,1,269,132,838,34,13905,0,336,280,"Anderson",76978,787.237912130739,0.27668659265585,301.384811244771,216.945101197745,1088.62272337551,27.668659265585
2022-01-06,15154,142,9946,72,5208,70,10981,71,87858,120,98839,191,1,270,114,952,27,13932,1,337,280,"Anderson",76978,852.191535243836,0.296265560165975,248.122840292031,184.468289641196,1236.71698407337,29.6265560165975
2022-01-07,15293,139,10016,70,5277,69,11057,76,87998,140,99055,216,0,270,125,1077,14,13946,1,338,280,"Anderson",76978,947.023824988958,0.308730158730159,280.59965184858,180.57107225441,1399.10104185611,30.8730158730159
2022-01-08,15396,103,10058,42,5338,61,11102,45,88073,75,99175,120,0,270,97,1174,6,13952,1,339,282,"Anderson",76978,1001.58486840396,0.319131832797428,155.888695471433,133.80446361298,1525.11107069552,31.9131832797428
2022-01-09,15481,85,10113,55,5368,30,11164,62,88216,143,99380,205,0,270,53,1227,32,13984,0,339,282,"Anderson",76978,1070.43570890384,0.327692307692308,266.309854763699,110.421159292265,1593.96191119541,32.7692307692308
2022-01-10,15637,156,10188,75,5449,81,11243,79,88329,113,99572,192,1,271,69,1296,86,14070,3,342,284,"Anderson",76978,1193.84759281873,0.346015793251974,249.421912754293,202.655304112863,1683.59791109148,34.6015793251974
2022-01-11,15811,174,10297,109,5514,65,11345,102,88470,141,99815,243,0,271,54,1350,120,14190,0,342,285,"Anderson",76978,1254.90399854504,0.37240886347391,315.674608329653,226.038608433578,1753.74782405363,37.240886347391
2022-01-12,16065,254,10459,162,5606,92,11508,163,88661,191,100169,354,0,271,170,1520,84,14274,1,343,285,"Anderson",76978,1367.92330276183,0.393162393162393,459.871651640728,329.964405414534,1974.59014263816,39.3162393162393
2022-01-13,16296,231,10611,152,5685,79,11663,155,88893,232,100556,387,4,275,112,1632,115,14389,0,343,285,"Anderson",76978,1483.54075190314,0.397204426324985,502.741042895373,300.085738782509,2120.08625841149,39.7204426324985
2022-01-14,16554,258,10756,145,5798,113,11812,149,89049,156,100861,305,2,277,208,1840,48,14437,2,345,285,"Anderson",76978,1638.13037491231,0.418050941306755,396.217100989893,335.160695263582,2390.29333056198,41.8050941306755
2022-01-15,16650,96,10814,58,5836,38,11873,61,89167,118,101040,179,1,278,72,1912,23,14460,1,346,285,"Anderson",76978,1629.03686767648,0.413404825737265,232.533970744888,124.710956377147,2483.82654784484,41.3404825737265
2022-01-16,16802,152,10942,128,5860,24,12006,133,89364,197,101370,330,0,278,101,2013,51,14511,0,346,285,"Anderson",76978,1716.07472264803,0.423115577889447,428.693912546442,197.459014263816,2615.0328665333,42.3115577889447
2022-01-17,16983,181,11054,112,5929,69,12122,116,89483,119,101605,235,0,278,24,2037,157,14668,1,347,285,"Anderson",76978,1748.55153420458,0.432365961633055,305.282028631557,235.132115669412,2646.21060562758,43.2365961633055
2022-01-18,17198,215,11194,140,6004,75,12264,142,89620,137,101884,279,0,278,15,2052,200,14868,0,347,287,"Anderson",76978,1801.81350515732,0.44417593040116,362.441216971083,279.300579386318,2665.69669256151,44.417593040116
2022-01-19,17499,301,11404,210,6095,91,12478,214,89840,220,102318,434,3,281,116,2168,182,15050,0,347,287,"Anderson",76978,1862.86991088363,0.451372731503025,563.797448621684,391.020811140845,2816.3890981839,45.1372731503025
2022-01-20,17795,296,11645,241,6150,55,12738,260,89997,157,102735,417,1,282,181,2349,114,15164,1,348,288,"Anderson",76978,1947.30962093066,0.493345571363011,541.713216763231,384.525448829536,3051.52121385331,49.3345571363011
2022-01-21,18041,246,11860,215,6181,31,12963,225,90216,219,103179,444,2,284,112,2461,132,15296,0,348,290,"Anderson",76978,1931.72075138351,0.496548748921484,576.788173244304,319.571825716438,3197.01732962665,49.6548748921484
2022-01-22,18169,128,11952,92,6217,36,13067,104,90335,119,103402,223,0,284,37,2498,91,15387,0,348,290,"Anderson",76978,1973.29107017589,0.505503810330229,289.693159084414,166.281275169529,3245.08301073034,50.5503810330229
2022-01-23,18296,127,12062,110,6234,17,13180,113,90442,107,103622,220,0,284,65,2563,62,15449,0,348,291,"Anderson",76978,1940.81425861935,0.521314387211368,285.795941697628,164.982202707267,3329.52272077737,52.1314387211368
2022-01-24,18564,268,12212,150,6352,118,13341,161,90620,178,103961,339,1,285,-13,2550,280,15729,1,349,293,"Anderson",76978,2053.83356283614,0.517402376910017,440.385564706799,348.151419886201,3312.63477876796,51.7402376910017
2022-01-25,18747,183,12345,133,6402,50,13486,145,90740,120,104226,265,1,286,-88,2462,270,15999,0,349,294,"Anderson",76978,2012.26324404375,0.521776259607173,344.254202499415,237.730260593936,3198.31640208891,52.1776259607173
2022-01-26,18952,205,12499,154,6453,51,13652,166,90892,152,104544,318,1,287,-49,2413,253,16252,0,349,294,"Anderson",76978,1887.55228766661,0.527403414195867,413.105042999298,266.309854763699,3134.66185143807,52.7403414195867
2022-01-27,19173,221,12671,172,6502,49,13830,178,91112,220,104942,398,0,287,-68,2345,289,16541,0,349,294,"Anderson",76978,1790.12185299696,0.494789306751246,517.030839980254,287.09501415989,3046.32492400426,49.4789306751246
2022-01-28,19363,190,12809,138,6554,52,13974,144,91275,163,105249,307,1,288,-136,2209,325,16866,0,349,294,"Anderson",76978,1717.37379511029,0.488405797101449,398.815245914417,246.82376782977,2869.65106913664,48.8405797101449
2022-01-29,19506,143,12909,100,6597,43,14079,105,91392,117,105471,222,0,288,-7,2202,150,17016,0,349,296,"Anderson",76978,1736.85988204422,0.489125181246979,288.394086622152,185.767362103458,2860.5575619008,48.9125181246979
2022-01-30,19573,67,12954,45,6619,22,14129,50,91483,91,105612,141,0,288,-13,2189,80,17096,1,350,297,"Anderson",76978,1658.9155343085,0.476884422110553,183.169217178934,87.0378549715503,2843.6696198914,47.6884422110553
2022-01-31,19769,196,13075,121,6694,75,14270,141,91633,150,105903,291,4,292,-90,2099,282,17378,1,351,299,"Anderson",76978,1565.38231702564,0.478372811534501,378.030086518226,254.618202603341,2726.75309828782,47.83728115345
2022-02-01,19932,163,13170,95,6762,68,14377,107,91753,120,106130,227,1,293,-234,1865,396,17774,1,352,299,"Anderson",76978,1539.4008677804,0.46796218487395,294.889448933461,211.748811348697,2422.77014211853,46.796218487395
2022-02-02,20076,144,13257,87,6819,57,14470,93,91894,141,106364,234,1,294,-231,1634,374,18148,0,352,300,"Anderson",76978,1460.15744758243,0.449450549450549,303.982956169295,187.06643456572,2122.68440333602,44.9450549450549
2022-02-03,20708,632,13348,91,7360,541,14568,98,92102,208,106670,306,2,296,346,1980,284,18432,1,353,301,"Anderson",76978,1994.07622957209,0.427083333333333,397.516173452155,821.013796149549,2572.16347527865,42.7083333333333
2022-02-04,20854,146,13458,110,7396,36,14678,110,92226,124,106904,234,0,296,-70,1910,216,18648,0,353,303,"Anderson",76978,1936.91704123256,0.425377643504532,303.982956169295,189.664579490244,2481.22840292031,42.5377643504532
2022-02-05,20903,49,13484,26,7419,23,14708,30,92302,76,107010,106,0,296,-50,1860,99,18747,0,353,303,"Anderson",76978,1814.80422977994,0.408706952566602,137.701680999766,63.6545506508353,2416.27477980722,40.8706952566602
2022-02-06,20961,58,13526,42,7435,16,14756,48,92376,74,107132,122,0,296,-10,1850,68,18815,0,353,304,"Anderson",76978,1803.11257761958,0.4125,158.486840395957,75.3462028111928,2403.2840551846,41.25
2022-02-07,21047,86,13579,53,7468,33,14814,58,92478,102,107292,160,3,299,-261,1589,344,19159,0,353,305,"Anderson",76978,1660.21460677077,0.391648668106551,207.851593961911,111.720231754527,2064.22614253423,39.1648668106551
2022-02-08,21133,86,13626,47,7507,39,14871,57,92575,97,107446,154,0,299,-201,1388,287,19446,0,353,305,"Anderson",76978,1560.1860271766,0.375379939209726,200.05715918834,111.720231754527,1803.11257761958,37.5379939209726
2022-02-09,21232,99,13690,64,7542,35,14945,74,92682,107,107627,181,0,299,-102,1286,201,19647,0,353,306,"Anderson",76978,1501.72776637481,0.376088677751386,235.132115669412,128.608173763933,1670.60718646886,37.6088677751386
2022-02-10,21320,88,13740,50,7580,38,14999,54,92808,126,107807,180,2,301,-96,1190,182,19829,0,353,306,"Anderson",76978,795.03234690431,0.379067722075638,233.83304320715,114.318376679051,1545.89623009171,37.9067722075638
2022-02-11,21379,59,13782,42,7597,17,15044,45,92910,102,107954,147,1,302,-123,1067,181,20010,0,353,306,"Anderson",76978,682.013042687521,0.348571428571429,190.963651952506,76.6452752734548,1386.1103172335,34.8571428571429
2022-02-12,21410,31,13805,23,7605,8,15069,25,92972,62,108041,87,0,302,-42,1025,73,20083,1,354,306,"Anderson",76978,658.629738366806,0.350145489815713,113.019304216789,40.2712463301203,1331.54927381849,35.0145489815713
2022-02-13,21431,21,13819,14,7612,7,15084,15,93019,47,108103,62,0,302,-34,991,55,20138,0,354,306,"Anderson",76978,610.564057263114,0.337796086508754,80.5424926602406,27.2805217075008,1287.38081010159,33.7796086508754
2022-02-14,21482,51,13845,26,7637,25,15120,36,93076,57,108196,93,1,303,-141,850,191,20329,0,354,306,"Anderson",76978,565.096521083946,0.338495575221239,120.813738990361,66.2526955753592,1104.21159292265,33.8495575221239
2022-02-15,21538,56,13884,39,7654,17,15164,44,93153,77,108317,121,0,303,-100,750,156,20485,0,354,307,"Anderson",76978,526.124347216088,0.336394948335247,157.187767933695,72.7480578866689,974.304346696459,33.6394948335247
2022-02-16,21600,62,13917,33,7683,29,15195,31,93245,92,108440,123,0,303,-75,675,137,20622,0,354,307,"Anderson",76978,478.058666112396,0.30750307503075,159.785912858219,80.5424926602406,876.873912026813,30.750307503075
2022-02-17,21648,48,13949,32,7699,16,15230,35,93339,94,108569,129,0,303,-68,607,116,20738,0,354,307,"Anderson",76978,426.095767621918,0.303149606299213,167.580347631791,62.3554781885734,788.536984593001,30.3149606299213
2022-02-18,21697,49,13980,31,7717,18,15267,37,93411,72,108678,109,0,303,-32,575,81,20819,0,354,307,"Anderson",76978,413.105042999299,0.308011049723757,141.598898386552,63.6545506508353,746.966665800618,30.8011049723757
2022-02-19,21725,28,13990,10,7735,18,15278,11,93466,55,108744,66,0,303,-5,570,33,20852,0,354,308,"Anderson",76978,409.207825612513,0.297297297297297,85.7387825092884,36.3740289433345,740.471303489309,29.7297297297297
2022-02-20,21735,10,13992,2,7743,8,15280,2,93503,37,108783,39,0,303,-18,552,28,20880,0,354,308,"Anderson",76978,394.918028527631,0.288235294117647,50.6638260282159,12.9907246226195,717.087999168594,28.8235294117647
2022-02-21,21752,17,14002,10,7750,7,15290,10,93532,29,108822,39,0,303,-81,471,98,20978,1,355,309,"Anderson",76978,350.749564810725,0.271565495207668,50.6638260282159,22.0842318584531,611.863129725376,27.1565495207668
2022-02-22,21787,35,14017,15,7770,20,15308,18,93609,77,108917,95,2,305,-77,394,110,21088,0,355,309,"Anderson",76978,323.469043103224,0.24,123.411883914885,45.4675361791681,511.834550131206,24
2022-02-23,21822,35,14034,17,7788,18,15327,19,93675,66,109002,85,4,309,-35,359,66,21154,0,355,309,"Anderson",76978,288.394086622152,0.234875444839858,110.421159292265,45.4675361791681,466.367013952038,23.4875444839858
2022-02-24,21850,28,14048,14,7802,14,15344,17,93753,78,109097,95,1,310,-27,332,54,21208,0,355,309,"Anderson",76978,262.412637376913,0.215909090909091,123.411883914885,36.3740289433345,431.292057470966,21.5909090909091
2022-02-25,21863,13,14053,5,7810,8,15350,6,93820,67,109170,73,-1,309,-36,296,50,21258,0,355,309,"Anderson",76978,215.646028735483,0.16869918699187,94.832289745122,16.8879420094053,384.525448829536,16.869918699187
2022-02-26,21877,14,14059,6,7818,8,15357,7,93865,45,109222,52,NA,NA,NA,NA,17,21275,0,355,309,"Anderson",76978,197.459014263816,0.165271966527197,67.5517680376211,18.1870144716672,NA,16.5271966527197
2020-03-12,1,1,1,1,0,0,1,1,11,11,12,12,NA,NA,NA,NA,0,0,0,0,0,"East TN",2455501,NA,NA,0.488698640318208,0.040724886693184,NA,NA
2020-03-13,1,0,1,0,0,0,1,0,23,12,24,12,NA,NA,NA,NA,0,0,0,0,0,"East TN",2455501,NA,NA,0.488698640318208,0,NA,NA
2020-03-14,3,2,3,2,0,0,3,2,50,27,53,29,NA,NA,NA,NA,0,0,0,0,0,"East TN",2455501,NA,NA,1.18102171410234,0.081449773386368,NA,NA
2020-03-15,3,0,3,0,0,0,3,0,53,3,56,3,NA,NA,NA,NA,0,0,0,0,0,"East TN",2455501,NA,NA,0.122174660079552,0,NA,NA
2020-03-16,5,2,5,2,0,0,5,2,89,36,94,38,NA,NA,NA,NA,0,0,0,0,0,"East TN",2455501,NA,NA,1.54754569434099,0.081449773386368,NA,NA
2020-03-17,6,1,6,1,0,0,5,0,130,41,135,41,NA,NA,NA,NA,0,0,0,0,0,"East TN",2455501,NA,NA,1.66972035442054,0.040724886693184,NA,NA
2020-03-18,8,2,8,2,0,0,7,2,171,41,178,43,NA,NA,NA,NA,0,0,0,0,0,"East TN",2455501,0.325799093545472,0.0393258426966292,1.75117012780691,0.081449773386368,NA,3.93258426966292
2020-03-19,11,3,11,3,0,0,11,4,238,67,249,71,NA,NA,NA,NA,0,0,0,0,0,"East TN",2455501,0.40724886693184,0.0421940928270042,2.89146695521606,0.122174660079552,NA,4.21940928270042
2020-03-20,29,18,29,18,0,0,27,16,382,144,409,160,NA,NA,NA,NA,3,3,2,2,0,"East TN",2455501,1.14029682740915,0.0675324675324675,6.51598187090944,0.733047960477312,NA,6.75324675324675
2020-03-21,38,9,38,9,0,0,38,11,610,228,648,239,NA,NA,NA,NA,3,6,1,3,1,"East TN",2455501,1.42537103426144,0.0588235294117647,9.73324791967098,0.366523980238656,NA,5.88235294117647
2020-03-22,48,10,47,9,1,1,43,5,713,103,756,108,NA,NA,NA,NA,2,8,4,7,2,"East TN",2455501,1.83261990119328,0.0571428571428571,4.39828776286387,0.40724886693184,NA,5.71428571428571
2020-03-23,64,16,63,16,1,0,56,13,846,133,902,146,NA,NA,NA,NA,7,15,4,11,2,"East TN",2455501,2.40276831489786,0.0631188118811881,5.94583345720486,0.651598187090944,NA,6.31188118811881
2020-03-24,83,19,82,19,1,0,70,14,987,141,1057,155,NA,NA,NA,NA,7,22,5,16,2,"East TN",2455501,3.13581627537517,0.0704989154013015,6.31235743744352,0.773772847170496,NA,7.04989154013015
2020-03-25,116,33,115,33,1,0,99,29,1288,301,1387,330,NA,NA,NA,NA,15,37,12,28,3,"East TN",2455501,4.39828776286387,0.076095947063689,13.4392126087507,1.34392126087507,NA,7.6095947063689
2020-03-26,144,28,143,28,1,0,130,31,1774,486,1904,517,NA,NA,NA,NA,15,52,5,33,4,"East TN",2455501,5.41640993019347,0.0719033232628399,21.0547664203761,1.14029682740915,NA,7.19033232628399
2020-03-27,166,22,165,22,1,0,147,17,2171,397,2318,414,NA,NA,NA,NA,17,69,6,39,4,"East TN",2455501,5.57930947696621,0.0628601361969618,16.8601030909782,0.895947507250048,NA,6.28601361969618
2020-03-28,197,31,196,31,1,0,180,33,2608,437,2788,470,NA,NA,NA,NA,12,81,8,47,4,"East TN",2455501,6.47525698421626,0.0663551401869159,19.1406967457965,1.2624714874887,NA,6.63551401869159
2020-03-29,213,16,212,16,1,0,196,16,2795,187,2991,203,NA,NA,NA,NA,27,108,3,50,7,"East TN",2455501,6.71960630437536,0.0684563758389262,8.26715199871635,0.651598187090944,NA,6.84563758389262
2020-03-30,246,33,245,33,1,0,226,30,3345,550,3571,580,NA,NA,NA,NA,33,141,8,58,9,"East TN",2455501,7.41192937815949,0.0636942675159236,23.6204342820467,1.34392126087507,NA,6.36942675159236
2020-03-31,295,49,294,49,1,0,278,52,3645,300,3923,352,NA,NA,NA,NA,39,180,12,70,10,"East TN",2455501,8.63367597895501,0.0725750174459177,14.3351601160008,1.99551944796602,NA,7.25750174459177
2020-04-01,346,51,345,51,1,0,336,58,4243,598,4579,656,NA,NA,NA,NA,36,216,9,79,12,"East TN",2455501,9.36672393943232,0.0742481203007519,26.7155256707287,2.07696922135238,NA,7.42481203007519
2020-04-02,391,45,390,45,1,0,383,47,4839,596,5222,643,2,7,NA,134,34,250,5,84,14,"East TN",2455501,10.0590470132164,0.0762507534659433,26.1861021437173,1.83261990119328,5.45713481688666,7.62507534659433
2020-04-03,412,21,411,21,1,0,401,18,5124,285,5525,303,1,8,-13,121,33,283,2,86,17,"East TN",2455501,10.0183221265233,0.0792017461802308,12.3396406680348,0.855222620556864,4.92771128987526,7.92017461802307
2020-04-04,447,35,446,35,1,0,431,30,5716,592,6147,622,3,11,0,121,32,315,5,91,19,"East TN",2455501,10.181221673296,0.0747246204227449,25.3308795231604,1.42537103426144,4.92771128987526,7.47246204227449
2020-04-05,473,26,472,26,1,0,464,33,6093,377,6557,410,-1,10,1,122,26,341,2,93,20,"East TN",2455501,10.5884705402278,0.0751542344363432,16.6972035442054,1.05884705402278,4.96843617656845,7.51542344363432
2020-04-06,514,41,513,41,1,0,514,50,6626,533,7140,583,8,18,0,122,33,374,5,98,20,"East TN",2455501,10.9142696337733,0.080694872513309,23.7426089421263,1.66972035442054,4.96843617656845,8.06948725133091
2020-04-07,570,56,569,56,1,0,592,78,7755,1129,8347,1207,0,18,19,141,37,411,7,105,21,"East TN",2455501,11.1993438406256,0.0709764918625678,49.1549382386731,2.2805936548183,5.74220902373894,7.09764918625678
2020-04-08,607,37,606,37,1,0,632,40,8162,407,8794,447,1,19,4,145,32,443,8,113,25,"East TN",2455501,10.629195426921,0.0702253855278766,18.2040243518532,1.50682080764781,5.90510857051168,7.02253855278766
2020-04-09,633,26,632,26,1,0,662,30,8613,451,9275,481,3,22,3,148,20,463,2,115,25,"East TN",2455501,9.85542257975053,0.0688378978534419,19.5886704994215,1.05884705402278,6.02728323059123,6.88378978534419
2020-04-10,655,22,654,22,1,0,682,20,8941,328,9623,348,0,22,-7,141,29,492,4,119,25,"East TN",2455501,9.89614746644371,0.0685700341630063,14.172260569228,0.895947507250048,5.74220902373894,6.85700341630063
2020-04-11,679,24,678,24,1,0,728,46,10022,1081,10750,1127,2,24,-5,136,27,519,5,124,27,"East TN",2455501,9.44817371281869,0.0645231370845101,45.8969473032184,0.977397280636416,5.53858459027302,6.45231370845101
2020-04-12,709,30,708,30,1,0,761,33,11472,1450,12233,1483,0,24,18,154,12,531,1,125,28,"East TN",2455501,9.61107325959142,0.0523255813953488,60.3950069659919,1.22174660079552,6.27163255075034,5.23255813953488
2020-04-13,738,29,737,29,1,0,803,42,12435,963,13238,1005,0,24,-2,152,31,562,7,132,32,"East TN",2455501,9.12237461927321,0.0473925877336832,40.9285111266499,1.18102171410234,6.19018277736397,4.73925877336832
2020-04-14,749,11,748,11,1,0,823,20,12720,285,13543,305,4,28,-18,134,25,587,1,133,33,"East TN",2455501,7.28975471807994,0.0444572748267898,12.4210904414211,0.447973753625024,5.45713481688666,4.44572748267898
2020-04-15,773,24,772,24,1,0,850,27,13132,412,13982,439,2,30,-6,128,28,615,4,137,34,"East TN",2455501,6.76033119106854,0.0420200462606014,17.8782252583078,0.977397280636416,5.21278549672755,4.20200462606014
2020-04-16,801,28,800,28,1,0,886,36,13809,677,14695,713,1,31,1,129,26,641,6,143,34,"East TN",2455501,6.84178096445491,0.0413284132841328,29.0368442122402,1.14029682740915,5.25351038342074,4.13284132841328
2020-04-17,823,22,821,21,2,1,916,30,14138,329,15054,359,0,31,-1,128,23,664,4,147,35,"East TN",2455501,6.84178096445491,0.0430859878475419,14.6202343228531,0.895947507250048,5.21278549672755,4.30859878475419
2020-04-18,835,12,833,12,2,0,935,19,14919,781,15854,800,0,31,-11,117,23,687,0,147,35,"East TN",2455501,6.3530823241367,0.0405564263322884,32.5799093545472,0.488698640318208,4.76481174310253,4.05564263322884
2020-04-19,914,79,912,79,2,0,1016,81,15605,686,16621,767,1,32,66,183,12,699,1,148,35,"East TN",2455501,8.34860177210272,0.0581130355515041,31.2359880936721,3.21726604876154,7.45265426485267,5.81130355515041
2020-04-20,939,25,931,19,8,6,1033,17,16568,963,17601,980,0,32,10,193,15,714,2,150,35,"East TN",2455501,8.18570222532998,0.0527160210864084,39.9103889593203,1.0181221673296,7.85990313178451,5.27160210864084
2020-04-21,1045,106,1037,106,8,0,1154,121,19274,2706,20428,2827,0,32,83,276,23,737,6,156,36,"East TN",2455501,12.0545664611825,0.0480755265068991,115.129254681631,4.3168379894775,11.2400687273188,4.80755265068991
2020-04-22,1247,202,1237,200,10,2,1354,200,21826,2552,23180,2752,2,34,177,453,23,760,2,158,36,"East TN",2455501,19.3035962925692,0.0547945205479452,112.074888179642,8.22642711202317,18.4483736720124,5.47945205479452
2020-04-23,1492,245,1480,243,12,2,1601,247,22933,1107,24534,1354,0,34,236,689,9,769,3,161,36,"East TN",2455501,28.1408967049901,0.0726699867872751,55.1414965825711,9.97759723983008,28.0594469316038,7.26699867872751
2020-04-24,1540,48,1527,47,13,1,1655,54,25622,2689,27277,2743,0,34,22,711,26,795,4,165,36,"East TN",2455501,29.1997437590129,0.0604597889225231,111.708364199404,1.95479456127283,28.9553944388538,6.04597889225231
2020-04-25,1563,23,1546,19,17,4,1674,19,26397,775,28071,794,0,34,10,721,13,808,3,168,37,"East TN",2455501,29.6477175126379,0.0604894818695261,32.3355600343881,0.936672393943232,29.3626433057857,6.04894818695261
2020-04-26,1583,20,1565,19,18,1,1700,26,27514,1117,29214,1143,0,34,-1,720,21,829,0,168,37,"East TN",2455501,27.2449491977401,0.0543158897800365,46.5485454903093,0.81449773386368,29.3219184190925,5.43158897800365
2020-04-27,1652,69,1633,68,19,1,1772,72,28429,915,30201,987,0,34,50,770,19,848,8,176,38,"East TN",2455501,29.0368442122402,0.0586507936507936,40.1954631661726,2.8100171818297,31.3581627537517,5.86507936507936
2020-04-28,1689,37,1667,34,22,3,1812,40,30603,2174,32415,2214,2,36,19,789,16,864,1,177,39,"East TN",2455501,26.2268270304105,0.0548928005339117,90.1648991387094,1.50682080764781,32.1319356009222,5.48928005339117
2020-04-29,1752,63,1729,62,23,1,1878,66,33351,2748,35229,2814,1,37,39,828,23,887,6,183,40,"East TN",2455501,20.5660677800579,0.0434890862312225,114.59983115462,2.56566786167059,33.7202061819563,4.34890862312225
2020-04-30,1774,22,1750,21,24,1,1900,22,33900,549,35800,571,0,37,-1,827,23,910,1,184,40,"East TN",2455501,11.4844180474779,0.0265400319545535,23.2539103018081,0.895947507250048,33.6794812952632,2.65400319545535
2020-05-01,1814,40,1786,36,28,4,1929,29,35562,1662,37491,1691,0,37,-16,811,56,966,0,184,40,"East TN",2455501,11.1586189539324,0.0268259252007049,68.8657833981741,1.62899546772736,33.0278831081722,2.68259252007049
2020-05-02,1835,21,1807,21,28,0,1966,37,37439,1877,39405,1914,0,37,-107,704,128,1094,3,187,40,"East TN",2455501,11.077169180546,0.0257631904005647,77.9474331307542,0.855222620556864,28.6703202320015,2.57631904005647
2020-05-03,1873,38,1840,33,33,5,2003,37,39559,2120,41562,2157,0,37,-20,684,58,1152,3,190,42,"East TN",2455501,11.8102171410234,0.0245383867832847,87.8435805971979,1.54754569434099,27.8558224981379,2.45383867832847
2020-05-04,1920,47,1884,44,36,3,2060,57,41505,1946,43565,2003,0,37,-312,372,359,1511,1,191,42,"East TN",2455501,10.9142696337733,0.0215504340017959,81.5719480464475,1.91406967457965,15.1496578498644,2.15504340017959
2020-05-05,1948,28,1911,27,37,1,2092,32,44415,2910,46507,2942,2,39,-45,327,71,1582,1,192,42,"East TN",2455501,10.5477456535347,0.0198694294635254,119.812616651347,1.14029682740915,13.3170379486712,1.98694294635254
2020-05-06,1985,37,1948,37,37,0,2135,43,45459,1044,47594,1087,1,40,7,334,29,1611,0,192,42,"East TN",2455501,9.48889859951187,0.0207844723008492,44.267951835491,1.50682080764781,13.6021121555235,2.07844723008492
2020-05-07,2028,43,1989,41,39,2,2183,48,46850,1391,49033,1439,0,40,18,352,25,1636,4,196,46,"East TN",2455501,10.3441212200687,0.0213859291166024,58.6031119514918,1.75117012780691,14.3351601160008,2.13859291166024
2020-05-08,2047,19,2008,19,39,0,2219,36,48520,1670,50739,1706,1,41,-15,337,33,1669,0,196,47,"East TN",2455501,9.48889859951187,0.0218900966183575,69.4766566985719,0.773772847170496,13.724286815603,2.18900966183575
2020-05-09,2063,16,2022,14,41,2,2237,18,51338,2818,53575,2836,0,41,-32,305,48,1717,1,197,48,"East TN",2455501,9.28527416604595,0.0191249117854622,115.49577866187,0.651598187090944,12.4210904414211,1.91249117854622
2020-05-10,2079,16,2037,15,42,1,2256,19,53902,2564,56158,2583,1,42,-27,278,42,1759,3,200,48,"East TN",2455501,8.3893266587959,0.0173335160317895,105.192382328494,0.651598187090944,11.3215185007052,1.73335160317895
2020-05-11,2140,61,2097,60,43,1,2307,51,55473,1571,57780,1622,3,45,13,291,45,1804,5,205,50,"East TN",2455501,8.95947507250048,0.0173760112557158,66.0557662163444,2.48421808828422,11.8509420277165,1.73760112557158
2020-05-12,2193,53,2150,53,43,0,2373,66,59028,3555,61401,3621,3,48,30,321,20,1824,3,208,50,"East TN",2455501,9.97759723983008,0.0188666577145159,147.464814716019,2.15841899473875,13.0726886285121,1.88666577145159
2020-05-13,2247,54,2201,51,46,3,2425,52,60653,1625,63078,1677,0,48,18,339,36,1860,7,215,52,"East TN",2455501,10.6699203136142,0.0187290105915784,68.2956349844696,2.19914388143194,13.8057365889894,1.87290105915784
2020-05-14,2278,31,2232,31,46,0,2470,45,62361,1708,64831,1753,1,49,-2,337,32,1892,2,217,53,"East TN",2455501,10.181221673296,0.018166856564122,71.3907263731516,1.2624714874887,13.724286815603,1.8166856564122
2020-05-15,2306,28,2260,28,46,0,2507,37,64680,2319,67187,2356,1,50,-21,316,48,1940,4,221,53,"East TN",2455501,10.5477456535347,0.0175097276264591,95.9478330491415,1.14029682740915,12.8690641950461,1.75097276264591
2020-05-16,2316,10,2270,10,46,0,2525,18,67449,2769,69974,2787,1,51,-28,288,37,1977,1,222,53,"East TN",2455501,10.3033963333756,0.0175620464662479,113.500259213904,0.40724886693184,11.728767367637,1.75620464662479
2020-05-17,2396,80,2350,80,46,0,2604,79,69676,2227,72280,2306,0,51,59,347,21,1998,4,226,55,"East TN",2455501,12.9097890817393,0.0215854112393003,93.9115887144823,3.25799093545472,14.1315356825348,2.15854112393003
2020-05-18,2445,49,2398,48,47,1,2665,61,71554,1878,74219,1939,0,51,8,355,41,2039,3,229,55,"East TN",2455501,12.4210904414211,0.0217774803820184,78.9655552980838,1.99551944796602,14.4573347760803,2.17774803820184
2020-05-19,2486,41,2438,40,48,1,2705,40,72678,1124,75383,1164,1,52,-6,349,46,2085,3,232,55,"East TN",2455501,11.9323918011029,0.0237448147618366,47.4037681108662,1.66972035442054,14.2129854559212,2.37448147618366
2020-05-20,2528,42,2480,42,48,0,2750,45,74418,1740,77168,1785,0,52,13,362,29,2114,3,235,55,"East TN",2455501,11.4436931607847,0.0230660042583392,72.6939227473334,1.71044524111373,14.7424089829326,2.30660042583392
2020-05-21,2769,241,2720,240,49,1,2988,238,75880,1462,78868,1700,0,52,211,573,30,2144,4,239,56,"East TN",2455501,19.9959193663533,0.0369024720381848,69.2323073784128,9.81469769305734,23.3353600751944,3.69024720381848
2020-05-22,2860,91,2808,88,52,3,3066,78,77404,1524,80470,1602,0,52,40,613,51,2195,7,246,56,"East TN",2455501,22.5615872280239,0.0420838665964014,65.2412684824808,3.70596468907974,24.9643555429218,4.20838665964014
2020-05-23,2926,66,2870,62,56,4,3157,91,79619,2215,82776,2306,2,54,36,649,28,2223,7,253,57,"East TN",2455501,24.8421808828422,0.049367286361506,93.9115887144823,2.68784252175014,26.4304514638764,4.9367286361506
2020-05-24,2978,52,2922,52,56,0,3227,70,81739,2120,84966,2190,0,54,26,675,26,2249,0,253,58,"East TN",2455501,23.7018840554331,0.0491092542960744,89.187501858073,2.11769410804557,27.4892985178992,4.91092542960744
2020-05-25,3062,84,3005,83,57,1,3321,94,84389,2650,87710,2744,1,55,42,717,41,2290,2,255,58,"East TN",2455501,25.1272550896945,0.0486250092654362,111.749089086097,3.42089048222746,29.1997437590129,4.86250092654362
2020-05-26,3123,61,3057,52,66,9,3377,56,86775,2386,90152,2442,1,56,15,732,45,2335,3,258,58,"East TN",2455501,25.9417528235582,0.0455007109486086,99.4501733047553,2.48421808828422,29.8106170594107,4.55007109486086
2020-05-27,3199,76,3130,73,69,3,3444,67,88642,1867,92086,1934,0,56,40,772,36,2371,9,267,58,"East TN",2455501,27.3263989711265,0.0465209813647942,78.7619308646179,3.09509138868198,31.439612527138,4.65209813647942
2020-05-28,3273,74,3204,74,69,0,3511,67,90041,1399,93552,1466,0,56,14,786,60,2431,1,268,58,"East TN",2455501,20.5253428933647,0.0356169980931626,59.7026838922077,3.01364161529562,32.0097609408426,3.56169980931626
2020-05-29,3348,75,3278,74,70,1,3594,83,91319,1278,94913,1361,0,56,10,796,65,2496,4,272,58,"East TN",2455501,19.8737447062738,0.0365575019040366,55.4265707894234,3.0543665019888,32.4170098077745,3.65575019040366
2020-05-30,3421,73,3350,72,71,1,3675,81,93564,2245,97239,2326,0,56,-1,795,74,2570,5,277,59,"East TN",2455501,20.1588189131261,0.0358155292816152,94.726086448346,2.97291672860243,32.3762849210813,3.58155292816152
2020-05-31,3533,112,3460,110,73,2,3769,94,96347,2783,100116,2877,0,56,71,866,41,2611,1,278,60,"East TN",2455501,22.6023121147171,0.0357755775577558,117.16549901629,4.56118730963661,35.2677518762973,3.57755775577558
2020-06-01,3629,96,3553,93,76,3,3903,134,100179,3832,104082,3966,0,56,-169,697,265,2876,5,283,60,"East TN",2455501,23.0910107550353,0.0355484974346445,161.514900625168,3.90958912254566,28.3852460251492,3.55484974346445
2020-06-02,3736,107,3658,105,78,2,4018,115,104238,4059,108256,4174,1,57,16,713,90,2966,3,286,64,"East TN",2455501,24.9643555429218,0.0354065399911622,169.98567705735,4.35756287617069,29.0368442122402,3.54065399911622
2020-06-03,3786,50,3708,50,78,0,4068,50,106168,1930,110236,1980,0,57,-65,648,115,3081,4,290,65,"East TN",2455501,23.905508488899,0.0343801652892562,80.6352756525043,2.0362443346592,26.3897265771832,3.43801652892562
2020-06-04,3837,51,3757,49,80,2,4129,61,107716,1548,111845,1609,6,63,-37,611,82,3163,5,295,66,"East TN",2455501,22.9688360949558,0.0337834144208167,65.526342689333,2.07696922135238,24.8829057695354,3.37834144208167
2020-06-05,3936,99,3852,95,84,4,4211,82,109872,2156,114083,2238,1,64,-43,568,141,3304,4,299,67,"East TN",2455501,23.9462333755922,0.0321857068335942,91.1422964193458,4.03176378262522,23.1317356417285,3.21857068335942
2020-06-06,3989,53,3902,50,87,3,4286,75,112977,3105,117263,3180,1,65,-14,554,66,3370,4,303,67,"East TN",2455501,23.1317356417285,0.0305133839392729,129.505139684325,2.15841899473875,22.5615872280239,3.05133839392729
2020-06-07,4047,58,3958,56,89,2,4367,81,116937,3960,121304,4041,0,65,-8,546,66,3436,6,309,68,"East TN",2455501,20.9325917602966,0.0282235227487257,164.569267127157,2.36204342820467,22.2357881344785,2.82235227487257
2020-06-08,4207,160,4114,156,93,4,4524,157,119888,2951,124412,3108,0,65,75,621,85,3521,6,315,68,"East TN",2455501,23.5389845086604,0.0305459911460895,126.572947842416,6.51598187090944,25.2901546364673,3.05459911460895
2020-06-09,4315,108,4221,107,94,1,4642,118,122215,2327,126857,2445,1,66,-35,586,142,3663,7,322,69,"East TN",2455501,23.5797093953535,0.0335465835170152,99.5723479648349,4.39828776286387,23.8647836022058,3.35465835170152
2020-06-10,4392,77,4295,74,97,3,4716,74,125053,2838,129769,2912,0,66,-63,523,140,3803,6,328,69,"East TN",2455501,24.6792813360695,0.0331746275533712,118.590870050552,3.13581627537517,21.2991157405352,3.31746275533712
2020-06-11,4656,264,4557,262,99,2,4996,280,127344,2291,132340,2571,1,67,149,672,114,3917,8,336,69,"East TN",2455501,33.3536822017177,0.0423030007318858,104.703683688176,10.7513700870006,27.3671238578196,4.23030007318858
2020-06-12,4827,171,4727,170,100,1,5168,172,129972,2628,135140,2800,2,69,24,696,145,4062,3,339,70,"East TN",2455501,36.2858740436269,0.0454480695255734,114.029682740915,6.96395562453446,28.3445211384561,4.54480695255734
2020-06-13,4975,148,4871,144,104,4,5336,168,132163,2191,137499,2359,0,69,50,746,98,4160,4,343,71,"East TN",2455501,40.1547382794794,0.0518877248468077,96.0700077092211,6.02728323059123,30.3807654731153,5.18877248468077
2020-06-14,5091,116,4986,115,105,1,5471,135,136033,3870,141504,4005,0,69,30,776,86,4246,4,347,72,"East TN",2455501,42.5167817076841,0.0546534653465347,163.103171206202,4.72408685640934,31.6025120739108,5.46534653465347
2020-06-15,5273,182,5157,171,116,11,5650,179,139207,3174,144857,3353,0,69,58,834,124,4370,9,356,77,"East TN",2455501,43.4127292149341,0.0550745903643923,136.550545082246,7.41192937815949,33.9645555021155,5.50745903643923
2020-06-16,5427,154,5309,152,118,2,5808,158,141007,1800,146815,1958,3,72,64,898,87,4457,4,360,80,"East TN",2455501,45.2860740028206,0.0584226876440525,79.7393281452543,6.27163255075034,36.5709482504792,5.84226876440525
2020-06-17,5560,133,5439,130,121,3,5930,122,142447,1440,148377,1562,3,75,-6,892,136,4593,6,366,82,"East TN",2455501,47.5666676576389,0.0652407566638005,63.6122730147534,5.41640993019347,36.3265989303201,6.52407566638005
2020-06-18,5738,178,5616,177,122,1,6136,206,146038,3591,152174,3797,1,76,42,934,135,4728,12,378,82,"East TN",2455501,44.0643274020251,0.0574770595946355,154.63239477402,7.24902983138675,38.0370441714339,5.74770595946355
2020-06-19,5873,135,5747,131,126,4,6254,118,147502,1464,153756,1582,4,80,22,956,109,4837,13,391,83,"East TN",2455501,42.5982314810705,0.0583369144821659,64.4267707486171,5.49785970357984,38.9329916786839,5.83369144821659
2020-06-20,5939,66,5812,65,127,1,6349,95,149677,2175,156026,2270,0,80,-44,912,110,4947,7,398,83,"East TN",2455501,39.2587907722294,0.0546769579532574,92.4454927935277,2.68784252175014,37.1410966641838,5.46769579532574
2020-06-21,6027,88,5899,87,128,1,6468,119,153027,3350,159495,3469,1,81,0,912,87,5034,3,401,86,"East TN",2455501,38.1184939448202,0.0554165971874826,141.274631938655,3.58379002900019,37.1410966641838,5.54165971874826
2020-06-22,6223,196,6088,189,135,7,6666,198,156438,3411,163104,3609,1,82,43,955,152,5186,7,408,87,"East TN",2455501,38.6886423585248,0.0556803858168466,146.976116075701,7.98207779186406,38.8922667919907,5.56803858168466
2020-06-23,6413,190,6272,184,141,6,6850,184,158243,1805,165093,1989,4,86,57,1012,129,5315,15,423,87,"East TN",2455501,40.1547382794794,0.0570084254294781,81.001799632743,7.73772847170496,41.2135853335022,5.70084254294781
2020-06-24,6591,178,6448,176,143,2,7033,183,159874,1631,166907,1814,2,88,38,1050,138,5453,9,432,87,"East TN",2455501,41.9873581806727,0.0595250944414463,73.8749444614358,7.24902983138675,42.7611310278432,5.95250944414463
2020-06-25,6760,169,6608,160,152,9,7217,184,163048,3174,170265,3358,0,88,22,1072,147,5600,8,440,87,"East TN",2455501,41.620834200434,0.0597534685755348,136.754169515712,6.8825058511481,43.6570785350932,5.97534685755348
2020-06-26,6974,214,6812,204,162,10,7389,172,164637,1589,172026,1761,1,89,67,1139,146,5746,16,456,87,"East TN",2455501,44.8381002491956,0.0621237000547345,71.716525466697,8.71512575234138,46.3856459435366,6.21237000547345
2020-06-27,7048,74,6881,69,167,5,7435,46,164846,209,172281,255,-1,88,-52,1087,127,5873,5,461,89,"East TN",2455501,45.1638993427411,0.066810212242387,10.3848461067619,3.01364161529562,44.267951835491,6.6810212242387
2020-06-28,7175,127,7006,125,169,2,7606,171,167933,3087,175539,3258,0,88,30,1117,97,5970,5,466,90,"East TN",2455501,46.7521699237752,0.0709299426576914,132.681680846393,5.17206061003437,45.4896984362865,7.09299426576914
2020-06-29,7518,343,7347,341,171,2,7946,340,173201,5268,181147,5608,1,89,147,1264,195,6165,22,488,91,"East TN",2455501,52.7387282676733,0.0709416394169484,228.385164575376,13.9686361357621,51.4762567801846,7.09416394169484
2020-06-30,7788,270,7613,266,175,4,8394,448,179487,6286,187881,6734,0,89,100,1364,170,6335,22,510,92,"East TN",2455501,55.996719203128,0.0677549587502194,274.241386991901,10.9957194071597,55.548745449503,6.77549587502194
2020-07-01,8063,275,7885,272,178,3,8728,334,182691,3204,191419,3538,0,89,66,1430,209,6544,17,527,95,"East TN",2455501,59.9470332123668,0.0691498041775457,144.084649120485,11.1993438406256,58.2365879712531,6.91498041775457
2020-07-02,8543,480,8360,475,183,5,9334,606,189074,6383,198408,6989,2,91,314,1744,164,6708,25,552,98,"East TN",2455501,72.6124729739471,0.0752229684113279,284.626233098663,19.5479456127283,71.0242023929129,7.52229684113279
2020-07-03,8769,226,8580,220,189,6,9562,228,192430,3356,201992,3584,5,96,24,1768,197,6905,14,566,99,"East TN",2455501,73.1011716142653,0.0725155175865981,145.957993908371,9.20382439265958,72.0015996735493,7.25155175865982
2020-07-04,8989,220,8798,218,191,2,9842,280,197194,4764,207036,5044,2,98,77,1845,141,7046,15,581,105,"East TN",2455501,79.0470050714701,0.0692562221263128,205.41632848042,8.95947507250048,75.1374159489245,6.92562221263128
2020-07-05,9309,320,9117,319,192,1,10210,368,201041,3847,211251,4215,2,100,163,2008,155,7201,12,593,108,"East TN",2455501,86.9069082032546,0.0729166666666667,171.655397411771,13.0319637418189,81.7755724799135,7.29166666666667
2020-07-06,9543,234,9340,223,203,11,10420,210,202672,1631,213092,1841,4,104,-51,1957,281,7482,26,619,108,"East TN",2455501,82.4678955536976,0.0774456096415714,74.9745164021517,9.52962348620506,79.6986032585611,7.74456096415715
2020-07-07,9991,448,9779,439,212,9,10986,566,208950,6278,219936,6844,0,104,159,2116,289,7771,32,651,109,"East TN",2455501,89.7169253850844,0.0808610201216659,278.721124528151,18.2447492385464,86.1738602427773,8.08610201216659
2020-07-08,10372,381,10150,371,222,10,11420,434,213121,4171,224541,4605,1,105,61,2177,319,8090,20,671,109,"East TN",2455501,94.0337633745619,0.0812752853088582,187.538103222112,15.5161818301031,88.6580783310616,8.12752853088582
2020-07-09,10821,449,10585,435,236,14,11892,472,219070,5949,230962,6421,1,106,149,2326,299,8389,24,695,113,"East TN",2455501,92.7712918870731,0.0785771333783867,261.494497456934,18.2854741252396,94.726086448346,7.85771333783867
2020-07-10,11288,467,11040,455,248,12,12345,453,222354,3284,234699,3737,0,106,141,2467,326,8715,29,724,115,"East TN",2455501,102.58598958013,0.0850888189072676,152.188901572429,19.0185220857169,100.468295472085,8.50888189072676
2020-07-11,11594,306,11339,299,255,7,12767,422,226832,4478,239599,4900,5,111,44,2511,257,8972,23,747,120,"East TN",2455501,106.088329835744,0.0898258759942266,199.551944796602,12.4618153281143,102.260190486585,8.98258759942266
2020-07-12,12064,470,11801,462,263,8,13400,633,232762,5930,246162,6563,1,112,222,2733,247,9219,25,772,125,"East TN",2455501,112.197062839722,0.091375211251468,267.277431367367,19.1406967457965,111.301115332472,9.1375211251468
2020-07-13,12418,354,12142,341,276,13,13743,343,236196,3434,249939,3777,3,115,-119,2614,470,9689,20,792,129,"East TN",2455501,117.084049242904,0.0901837327326512,153.817897040156,14.4166098893871,106.454853815983,9.01837327326512
2020-07-14,12933,515,12652,510,281,5,14327,584,240684,4488,255011,5072,4,119,77,2691,434,10123,34,826,133,"East TN",2455501,119.812616651347,0.0952530292230934,206.556625307829,20.9733166469898,109.590670091358,9.52530292230934
2020-07-15,13313,380,13026,374,287,6,14710,383,243781,3097,258491,3480,6,125,-106,2585,480,10603,24,850,140,"East TN",2455501,119.771891764654,0.0969072164948454,141.72260569228,15.4754569434099,105.273832101881,9.69072164948454
2020-07-16,14140,827,13838,812,302,15,15807,1097,253615,9834,269422,10931,6,131,349,2934,472,11075,44,894,142,"East TN",2455501,135.165898934678,0.101794071762871,445.163736443194,33.6794812952632,119.486817557802,10.1794071762871
2020-07-17,14608,468,14292,454,316,14,16318,511,257934,4319,274252,4830,3,134,95,3029,370,11445,24,918,147,"East TN",2455501,135.206623821371,0.100447500821682,196.701202728079,19.0592469724101,123.355681793654,10.0447500821682
2020-07-18,15117,509,14786,494,331,15,16986,668,266024,8090,283010,8758,6,140,185,3214,318,11763,27,945,150,"East TN",2455501,143.473775820087,0.0971873488286379,356.668557658905,20.7289673268307,130.889785831893,9.71873488286379
2020-07-19,15598,481,15248,462,350,19,17546,560,270878,4854,288424,5414,0,140,76,3290,405,12168,26,971,154,"East TN",2455501,143.921749573712,0.0981023141356301,220.484536556898,19.5886704994215,133.984877220575,9.81023141356301
2020-07-20,16034,436,15669,421,365,15,17957,411,273335,2457,291292,2868,2,142,-270,3020,704,12872,29,1000,158,"East TN",2455501,147.261190282553,0.101903126738084,116.798975036052,17.7560505982282,122.989157813416,10.1903126738084
2020-07-21,17035,1001,16653,984,382,17,19169,1212,281713,8378,300882,9590,1,143,381,3401,619,13491,61,1061,161,"East TN",2455501,167.053485215441,0.105556887794031,390.551663387635,40.7656115798772,138.505339643519,10.5556887794031
2020-07-22,17619,584,17221,568,398,16,19823,654,285013,3300,304836,3954,4,147,-79,3322,659,14150,29,1090,166,"East TN",2455501,175.36136210085,0.110324738375229,161.02620198485,23.7833338288195,135.288073594757,11.0324738375229
2020-07-23,18414,795,17994,773,420,22,20822,999,295216,10203,316038,11202,4,151,242,3564,549,14699,50,1140,172,"East TN",2455501,174.058165726668,0.107581088038442,456.200180737047,32.3762849210813,145.143496174508,10.7581088038442
2020-07-24,19017,603,18584,590,433,13,21506,684,301026,5810,322532,6494,2,153,7,3571,594,15293,34,1174,179,"East TN",2455501,179.556025430248,0.107456503728252,264.467414185537,24.55710667599,145.42857038136,10.7456503728252
2020-07-25,19995,978,19550,966,445,12,22708,1202,310640,9614,333348,10816,10,163,550,4121,418,15711,29,1203,187,"East TN",2455501,198.655997289352,0.1136715801184,440.480374473478,39.8289391859339,167.827258062611,11.36715801184
2020-07-26,20770,775,20310,760,460,15,23605,897,318163,7523,341768,8420,1,164,391,4512,383,16094,21,1224,194,"East TN",2455501,210.629113977148,0.113583533293341,342.903545956609,31.5617871872176,183.750688759646,11.3583533293341
2020-07-27,21416,646,20934,624,482,22,24311,706,322629,4466,346940,5172,6,170,-78,4434,718,16812,38,1262,198,"East TN",2455501,219.181340182716,0.114182001150086,210.629113977148,26.3082768037969,180.574147597578,11.4182001150086
2020-07-28,22231,815,21726,792,505,23,25283,972,330850,8221,356133,9193,7,177,170,4604,638,17450,50,1312,203,"East TN",2455501,211.606511257784,0.110658630613021,374.38388337044,33.190782654945,187.497378335419,11.0658630613021
2020-07-29,22574,343,22058,332,516,11,25599,316,332420,1570,358019,1886,5,182,-337,4267,675,18125,24,1336,212,"East TN",2455501,201.791813564727,0.108606133538913,76.807136303345,13.9686361357621,173.773091519816,10.8606133538913
2020-07-30,23762,1188,23231,1173,531,15,26980,1381,344954,12534,371934,13915,5,187,674,4941,509,18634,46,1382,219,"East TN",2455501,217.796694035148,0.110168885072277,566.686798335655,48.3811653915026,201.221665151022,11.0168885072277
2020-07-31,24384,622,23837,606,547,16,27634,654,348922,3968,376556,4622,6,193,80,5021,536,19170,27,1409,228,"East TN",2455501,218.570466882319,0.113431067673627,188.230426295896,25.3308795231604,204.479656086477,11.3431067673627
2020-08-01,24943,559,24379,542,564,17,28270,636,355897,6975,384167,7611,1,194,152,5173,406,19576,16,1425,231,"East TN",2455501,201.506739357874,0.109447253979811,309.957112621823,22.7652116614899,210.669838863841,10.9447253979811
2020-08-02,25374,431,24799,420,575,11,28754,484,359695,3798,388449,4282,4,198,49,5222,378,19954,21,1446,236,"East TN",2455501,187.497378335419,0.110301835864699,174.383964820214,17.5524261647623,212.665358311807,11.0301835864699
2020-08-03,26000,626,25407,608,593,18,29462,708,363839,4144,393301,4852,3,201,-43,5179,666,20620,39,1485,244,"East TN",2455501,186.682880601555,0.111106317810228,197.597150235329,25.4937790699332,210.914188184,11.1106317810228
2020-08-04,26486,486,25873,466,613,20,29988,526,369210,5371,399198,5897,6,207,-218,4961,698,21318,34,1519,253,"East TN",2455501,173.284392879498,0.10925345408104,240.154656829706,19.7922949328874,202.036162884886,10.925345408104
2020-08-05,26954,468,26333,460,621,8,30509,521,373423,4213,403932,4734,9,216,-222,4739,681,21999,20,1539,259,"East TN",2455501,178.375003716146,0.106941389149043,192.791613605533,19.0592469724101,192.995238038999,10.6941389149043
2020-08-06,27685,731,27026,693,659,38,31361,852,380492,7069,411853,7921,7,223,202,4941,522,22521,37,1576,265,"East TN",2455501,159.763730497361,0.109747238157268,322.58182749671,29.7698921727175,201.221665151022,10.9747238157268
2020-08-07,28240,555,27567,541,673,14,31980,619,384462,3970,416442,4589,6,229,40,4981,509,23030,34,1610,278,"East TN",2455501,157.035163088917,0.108960537531966,186.886505035021,22.6023121147171,202.850660618749,10.8960537531966
2020-08-08,28915,675,28230,663,685,12,32780,800,394539,10077,427319,10877,8,237,290,5271,377,23407,24,1634,289,"East TN",2455501,161.759249945327,0.104514275120504,442.964592561762,27.4892985178992,214.660877759773,10.4514275120504
2020-08-09,29443,528,28746,516,697,12,33414,634,398840,4301,432254,4935,2,239,115,5386,411,23818,20,1654,296,"East TN",2455501,165.709563954566,0.106380550165506,200.977315830863,21.5027401740012,219.344239729489,10.6380550165506
2020-08-10,29746,303,29038,292,708,11,33742,328,401129,2289,434871,2617,3,242,-477,4909,777,24595,26,1680,300,"East TN",2455501,152.555425552667,0.102958864565793,106.577028476063,12.3396406680348,199.91846877684,10.2958864565793
2020-08-11,30358,612,29633,595,725,17,34427,685,407229,6100,441656,6785,17,259,-7,4902,602,25197,28,1708,305,"East TN",2455501,157.686761276008,0.104550379198267,276.318356213253,24.9236306562286,199.633394569988,10.4550379198267
2020-08-12,30803,445,30057,424,746,21,34901,474,410977,3748,445878,4222,6,265,-251,4651,690,25887,25,1733,310,"East TN",2455501,156.750088882065,0.104706050636533,171.940471618623,18.1225745784669,189.411448009999,10.4706050636533
2020-08-13,31620,817,30861,804,759,13,36018,1117,419540,8563,455558,9680,6,271,202,4853,609,26496,44,1777,318,"East TN",2455501,160.252429137679,0.106555314037295,394.216903190021,33.2722324283313,197.637875122022,10.6555314037295
2020-08-14,32081,461,31293,432,788,29,36552,534,424196,4656,460748,5190,4,275,-142,4711,599,27095,18,1795,325,"East TN",2455501,156.42428978852,0.103191441339773,211.362161937625,18.7741727655578,191.85494121159,10.3191441339773
2020-08-15,32731,650,31931,638,800,12,37429,877,431129,6933,468558,7810,4,279,216,4927,430,27525,17,1812,334,"East TN",2455501,155.40616762119,0.11273309246102,318.061365073767,26.4711763505696,200.651516737318,11.273309246102
2020-08-16,33205,474,32394,463,811,11,38022,593,436594,5465,474616,6058,2,281,110,5037,362,27887,10,1822,343,"East TN",2455501,153.207023739758,0.108776733865257,246.711363587309,19.3035962925692,205.131254273568,10.8776733865257
2020-08-17,33478,273,32597,203,881,70,38249,227,438066,1472,476315,1699,8,289,-397,4640,662,28549,12,1834,349,"East TN",2455501,151.985277138963,0.108749155486922,69.1915824917196,11.1178940672392,188.963474256374,10.8749155486922
2020-08-18,34108,630,33162,565,946,65,39061,812,448663,10597,487724,11409,8,297,52,4692,570,29119,22,1856,352,"East TN",2455501,152.71832509944,0.10059043153599,464.630232282536,25.6566786167059,191.081168364419,10.059043153599
2020-08-19,34563,455,33596,434,967,21,39558,497,453447,4784,493005,5281,7,304,-113,4579,561,29680,22,1878,359,"East TN",2455501,153.125573966372,0.0988180872960299,215.068126626705,18.5298234453987,186.47925616809,9.88180872960299
2020-08-20,35341,778,34353,757,988,21,40432,874,464986,11539,505418,12413,6,310,265,4844,507,30187,27,1905,367,"East TN",2455501,151.537303385338,0.088527878058564,505.518018522493,31.6839618472971,197.271351141783,8.8527878058564
2020-08-21,35550,209,34550,197,1000,12,40645,213,467437,2451,508082,2664,17,327,-321,4523,513,30700,17,1922,374,"East TN",2455501,141.274631938655,0.0864706130899565,108.491098150642,8.51150131887546,184.198662513271,8.64706130899565
2020-08-22,36419,869,35407,857,1012,12,41617,972,480804,13367,522421,14339,2,329,453,4976,414,31114,20,1942,381,"East TN",2455501,150.193382124463,0.077752817332863,583.954150293565,35.3899265363769,202.647036185284,7.7752817332863
2020-08-23,36672,253,35649,242,1023,11,41871,254,485910,5106,527781,5360,0,329,-94,4882,347,31461,20,1962,386,"East TN",2455501,141.193182165269,0.0723972538324085,218.285392675466,10.3033963333756,198.818896836124,7.23972538324085
2020-08-24,36864,192,35824,175,1040,17,42069,198,487253,1343,529322,1541,8,337,-485,4397,669,32130,15,1977,396,"East TN",2455501,137.894466343121,0.0720659535533043,62.7570503941965,7.81917824509133,179.06732678993,7.20659535533043
2020-08-25,37478,614,36413,589,1065,25,42754,685,496987,9734,539741,10419,16,353,120,4517,478,32608,23,2000,405,"East TN",2455501,137.24286815603,0.0709960205317492,424.312594456284,25.005080429615,183.954313193112,7.09960205317492
2020-08-26,37823,345,36733,320,1090,25,43138,384,500949,3962,544087,4346,6,359,-208,4309,547,33155,11,2011,413,"East TN",2455501,132.76313061978,0.0700833953251635,176.990357568578,14.0500859091485,175.48353676093,7.00833953251635
2020-08-27,38684,861,37577,844,1107,17,44114,976,511241,10292,555355,11268,8,367,387,4696,466,33621,29,2040,420,"East TN",2455501,136.143296215314,0.0737329034583575,458.888023258797,35.0641274428314,191.244067911192,7.37329034583575
2020-08-28,39018,334,37891,314,1127,20,44452,338,513850,2609,558302,2947,12,379,-182,4514,504,34125,10,2050,426,"East TN",2455501,141.233907051962,0.0758064516129032,120.016241084813,13.6021121555235,183.832138533033,7.58064516129032
2020-08-29,39469,451,38326,435,1143,16,44980,528,520369,6519,565349,7047,8,387,61,4575,382,34507,16,2066,435,"East TN",2455501,124.210904414211,0.0783404770778979,286.988276526868,18.366923898626,186.316356621317,7.83404770778979
2020-08-30,39732,263,38578,252,1154,11,45247,267,522250,1881,567497,2148,8,395,-55,4520,310,34817,14,2080,438,"East TN",2455501,124.618153281143,0.0850035250276966,87.4770566169592,10.7106452003074,184.076487853192,8.50035250276967
2020-08-31,40139,407,38956,378,1183,29,45697,450,525737,3487,571434,3937,2,397,-133,4387,538,35355,17,2097,443,"East TN",2455501,133.374003920178,0.0861512158054711,160.333878911065,16.5750288841259,178.660077922998,8.61512158054711
2020-09-01,40746,607,39521,565,1225,42,46371,674,531402,5665,577773,6339,6,403,105,4492,496,35851,28,2125,452,"East TN",2455501,133.088929713325,0.0951041228439209,258.155056748093,24.7200062227627,182.936191025783,9.51041228439209
2020-09-02,41234,488,39980,459,1254,29,46824,453,536195,4793,583019,5246,7,410,23,4515,458,36309,22,2147,459,"East TN",2455501,138.912588510451,0.0946778999280797,213.642755592443,19.8737447062738,183.872863419726,9.46778999280797
2020-09-03,41789,555,40502,522,1287,33,47471,647,544451,8256,591922,8903,6,416,-39,4476,588,36897,22,2169,462,"East TN",2455501,126.450773182336,0.0918040856509968,362.573666229417,22.6023121147171,182.284592838692,9.18040856509968
2020-09-04,42146,357,40845,343,1301,14,47819,348,547783,3332,595602,3680,7,423,-40,4436,390,37287,11,2180,463,"East TN",2455501,127.38744557628,0.0902680965147453,149.867583030917,14.5387845494667,180.655597370964,9.02680965147453
2020-09-05,43144,998,41828,983,1316,15,48909,1090,557102,9319,606011,10409,1,424,640,5076,357,37644,26,2206,469,"East TN",2455501,149.663958597451,0.0966258423097733,423.905345589352,40.6434369197976,206.719524854602,9.66258423097733
2020-09-06,43407,263,42075,247,1332,16,49177,268,559729,2627,608906,2895,0,424,-51,5025,314,37958,9,2215,483,"East TN",2455501,149.663958597451,0.0949069042961675,117.898546976768,10.7106452003074,204.64255563325,9.49069042961675
2020-09-07,43611,204,42272,197,1339,7,49414,237,561065,1336,610479,1573,3,427,-342,4683,543,38501,13,2228,487,"East TN",2455501,141.396806598735,0.095197848636189,64.0602467683784,8.30787688540954,190.714644384181,9.5197848636189
2020-09-08,43922,311,42561,289,1361,22,49734,320,564491,3426,614225,3746,7,434,-302,4381,606,39107,24,2252,494,"East TN",2455501,129.342240137552,0.0922583123011083,152.555425552667,12.6654397615802,178.415728602839,9.22583123011083
2020-09-09,44255,333,42877,316,1378,17,50109,375,569637,5146,619746,5521,6,440,-161,4220,488,39595,16,2268,501,"East TN",2455501,123.029882700109,0.0894437334930705,224.842099433069,13.5613872688303,171.859021845236,8.94437334930705
2020-09-10,44930,675,43515,638,1415,37,50816,707,577448,7811,628264,8518,18,458,194,4414,463,40058,39,2307,512,"East TN",2455501,127.916869103291,0.0920422651477629,346.894584852541,27.4892985178992,179.759649863714,9.20422651477629
2020-09-11,45256,326,43818,303,1438,23,51171,355,581608,4160,632779,4515,17,475,-205,4209,514,40572,26,2333,523,"East TN",2455501,126.654397615802,0.0901632729913656,183.872863419726,13.276313061978,171.411048091611,9.01632729913656
2020-09-12,45675,419,44219,401,1456,18,51683,512,588594,6986,640277,7498,10,485,92,4301,317,40889,15,2348,534,"East TN",2455501,103.074688220449,0.080954882390708,305.355200425494,17.0637275244441,175.157737667384,8.0954882390708
2020-09-13,46115,440,44639,420,1476,20,52185,502,594168,5574,646353,6076,2,487,48,4349,390,41279,21,2369,539,"East TN",2455501,110.282993165142,0.0803268619649104,247.444411547786,17.918950145001,177.112532228657,8.03268619649104
2020-09-14,46559,444,45068,429,1491,15,52670,485,599141,4973,651811,5458,9,496,-151,4198,586,41865,25,2394,549,"East TN",2455501,120.056965971506,0.0787767347333785,222.276431571398,18.0818496917737,170.963074337986,7.87767347333785
2020-09-15,47052,493,45524,456,1528,37,53210,540,607317,8176,660527,8716,7,503,-66,4132,552,42417,20,2414,552,"East TN",2455501,127.468895349666,0.0750723510863462,354.958112417792,20.0773691397397,168.275231816236,7.50723510863462
2020-09-16,47405,353,45834,310,1571,43,53604,394,610731,3414,664335,3808,6,509,-175,3957,522,42939,17,2431,561,"East TN",2455501,128.28339308353,0.0783825607212541,155.080368527645,14.375885002694,161.148376644929,7.83825607212541
2020-09-17,47956,551,46353,519,1603,32,54181,577,617906,7175,672087,7752,8,517,119,4076,424,43363,21,2452,572,"East TN",2455501,123.233507133575,0.0767861625173995,315.699321645562,22.4394125679444,165.994638161418,7.67861625173995
2020-09-18,48490,534,46839,486,1651,48,54747,566,626020,8114,680767,8680,17,534,-29,4047,546,43909,30,2482,578,"East TN",2455501,131.704283565757,0.0745186296574143,353.492016496837,21.7470894941603,164.813616447316,7.45186296574143
2020-09-19,48998,508,47324,485,1674,23,55320,573,634374,8354,689694,8927,3,537,193,4240,312,44221,30,2512,580,"East TN",2455501,135.32879848145,0.0735981544812514,363.551063510054,20.6882424401375,172.6735195791,7.35981544812514
2020-09-20,49304,306,47605,281,1699,25,55649,329,639332,4958,694981,5287,1,538,-19,4221,324,44545,13,2525,591,"East TN",2455501,129.871663664564,0.071234679608456,215.312475946864,12.4618153281143,171.89974673193,7.1234679608456
2020-09-21,49467,163,47738,133,1729,30,55801,152,640849,1517,696650,1669,3,541,-208,4013,368,44913,9,2534,596,"East TN",2455501,118.427970503779,0.0698276054327706,67.9698358909241,6.63815653098899,163.428970299747,6.98276054327706
2020-09-22,49927,460,48140,402,1787,58,56291,490,646998,6149,703289,6639,6,547,-55,3958,509,45422,29,2563,603,"East TN",2455501,117.084049242904,0.072049950890978,270.372522756049,18.7334478788646,161.189101531622,7.2049950890978
2020-09-23,50221,294,48394,254,1827,40,56573,282,649091,2093,705664,2375,8,555,-217,3741,503,45925,13,2576,612,"East TN",2455501,114.681280928006,0.0718381765830289,96.721605896312,11.9731166877961,152.351801119201,7.18381765830289
2020-09-24,50684,463,48836,442,1848,21,57054,481,655984,6893,713038,7374,11,566,-36,3705,488,46413,28,2604,617,"East TN",2455501,111.097490899006,0.0701570169226637,300.305314475539,18.8556225389442,150.885705198247,7.01570169226637
2020-09-25,51138,454,49266,430,1872,24,57540,486,662657,6673,720197,7159,11,577,14,3719,429,46842,18,2622,624,"East TN",2455501,107.839499963551,0.0708343900583312,291.549463836504,18.4890985587055,151.455853611951,7.08343900583312
2020-09-26,51696,558,49800,534,1896,24,58178,638,673213,10556,731391,11194,5,582,194,3913,359,47201,29,2651,631,"East TN",2455501,109.87574429821,0.068542101350217,455.874381643502,22.7244867747967,159.356481630429,6.8542101350217
2020-09-27,52089,393,50165,365,1924,28,58585,407,679232,6019,737817,6426,3,585,91,4004,299,47500,30,2681,638,"East TN",2455501,113.418809440517,0.0685404799701186,261.6981218904,16.0048804704213,163.062446319509,6.85404799701186
2020-09-28,52323,234,50360,195,1963,39,58810,225,680919,1687,739729,1912,4,589,-315,3689,545,48045,15,2696,645,"East TN",2455501,116.310276395733,0.0698484180227025,77.8659833573678,9.52962348620506,150.234107011156,6.98484180227025
2020-09-29,52706,383,50700,340,2006,43,59207,397,686728,5809,745935,6206,9,598,-43,3646,417,48462,33,2729,647,"East TN",2455501,113.174460120358,0.0683768700464287,252.7386468179,15.5976316034895,148.482936883349,6.83768700464287
2020-09-30,53188,482,51150,450,2038,32,59683,476,690166,3438,749849,3914,6,604,79,3725,397,48859,23,2752,651,"East TN",2455501,120.830738818677,0.070385877560258,159.397206517122,19.6293953861147,151.70020293211,7.0385877560258
2020-10-01,53576,388,51499,349,2077,39,60062,379,693446,3280,753508,3659,11,615,0,3725,377,49236,31,2783,656,"East TN",2455501,117.776372316688,0.0743266617247344,149.01236041036,15.8012560369554,151.70020293211,7.43266617247344
2020-10-02,54041,465,51936,437,2105,28,60525,463,697067,3621,757592,4084,2,617,24,3749,439,49675,17,2800,660,"East TN",2455501,118.224346070313,0.0798235058162856,166.320437254963,18.9370723123306,152.677600212747,7.98235058162856
2020-10-03,54446,405,52324,388,2122,17,61008,483,704527,7460,765535,7943,12,629,83,3832,310,49985,22,2822,666,"East TN",2455501,111.993438406256,0.0828842549203374,323.477775003961,16.4935791107395,156.057765808281,8.28842549203374
2020-10-04,54901,455,52749,425,2152,30,61547,539,714650,10123,776197,10662,4,633,144,3976,307,50292,27,2849,679,"East TN",2455501,114.518381381233,0.0771756122980719,434.208741922728,18.5298234453987,161.9221494921,7.71756122980719
2020-10-05,55572,671,53361,612,2211,59,62298,751,721898,7248,784196,7999,5,638,151,4127,515,50807,42,2891,688,"East TN",2455501,132.315156866155,0.0784401916027616,325.758368658779,27.3263989711265,168.07160738277,7.84401916027616
2020-10-06,56322,750,54027,666,2295,84,63037,739,728538,6640,791575,7379,8,646,302,4429,440,51247,46,2937,697,"East TN",2455501,147.261190282553,0.0839176161262051,300.508938909005,30.543665019888,180.370523164112,8.39176161262051
2020-10-07,57059,737,54686,659,2373,78,63745,708,735291,6753,799036,7461,3,649,293,4722,441,51688,38,2975,703,"East TN",2455501,157.646036389315,0.0825827962673064,303.848379617846,30.0142414928766,192.302914965215,8.25827962673064
2020-10-08,57777,718,55343,657,2434,61,64423,678,741752,6461,806175,7139,10,659,266,4988,442,52130,32,3007,709,"East TN",2455501,171.085248998066,0.0828032733970038,290.734966102641,29.2404686457061,203.135734825602,8.28032733970038
2020-10-09,58318,541,55842,499,2476,42,64983,560,747231,5479,812214,6039,4,663,123,5111,414,52544,20,3027,716,"East TN",2455501,174.180340386748,0.0816154662956318,245.937590740138,22.0321637010125,208.144895888863,8.16154662956318
2020-10-10,58936,618,56430,588,2506,30,65652,669,755657,8426,821309,9095,12,675,252,5363,354,52898,20,3047,730,"East TN",2455501,182.854741252396,0.0832646035787284,370.392844474508,25.1679799763877,218.407567335546,8.32646035787285
2020-10-11,59879,943,57342,912,2537,31,66681,1029,766085,10428,832766,11457,1,676,586,5949,356,53254,37,3084,737,"East TN",2455501,202.72848595867,0.0907564213615231,466.585026843809,38.4035681516725,242.272350937752,9.07564213615231
2020-10-12,60235,356,57627,285,2608,71,66998,317,769006,2921,836004,3238,6,682,-337,5612,687,53941,19,3103,748,"East TN",2455501,189.900146650317,0.0907195799876467,131.86718311253,14.4980596627735,228.548064122149,9.07195799876467
2020-10-13,60740,505,58080,453,2660,52,67482,484,773391,4385,840873,4869,9,691,7,5619,489,54430,24,3127,755,"East TN",2455501,179.922549410487,0.0901659296523186,198.289473309113,20.5660677800579,228.833138329001,9.01659296523185
2020-10-14,61614,874,58892,812,2722,62,68330,848,779575,6184,847905,7032,1,692,328,5947,545,54975,44,3171,762,"East TN",2455501,185.501858887453,0.0938222595101189,286.37740322647,35.5935509698428,242.190901164365,9.38222595101189
2020-10-15,62123,509,59332,440,2791,69,68795,465,783729,4154,852524,4619,14,706,-67,5880,562,55537,19,3190,771,"East TN",2455501,176.990357568578,0.0943278172128849,188.108251635817,20.7289673268307,239.462333755922,9.43278172128849
2020-10-16,62762,639,59928,596,2834,43,69379,584,787818,4089,857197,4673,2,708,-135,5745,772,56309,22,3212,783,"East TN",2455501,180.98139646451,0.0977258075272881,190.307395517249,26.0232025969446,233.964474052342,9.77258075272881
2020-10-17,63480,718,60609,681,2871,37,70239,860,796602,8784,866841,9644,6,714,237,5982,475,56784,37,3249,790,"East TN",2455501,185.053885133828,0.100742335061056,392.750807269066,29.2404686457061,243.616272198627,10.0742335061056
2020-10-18,64285,805,61368,759,2917,46,71110,871,804712,8110,875822,8981,3,717,348,6330,454,57238,39,3288,798,"East TN",2455501,179.433850770169,0.102866034931252,365.750207391485,32.7835337880131,257.788532767855,10.2866034931252
2020-10-19,65033,748,62053,685,2980,63,71869,759,809611,4899,881480,5658,3,720,-19,6311,764,58002,67,3355,809,"East TN",2455501,195.398006353897,0.107111443398716,230.421408910035,30.4622152465016,257.014759920684,10.7111443398716
2020-10-20,65719,686,62662,609,3057,77,72560,691,813226,3615,885786,4306,15,735,34,6345,637,58639,32,3387,822,"East TN",2455501,202.769210845363,0.113063032974863,175.36136210085,27.9372722715242,258.399406068252,11.3063032974863
2020-10-21,66313,594,63215,553,3098,41,73177,617,816970,3744,890147,4361,5,740,-128,6217,717,59356,27,3414,836,"East TN",2455501,191.366242571272,0.114743620093746,177.601230868975,24.1905826957513,253.186620571525,11.4743620093746
2020-10-22,67443,1130,64251,1036,3192,94,74278,1101,825536,8566,899814,9667,10,750,440,6657,680,60036,43,3457,851,"East TN",2455501,216.656397207739,0.115944174244026,393.68747966301,46.0191219632979,271.105570716526,11.5944174244026
2020-10-23,68414,971,65155,904,3259,67,75248,970,832652,7116,907900,8086,19,769,290,6947,662,60698,39,3496,859,"East TN",2455501,230.177059589876,0.115752519574779,329.301433801086,39.5438649790817,282.915787857549,11.5752519574779
2020-10-24,69651,1237,66330,1175,3321,62,76575,1327,843177,10525,919752,11852,12,781,644,7591,581,61279,50,3546,876,"East TN",2455501,251.313275783638,0.119748256506209,482.671357087617,50.3766848394686,309.14261488796,11.9748256506209
2020-10-25,70580,929,67202,872,3378,57,77622,1047,851054,7877,928676,8924,9,790,437,8028,483,61762,43,3589,887,"East TN",2455501,256.363161733593,0.123207325840996,363.428888849974,37.8334197379679,326.939390372881,12.3207325840996
2020-10-26,71042,462,67608,406,3434,56,78056,434,853809,2755,931865,3189,6,796,-449,7579,905,62667,21,3610,900,"East TN",2455501,244.715844139343,0.122794482484867,129.871663664564,18.814897652251,308.653916247642,12.2794482484867
2020-10-27,71884,842,68320,712,3564,130,78839,783,858194,4385,937033,5168,12,808,80,7659,750,63417,54,3664,924,"East TN",2455501,251.068926463479,0.122524245321677,210.466214430375,34.2903545956609,311.911907183096,12.2524245321677
2020-10-28,72881,997,69231,911,3650,86,79809,970,865411,7217,945220,8187,13,821,200,7859,784,64201,41,3705,938,"East TN",2455501,267.481055800833,0.120421985364879,333.414647357097,40.6027120331044,320.056884521733,12.0421985364879
2020-10-29,73789,908,70024,793,3765,115,80643,834,871914,6503,952557,7337,11,832,151,8010,746,64947,40,3745,950,"East TN",2455501,258.440130954946,0.120679521453084,298.798493667891,36.9781971174111,326.206342412404,12.0679521453084
2020-10-30,74689,900,70831,807,3858,93,81483,840,876771,4857,958254,5697,28,860,50,8060,822,65769,39,3784,966,"East TN",2455501,255.54866399973,0.12382333081781,232.009679491069,36.6523980238656,328.242586747063,12.382333081781
2020-10-31,74703,14,70845,14,3858,0,81499,16,876792,21,958291,37,5,865,-603,7457,612,66381,0,3784,977,"East TN",2455501,205.742127573966,0.127766677910688,1.50682080764781,0.570148413704576,303.685480071073,12.7766677910688
2020-11-01,75210,507,71235,390,3975,117,81969,470,883356,6564,965325,7034,0,865,-137,7320,644,67025,27,3811,993,"East TN",2455501,188.556225389442,0.118611694725641,286.458852999856,20.6475175534443,298.106170594107,11.8611694725641
2020-11-02,76022,812,71979,744,4043,68,82746,777,887584,4228,970330,5005,11,876,-228,7092,1029,68054,38,3849,1007,"East TN",2455501,202.809935732056,0.121929026387625,203.828057899386,33.0686079948654,288.820896428061,12.1929026387625
2020-11-03,77062,1040,72939,960,4123,80,83822,1076,894448,6864,978270,7940,31,907,30,7122,979,69033,29,3878,1020,"East TN",2455501,210.873463297307,0.120838082304726,323.355600343881,42.3538821609114,290.042643028856,12.0838082304726
2020-11-04,77973,911,73751,812,4222,99,84669,847,899333,4885,984002,5732,6,913,-5,7117,910,69943,35,3913,1044,"East TN",2455501,207.371123041693,0.125315868186272,233.435050525331,37.1003717774906,289.839018595391,12.5315868186272
2020-11-05,78551,578,74235,484,4316,94,85170,501,901995,2662,987165,3163,17,930,-365,6752,926,70869,27,3940,1058,"East TN",2455501,193.931910432942,0.130807905686546,128.812816610541,23.5389845086603,274.974434952378,13.0807905686546
2020-11-06,79517,966,75084,849,4433,117,86097,927,908405,6410,994502,7337,10,940,43,6795,913,71782,37,3977,1082,"East TN",2455501,196.619752954692,0.127289781505186,298.798493667891,39.3402405456157,276.725605080185,12.7289781505186
2020-11-07,80844,1327,76325,1241,4519,86,87516,1419,919326,10921,1006842,12340,21,961,649,7444,657,72439,52,4029,1092,"East TN",2455501,250.091529182843,0.123931535910692,502.54510179389,54.0419246418552,303.156056544062,12.3931535910692
2020-11-08,82401,1557,77764,1439,4637,118,89183,1667,932227,12901,1021410,14568,3,964,889,8333,665,73104,52,4081,1109,"East TN",2455501,292.852660210686,0.128626192386556,593.280149346304,63.4086485812875,339.360480814302,12.8626192386556
2020-11-09,83020,619,78303,539,4717,80,89763,580,935679,3452,1025442,4032,9,973,-467,7866,1077,74181,19,4100,1120,"East TN",2455501,284.992757078902,0.127322543184787,164.202743146918,25.2087048630809,320.341958728585,12.7322543184787
2020-11-10,83959,939,79153,850,4806,89,90686,923,940681,5002,1031367,5925,27,1000,7,7873,905,75086,44,4144,1138,"East TN",2455501,280.87954352289,0.129272840273462,241.294953657115,38.2406686048998,320.627032935438,12.9272840273462
2020-11-11,85263,1304,80253,1100,5010,204,91855,1169,947228,6547,1039083,7716,26,1026,383,8256,895,75981,59,4203,1152,"East TN",2455501,296.884423993311,0.130462409905412,314.233225724608,53.1052522479119,336.224664538927,13.0462409905412
2020-11-12,86100,837,80958,705,5142,132,92619,764,951444,4216,1044063,4980,15,1041,8,8264,814,76795,34,4237,1170,"East TN",2455501,307.432169646846,0.130918485711273,202.809935732056,34.086730162195,336.550463632473,13.0918485711273
2020-11-13,87559,1459,82246,1288,5313,171,93919,1300,957306,5862,1051225,7162,27,1068,526,8790,906,77701,47,4284,1186,"East TN",2455501,327.509538786586,0.137898207076495,291.671638496584,59.4176096853555,357.971754033087,13.7898207076495
2020-11-14,89035,1476,83638,1392,5397,84,95454,1535,966203,8897,1061657,10432,7,1075,918,9708,551,78252,52,4336,1215,"East TN",2455501,333.57754690387,0.144814375627109,424.842017983295,60.1099327591396,395.35720001743,14.4814375627109
2020-11-15,90987,1952,85371,1733,5616,219,97415,1961,977376,11173,1074791,13134,7,1082,1339,11047,606,78858,56,4392,1232,"East TN",2455501,349.663877147678,0.154212172870497,534.880661828279,79.4949788250952,449.887823299604,15.4212172870497
2020-11-16,92512,1525,86770,1399,5742,126,98952,1537,984996,7620,1083948,9157,10,1092,172,11219,1343,80201,41,4433,1251,"East TN",2455501,386.560624491703,0.157060814275459,372.917787449486,62.1054522071056,456.892503810831,15.7060814275459
2020-11-17,93724,1212,87889,1119,5835,93,100173,1221,990140,5144,1090313,6365,31,1123,89,11308,1092,81293,46,4479,1278,"East TN",2455501,397.678518558942,0.16094391476945,259.213903802116,49.358562672139,460.517018726525,16.094391476945
2020-11-18,94921,1197,88844,955,6077,242,101206,1033,995281,5141,1096487,6174,14,1137,55,11363,1128,82421,53,4532,1293,"East TN",2455501,393.320955682771,0.162898055884607,251.435450443718,48.7476893717412,462.75688749465,16.2898055884607
2020-11-19,96001,1080,89724,880,6277,200,102065,859,999942,4661,1102007,5520,45,1182,-242,11121,1277,83698,52,4584,1313,"East TN",2455501,403.217103149215,0.163019467071655,224.801374546376,43.9828776286387,452.901464914899,16.3019467071655
2020-11-20,97127,1126,90687,963,6440,163,103088,1023,1004842,4900,1107930,5923,28,1210,-126,10995,1224,84922,36,4620,1339,"East TN",2455501,389.655715880384,0.161696499426858,241.213503883729,45.8562224165252,447.770129191558,16.1696499426858
2020-11-21,98345,1218,91751,1064,6594,154,104187,1099,1011249,6407,1115436,7506,3,1213,362,11357,853,85775,47,4667,1363,"East TN",2455501,379.148695113543,0.162386805258558,305.680999519039,49.6029119922981,462.512538174491,16.2386805258558
2020-11-22,99931,1586,93180,1429,6751,157,105853,1666,1020849,9600,1126702,11266,17,1230,803,12160,766,86541,57,4724,1390,"East TN",2455501,364.243386583838,0.162547436959411,458.806573485411,64.5896702953898,495.214622189117,16.2547436959411
2020-11-23,100822,891,93938,758,6884,133,106555,702,1023965,3116,1130520,3818,18,1248,-1158,11002,2031,88572,35,4759,1417,"East TN",2455501,338.423808420359,0.16325259812763,155.487617394577,36.2858740436269,448.05520339841,16.325259812763
2020-11-24,101733,911,94671,733,7062,178,107260,705,1026992,3027,1134252,3732,13,1261,-736,10266,1634,90206,57,4816,1445,"East TN",2455501,326.165617525711,0.161291790891918,151.985277138963,37.1003717774906,418.081686792227,16.1291790891918
2020-11-25,102640,907,95357,686,7283,221,107805,545,1029300,2308,1137105,2853,38,1299,-494,9772,1363,91569,56,4872,1470,"East TN",2455501,314.355400384687,0.162464917031858,116.188101735654,36.9374722307179,397.963592765794,16.2464917031858
2020-11-26,104106,1466,96744,1387,7362,79,109475,1670,1037666,8366,1147141,10036,18,1317,-441,9331,1889,93458,25,4897,1489,"East TN",2455501,330.075206648256,0.164177781716666,408.714962852795,59.7026838922077,380.0039177341,16.4177781716666
2020-11-27,105810,1704,98311,1567,7499,137,111225,1750,1045206,7540,1156431,9290,5,1322,161,9492,1538,94996,50,4947,1517,"East TN",2455501,353.614191156917,0.16776973670646,378.334197379679,69.3952069251855,386.560624491703,16.776973670646
2020-11-28,107436,1626,99693,1382,7743,244,112719,1494,1052739,7533,1165458,9027,2,1324,569,10061,1055,96051,45,4992,1545,"East TN",2455501,370.229944927736,0.170564951421375,367.623552179372,66.2186657631172,409.733085020124,17.0564951421375
2020-11-29,109724,2288,101814,2121,7910,167,115045,2326,1063435,10696,1178480,13022,4,1328,1279,11340,1005,97056,51,5043,1570,"East TN",2455501,398.818815386351,0.177527135076674,530.319474518642,93.178540754005,461.820215100707,17.7527135076674
2020-11-30,111962,2238,103823,2009,8139,229,117266,2221,1072886,9451,1190152,11672,15,1343,-107,11233,2330,99386,53,5096,1601,"East TN",2455501,453.67523776207,0.179618325731151,475.340877482844,91.1422964193458,457.462652224536,17.9618325731151
2020-12-01,114225,2263,105831,2008,8394,255,119404,2138,1081724,8838,1201128,10976,20,1363,423,11656,1820,101206,63,5159,1629,"East TN",2455501,508.735284571255,0.181589808002871,446.996356344388,92.1604185866754,474.689279295753,18.1589808002871
2020-12-02,115282,1057,106744,913,8538,144,120280,876,1084634,2910,1204914,3786,15,1378,-688,10968,1730,102936,42,5201,1662,"East TN",2455501,514.844017575232,0.18397262900205,154.184421020395,43.0462052346955,446.670557250842,18.397262900205
2020-12-03,117091,1809,108314,1570,8777,239,122002,1722,1090624,5990,1212626,7712,33,1411,318,11286,1458,104394,45,5246,1683,"East TN",2455501,528.812653710994,0.191295716576315,314.070326177835,73.6713200279699,459.621071219275,19.1295716576315
2020-12-04,118819,1728,109701,1387,9118,341,123459,1457,1096146,5522,1219605,6979,37,1448,-302,10984,1993,106387,36,5282,1718,"East TN",2455501,529.790050991631,0.193655617817457,284.218984231731,70.3726042058219,447.322155437933,19.3655617817457
2020-12-05,119952,1133,110610,909,9342,224,124388,929,1099208,3062,1223596,3991,5,1453,123,11107,1005,107392,24,5306,1744,"East TN",2455501,509.712681851891,0.200712098799408,162.533022792497,46.1412966233775,452.331316501195,20.0712098799408
2020-12-06,121421,1469,111873,1263,9548,206,125630,1242,1103699,4491,1229329,5733,20,1473,484,11591,965,108357,40,5346,1780,"East TN",2455501,476.358999650173,0.208165352317646,233.475775412024,59.8248585522873,472.042161660696,20.8165352317646
2020-12-07,124144,2723,114278,2405,9866,318,128201,2571,1113245,9546,1241446,12117,31,1504,-211,11380,2903,111260,51,5397,1802,"East TN",2455501,496.110569696367,0.213182828400983,493.46345206131,110.89386646554,463.449210568434,21.3182828400983
2020-12-08,126909,2765,116641,2363,10268,402,130732,2531,1121606,8361,1252338,10892,45,1549,719,12099,2001,113261,71,5468,1826,"East TN",2455501,516.554462816346,0.221206795547745,443.57546586216,112.604311706654,492.730404100833,22.1206795547745
2020-12-09,129555,2646,119026,2385,10529,261,133310,2578,1128704,7098,1262014,9676,21,1570,577,12676,2048,115309,56,5524,1849,"East TN",2455501,581.266307771815,0.228196147110333,394.054003643248,107.758050190165,516.2286637228,22.8196147110333
2020-12-10,132630,3075,121708,2682,10922,393,136260,2950,1140175,11471,1276435,14421,30,1600,2512,15188,533,115842,74,5598,1886,"East TN",2455501,632.824014325386,0.223448102932188,587.293591002406,125.229026581541,618.529579096079,22.3448102932188
2020-12-11,134616,1986,123458,1750,11158,236,138050,1790,1147349,7174,1285399,8964,35,1635,440,15628,1511,117353,50,5648,1911,"East TN",2455501,643.331035092228,0.221767942365565,365.057884317701,80.8796249726634,636.448529241079,22.1767942365565
2020-12-12,137877,3261,126185,2727,11692,534,141024,2974,1158582,11233,1299606,14207,21,1656,1878,17506,1362,118715,73,5721,1936,"East TN",2455501,729.993593975323,0.218865938692277,578.578465250065,132.803855506473,712.929866450879,21.8865938692277
2020-12-13,142169,4292,130046,3861,12123,431,145390,4366,1175866,17284,1321256,21650,15,1671,2959,20465,1318,120033,62,5783,1970,"East TN",2455501,844.959949110182,0.214953169362646,881.693796907433,174.791213687146,833.434806176011,21.4953169362646
2020-12-14,145028,2859,132503,2457,12525,402,148063,2673,1185145,9279,1333208,11952,37,1708,-1085,19380,3907,123940,72,5855,2004,"East TN",2455501,850.498533700455,0.216451254331858,486.743845756935,116.432451055813,789.248304113906,21.6451254331859
2020-12-15,149155,4127,136044,3541,13111,586,151926,3863,1200166,15021,1352092,18884,34,1742,1611,20991,2482,126422,94,5949,2035,"East TN",2455501,905.965829376571,0.212462658139022,769.048760314087,168.07160738277,854.856096576625,21.2462658139022
2020-12-16,152373,3218,138301,2257,14072,961,154312,2386,1208061,7895,1362373,10281,19,1761,664,21655,2535,128957,60,6009,2077,"East TN",2455501,929.260464565072,0.209268725276258,418.692560092625,131.052685378666,881.8974213409,20.9268725276258
2020-12-17,156441,4068,141674,3373,14767,695,157921,3609,1218761,10700,1376682,14309,58,1819,1450,23105,2560,131517,75,6084,2116,"East TN",2455501,969.700277051404,0.216076291559847,582.73240369277,165.668839067872,940.948507046016,21.6076291559847
2020-12-18,159648,3207,144410,2736,15238,471,160800,2879,1227451,8690,1388251,11569,43,1862,849,23954,2315,133832,62,6146,2146,"East TN",2455501,1019.42536370378,0.221191615136312,471.146214153446,130.604711625041,975.523935848529,22.1191615136312
2020-12-19,162288,2640,146652,2242,15636,398,163268,2468,1235816,8365,1399084,10833,27,1889,1270,25224,1343,135175,41,6187,2183,"East TN",2455501,994.135209067315,0.223607229739239,441.172697547262,107.513700870006,1027.24454194887,22.3607229739239
2020-12-20,165919,3631,149618,2966,16301,665,166586,3318,1249759,13943,1416345,17261,16,1905,2279,27503,1336,136511,55,6242,2217,"East TN",2455501,967.21605896312,0.222906960847206,702.952269211049,147.872063582951,1120.05655872264,22.2906960847206
2020-12-21,168233,2314,151360,1742,16873,572,168489,1903,1256675,6916,1425164,8819,14,1919,-1321,26182,3621,140132,35,6277,2252,"East TN",2455501,945.020995715335,0.222127974248554,359.15277574719,94.2373878080278,1066.25898340094,22.2127974248554
2020-12-22,170888,2655,153062,1702,17826,953,170290,1801,1261728,5053,1432018,6854,62,1981,-292,25890,2885,143017,60,6337,2297,"East TN",2455501,885.073962502968,0.229762530340565,279.128373395083,108.124574170404,1054.36731648653,22.9762530340565
2020-12-23,173106,2218,154508,1446,18598,772,171832,1542,1267505,5777,1439337,7319,41,2022,-557,25333,2734,145751,35,6372,2337,"East TN",2455501,844.349075809784,0.227638896107271,298.065445707414,90.3277986854821,1031.68355459843,22.7638896107271
2020-12-24,175197,2091,155965,1457,19232,634,173430,1598,1273795,6290,1447225,7888,15,2037,-585,24748,2661,148412,30,6402,2376,"East TN",2455501,763.835974817359,0.219851721644954,321.237906235835,85.1557380754477,1007.85949588292,21.9851721644954
2020-12-25,177563,2366,157944,1979,19619,387,175596,2166,1282343,8548,1457939,10714,3,2040,-291,24457,2654,151066,27,6429,2412,"East TN",2455501,729.586345108391,0.212317759155091,436.326436030773,96.3550819160733,996.008553855201,21.2317759155091
2020-12-26,179503,1940,159412,1468,20091,472,177209,1613,1287997,5654,1465206,7267,2,2042,417,24874,1521,152587,43,6472,2450,"East TN",2455501,701.078924423163,0.210837542724056,295.947751599368,79.006280184777,1012.99083160626,21.0837542724056
2020-12-27,180798,1295,160321,909,20477,386,178199,990,1290790,2793,1468989,3783,27,2069,-191,24683,1459,154046,41,6513,2481,"East TN",2455501,605.945589107885,0.220594939594256,154.062246360315,52.7387282676733,1005.21237824786,22.0594939594256
2020-12-28,182194,1396,161299,978,20895,418,179219,1020,1292609,1819,1471828,2839,25,2094,-2415,22268,3786,157832,42,6555,2518,"East TN",2455501,568.560143123542,0.229941710954912,115.617953321949,56.8519418236849,906.861776883821,22.9941710954912
2020-12-29,185100,2906,163026,1727,22074,1179,180999,1780,1296698,4089,1477697,5869,50,2144,-110,22158,2966,160798,64,6619,2560,"East TN",2455501,578.782089683531,0.234440333632523,239.014360002297,118.346520730393,902.382039347571,23.4440333632523
2020-12-30,187428,2328,164642,1616,22786,712,182680,1681,1301178,4480,1483858,6161,40,2184,-531,21627,2819,163617,44,6663,2598,"East TN",2455501,583.261827219781,0.243660295141619,250.906026916707,94.8075362217323,880.75712451349,24.3660295141619
2020-12-31,190872,3444,167321,2679,23551,765,185575,2895,1308299,7121,1493874,10016,52,2236,594,22221,2798,166415,30,6693,2641,"East TN",2455501,638.362598915659,0.260348560526485,407.900465118931,140.256509771326,904.947707209242,26.0348560526485
2021-01-01,193112,2240,169037,1716,24075,524,187431,1856,1314501,6202,1501932,8058,24,2260,-443,21778,2659,169074,30,6723,2680,"East TN",2455501,633.231263192318,0.269020071374991,328.161136973677,91.2237461927322,886.906582404161,26.9020071374991
2021-01-02,195835,2723,171146,2109,24689,614,189682,2251,1321062,6561,1510744,8812,4,2264,1166,22944,1553,170627,63,6786,2716,"East TN",2455501,665.118849473081,0.273903113882911,358.867701540337,110.89386646554,934.391800288414,27.3903113882911
2021-01-03,197149,1314,172050,904,25099,410,190619,937,1324433,3371,1515052,4308,15,2279,-187,22757,1486,172113,26,6812,2760,"East TN",2455501,665.892622320252,0.269630723140047,175.442811874237,53.5125011148438,926.776246476788,26.9630723140047
2021-01-04,198705,1556,173175,1125,25530,431,191799,1180,1326798,2365,1518597,3545,46,2325,-1566,21191,3076,175189,34,6846,2810,"East TN",2455501,672.408604191161,0.268981590369689,144.369723327337,63.3679236945943,863.001073915262,26.8981590369689
2021-01-05,201608,2903,174914,1739,26694,1164,193628,1829,1332070,5272,1525698,7101,43,2368,-428,20763,3288,178477,60,6906,2854,"East TN",2455501,672.286429531081,0.263098685444053,289.1874204083,118.224346070313,845.570822410579,26.3098685444053
2021-01-06,204153,2545,176707,1793,27446,752,195531,1903,1337654,5584,1533185,7487,52,2420,61,20824,2432,180909,62,6968,2897,"East TN",2455501,681.123729943502,0.260526689237132,304.907226671869,103.644836634153,848.055040498864,26.0526689237132
2021-01-07,206665,2512,178846,2139,27819,373,197853,2322,1344763,7109,1542616,9431,33,2453,975,21799,1504,182413,44,7012,2929,"East TN",2455501,643.168135545455,0.251897747322638,384.076406403418,102.300915373278,887.761805024718,25.1897747322638
2021-01-08,209015,2350,180706,1860,28309,490,199844,1991,1352108,7345,1551952,9336,50,2503,1668,23467,632,183045,47,7059,2984,"East TN",2455501,647.647873081705,0.248160735705718,380.207542167566,95.7034837289824,955.690916028949,24.8160735705718
2021-01-09,211591,2576,182708,2002,28883,574,202023,2179,1360299,8191,1562322,10370,27,2530,754,24221,1795,184840,33,7092,3012,"East TN",2455501,641.661314737807,0.239268680445151,422.317075008318,104.907308121642,986.39748059561,23.9268680445151
2021-01-10,213258,1667,183841,1133,29417,534,203274,1251,1366105,5806,1569379,7057,36,2566,-12,24209,1643,186483,41,7133,3052,"East TN",2455501,656.037199740501,0.232941263092017,287.395525393799,67.8883861175377,985.908781955291,23.2941263092017
2021-01-11,214682,1424,184854,1013,29828,411,204371,1097,1369378,3273,1573749,4370,28,2594,-2169,22040,3565,190048,40,7173,3092,"East TN",2455501,650.661514697001,0.227951842181607,177.967754849214,57.992238651094,897.576502717775,22.7951842181607
2021-01-12,216501,1819,185991,1137,30510,682,205566,1195,1373582,4204,1579148,5399,60,2654,-2137,19903,3896,193944,39,7212,3131,"East TN",2455501,606.515737521589,0.223348924228251,219.8736632565,74.0785688949017,810.547419854441,22.3348924228251
2021-01-13,218030,1529,187069,1078,30961,451,206702,1136,1378320,4738,1585022,5874,49,2703,-1335,18568,2815,196759,33,7245,3158,"East TN",2455501,565.139252641314,0.215502440341841,239.217984435763,62.2683517538783,756.17969611904,21.5502440341841
2021-01-14,220281,2251,188850,1781,31431,470,208668,1966,1386845,8525,1595513,10491,38,2741,-199,18369,2412,199171,50,7295,3200,"East TN",2455501,554.510057214393,0.204453938786699,427.244786298193,91.6717199463572,748.075443667097,20.4453938786699
2021-01-15,221246,965,189522,672,31724,293,209362,694,1389903,3058,1599265,3752,23,2764,-376,17993,1318,200489,30,7325,3241,"East TN",2455501,498.106089144333,0.201170925538436,152.799774872826,39.2995156589226,732.76288627046,20.1170925538436
2021-01-16,223679,2433,191273,1751,32406,682,211365,2003,1400794,10891,1612159,12894,13,2777,357,18350,2063,202552,54,7379,3284,"East TN",2455501,492.282430347208,0.18745109055521,525.106689021914,99.0836493245167,747.301670819926,18.745109055521
2021-01-17,224535,856,191879,606,32656,250,212037,672,1404413,3619,1616450,4291,13,2790,-846,17504,1689,204241,24,7403,3318,"East TN",2455501,459.254547239036,0.186165579656264,174.750488800453,34.8605030093655,712.848416677493,18.6165579656264
2021-01-18,225097,562,192198,319,32899,243,212391,354,1406497,2084,1618888,2438,13,2803,-2468,15036,3017,207258,21,7424,3349,"East TN",2455501,424.149694909511,0.177673408803917,99.2872737579826,22.8873863215694,612.339396318715,17.7673408803917
2021-01-19,226775,1678,193168,970,33607,708,213456,1065,1410705,4208,1624161,5273,21,2824,-1171,13865,2828,210086,52,7476,3388,"East TN",2455501,418.407485885772,0.175282696110013,214.742327533159,68.3363598711627,564.650554000996,17.5282696110013
2021-01-20,227759,984,193826,658,33933,326,214152,696,1414701,3996,1628853,4692,32,2856,-1011,12854,1963,212049,29,7505,3428,"East TN",2455501,396.212422637987,0.169971025073578,191.081168364419,40.073288506093,523.477693554187,16.9971025073578
2021-01-21,229325,1566,194968,1142,34357,424,215433,1281,1421634,6933,1637067,8214,65,2921,-761,12093,2262,214311,37,7542,3474,"East TN",2455501,368.315875253156,0.162800211772633,334.514219297813,63.7751725615261,492.486054780674,16.2800211772633
2021-01-22,230313,988,195675,707,34638,281,216250,817,1427078,5444,1643328,6261,32,2953,-728,11365,1684,215995,31,7573,3506,"East TN",2455501,369.252547647099,0.156321630392847,254.978515586025,40.2361880528658,462.838337268036,15.6321630392847
2021-01-23,231745,1432,196644,969,35101,463,217351,1101,1435360,8282,1652711,9383,19,2972,206,11571,1207,217202,41,7614,3531,"East TN",2455501,328.486936067222,0.147612941408562,382.121611842145,58.3180377446395,471.227663926832,14.7612941408562
2021-01-24,232370,625,197135,491,35235,134,217894,543,1438736,3376,1656630,3919,19,2991,-602,10969,1208,218410,20,7634,3559,"East TN",2455501,319.079487241097,0.145769039323046,159.600830950588,25.45305418324,446.711282137535,14.5769039323046
2021-01-25,233110,740,197646,511,35464,229,218443,549,1440493,1757,1658936,2306,44,3035,-1148,9821,1844,220254,20,7654,3590,"East TN",2455501,326.328517072483,0.151118657610867,93.9115887144823,30.1364161529562,399.95911221376,15.1118657610867
2021-01-26,234142,1032,198375,729,35767,303,219227,784,1444959,4466,1664186,5250,63,3098,-917,8904,1886,222140,25,7679,3613,"East TN",2455501,300.020240268687,0.14418488444722,213.805655139216,42.0280830673659,362.61439111611,14.418488444722
2021-01-27,235095,953,199079,704,36016,249,219982,755,1449481,4522,1669463,5277,55,3153,-390,8514,1288,223428,27,7706,3636,"East TN",2455501,298.757768781198,0.143560699335139,214.905227079932,38.8108170186043,346.731685305769,14.3560699335139
2021-01-28,236423,1328,199793,714,36630,614,220778,796,1453912,4431,1674690,5227,46,3199,-178,8336,1460,224888,28,7734,3663,"East TN",2455501,289.06524574822,0.142067352417404,212.868982745273,54.0826495285484,339.482655474382,14.2067352417404
2021-01-29,237017,594,200144,351,36873,243,221175,397,1456579,2667,1677754,3064,17,3216,-683,7653,1260,226148,17,7751,3683,"East TN",2455501,273.019640391105,0.143060477546041,124.781052827916,24.1905826957513,311.667557862937,14.3060477546041
2021-01-30,238171,1154,201110,966,37061,188,222272,1097,1465629,9050,1687901,10147,44,3260,236,7889,874,227022,29,7780,3703,"East TN",2455501,261.6981218904,0.139840863881785,413.235425275738,46.9965192439343,321.278631122529,13.9840863881785
2021-01-31,238852,681,201552,442,37300,239,222763,491,1469554,3925,1692317,4416,29,3289,-82,7807,734,227756,30,7810,3722,"East TN",2455501,263.978715545219,0.136436237285286,179.841099637101,27.7336478380583,317.939190413687,13.6436237285286
2021-02-01,239545,693,201959,407,37586,286,223204,441,1471250,1696,1694454,2137,39,3328,-543,7264,1197,228953,10,7820,3749,"East TN",2455501,262.064645870639,0.134044709724647,87.0290828633342,28.2223464783765,295.825576939289,13.4044709724647
2021-02-02,240083,538,202308,349,37775,189,223567,363,1472309,1059,1695876,1422,57,3385,-840,6424,1321,230274,12,7832,3765,"East TN",2455501,241.946551844206,0.136951719785421,57.9107888777077,21.909989040933,261.616672117014,13.6951719785421
2021-02-03,241194,1111,203066,758,38128,353,224394,827,1478314,6005,1702708,6832,46,3431,35,6459,1030,231304,39,7871,3778,"East TN",2455501,248.381083941729,0.132711685967815,278.232425887833,45.2453491161274,263.042043151275,13.2711685967815
2021-02-04,242288,1094,203845,779,38443,315,225260,866,1486028,7714,1711288,8580,58,3489,-6,6453,1042,232346,36,7907,3797,"East TN",2455501,238.851460455524,0.122465708508662,349.419527827519,44.5530260423433,262.797693831116,12.2465708508662
2021-02-05,243105,817,204404,559,38701,258,225866,606,1489834,3806,1715700,4412,67,3556,-150,6303,900,233246,28,7935,3811,"East TN",2455501,247.933110188104,0.123623043272018,179.678200090328,33.2722324283313,256.688960827139,12.3623043272018
2021-02-06,244338,1233,205226,822,39112,411,226827,961,1498489,8655,1725316,9616,27,3583,500,6803,706,233952,22,7957,3841,"East TN",2455501,251.150376236866,0.121742616597621,391.610510441657,50.2137852926959,277.051404173731,12.1742616597621
2021-02-07,244855,517,205579,353,39276,164,227233,406,1501573,3084,1728806,3490,2,3585,-129,6674,644,234596,9,7966,3858,"East TN",2455501,244.471494819184,0.122502672038148,142.129854559212,21.0547664203761,271.79789379031,12.2502672038148
2021-02-08,245367,512,205878,299,39489,213,227553,320,1502936,1363,1730489,1683,32,3617,-628,6046,1108,235704,9,7975,3874,"East TN",2455501,237.100290327717,0.120688219786319,68.5399843046287,20.8511419869102,246.22266494699,12.0688219786319
2021-02-09,246395,1028,206510,632,39885,396,228221,668,1507169,4233,1735390,4901,16,3633,-59,5987,1071,236775,38,8013,3885,"East TN",2455501,257.055484807377,0.117781039631523,199.592669683295,41.8651835205931,243.819896632093,11.7781039631523
2021-02-10,247244,849,207093,583,40151,266,228858,637,1513156,5987,1742014,6624,39,3672,-29,5958,839,237614,30,8043,3898,"East TN",2455501,246.385564493763,0.11357044725996,269.761649455651,34.5754288025132,242.63887491799,11.357044725996
2021-02-11,248111,867,207676,583,40435,284,229509,651,1518730,5574,1748239,6225,37,3709,-99,5859,929,238543,31,8074,3916,"East TN",2455501,237.14101521441,0.11499012205353,253.51241966507,35.3084767629905,238.607111135365,11.499012205353
2021-02-12,248943,832,208269,593,40674,239,230158,649,1524241,5511,1754399,6160,34,3743,59,5918,739,239282,11,8085,3925,"East TN",2455501,237.751888514808,0.110907258585493,250.865302030013,33.8831057287291,241.009879450263,11.0907258585493
2021-02-13,249537,594,208642,373,40895,221,230592,434,1528668,4427,1759260,4861,12,3755,-25,5893,607,239889,17,8102,3937,"East TN",2455501,211.728685917864,0.11091798255951,197.963674215567,24.1905826957513,239.991757282933,11.091798255951
2021-02-14,250077,540,209056,414,41021,126,231044,452,1531636,2968,1762680,3420,15,3770,-52,5841,577,240466,15,8117,3950,"East TN",2455501,212.665358311807,0.112505166204168,139.279112490689,21.9914388143194,237.874063174888,11.2505166204168
2021-02-15,250455,378,209265,209,41190,169,231272,228,1532960,1324,1764232,1552,5,3775,-575,5266,948,241414,10,8127,3961,"East TN",2455501,207.20822349492,0.110215452093768,63.2050241478216,15.3940071700236,214.457253326307,11.0215452093768
2021-02-16,251221,766,209693,428,41528,338,231744,472,1536369,3409,1768113,3881,8,3783,-39,5227,797,242211,25,8152,3971,"East TN",2455501,196.538303181306,0.107661278000183,158.053285256247,31.1952632069789,212.868982745273,10.7661278000183
2021-02-17,251842,621,210112,419,41730,202,232195,451,1539623,3254,1771818,3705,11,3794,-90,5137,700,242911,11,8163,3988,"East TN",2455501,187.25302901526,0.11196483693464,150.885705198247,25.2901546364673,209.203742942886,11.196483693464
2021-02-18,252636,794,210663,551,41973,243,232801,606,1545343,5720,1778144,6326,42,3836,23,5160,729,243640,20,8183,4005,"East TN",2455501,184.280112286658,0.110081926099314,257.625633221082,32.3355600343881,210.140415336829,11.0081926099315
2021-02-19,253115,479,210967,304,42148,175,233146,345,1548051,2708,1781197,3053,5,3841,-222,4938,696,244336,11,8194,4014,"East TN",2455501,169.904227283964,0.111500858273005,124.333079074291,19.5072207260351,201.099490490943,11.1500858273005
2021-02-20,253737,622,211414,447,42323,175,233651,505,1553278,5227,1786929,5732,18,3859,74,5012,530,244866,18,8212,4024,"East TN",2455501,171.044524111373,0.110556940980881,233.435050525331,25.3308795231604,204.113132106238,11.0556940980881
2021-02-21,254085,348,211641,227,42444,121,233914,263,1555412,2134,1789326,2397,7,3866,-83,4929,424,245290,12,8224,4042,"East TN",2455501,163.225345866281,0.107708474067402,97.617553403562,14.172260569228,200.732966510704,10.7708474067402
2021-02-22,254443,358,211837,196,42606,162,234142,228,1556794,1382,1790936,1610,7,3873,-481,4448,832,246122,22,8246,4058,"East TN",2455501,162.410848132418,0.10747453565009,65.5670675760262,14.5795094361599,181.144296011282,10.747453565009
2021-02-23,255086,643,212186,349,42900,294,234510,368,1559741,2947,1794251,3315,26,3899,-143,4305,760,246882,27,8273,4065,"East TN",2455501,157.401687069156,0.105822939781162,135.002999387905,26.1861021437173,175.320637214157,10.5822939781162
2021-02-24,255827,741,212735,549,43092,192,235120,610,1565943,6202,1801063,6812,19,3918,56,4361,666,247548,23,8296,4072,"East TN",2455501,162.288673472338,0.100017096939648,277.417928153969,30.1771410396493,177.601230868975,10.0017096939648
2021-02-25,256462,635,213180,445,43282,190,235615,495,1570711,4768,1806326,5263,21,3939,-95,4266,709,248257,16,8312,4081,"East TN",2455501,155.813416488122,0.0998509687034277,214.335078666227,25.8603030501718,173.732366633123,9.98509687034277
2021-02-26,256924,462,213504,324,43420,138,235983,368,1573834,3123,1809817,3491,14,3953,-183,4083,631,248888,11,8323,4086,"East TN",2455501,155.121093414338,0.0991264849755416,142.170579445905,18.814897652251,166.27971236827,9.91264849755416
2021-02-27,257363,439,213729,225,43634,214,236257,274,1577929,4095,1814186,4369,7,3960,10,4093,422,249310,16,8339,4095,"East TN",2455501,147.668439149485,0.0956084675496203,177.927029962521,17.8782252583078,166.686961235202,9.56084675496203
2021-02-28,257729,366,214003,274,43726,92,236570,313,1580489,2560,1817059,2873,5,3965,-51,4042,412,249722,11,8350,4104,"East TN",2455501,148.401487109962,0.0957703818555511,117.002599469518,14.9053085297053,164.60999201385,9.57703818555511
2021-03-01,257973,244,214151,148,43822,96,236726,156,1581268,779,1817994,935,4,3969,-410,3632,650,250372,11,8361,4113,"East TN",2455501,143.75885002694,0.0954985586517851,38.077769058127,9.9368723531369,147.912788469644,9.54985586517851
2021-03-02,258593,620,214541,390,44052,230,237173,447,1584724,3456,1821897,3903,7,3976,5,3637,608,250980,24,8385,4123,"East TN",2455501,142.822177632996,0.0963249656369818,158.949232763497,25.2494297497741,148.11641290311,9.63249656369818
2021-03-03,259076,483,214844,303,44232,180,237528,355,1588898,4174,1826426,4529,7,3983,-145,3492,621,251601,17,8402,4126,"East TN",2455501,132.315156866155,0.0949414501439104,184.44301183343,19.6701202728079,142.211304332599,9.49414501439104
2021-03-04,259684,608,215258,414,44426,194,238000,472,1593720,4822,1831720,5294,18,4001,46,3538,544,252145,20,8422,4131,"East TN",2455501,131.215584925439,0.0939198235803733,215.597550153716,24.7607311094559,144.084649120485,9.39198235803733
2021-03-05,260155,471,215569,311,44586,160,238354,354,1597401,3681,1835755,4035,15,4016,-63,3475,519,252664,16,8438,4136,"East TN",2455501,131.582108905678,0.0914102860667746,164.324917806997,19.1814216324897,141.518981258814,9.14102860667746
2021-03-06,260618,463,215892,323,44726,140,238726,372,1601677,4276,1840403,4648,1,4017,50,3525,412,253076,10,8448,4142,"East TN",2455501,132.559506186314,0.0941755349582332,189.289273349919,18.8556225389442,143.555225593474,9.41755349582332
2021-03-07,260873,255,216056,164,44817,91,238910,184,1603407,1730,1842317,1914,1,4018,-110,3415,364,253440,4,8452,4146,"East TN",2455501,128.039043763371,0.0926439147992715,77.9474331307542,10.3848461067619,139.075488057223,9.26439147992715
2021-03-08,261329,456,216348,292,44981,164,239222,312,1604988,1581,1844210,1893,3,4021,-127,3288,580,254020,9,8461,4154,"East TN",2455501,136.672719742325,0.0952090326518157,77.0922105101973,18.5705483320919,133.903427447189,9.52090326518157
2021-03-09,261868,539,216630,282,45238,257,239541,319,1607564,2576,1847105,2895,6,4027,26,3314,507,254527,21,8482,4166,"East TN",2455501,133.374003920178,0.0939384322437321,117.898546976768,21.9507139276262,134.962274501212,9.39384322437322
2021-03-10,262517,649,217093,463,45424,186,240048,507,1613036,5472,1853084,5979,7,4034,173,3487,469,254996,29,8511,4175,"East TN",2455501,140.134335111246,0.0945307224848076,243.494097538547,26.4304514638764,142.007679899133,9.45307224848076
2021-03-11,263051,534,217433,340,45618,194,240413,365,1616374,3338,1856787,3703,5,4039,88,3575,441,255437,9,8520,4183,"East TN",2455501,137.120693495951,0.0962620177923166,150.80425542486,21.7470894941603,145.591469928133,9.62620177923166
2021-03-12,263514,463,217801,368,45713,95,240829,416,1619721,3347,1860550,3763,5,4044,5,3580,453,255890,12,8532,4191,"East TN",2455501,136.794894402405,0.0998185117967332,153.247748626451,18.8556225389442,145.795094361599,9.98185117967332
2021-03-13,263961,447,218017,216,45944,231,241109,280,1623360,3639,1864469,3919,2,4046,42,3622,403,256293,20,8552,4197,"East TN",2455501,136.143296215314,0.0990193634172692,159.600830950588,18.2040243518532,147.505539602712,9.90193634172692
2021-03-14,264223,262,218193,176,46030,86,241320,211,1625202,1842,1866522,2053,0,4046,-51,3571,313,256606,10,8562,4203,"East TN",2455501,136.428370422166,0.0995662053294774,83.6081923811067,10.6699203136142,145.42857038136,9.95662053294774
2021-03-15,264579,356,218378,185,46201,171,241537,217,1626398,1196,1867935,1413,4,4050,-167,3404,519,257125,15,8577,4207,"East TN",2455501,132.355881752848,0.0975763962065332,57.544264897469,14.4980596627735,138.627514303598,9.75763962065332
2021-03-16,265278,699,218829,451,46449,248,242033,496,1629665,3267,1871698,3763,4,4054,190,3594,505,257630,36,8613,4208,"East TN",2455501,138.871863623757,0.10132964664742,153.247748626451,28.4666957985356,146.365242775303,10.132964664742
2021-03-17,265703,425,219161,332,46542,93,242397,364,1633389,3724,1875786,4088,1,4055,-31,3563,455,258085,16,8629,4217,"East TN",2455501,129.749489004484,0.103471059818518,166.483336801736,17.3080768446032,145.102771287815,10.3471059818518
2021-03-18,266253,550,219510,349,46743,201,242782,385,1636680,3291,1879462,3676,6,4061,99,3662,445,258530,31,8660,4224,"East TN",2455501,130.401087191575,0.104476295479603,149.704683484144,22.3986876812512,149.13453507044,10.4476295479603
2021-03-19,267045,792,220040,530,47005,262,243345,563,1641725,5045,1885070,5608,15,4076,337,3999,440,258970,25,8685,4230,"East TN",2455501,143.799574913633,0.102610114192496,228.385164575376,32.2541102610017,162.858821886043,10.2610114192496
2021-03-20,267318,273,220206,166,47112,107,243539,194,1643846,2121,1887385,2315,1,4077,-42,3957,314,259284,15,8700,4232,"East TN",2455501,136.713444629019,0.106039448420318,94.278112694721,11.1178940672392,161.148376644929,10.6039448420318
2021-03-21,267599,281,220402,196,47197,85,243764,225,1645645,1799,1889409,2024,-10,4067,-28,3929,319,259603,8,8708,4239,"East TN",2455501,137.487217476189,0.1067855114257,82.4271706670044,11.4436931607847,160.00807981752,10.67855114257
2021-03-22,268124,525,220741,339,47383,186,244120,356,1647734,2089,1891854,2445,14,4081,-16,3913,527,260130,19,8727,4246,"East TN",2455501,144.369723327337,0.107989464442493,99.5723479648349,21.3805655139216,159.356481630429,10.7989464442493
2021-03-23,268561,437,220989,248,47572,189,244387,267,1650189,2455,1894576,2722,11,4092,-78,3835,504,260634,17,8744,4252,"East TN",2455501,133.699803013723,0.102893609581257,110.853141578847,17.7967754849214,156.179940468361,10.2893609581257
2021-03-24,269158,597,221446,457,47712,140,244880,493,1654888,4699,1899768,5192,4,4096,85,3920,508,261142,26,8770,4258,"East TN",2455501,140.704483524951,0.103535985322325,211.443611711011,24.3127573558308,159.641555837281,10.3535985322325
2021-03-25,269558,400,221753,307,47805,93,245213,333,1657856,2968,1903069,3301,8,4104,-66,3854,458,261600,23,8793,4262,"East TN",2455501,134.595750520973,0.102977930274918,134.4328509742,16.2899546772736,156.953713315531,10.2977930274918
2021-03-26,269968,410,222075,322,47893,88,245559,346,1660488,2632,1906047,2978,7,4111,-63,3791,466,262066,14,8807,4272,"East TN",2455501,119.038843804177,0.105544167421462,121.278712572302,16.6972035442054,154.388045453861,10.5544167421462
2021-03-27,270171,203,222255,180,47916,23,245769,210,1663000,2512,1908769,2722,2,4113,-164,3627,365,262431,12,8819,4283,"East TN",2455501,116.188101735654,0.104283576505799,110.853141578847,8.26715199871635,147.709164036178,10.4283576505799
2021-03-28,270487,316,222474,219,48013,97,246014,245,1665072,2072,1911086,2317,5,4118,-67,3560,378,262809,17,8836,4289,"East TN",2455501,117.613472769915,0.103796650828067,94.3595624681073,12.8690641950461,144.980596627735,10.3796650828067
2021-03-29,270926,439,222711,237,48215,202,246269,255,1666927,1855,1913196,2110,18,4136,-91,3469,512,263321,18,8854,4294,"East TN",2455501,114.111132514302,0.100693468278512,85.9295109226182,17.8782252583078,141.274631938655,10.0693468278512
2021-03-30,271301,375,222969,258,48332,117,246591,322,1669404,2477,1915995,2799,5,4141,-143,3326,513,263834,20,8874,4300,"East TN",2455501,111.586189539324,0.102899295018442,113.988957854222,15.271832509944,135.45097314153,10.2899295018442
2021-03-31,271962,661,223411,442,48551,219,247079,488,1674221,4817,1921300,5305,4,4145,168,3494,489,264323,18,8892,4305,"East TN",2455501,114.192582287688,0.102127066691436,216.045523907341,26.9191501041946,142.292754105985,10.2127066691436
2021-04-01,272410,448,223732,321,48678,127,247429,350,1677049,2828,1924478,3178,1,4146,-87,3407,534,264857,18,8910,4313,"East TN",2455501,116.147376848961,0.103507870521743,129.423689910939,18.2447492385464,138.749688963678,10.3507870521743
2021-04-02,272761,351,223967,235,48794,116,247681,252,1680069,3020,1927750,3272,0,4146,-78,3329,429,265286,12,8922,4318,"East TN",2455501,113.744608534063,0.0977745012210293,133.251829260098,14.2944352293076,135.57314780161,9.77745012210293
2021-04-03,273104,343,224218,251,48886,92,247956,275,1682420,2351,1930376,2626,0,4146,-55,3274,398,265684,13,8935,4327,"East TN",2455501,119.446092671109,0.101217198130236,106.943552456301,13.9686361357621,133.333279033484,10.1217198130236
2021-04-04,273275,171,224341,123,48934,48,248097,141,1684015,1595,1932112,1736,6,4152,-179,3095,344,266028,8,8943,4331,"East TN",2455501,113.540984100597,0.0990678207933035,70.6984032993674,6.96395562453446,126.043524315404,9.90678207933035
2021-04-05,273682,407,224576,235,49106,172,248320,223,1685234,1219,1933554,1442,6,4158,-93,3002,494,266522,40,8983,4337,"East TN",2455501,112.237787726415,0.100746635229394,58.7252866115713,16.5750288841259,122.256109852938,10.0746635229394
2021-04-06,274113,431,224826,250,49287,181,248598,278,1687320,2086,1935918,2364,3,4161,-6,2996,434,266956,27,9010,4342,"East TN",2455501,114.518381381233,0.100737840686644,96.273632142687,17.5524261647623,122.011760532779,10.0737840686644
2021-04-07,274745,632,225289,463,49456,169,249105,507,1692013,4693,1941118,5200,5,4166,209,3205,418,267374,24,9034,4346,"East TN",2455501,113.337359667131,0.102230295690786,211.769410804557,25.7381283900923,130.523261851655,10.2230295690786
2021-04-08,275151,406,225544,255,49607,151,249394,289,1695024,3011,1944418,3300,-1,4165,48,3253,359,267733,21,9055,4351,"East TN",2455501,111.626914426017,0.0985456369107322,134.392126087507,16.5343039974327,132.478056412928,9.85456369107322
2021-04-09,275669,518,225950,406,49719,112,249844,450,1698900,3876,1948744,4326,4,4169,109,3362,405,268138,31,9086,4354,"East TN",2455501,118.427970503779,0.103029436981995,176.175859834714,21.0954913070693,136.917069062485,10.3029436981995
2021-04-10,275973,304,226165,215,49808,89,250091,247,1701681,2781,1951772,3028,1,4170,-11,3351,314,268452,15,9101,4359,"East TN",2455501,116.839699922745,0.0997850065432791,123.314956906961,12.3803655547279,136.46909530886,9.97850065432791
2021-04-11,276210,237,226328,163,49882,74,250265,174,1703394,1713,1953659,1887,2,4172,-85,3266,320,268772,10,9111,4363,"East TN",2455501,119.527542444495,0.100617255302362,76.8478611900382,9.65179814628461,133.007479939939,10.0617255302362
2021-04-12,276675,465,226651,323,50024,142,250595,330,1705157,1763,1955752,2093,3,4175,13,3279,449,269221,15,9126,4372,"East TN",2455501,121.8895858727,0.102486710514461,85.2371878488341,18.9370723123306,133.53690346695,10.2486710514461
2021-04-13,277053,378,226891,240,50162,138,250845,250,1707214,2057,1958059,2307,3,4178,-56,3223,431,269652,16,9142,4376,"East TN",2455501,119.731166877961,0.10148593107809,93.9523136011755,15.3940071700236,131.256309812132,10.148593107809
2021-04-14,277733,680,227393,502,50340,178,251402,557,1712035,4821,1963437,5378,0,4178,269,3492,411,270063,29,9171,4379,"East TN",2455501,121.685961439234,0.102916797347551,219.018440635944,27.6929229513651,142.211304332599,10.2916797347551
2021-04-15,278273,540,227759,366,50514,174,251782,380,1715180,3145,1966962,3525,2,4180,115,3607,423,270486,24,9195,4384,"East TN",2455501,127.14309625612,0.105926188786373,143.555225593474,21.9914388143194,146.894666302315,10.5926188786373
2021-04-16,279251,978,228654,895,50597,83,252887,1105,1722665,7485,1975552,8590,3,4183,634,4241,341,270827,32,9227,4387,"East TN",2455501,145.876544134985,0.113510892270964,349.826776694451,39.8289391859339,172.714244465793,11.3510892270964
2021-04-17,279453,202,228801,147,50652,55,253060,173,1724896,2231,1977956,2404,0,4183,-91,4150,293,271120,10,9237,4388,"East TN",2455501,141.72260569228,0.113389856400855,97.9026276104143,8.22642711202317,169.008279776714,11.3389856400855
2021-04-18,279671,218,228988,187,50683,31,253262,202,1726699,1803,1979961,2005,6,4189,-122,4028,334,271454,8,9245,4397,"East TN",2455501,140.94883284511,0.113945707550757,81.6533978198339,8.87802529911411,164.039843600145,11.3945707550757
2021-04-19,279999,328,229183,195,50816,133,253472,210,1728148,1449,1981620,1659,8,4197,-212,3816,532,271986,15,9260,4404,"East TN",2455501,135.369523368144,0.111218493892067,67.5625870239923,13.3577628353644,155.40616762119,11.1218493892067
2021-04-20,280352,353,229460,277,50892,76,253753,281,1730596,2448,1984349,2729,4,4201,-113,3703,462,272448,20,9280,4408,"East TN",2455501,134.351401200814,0.110612400152149,111.138215785699,14.375885002694,150.80425542486,11.0612400152149
2021-04-21,280865,513,229790,330,51075,183,254092,339,1734378,3782,1988470,4121,4,4205,30,3733,479,272927,14,9294,4414,"East TN",2455501,127.550345123052,0.10745815523509,167.827258062611,20.8918668736034,152.026002025656,10.745815523509
2021-04-22,281507,642,230188,398,51319,244,254543,451,1738630,4252,1993173,4703,3,4208,193,3926,446,273373,23,9317,4418,"East TN",2455501,131.704283565757,0.105337453740796,191.529142118044,26.1453772570241,159.88590515744,10.5337453740796
2021-04-23,281891,384,230466,278,51425,106,254851,308,1741833,3203,1996684,3511,0,4208,-9,3917,393,273766,11,9328,4423,"East TN",2455501,107.513700870006,0.0929396176414916,142.985077179769,15.6383564901827,159.519381177202,9.29396176414916
2021-04-24,282151,260,230654,188,51497,72,255060,209,1744831,2998,1999891,3207,0,4208,-132,3785,392,274158,20,9348,4430,"East TN",2455501,109.87574429821,0.0911784818782767,130.604711625041,10.5884705402278,154.143696133701,9.11784818782767
2021-04-25,282351,200,230802,148,51549,52,255219,159,1746482,1651,2001701,1810,4,4212,-113,3672,309,274467,17,9365,4435,"East TN",2455501,109.142696337733,0.0900183992640294,73.712044914663,8.1449773386368,149.541783937372,9.00183992640294
2021-04-26,282737,386,231046,244,51691,142,255471,252,1748454,1972,2003925,2224,6,4218,-143,3529,523,274990,16,9381,4443,"East TN",2455501,111.504739765938,0.0896211611746245,90.5721480056412,15.719806263569,143.718125140246,8.96211611746245
2021-04-27,283127,390,231250,204,51877,186,255689,218,1750818,2364,2006507,2582,3,4221,-48,3481,435,275425,25,9406,4449,"East TN",2455501,113.011560573586,0.0873725065439119,105.151657441801,15.8827058103418,141.763330578973,8.73725065439119
2021-04-28,283615,488,231596,346,52019,142,256070,381,1754946,4128,2011016,4509,6,4227,11,3492,471,275896,24,9430,4457,"East TN",2455501,111.993438406256,0.0877317484254413,183.628514099567,19.8737447062738,142.211304332599,8.77317484254413
2021-04-29,284007,392,231875,279,52132,113,256374,304,1757878,2932,2014252,3236,1,4228,18,3510,373,276269,22,9452,4462,"East TN",2455501,101.81221673296,0.0868637032117273,131.785733339143,15.9641555837281,142.944352293076,8.68637032117273
2021-04-30,284376,369,232102,227,52274,142,256614,240,1761145,3267,2017759,3507,0,4228,-1,3509,370,276639,17,9469,4467,"East TN",2455501,101.201343432562,0.0836536180308422,142.822177632996,15.0274831897849,142.903627406383,8.36536180308422
2021-05-01,284611,235,232284,182,52327,53,256803,189,1763636,2491,2020439,2680,-1,4227,-28,3481,264,276903,15,9484,4468,"East TN",2455501,100.183221265233,0.0848257737979365,109.142696337733,9.57034837289824,141.763330578973,8.48257737979365
2021-05-02,284786,175,232412,128,52374,47,256936,133,1765112,1476,2022048,1609,1,4228,-76,3405,250,277153,11,9495,4472,"East TN",2455501,99.165099097903,0.0843859045559542,65.526342689333,7.1268551713072,138.668239190292,8.43859045559542
2021-05-03,284998,212,232526,114,52472,98,257062,126,1766596,1484,2023658,1610,5,4233,-224,3181,431,277584,17,9512,4476,"East TN",2455501,92.078968813289,0.0806263619317894,65.5670675760262,8.63367597895501,129.545864571018,8.06263619317894
2021-05-04,285319,321,232747,221,52572,100,257307,245,1768996,2400,2026303,2645,7,4240,-80,3101,394,277978,12,9524,4484,"East TN",2455501,89.2689516314593,0.0817336835724389,107.717325303472,13.0726886285121,126.287873635564,8.17336835724389
2021-05-05,285783,464,233040,293,52743,171,257618,311,1773146,4150,2030764,4461,5,4245,127,3228,332,278310,22,9546,4489,"East TN",2455501,88.2915543508229,0.0783876848288434,181.673719538294,18.8963474256374,131.459934245598,7.83876848288434
2021-05-06,286069,286,233237,197,52832,89,257849,231,1775584,2438,2033433,2669,4,4249,-100,3128,382,278692,10,9556,4495,"East TN",2455501,83.9747163613454,0.076899014649914,108.694722584108,11.6473175942506,127.38744557628,7.6899014649914
2021-05-07,286435,366,233486,249,52949,117,258118,269,1779033,3449,2037151,3718,0,4249,16,3144,350,279042,15,9571,4500,"East TN",2455501,83.8525417012658,0.0775577557755776,151.415128725258,14.9053085297053,128.03904376337,7.75577557755776
2021-05-08,286606,171,233589,103,53017,68,258232,114,1780928,1895,2039160,2009,0,4249,-94,3050,265,279307,7,9578,4507,"East TN",2455501,81.2461489529021,0.0763313925538166,81.8162973666066,6.96395562453446,124.210904414211,7.63313925538166
2021-05-09,286752,146,233704,115,53048,31,258364,132,1782639,1711,2041003,1843,4,4253,-161,2889,303,279610,11,9589,4512,"East TN",2455501,80.0651272387997,0.0753363228699552,75.0559661755381,5.94583345720486,117.654197656609,7.53363228699552
2021-05-10,286987,235,233840,136,53147,99,258509,145,1784155,1516,2042664,1661,7,4260,-200,2689,428,280038,22,9611,4515,"East TN",2455501,81.001799632743,0.0761338524676418,67.6440367973786,9.57034837289824,109.509220317972,7.61338524676418
2021-05-11,287302,315,234068,228,53234,87,258753,244,1786833,2678,2045586,2922,1,4261,-57,2632,371,280409,19,9630,4519,"East TN",2455501,80.7574503125839,0.0749883316911269,118.998118917484,12.828339308353,107.18790177646,7.49883316911269
2021-05-12,287606,304,234285,217,53321,87,259004,251,1790899,4066,2049903,4317,3,4264,-53,2579,354,280763,16,9646,4521,"East TN",2455501,74.2414684416744,0.0724175766758974,175.809335854475,12.3803655547279,105.029482781722,7.24175766758974
2021-05-13,287816,210,234421,136,53395,74,259149,145,1793632,2733,2052781,2878,1,4265,-131,2448,340,281103,9,9655,4526,"East TN",2455501,71.1463770529924,0.067190407277238,117.206223902984,8.55222620556864,99.6945226249144,6.7190407277238
2021-05-14,288117,301,234640,219,53477,82,259397,248,1796317,2685,2055714,2933,1,4266,34,2482,266,281369,21,9676,4531,"East TN",2455501,68.4992594179355,0.0689005009966061,119.446092671109,12.2581908946484,101.079168772483,6.89005009966061
2021-05-15,288225,108,234721,81,53504,27,259499,102,1798305,1988,2057804,2090,0,4266,-154,2328,262,281631,6,9682,4535,"East TN",2455501,65.9335915562649,0.0679575198455267,85.1150131887546,4.39828776286387,94.8075362217323,6.79575198455267
2021-05-16,288325,100,234795,74,53530,26,259584,85,1799754,1449,2059338,1534,3,4269,-121,2207,218,281849,4,9686,4539,"East TN",2455501,64.0602467683784,0.0665394055085901,62.4719761873443,4.0724886693184,89.8798249318571,6.65394055085901
2021-05-17,288524,199,234899,104,53625,95,259694,110,1801321,1567,2061015,1677,6,4275,-117,2090,310,282159,10,9696,4546,"East TN",2455501,62.5941508474238,0.0645741376491744,68.2956349844696,8.10425245194362,85.1150131887546,6.45741376491744
2021-05-18,288737,213,235034,135,53703,78,259840,146,1803559,2238,2063399,2384,8,4283,-100,1990,305,282464,22,9718,4552,"East TN",2455501,58.440212404719,0.0610228484814461,97.0881298765507,8.67440086564819,81.0425245194362,6.10228484814461
2021-05-19,288954,217,235198,164,53756,53,260007,167,1806829,3270,2066836,3437,1,4284,-53,1937,269,282733,21,9739,4555,"East TN",2455501,54.897147262412,0.0592334494773519,139.971435564473,8.83730041242093,78.8841055246974,5.92334494773519
2021-05-20,289132,178,235331,133,53801,45,260163,156,1820997,14168,2081160,14324,3,4287,-91,1846,266,282999,7,9746,4560,"East TN",2455501,53.5939508882301,0.0357306459001374,583.343276993168,7.24902983138675,75.1781408356177,3.57306459001374
2021-05-21,289296,164,235439,108,53857,56,260284,121,1823275,2278,2083559,2399,0,4287,-58,1788,222,283221,10,9756,4563,"East TN",2455501,48.0146414112639,0.0318549111151015,97.6990031769484,6.67888141768218,72.816097407413,3.18549111151015
2021-05-22,289367,71,235487,48,53880,23,260346,62,1824861,1586,2085207,1648,0,4287,-105,1683,176,283397,12,9768,4564,"East TN",2455501,46.5078206036161,0.0309090245593548,67.1146132703672,2.89146695521606,68.5399843046287,3.09090245593548
2021-05-23,289441,74,235538,51,53903,23,260407,61,1825926,1065,2086333,1126,3,4290,-128,1555,199,283596,5,9773,4566,"East TN",2455501,45.4489735495933,0.0304871272457863,45.8562224165252,3.01364161529562,63.3271988079011,3.04871272457863
2021-05-24,289601,160,235649,111,53952,49,260533,126,1827850,1924,2088383,2050,0,4290,-90,1465,250,283846,7,9780,4570,"East TN",2455501,43.8607029685592,0.0306562408652441,83.4860177210272,6.51598187090944,59.6619590055146,3.06562408652441
2021-05-25,289745,144,235745,96,54000,48,260621,88,1829577,1727,2090198,1815,0,4290,-72,1393,216,284062,9,9789,4576,"East TN",2455501,41.0506857867295,0.0291428784656144,73.915669348129,5.8643836838185,56.7297671636053,2.91428784656144
2021-05-26,289929,184,235885,140,54044,44,260786,165,1832460,2883,2093246,3048,7,4297,-33,1360,210,284272,14,9803,4581,"East TN",2455501,39.7067645258544,0.0294964028776978,124.129454640825,7.49337915154586,55.3858459027302,2.94964028776978
2021-05-27,290053,124,235961,76,54092,48,260925,139,1835432,2972,2096357,3111,4,4301,-81,1279,201,284473,11,9814,4585,"East TN",2455501,37.5076206444225,0.0501414752911759,126.695122502495,5.04988594995482,52.0871300805823,5.01414752911759
2021-05-28,290170,117,236051,90,54119,27,261023,98,1837544,2112,2098567,2210,0,4301,-59,1220,176,284649,9,9823,4588,"East TN",2455501,35.5935509698428,0.0492404051172708,90.0019995919366,4.76481174310253,49.6843617656845,4.92404051172708
2021-05-29,290221,51,236083,32,54138,19,261060,37,1838620,1076,2099680,1113,0,4301,-88,1132,139,284788,7,9830,4591,"East TN",2455501,34.7790532359791,0.0493332412077662,45.3267988895138,2.07696922135238,46.1005717366843,4.93332412077662
2021-05-30,290276,55,236123,40,54153,15,261106,46,1839707,1087,2100813,1133,0,4301,-66,1066,121,284909,7,9837,4596,"East TN",2455501,34.0052803888086,0.0482734806629834,46.1412966233775,2.23986876812512,43.4127292149341,4.82734806629834
2021-05-31,290356,80,236189,66,54167,14,261177,71,1841134,1427,2102311,1498,6,4307,-95,971,169,285078,4,9841,4601,"East TN",2455501,30.7472894533539,0.0462377943710511,61.0058802663896,3.25799093545472,39.5438649790817,4.62377943710511
2021-06-01,290486,130,236282,93,54204,37,261271,94,1842450,1316,2103721,1410,3,4310,-37,934,164,285242,11,9852,4604,"East TN",2455501,30.1771410396493,0.048066257487244,57.4220902373894,5.29423527011392,38.0370441714339,4.8066257487244
2021-06-02,290605,119,236353,71,54252,48,261344,73,1844429,1979,2105773,2052,1,4311,-19,915,137,285379,9,9861,4608,"East TN",2455501,27.5300234045924,0.0445437854234853,83.5674674944136,4.8462615164889,37.2632713242634,4.45437854234853
2021-06-03,290693,88,236409,56,54284,32,261463,119,1847596,3167,2109059,3286,1,4312,-43,872,130,285509,7,9868,4613,"East TN",2455501,26.0639274836378,0.0423555345614864,133.821977673803,3.58379002900019,35.5121011964564,4.23555345614864
2021-06-04,290784,91,236468,59,54316,32,261541,78,1849748,2152,2111289,2230,1,4313,-32,840,122,285631,7,9875,4613,"East TN",2455501,25.005080429615,0.0407168684169156,90.8164973258003,3.70596468907974,34.2089048222746,4.07168684169156
2021-06-05,290825,41,236494,26,54331,15,261571,30,1851131,1383,2112702,1413,-1,4312,-67,773,109,285740,2,9877,4618,"East TN",2455501,24.5978315626831,0.0392412839809553,57.544264897469,1.66972035442054,31.4803374138312,3.92412839809553
2021-06-06,290851,26,236510,16,54341,10,261590,19,1852047,916,2113637,935,-1,4311,-56,717,83,285823,2,9879,4621,"East TN",2455501,23.4168098485808,0.0377417342482845,38.077769058127,1.05884705402278,29.1997437590129,3.77417342482845
2021-06-07,290924,73,236545,35,54379,38,261642,52,1853317,1270,2114959,1322,3,4314,-68,649,138,285961,10,9889,4623,"East TN",2455501,23.1317356417285,0.0367647058823529,53.8383002083892,2.97291672860243,26.4304514638764,3.67647058823529
2021-06-08,291011,87,236612,67,54399,20,261712,70,1854796,1479,2116508,1549,3,4317,-29,620,113,286074,4,9893,4626,"East TN",2455501,21.3805655139216,0.0344881520294049,63.082849487742,3.54306514230701,25.2494297497741,3.44881520294049
2021-06-09,291059,48,236650,38,54409,10,261766,54,1857526,2730,2119292,2784,0,4317,-63,557,111,286185,3,9896,4629,"East TN",2455501,18.4890985587055,0.0312153265774096,113.378084553824,1.95479456127283,22.6837618881035,3.12153265774096
2021-06-10,291134,75,236707,57,54427,18,261832,66,1859311,1785,2121143,1851,4,4321,-21,536,92,286277,4,9900,4632,"East TN",2455501,17.9596750316941,0.0305362462760675,75.3817652690836,3.0543665019888,21.8285392675466,3.05362462760675
2021-06-11,291204,70,236753,46,54451,24,261888,56,1860796,1485,2122684,1541,2,4323,-4,532,72,286349,4,9904,4633,"East TN",2455501,17.1044524111373,0.0304519526107942,62.7570503941965,2.85074206852288,21.6656397207739,3.04519526107942
2021-06-12,291233,29,236775,22,54458,7,261919,31,1861990,1194,2123909,1225,3,4326,-24,508,50,286399,1,9905,4636,"East TN",2455501,16.6157537708191,0.0310520210582672,49.8879861991504,1.18102171410234,20.6882424401375,3.10520210582672
2021-06-13,291251,18,236789,14,54462,4,261940,21,1862833,843,2124773,864,1,4327,-41,467,58,286457,1,9906,4637,"East TN",2455501,16.2899546772736,0.0314295977011494,35.186302102911,0.733047960477312,19.0185220857169,3.14295977011494
2021-06-14,291304,53,236822,33,54482,20,261981,41,1864086,1253,2126067,1294,3,4330,-9,458,59,286516,3,9909,4638,"East TN",2455501,15.4754569434099,0.0305185451926539,52.6980033809801,2.15841899473875,18.6519981054783,3.05185451926539
2021-06-15,291392,88,236891,69,54501,19,262069,88,1865968,1882,2128037,1970,0,4330,-7,451,95,286611,4,9913,4642,"East TN",2455501,15.5161818301031,0.0309653916211293,80.2280267855725,3.58379002900019,18.366923898626,3.09653916211293
2021-06-16,291459,67,236931,40,54528,27,262107,38,1867874,1906,2129981,1944,2,4332,-14,437,79,286690,7,9920,4645,"East TN",2455501,16.2899546772736,0.0319019552811301,79.1691797315497,2.72856740844333,17.7967754849214,3.19019552811301
2021-06-17,291510,51,236969,38,54541,13,262153,46,1870224,2350,2132377,2396,1,4333,-7,430,57,286747,1,9921,4649,"East TN",2455501,15.3125573966372,0.0285739718711056,97.5768285168689,2.07696922135238,17.5117012780691,2.85739718711056
2021-06-18,291572,62,237020,51,54552,11,262208,55,1871952,1728,2134160,1783,2,4335,-1,429,61,286808,4,9925,4651,"East TN",2455501,14.9867583030917,0.0278842802370164,72.6124729739471,2.52494297497741,17.4709763913759,2.78842802370164
2021-06-19,291600,28,237037,17,54563,11,262226,18,1873103,1151,2135329,1169,0,4335,-16,413,44,286852,5,9930,4653,"East TN",2455501,14.9460334163985,0.0268826619964974,47.6073925443321,1.14029682740915,16.819378204285,2.68826619964974
2021-06-20,291625,25,237058,21,54567,4,262243,17,1873857,754,2136100,771,3,4338,-13,400,35,286887,2,9932,4656,"East TN",2455501,15.2311076232508,0.0267502427827315,31.3988876404449,1.0181221673296,16.2899546772736,2.67502427827315
2021-06-21,291692,67,237098,40,54594,27,262295,52,1875128,1271,2137423,1323,6,4344,3,403,58,286945,2,9934,4658,"East TN",2455501,15.8012560369554,0.0276505811905601,53.8790250950824,2.72856740844333,16.4121293373532,2.76505811905601
2021-06-22,291785,93,237144,46,54641,47,262346,51,1876555,1427,2138901,1478,5,4349,36,439,52,286997,7,9941,4662,"East TN",2455501,16.0048804704213,0.0254970544918999,60.1913825325259,3.78741446246611,17.8782252583078,2.54970544918999
2021-06-23,291854,69,237192,48,54662,21,262401,55,1878344,1789,2140745,1844,2,4351,6,445,61,287058,5,9946,4666,"East TN",2455501,16.0863302438077,0.0273132664437012,75.0966910622313,2.8100171818297,18.1225745784669,2.73132664437012
2021-06-24,291937,83,237244,52,54693,31,262463,62,1880188,1844,2142651,1906,3,4354,27,472,53,287111,6,9952,4667,"East TN",2455501,17.3895266179896,0.0301732528713257,77.6216340372087,3.38016559553427,19.2221465191828,3.01732528713257
2021-06-25,292016,79,237300,56,54716,23,262532,69,1881994,1806,2144526,1875,0,4354,32,504,47,287158,3,9955,4669,"East TN",2455501,18.0818496917737,0.0312560293266448,76.35916254972,3.21726604876154,20.5253428933647,3.12560293266448
2021-06-26,292051,35,237318,18,54733,17,262553,21,1883178,1184,2145731,1205,0,4354,1,505,34,287192,2,9957,4671,"East TN",2455501,18.366923898626,0.0314362622572582,49.0734884652867,1.42537103426144,20.5660677800579,3.14362622572582
2021-06-27,292080,29,237338,20,54742,9,262577,24,1883892,714,2146469,738,2,4356,-9,496,36,287228,3,9960,4673,"East TN",2455501,18.5298234453987,0.0322113993634873,30.0549663795698,1.18102171410234,20.1995437998193,3.22113993634873
2021-06-28,292124,44,237362,24,54762,20,262602,25,1884444,552,2147046,577,4,4360,-15,481,55,287283,3,9963,4673,"East TN",2455501,17.5931510514555,0.0319027330354359,23.4982596219672,1.7918950145001,19.5886704994215,3.19027330354359
2021-06-29,292255,131,237448,86,54807,45,262699,97,1886458,2014,2149157,2111,0,4360,79,560,52,287335,7,9970,4676,"East TN",2455501,19.1406967457965,0.0344188767550702,85.9702358093114,5.3349601568071,22.805936548183,3.44188767550702
2021-06-30,292340,85,237511,63,54829,22,262774,75,1888102,1644,2150876,1719,3,4363,29,589,53,287388,4,9974,4676,"East TN",2455501,19.7922949328874,0.0368176882834863,70.0060802255833,3.46161536892064,23.9869582622854,3.68176882834863
2021-07-01,292446,106,237564,53,54882,53,262839,65,1890654,2552,2153493,2617,1,4364,56,645,49,287437,2,9976,4679,"East TN",2455501,20.7289673268307,0.0346799483490131,106.577028476063,4.3168379894775,26.2675519171037,3.46799483490131
2021-07-02,292528,82,237627,63,54901,19,262913,74,1892336,1682,2155249,1756,0,4364,32,677,50,287487,3,9979,4681,"East TN",2455501,20.8511419869102,0.035531101370885,71.5129010332311,3.33944070884109,27.5707482912856,3.5531101370885
2021-07-03,292576,48,237663,36,54913,12,262953,40,1893425,1089,2156378,1129,1,4365,1,678,46,287533,3,9982,4684,"East TN",2455501,21.3805655139216,0.0375692683384991,45.9783970766047,1.95479456127283,27.6114731779788,3.75692683384991
2021-07-04,292603,27,237684,21,54919,6,262978,25,1894125,700,2157103,725,0,4365,-13,665,40,287573,1,9983,4685,"East TN",2455501,21.2991157405352,0.0377092345307504,29.5255428525584,1.09957194071597,27.0820496509674,3.77092345307504
2021-07-05,292646,43,237708,24,54938,19,263003,25,1894607,482,2157610,507,0,4365,-30,635,73,287646,2,9985,4686,"East TN",2455501,21.258390853842,0.0379591063990913,20.6475175534443,1.75117012780691,25.8603030501718,3.79591063990913
2021-07-06,292808,162,237812,104,54996,58,263116,113,1895932,1325,2159048,1438,5,4370,82,717,75,287721,6,9991,4686,"East TN",2455501,22.5208623413308,0.0421595389748256,58.5623870647986,6.59743164429581,29.1997437590129,4.21595389748256
2021-07-07,292950,142,237892,80,55058,62,263204,88,1897391,1459,2160595,1547,4,4374,81,798,57,287778,6,9997,4688,"East TN",2455501,24.8421808828422,0.04424323490071,63.0013997143556,5.78293391043213,32.4984595811608,4.42432349007099
2021-07-08,293090,140,237994,102,55096,38,263321,117,1899245,1854,2162566,1971,2,4376,76,874,62,287840,3,10000,4690,"East TN",2455501,26.2268270304105,0.0531246555714758,80.2687516722657,5.70148413704576,35.5935509698428,5.31246555714758
2021-07-09,293254,164,238116,122,55138,42,263452,131,1900990,1745,2164442,1876,0,4376,100,974,64,287904,4,10004,4692,"East TN",2455501,29.5662677392516,0.0586315674970086,76.3998874364132,6.67888141768218,39.6660396391612,5.86315674970086
2021-07-10,293358,104,238189,73,55169,31,263526,74,1902046,1056,2165572,1130,0,4376,56,1030,48,287952,13,10017,4693,"East TN",2455501,31.8468613940699,0.0623232542962802,46.0191219632979,4.23538821609114,41.9466332939795,6.23232542962802
2021-07-11,293406,48,238224,35,55182,13,263569,43,1902801,755,2166370,798,2,4378,4,1034,42,287994,7,10024,4693,"East TN",2455501,32.7020840146267,0.0637746843638718,32.4984595811608,1.95479456127283,42.1095328407523,6.37746843638718
2021-07-12,293579,173,238341,117,55238,56,263694,125,1904167,1366,2167861,1491,1,4379,93,1127,79,288073,14,10038,4694,"East TN",2455501,37.9963192847407,0.0674080577504634,60.7208060595373,7.04540539792083,45.8969473032184,6.74080577504634
2021-07-13,293793,214,238478,137,55315,77,263839,145,1905789,1622,2169628,1767,4,4383,149,1276,61,288134,17,10055,4698,"East TN",2455501,40.1140133927862,0.0683364839319471,71.9608747868561,8.71512575234138,51.9649554205028,6.83364839319471
2021-07-14,293966,173,238614,136,55352,37,263981,142,1907351,1562,2171332,1704,0,4383,103,1379,70,288204,12,10067,4699,"East TN",2455501,41.3764848802749,0.0723665828443699,69.3952069251855,7.04540539792083,56.1596187499007,7.23665828443699
2021-07-15,294186,220,238764,150,55422,70,264148,167,1909152,1801,2173300,1968,0,4383,118,1497,102,288306,15,10082,4699,"East TN",2455501,44.6344758157297,0.0770449040432271,80.1465770121861,8.95947507250048,60.9651553796964,7.70449040432271
2021-07-16,294416,230,238906,142,55510,88,264302,154,1910681,1529,2174983,1683,0,4383,164,1661,66,288372,10,10092,4703,"East TN",2455501,47.3223183374798,0.0806375106726117,68.5399843046287,9.36672393943232,67.6440367973786,8.06375106726117
2021-07-17,294560,144,239006,100,55554,44,264412,110,1911899,1218,2176311,1328,0,4383,54,1715,90,288462,5,10097,4705,"East TN",2455501,48.9513138052072,0.0825030263525468,54.0826495285484,5.8643836838185,69.8431806788106,8.25030263525468
2021-07-18,294704,144,239127,121,55577,23,264544,132,1913025,1126,2177569,1258,0,4383,50,1765,94,288556,6,10103,4707,"East TN",2455501,52.8609029277528,0.0870613447629253,51.2319074600255,5.8643836838185,71.8794250134698,8.70613447629253
2021-07-19,295007,303,239338,211,55669,92,264760,216,1914715,1690,2179475,1906,3,4386,165,1930,135,288691,14,10117,4708,"East TN",2455501,58.1551381978667,0.0917857757878423,77.6216340372087,12.3396406680348,78.5990313178451,9.17857757878423
2021-07-20,295363,356,239576,238,55787,118,265014,254,1916375,1660,2181389,1914,2,4388,213,2143,141,288832,22,10139,4710,"East TN",2455501,63.9380721082989,0.0999064705382195,77.9474331307542,14.4980596627735,87.2734321834933,9.99064705382195
2021-07-21,295764,401,239869,293,55895,108,265324,310,1918491,2116,2183815,2426,3,4391,247,2390,151,288983,28,10167,4714,"East TN",2455501,73.2233462743448,0.107586317391653,98.7985751176644,16.3306795639668,97.3324791967098,10.7586317391653
2021-07-22,296238,474,240202,333,56036,141,265691,367,1920860,2369,2186551,2736,5,4396,321,2711,148,289131,21,10188,4717,"East TN",2455501,83.5674674944136,0.116444041959097,111.423289992551,19.3035962925692,110.405167825222,11.6444041959097
2021-07-23,296699,461,240522,320,56177,141,266024,333,1922763,1903,2188787,2236,1,4397,328,3039,132,289263,27,10215,4723,"East TN",2455501,92.9749163205391,0.12474645030426,91.0608466459594,18.7741727655578,123.762930660586,12.474645030426
2021-07-24,297057,358,240771,249,56286,109,266289,265,1924514,1751,2190803,2016,0,4397,226,3265,132,289395,21,10236,4727,"East TN",2455501,101.69004207288,0.129519735026221,82.1013715734589,14.5795094361599,132.966755053246,12.9519735026221
2021-07-25,297285,228,240961,190,56324,38,266492,203,1925829,1315,2192321,1518,3,4400,97,3362,128,289523,17,10253,4732,"East TN",2455501,105.110932555108,0.13204989154013,61.8203780002533,9.28527416604595,136.917069062485,13.204989154013
2021-07-26,297952,667,241422,461,56530,206,266978,486,1927558,1729,2194536,2215,10,4410,448,3810,209,289732,36,10289,4736,"East TN",2455501,119.934791311427,0.147267777704004,90.2056240254026,27.1634994243537,155.161818301031,14.7267777704004
2021-07-27,298679,727,241912,490,56767,237,267493,515,1929879,2321,2197372,2836,2,4412,534,4344,191,289923,28,10317,4742,"East TN",2455501,135.043724274598,0.155102296189702,115.49577866187,29.6069926259448,176.908907795191,15.5102296189702
2021-07-28,299498,819,242460,548,57038,271,268106,613,1932746,2867,2200852,3480,2,4414,559,4903,258,290181,37,10354,4745,"East TN",2455501,152.066726912349,0.163291659329694,141.72260569228,33.3536822017177,199.674119456681,16.3291659329694
2021-07-29,300186,688,242915,455,57271,233,268602,496,1935174,2428,2203776,2924,3,4417,474,5377,211,290392,23,10377,4749,"East TN",2455501,160.78185266469,0.16899854862119,119.07956869087,28.0187220449106,218.97771574925,16.899854862119
2021-07-30,301184,998,243663,748,57521,250,269404,802,1936977,1803,2206381,2605,4,4421,750,6127,244,290636,41,10418,4754,"East TN",2455501,182.65111681893,0.192110946913721,106.088329835744,40.6434369197976,249.521380769138,19.2110946913721
2021-07-31,301719,535,244028,365,57691,170,269800,396,1938947,1970,2208747,2366,2,4423,319,6446,214,290850,32,10450,4764,"East TN",2455501,189.859421763624,0.195664288898796,96.3550819160733,21.7878143808534,262.512619624264,19.5664288898796
2021-08-01,302253,534,244450,422,57803,112,270261,461,1941085,2138,2211346,2599,3,4426,322,6768,209,291059,28,10478,4768,"East TN",2455501,202.321237091738,0.198107752956636,105.843980515585,21.7470894941603,275.626033139469,19.8107752956636
2021-08-02,303103,850,244987,537,58116,313,270797,536,1943420,2335,2214217,2871,9,4435,416,7184,425,291484,32,10510,4777,"East TN",2455501,209.773891356591,0.194045018037701,116.921149696131,34.6161536892064,292.567586003834,19.4045018037701
2021-08-03,304441,1338,245955,968,58486,370,271812,1015,1947195,3775,2219007,4790,4,4439,897,8081,437,291921,40,10550,4787,"East TN",2455501,234.656797126126,0.199630228795933,195.072207260351,54.4898983954802,329.09780936762,19.9630228795933
2021-08-04,305527,1086,246788,833,58739,253,272698,886,1950814,3619,2223512,4505,8,4447,646,8727,432,292353,40,10590,4793,"East TN",2455501,245.530341873206,0.202647837599294,183.465614552794,44.2272269487978,355.406086171417,20.2647837599294
2021-08-05,306705,1178,247677,889,59028,289,273649,951,1954780,3966,2228429,4917,10,4457,665,9392,503,292856,43,10633,4800,"East TN",2455501,265.485536352866,0.204721534904474,200.244267870386,47.9739165245707,382.488135822384,20.4721534904474
2021-08-06,308044,1339,248664,987,59380,352,274732,1083,1959408,4628,2234140,5711,3,4460,907,10299,429,293285,52,10685,4813,"East TN",2455501,279.372722715242,0.191937749918945,232.579827904774,54.5306232821734,419.425608053102,19.1937749918945
2021-08-07,308768,724,249188,524,59580,200,275316,584,1962410,3002,2237726,3586,0,4460,326,10625,398,293683,28,10713,4822,"East TN",2455501,287.069726300254,0.190344732392422,146.039443681758,29.4848179658652,432.70192111508,19.0344732392422
2021-08-08,309404,636,249639,451,59765,185,275842,526,1964525,2115,2240367,2641,5,4465,220,10845,411,294094,29,10742,4832,"East TN",2455501,291.223664742959,0.192309017607939,107.554425756699,25.901027936865,441.66139618758,19.2309017607939
2021-08-09,310773,1369,250599,960,60174,409,276849,1007,1968063,3538,2244912,4545,13,4478,572,11417,784,294878,66,10808,4844,"East TN",2455501,312.359880936721,0.197165662159961,185.094610020521,55.7523698829689,464.956031376082,19.7165662159961
2021-08-10,312100,1327,251447,848,60653,479,277766,917,1971315,3252,2249081,4169,6,4484,549,11966,772,295650,48,10856,4858,"East TN",2455501,311.911907183096,0.197978320143646,169.782052623884,54.0419246418552,487.31399417064,19.7978320143646
2021-08-11,313987,1887,252751,1304,61236,583,279150,1384,1976671,5356,2255821,6740,8,4492,1064,13030,815,296465,63,10919,4878,"East TN",2455501,344.532541424337,0.199696678943948,274.48573631206,76.8478611900382,530.645273612187,19.9696678943948
2021-08-12,315449,1462,253814,1063,61635,399,280312,1162,1981153,4482,2261465,5644,10,4502,586,13616,866,297331,45,10964,4892,"East TN",2455501,356.098409245201,0.201689066472939,229.85126049633,59.539784345435,554.510057214393,20.1689066472939
2021-08-13,317096,1647,254931,1117,62165,530,281486,1174,1986572,5419,2268058,6593,11,4513,794,14410,842,298173,30,10994,4916,"East TN",2455501,368.641674346702,0.199127307034613,268.499177968162,67.073888383674,586.845617248781,19.9127307034613
2021-08-14,318627,1531,256020,1089,62607,442,282686,1200,1992047,5475,2274733,6675,1,4514,912,15322,618,298791,27,11021,4930,"East TN",2455501,401.506657908101,0.199151511876132,271.838618677003,62.3498015272647,623.986713912965,19.9151511876132
2021-08-15,319772,1145,256984,964,62788,181,283743,1057,1995856,3809,2279599,4866,11,4525,426,15748,708,299499,20,11041,4943,"East TN",2455501,422.235625234932,0.201391721044046,198.167298649033,46.6299952636957,641.335515644262,20.1391721044046
2021-08-16,321213,1441,257900,916,63313,525,284705,962,1998916,3060,2283621,4022,17,4542,178,15926,1246,300745,29,11070,4961,"East TN",2455501,425.167817076841,0.202950218295487,163.795494279986,58.6845617248781,648.584545475648,20.2950218295487
2021-08-17,322950,1737,259115,1215,63835,522,286026,1321,2003775,4859,2289801,6180,10,4552,512,16438,1215,301960,25,11095,4978,"East TN",2455501,441.865020621046,0.202848722986248,251.679799763877,70.7391281860606,669.435687462559,20.2848722986248
2021-08-18,325041,2091,260501,1386,64540,705,287505,1479,2009195,5420,2296700,6899,13,4565,931,17369,1147,303107,32,11127,4993,"East TN",2455501,450.172897506456,0.20438366887644,280.960993296276,85.1557380754477,707.350556973913,20.438366887644
2021-08-19,327432,2391,261994,1493,65438,898,289083,1578,2019147,9952,2308230,11530,23,4588,1118,18487,1250,304357,43,11170,5014,"East TN",2455501,488.006317244424,0.18755479525286,469.557943572411,97.3732040834029,752.880980296893,18.755479525286
2021-08-20,329887,2455,263972,1978,65915,477,291193,2110,2026041,6894,2317234,9004,4,4592,1271,19758,1180,305537,37,11207,5047,"East TN",2455501,520.912025692517,0.197393037253945,366.686879785429,99.9795968317667,804.642311283929,19.7393037253945
2021-08-21,332809,2922,265935,1963,66874,959,293310,2117,2034970,8929,2328280,11046,0,4592,2166,21924,756,306293,57,11264,5071,"East TN",2455501,577.560343082735,0.198405139410238,449.84709841291,118.998118917484,892.852415861366,19.8405139410238
2021-08-22,334294,1485,267276,1341,67018,144,294826,1516,2040482,5512,2335308,7028,7,4599,546,22470,932,307225,17,11281,5090,"East TN",2455501,591.406804558418,0.198944515248883,286.214503679697,60.4764567393782,915.088203995844,19.8944515248883
2021-08-23,336243,1949,268404,1128,67839,821,296014,1188,2044449,3967,2340463,5155,18,4617,186,22656,1745,308970,38,11319,5111,"East TN",2455501,612.095046998556,0.198954998064811,209.936790903364,79.3728041650156,922.663032920777,19.8954998064811
2021-08-24,338226,1983,269791,1387,68435,596,297452,1438,2048228,3779,2345680,5217,15,4632,144,22800,1824,310794,25,11344,5148,"East TN",2455501,622.113369125079,0.204477531809803,212.461733878341,80.7574503125839,928.527416604595,20.4477531809803
2021-08-25,340453,2227,271001,1210,69452,1017,298699,1247,2052264,4036,2350963,5283,17,4649,616,23416,1594,312388,39,11383,5186,"East TN",2455501,627.651953715352,0.206291579897905,215.149576400091,90.6943226657208,953.613946807596,20.6291579897905
2021-08-26,343110,2657,272836,1835,70274,822,300661,1962,2059108,6844,2359769,8806,24,4673,739,24155,1894,314282,40,11423,5216,"East TN",2455501,638.484773575739,0.224645414152389,358.623352220178,108.20602394379,983.70963807386,22.4645414152389
2021-08-27,346118,3008,275109,2273,71009,735,303030,2369,2066176,7068,2369206,9437,19,4692,1303,25458,1686,315968,44,11467,5237,"East TN",2455501,661.00563591707,0.227757253905949,384.320755723577,122.500459173097,1036.77416543508,22.7757253905949
2021-08-28,348262,2144,276649,1540,71613,604,304702,1672,2072042,5866,2376744,7538,1,4693,922,26380,1221,317189,33,11500,5272,"East TN",2455501,629.321674069772,0.235061076262793,306.984195893221,87.3141570701865,1074.32251096619,23.5061076262793
2021-08-29,350598,2336,278476,1827,72122,509,306722,2020,2079036,6994,2385758,9014,9,4702,1071,27451,1256,318445,45,11545,5303,"East TN",2455501,663.978552645672,0.235797819623389,367.094128652361,95.1333353152778,1117.93886461459,23.5797819623389
2021-08-30,353841,3243,280890,2414,72951,829,309328,2606,2088078,9042,2397406,11648,21,4723,478,27929,2744,321189,70,11615,5343,"East TN",2455501,716.676556026652,0.23381276012855,474.363480202207,132.070807545996,1137.40536045394,23.381276012855
2021-08-31,357428,3587,283298,2408,74130,1179,311939,2611,2096665,8587,2408604,11198,7,4730,913,28842,2667,323856,79,11694,5378,"East TN",2455501,781.999274282519,0.230230118873562,456.037281190274,146.080168568451,1174.58718200481,23.0230118873562
2021-09-01,358862,1434,284247,949,74615,485,312928,989,2098948,2283,2411876,3272,15,4745,-966,27876,2385,326241,31,11725,5420,"East TN",2455501,749.704439134824,0.23359545581403,133.251829260098,58.3994875180259,1135.2469414592,23.359545581403
2021-09-02,361177,2315,285737,1490,75440,825,314444,1516,2103210,4262,2417654,5778,19,4764,-579,27297,2875,329116,44,11769,5450,"East TN",2455501,735.776527885755,0.238110045780427,235.308395313217,94.278112694721,1111.66723206384,23.8110045780427
2021-09-03,362930,1753,286959,1222,75971,531,315739,1295,2107316,4106,2423055,5401,17,4781,-1007,26290,2743,331859,32,11801,5479,"East TN",2455501,684.666795085809,0.236011810804286,219.955113029887,71.3907263731516,1070.65727116381,23.6011810804286
2021-09-04,366193,3263,289301,2342,76892,921,318316,2577,2115364,8048,2433680,10625,3,4784,1517,27807,1743,333602,56,11857,5510,"East TN",2455501,730.237943295482,0.239110580300688,432.70192111508,132.885305279859,1132.43692427737,23.9110580300688
2021-09-05,370650,4457,292554,3253,78096,1204,321804,3488,2127874,12510,2449678,15998,8,4792,2736,30543,1713,335315,58,11915,5564,"East TN",2455501,816.615427971726,0.235951188986233,651.516737317558,181.510819991521,1243.86021426992,23.5951188986233
2021-09-06,375563,4913,296493,3939,79070,974,326093,4289,2143513,15639,2469606,19928,11,4803,962,31505,3940,339255,102,12017,5600,"East TN",2455501,884.625988749343,0.232202216066482,811.565542021771,200.081368323613,1283.03755526876,23.2202216066482
2021-09-07,377645,2082,297949,1456,79696,626,327611,1518,2147939,4426,2475550,5944,34,4837,-1811,29694,3859,343114,62,12079,5632,"East TN",2455501,823.335034276101,0.234099124667643,242.068726504286,84.7892140952091,1209.28478546741,23.4099124667643
2021-09-08,379319,1674,299125,1176,80194,498,328872,1261,2152319,4380,2481191,5641,20,4857,-1782,27912,3436,346550,60,12139,5673,"East TN",2455501,833.109007082465,0.230022361682176,229.729085836251,68.17346032439,1136.71303738015,23.0022361682176
2021-09-09,381230,1911,300131,1006,81099,905,329952,1080,2155985,3666,2485937,4746,7,4864,-1609,26303,3513,350063,55,12194,5713,"East TN",2455501,816.656152858419,0.227113630039688,193.280312245851,77.8252584706746,1071.18669469082,22.7113630039688
2021-09-10,386718,5488,303966,3835,82752,1653,334086,4134,2168091,12106,2502177,16240,23,4887,2260,28563,3205,353268,142,12336,5748,"East TN",2455501,968.763604657461,0.231882409443644,661.372159897308,223.498178172194,1163.22493861741,23.1882409443644
2021-09-11,391000,4282,307075,3109,83925,1173,337405,3319,2179912,11821,2517317,15140,8,4895,2503,31066,1771,355039,119,12455,5792,"East TN",2455501,1010.26226419782,0.228236306897665,616.574784534806,174.383964820214,1265.15933001045,22.8236306897665
2021-09-12,392582,1582,308501,1426,84081,156,338960,1555,2185156,5244,2524116,6799,23,4918,-129,30937,1688,356727,49,12504,5836,"East TN",2455501,893.178214954911,0.230473682796421,276.888504626958,64.4267707486171,1259.90581962703,23.0473682796421
2021-09-13,394934,2352,309953,1452,84981,900,340466,1506,2190279,5123,2530745,6629,63,4981,-1935,29002,4224,360951,83,12587,5886,"East TN",2455501,788.881780133667,0.235087260177628,269.965273889117,95.7849335023688,1181.10316387572,23.5087260177628
2021-09-14,397747,2813,311908,1955,85839,858,342541,2075,2196501,6222,2539042,8297,43,5024,-937,28065,3707,364658,64,12651,5929,"East TN",2455501,818.651672306385,0.235147735147735,337.894384893348,114.559106267927,1142.94394504421,23.5147735147735
2021-09-15,399539,1792,313103,1195,86436,597,343758,1217,2200276,3775,2544034,4992,23,5047,-1553,26512,3322,367980,36,12687,5968,"East TN",2455501,823.45720893618,0.236876024378212,203.298634372375,72.9789969541857,1079.69819600969,23.6876024378212
2021-09-16,402185,2646,314955,1852,87230,794,345715,1957,2206935,6659,2552650,8616,23,5070,-558,25954,3181,371161,65,12752,6005,"East TN",2455501,853.390000655671,0.236280784854526,350.885623748473,107.758050190165,1056.9737092349,23.6280784854526
2021-09-17,404870,2685,316831,1876,88039,809,347720,2005,2214139,7204,2561859,9209,23,5093,-53,25901,2715,373876,83,12835,6060,"East TN",2455501,739.238143254676,0.228444086994404,375.035481557531,109.346320771199,1054.81529024016,22.8444086994404
2021-09-18,406325,1455,318011,1180,88314,275,349057,1337,2219611,5472,2568668,6809,3,5096,-278,25623,1730,375606,40,12875,6118,"East TN",2455501,624.108888573045,0.226908920955775,277.29575349389,59.2547101385827,1043.49377173945,22.6908920955775
2021-09-19,406969,644,318457,446,88512,198,349570,513,2221688,2077,2571258,2590,17,5113,-1069,24554,1696,377302,24,12899,6161,"East TN",2455501,585.908944854838,0.225064698146027,105.477456535347,26.2268270304105,999.95886786444,22.5064698146027
2021-09-20,408951,1982,319714,1257,89237,725,350941,1371,2227325,5637,2578266,7008,48,5161,187,24741,1747,379049,70,12969,6205,"East TN",2455501,570.84073677836,0.220428863028977,285.400005945833,80.7167254258907,1007.57442167607,22.0428863028977
2021-09-21,410823,1872,320816,1102,90007,770,352081,1140,2231630,4305,2583711,5445,31,5192,-2038,22703,3879,382928,61,13030,6252,"East TN",2455501,532.518618400074,0.213570932861716,221.747008044387,76.2369878896404,924.577102595356,21.3570932861716
2021-09-22,412414,1591,321932,1116,90482,475,353302,1221,2236988,5358,2590290,6579,14,5206,-1352,21351,2929,385857,45,13075,6290,"East TN",2455501,524.332916174744,0.206329989622968,267.929029554458,64.7932947288557,869.517055786172,20.6329989622968
2021-09-23,414763,2349,323440,1508,91323,841,354965,1663,2243344,6356,2598309,8019,32,5238,-393,20958,2710,388567,59,13134,6328,"East TN",2455501,512.237624826868,0.202588755776517,326.572866392642,95.6627588422892,853.51217531575,20.2588755776517
2021-09-24,416302,1539,324423,983,91879,556,356064,1099,2248227,4883,2604291,5982,37,5275,-915,20043,2417,390984,40,13174,6377,"East TN",2455501,465.566904676479,0.196644042232278,243.616272198627,62.6756006208102,816.248903991487,19.6644042232278
2021-09-25,416999,697,324911,488,92088,209,356626,562,2251249,3022,2607875,3584,2,5277,-915,19128,1610,392594,21,13195,6418,"East TN",2455501,434.697440563046,0.193052261075828,145.957993908371,28.3852460251492,778.985632667224,19.3052261075828
2021-09-26,417860,861,325538,627,92322,234,357349,723,2255226,3977,2612575,4700,6,5283,-430,18698,1285,393879,26,13221,6454,"East TN",2455501,443.534740975467,0.188276012295181,191.406967457965,35.0641274428314,761.473931389154,18.8276012295181
2021-09-27,419320,1460,326370,832,92950,628,358271,922,2258817,3591,2617088,4513,46,5329,-1369,17329,2783,396662,44,13265,6487,"East TN",2455501,422.276350121625,0.188810468291175,183.791413646339,59.4583345720486,705.721561506185,18.8810468291175
2021-09-28,420615,1295,327160,790,93455,505,359134,863,2262479,3662,2621613,4525,14,5343,-1018,16311,2299,398961,34,13299,6523,"East TN",2455501,398.778090499658,0.186085167009656,184.280112286658,52.7387282676733,664.263626852524,18.6085167009656
2021-09-29,422290,1675,328170,1010,94120,665,360272,1138,2267977,5498,2628249,6636,30,5373,-389,15922,2034,400995,50,13349,6567,"East TN",2455501,402.198980981885,0.183619168049738,270.250348095969,68.2141852110832,648.421645928876,18.3619168049738
2021-09-30,423499,1209,328928,758,94571,451,361091,819,2272649,4672,2633740,5491,11,5384,-787,15135,1985,402980,40,13389,6602,"East TN",2455501,355.772610151655,0.172899438344952,223.620352832273,49.2363880120595,616.37116010134,17.2899438344952
2021-10-01,424872,1373,329901,973,94971,400,362166,1075,2277622,4973,2639788,6048,14,5398,-296,14839,1655,404635,48,13437,6631,"East TN",2455501,349.012278960587,0.171901850860636,246.304114720377,55.9152694297416,604.316593640157,17.1901850860636
2021-10-02,425426,554,330253,352,95173,202,362561,395,2280292,2670,2642853,3065,11,5409,-467,14372,1010,405645,19,13456,6669,"East TN",2455501,343.188620163462,0.169678083366688,124.821777714609,22.5615872280239,585.29807155444,16.9678083366688
2021-10-03,425965,539,330718,465,95247,74,363085,524,2283384,3092,2646469,3616,13,5422,-348,14024,874,406519,15,13471,6702,"East TN",2455501,330.075206648256,0.169233492653567,147.261190282553,21.9507139276262,571.125810985212,16.9233492653567
2021-10-04,427315,1350,331576,858,95739,492,364025,940,2287522,4138,2651547,5078,22,5444,-606,13418,1934,408453,29,13500,6725,"East TN",2455501,325.595469112006,0.166981049943411,206.800974627988,54.9785970357984,546.446529649143,16.6981049943411
2021-10-05,428579,1264,332331,755,96248,509,364840,815,2291984,4462,2656824,5277,17,5461,-447,12971,1694,410147,40,13540,6765,"East TN",2455501,324.332997624517,0.1620516315924,214.905227079932,51.4762567801846,528.24250529729,16.20516315924
2021-10-06,429516,937,333038,707,96478,230,365621,781,2296405,4421,2662026,5202,18,5479,-404,12567,1323,411470,26,13566,6800,"East TN",2455501,294.278031244948,0.158362199129585,211.850860577943,38.1592188315134,511.789651073243,15.8362199129585
2021-10-07,430633,1117,333831,793,96802,324,366479,858,2301188,4783,2667667,5641,24,5503,-384,12183,1477,412947,26,13592,6830,"East TN",2455501,290.531341669175,0.158811566009373,229.729085836251,45.4896984362865,496.151294583061,15.8811566009373
2021-10-08,431687,1054,334417,586,97270,468,367123,644,2305435,4247,2672558,4891,9,5512,-127,12056,1172,414119,31,13623,6851,"East TN",2455501,277.540102814049,0.151266402197132,199.185420816363,42.9240305746159,490.979233973026,15.1266402197132
2021-10-09,432228,541,334772,355,97456,186,367540,417,2308244,2809,2675784,3226,4,5516,-294,11762,831,414950,32,13655,6880,"East TN",2455501,277.010679287038,0.151194922717197,131.378484472212,22.0321637010125,479.00611728523,15.1194922717197
2021-10-10,432548,320,335040,268,97508,52,367850,310,2310476,2232,2678326,2542,6,5522,-525,11237,839,415789,16,13671,6903,"East TN",2455501,268.09192910123,0.149574661769784,103.522661974074,13.0319637418189,457.625551771309,14.9574661769784
2021-10-11,433767,1219,335577,537,98190,682,368398,548,2313922,3446,2682320,3994,52,5574,-275,10962,1442,417231,33,13704,6917,"East TN",2455501,262.756968944423,0.142105092126215,162.655197452577,49.6436368789913,446.426207930683,14.2105092126215
2021-10-12,434702,935,336214,637,98488,298,369403,1005,2317566,3644,2686969,4649,29,5603,-366,10596,1272,418503,32,13736,6951,"East TN",2455501,249.358481222366,0.151368386133687,189.329998236612,38.077769058127,431.520899400978,15.1368386133687
2021-10-13,435549,847,336763,549,98786,298,370053,650,2321431,3865,2691484,4515,25,5628,-403,10193,1225,419728,37,13773,6974,"East TN",2455501,245.693241419979,0.150451490257315,183.872863419726,34.4939790291268,415.108770063624,15.0451490257315
2021-10-14,436498,949,337416,653,99082,296,370774,721,2325434,4003,2696208,4724,31,5659,-166,10027,1084,420812,33,13806,7006,"East TN",2455501,238.851460455524,0.150485266809152,192.384364738601,38.6479174718316,408.348438872556,15.0485266809152
2021-10-15,437300,802,337928,512,99372,290,371350,576,2329328,3894,2700678,4470,24,5683,-299,9728,1077,421889,30,13836,7031,"East TN",2455501,228.588789008842,0.150320056899004,182.040243518532,32.6613591279336,396.171697751294,15.0320056899004
2021-10-16,437607,307,338167,239,99440,68,371621,271,2331558,2230,2703179,2501,7,5690,-375,9353,675,422564,12,13848,7046,"East TN",2455501,219.059165522637,0.148968789925169,101.852941619653,12.5025402148075,380.89986524135,14.8968789925169
2021-10-17,437859,252,338377,210,99482,42,371869,248,2333221,1663,2705090,1911,7,5697,-449,8904,694,423258,14,13862,7062,"East TN",2455501,216.2898732275,0.150164399940218,77.8252584706746,10.2626714466824,362.61439111611,15.0164399940218
2021-10-18,438646,787,338844,467,99802,320,372385,516,2336412,3191,2708797,3707,23,5720,-469,8435,1233,424491,37,13899,7083,"East TN",2455501,198.696722176045,0.150583525323866,150.967154971633,32.0504858275358,343.514419257007,15.0583525323866
2021-10-19,439477,831,339285,441,100192,390,372859,474,2339740,3328,2712599,3802,25,5745,-269,8166,1075,425566,23,13922,7099,"East TN",2455501,194.461333959954,0.134841982052282,154.836019207486,33.8423808420359,332.559424736541,13.4841982052282
2021-10-20,440241,764,339775,490,100466,274,373400,541,2343761,4021,2717161,4562,15,5760,-211,7955,960,426526,21,13943,7118,"East TN",2455501,191.081168364419,0.130350118783347,185.786933094305,31.1138134335926,323.966473644279,13.0350118783347
2021-10-21,440870,629,340198,423,100672,206,373870,470,2347398,3637,2721268,4107,17,5777,-244,7711,856,427382,21,13964,7136,"East TN",2455501,178.0492046226,0.123543495610535,167.257109648907,25.6159537300127,314.029601291142,12.3543495610535
2021-10-22,441415,545,340538,340,100877,205,374256,386,2350502,3104,2724758,3490,6,5783,-317,7394,856,428238,18,13982,7154,"East TN",2455501,167.582908742452,0.120681063122924,142.129854559212,22.1950632477853,301.119812209402,12.0681063122924
2021-10-23,441772,357,340782,244,100990,113,374529,273,2352887,2385,2727416,2658,0,5783,-198,7196,555,428793,15,13997,7174,"East TN",2455501,169.619153077111,0.119981845938029,108.246748830483,14.5387845494667,293.056284644152,11.9981845938029
2021-10-24,442015,243,340944,162,101071,81,374725,196,2354784,1897,2729509,2093,7,5790,-301,6895,537,429330,14,14011,7186,"East TN",2455501,169.252629096873,0.116958106392563,85.2371878488341,9.89614746644371,280.798093749504,11.6958106392563
2021-10-25,442437,422,341192,248,101245,174,374996,271,2357215,2431,2732211,2702,28,5818,-489,6406,883,430213,21,14032,7197,"East TN",2455501,154.388045453861,0.111514478517127,110.038643844983,17.1859021845236,260.883624156537,11.1514478517127
2021-10-26,442963,526,341521,329,101442,197,375334,338,2359855,2640,2735189,2978,12,5830,-229,6177,743,430956,28,14060,7208,"East TN",2455501,141.966955012439,0.109561752988048,121.278712572302,21.4212904006148,251.557625103798,10.9561752988048
2021-10-27,443583,620,341916,395,101667,225,375758,424,2364052,4197,2739810,4621,10,5840,-83,6094,693,431649,21,14081,7229,"East TN",2455501,136.102571328621,0.104110556757473,188.189701409203,25.2494297497741,248.177459508263,10.4110556757473
2021-10-28,443999,416,342171,255,101828,161,376049,291,2366849,2797,2742898,3088,16,5856,-197,5897,597,432246,15,14096,7244,"East TN",2455501,127.428170462973,0.100739713361073,125.758450108552,16.9415528643645,240.154656829706,10.0739713361073
2021-10-29,444459,460,342476,305,101983,155,376382,333,2370367,3518,2746749,3851,4,5860,-151,5746,607,432853,10,14106,7261,"East TN",2455501,123.966555094052,0.0966759128734482,156.831538655452,18.7334478788646,234.005198939035,9.66759128734482
2021-10-30,444722,263,342678,202,102044,61,376611,229,2372941,2574,2749552,2803,0,5860,-147,5599,410,433263,16,14122,7275,"East TN",2455501,120.138415744893,0.0940549331405855,114.151857400995,10.7106452003074,228.018640595137,9.40549331405855
2021-10-31,444893,171,342805,127,102088,44,376757,146,2374566,1625,2751323,1771,0,5860,-224,5375,395,433658,5,14127,7286,"East TN",2455501,117.206223902984,0.0931511873109013,72.1237743336289,6.96395562453446,218.896265975864,9.31511873109013
2021-11-01,445489,596,343165,360,102324,236,377147,390,2377684,3118,2754831,3508,14,5874,-181,5194,763,434421,23,14150,7295,"East TN",2455501,124.292354187598,0.0950928381962865,142.862902519689,24.2720324691377,211.525061484398,9.50928381962865
2021-11-02,445901,412,343384,219,102517,193,377372,225,2379895,2211,2757267,2436,25,5899,-184,5010,571,434992,16,14166,7318,"East TN",2455501,119.649717104575,0.0923090859679319,99.2058239845962,16.7786533175918,204.031682332852,9.23090859679319
2021-11-03,446475,574,343763,379,102712,195,377765,393,2384473,4578,2762238,4971,6,5905,84,5094,484,435476,14,14180,7329,"East TN",2455501,117.776372316688,0.0894863563402889,202.443411751818,23.3760849618876,207.452572815079,8.94863563402889
2021-11-04,446894,419,344065,302,102829,117,378095,330,2388009,3536,2766104,3866,13,5918,-73,5021,479,435955,9,14189,7340,"East TN",2455501,117.898546976768,0.0881668533999828,157.442411955849,17.0637275244441,204.479656086477,8.81668533999828
2021-11-05,447329,435,344350,285,102979,150,378419,324,2391592,3583,2770011,3907,2,5920,25,5046,408,436363,13,14202,7346,"East TN",2455501,116.880424809438,0.0875677069899407,159.11213231027,17.715325711535,205.497778253806,8.75677069899407
2021-11-06,447562,233,344521,171,103041,62,378607,188,2393832,2240,2772439,2428,0,5920,-85,4961,318,436681,13,14215,7354,"East TN",2455501,115.658678208643,0.0872110805260628,98.8800248910507,9.48889859951187,202.036162884886,8.72110805260628
2021-11-07,447761,199,344649,128,103112,71,378761,154,2395734,1902,2774495,2056,6,5926,-130,4831,323,437004,8,14223,7366,"East TN",2455501,116.798975036052,0.0864836872087002,83.7303670411863,8.10425245194362,196.741927614772,8.64836872087002
2021-11-08,448303,542,344995,346,103308,196,379147,386,2399267,3533,2778414,3919,25,5951,-26,4805,543,437547,25,14248,7378,"East TN",2455501,114.59983115462,0.0848068523936734,159.600830950588,22.0728885877057,195.683080560749,8.48068523936734
2021-11-09,449172,869,345612,617,103560,252,379948,801,2406543,7276,2786491,8077,10,5961,426,5231,433,437980,27,14275,7393,"East TN",2455501,133.211104373405,0.0881467287161237,328.934909820847,35.3899265363769,213.031882292045,8.81467287161237
2021-11-10,449801,629,346049,437,103752,192,380450,502,2411794,5251,2792244,5753,7,5968,184,5415,438,438418,28,14303,7405,"East TN",2455501,135.45097314153,0.0894821035792841,234.290273145888,25.6159537300127,220.525261443591,8.94821035792841
2021-11-11,450306,505,346432,383,103874,122,380854,404,2416084,4290,2796938,4694,5,5973,83,5498,417,438835,10,14313,7418,"East TN",2455501,138.953313397144,0.0894791463968347,191.162618137806,20.5660677800579,223.905427039126,8.94791463968347
2021-11-12,450788,482,346754,322,104034,160,381186,332,2419534,3450,2800720,3782,2,5975,118,5616,362,439197,24,14337,7428,"East TN",2455501,140.867383071723,0.0901038783418542,154.021521473622,19.6293953861147,228.710963668921,9.01038783418542
2021-11-13,451026,238,346896,142,104130,96,381335,149,2421533,1999,2802868,2148,4,5979,-100,5516,334,439531,11,14348,7437,"East TN",2455501,141.071007505189,0.0896513194649841,87.4770566169592,9.69252303297779,224.638474999603,8.96513194649841
2021-11-14,451387,361,347212,316,104175,45,381680,345,2424512,2979,2806192,3324,1,5980,59,5575,301,439832,13,14361,7445,"East TN",2455501,147.668439149485,0.0920907341388775,135.369523368144,14.7016840962394,227.041243314501,9.20907341388775
2021-11-15,451964,577,347502,290,104462,287,381981,301,2427280,2768,2809261,3069,26,6006,-29,5546,580,440412,20,14381,7455,"East TN",2455501,149.093810183747,0.0918727915194346,124.984677261382,23.4982596219672,225.860221600398,9.18727915194346
2021-11-16,452636,672,347935,433,104701,239,382441,460,2430887,3607,2813328,4067,24,6030,180,5726,468,440880,17,14398,7465,"East TN",2455501,141.071007505189,0.0928941386891232,165.628114181179,27.3671238578196,233.190701205172,9.28941386891232
2021-11-17,453349,713,348401,466,104948,247,382950,509,2435532,4645,2818482,5154,5,6035,295,6021,413,441293,27,14425,7475,"East TN",2455501,144.491897987417,0.0952816525649821,209.89606601667,29.0368442122402,245.204542779661,9.52816525649821
2021-11-18,453976,627,348812,411,105164,216,383428,478,2440395,4863,2823823,5341,12,6047,183,6204,432,441725,19,14444,7484,"East TN",2455501,149.460334163985,0.0957411195834108,217.511619828296,25.5345039566264,252.657197044514,9.57411195834108
2021-11-19,454589,613,349255,443,105334,170,383888,460,2444869,4474,2828757,4934,7,6054,218,6422,388,442113,13,14457,7492,"East TN",2455501,154.795294320792,0.0963726504262225,200.93659094417,24.9643555429218,261.535222343628,9.63726504262225
2021-11-20,454911,322,349502,247,105409,75,384175,287,2447573,2704,2831748,2991,0,6054,21,6443,301,442414,14,14471,7499,"East TN",2455501,158.21618480302,0.0983379501385042,121.808136099313,13.1134135152052,262.390444964184,9.83379501385042
2021-11-21,455175,264,349654,152,105521,112,384339,164,2449057,1484,2833396,1648,9,6063,-94,6349,349,442763,10,14481,7510,"East TN",2455501,154.265870793781,0.0977429789736803,67.1146132703672,10.7513700870006,258.562305615025,9.77429789736803
2021-11-22,455928,753,350148,494,105780,259,384851,512,2452925,3868,2837776,4380,20,6083,153,6502,580,443343,38,14519,7515,"East TN",2455501,161.433450851781,0.100648781343153,178.375003716146,30.6658396799676,264.793213279082,10.0648781343153
2021-11-23,456604,676,350615,467,105989,209,385341,490,2456226,3301,2841567,3791,21,6104,119,6621,536,443879,18,14537,7522,"East TN",2455501,161.596350398554,0.102694854633663,154.388045453861,27.5300234045924,269.639474795571,10.2694854633663
2021-11-24,457342,738,351148,533,106194,205,385914,573,2460254,4028,2846168,4601,6,6110,255,6876,477,444356,21,14558,7532,"East TN",2455501,162.614472565884,0.107057718702593,187.37520367534,30.0549663795698,280.024320902333,10.7057718702593
2021-11-25,457628,286,351306,158,106322,128,386087,173,2461890,1636,2847977,1809,1,6111,-197,6679,482,444838,10,14568,7541,"East TN",2455501,148.727286203508,0.11008528608098,73.6713200279699,11.6473175942506,272.001518223776,11.008528608098
2021-11-26,457860,232,351508,202,106352,30,386330,243,2463567,1677,2849897,1920,1,6112,-286,6393,517,445355,16,14584,7545,"East TN",2455501,133.211104373405,0.115515610217597,78.1917824509133,9.44817371281869,260.354200629525,11.5515610217597
2021-11-27,458144,284,351736,228,106408,56,386584,254,2465162,1595,2851746,1849,0,6112,-96,6297,380,445735,14,14598,7556,"East TN",2455501,131.663558679064,0.12046204620462,75.3003154956972,11.5658678208643,256.44461150698,12.046204620462
2021-11-28,458458,314,351947,211,106511,103,386801,217,2466672,1510,2853473,1727,7,6119,-108,6189,415,446150,20,14618,7566,"East TN",2455501,133.699803013723,0.122627882651791,70.3318793191288,12.7876144216598,252.046323744116,12.2627882651791
2021-11-29,459557,1099,352660,713,106897,386,387539,738,2471219,4547,2858758,5285,19,6138,425,6614,655,446805,36,14654,7574,"East TN",2455501,147.790613809565,0.128109808407206,215.231026173477,44.7566504758092,269.354400588719,12.8109808407206
2021-11-30,460395,838,353168,508,107227,330,388044,505,2474586,3367,2862630,3872,64,6202,186,6800,588,447393,26,14680,7586,"East TN",2455501,154.388045453861,0.128329297820823,157.686761276008,34.1274550488882,276.929229513651,12.8329297820823
2021-12-01,461478,1083,353938,770,107540,313,388851,807,2479758,5172,2868609,5979,48,6250,505,7305,530,447923,32,14712,7607,"East TN",2455501,168.438131363009,0.13087652065416,243.494097538547,44.1050522887183,297.495297293709,13.087652065416
2021-12-02,462381,903,354561,623,107820,280,389517,666,2484419,4661,2873936,5327,39,6289,282,7587,582,448505,18,14730,7623,"East TN",2455501,193.565386452704,0.132131438036904,216.941471414591,36.7745726839452,308.979715341187,13.2131438036904
2021-12-03,463400,1019,355297,736,108103,283,390299,782,2489397,4978,2879696,5760,21,6310,519,8106,479,448984,24,14754,7635,"East TN",2455501,225.615872280239,0.133192389006343,234.57534735274,41.4986595403545,330.115931534949,13.3192389006343
2021-12-04,463823,423,355630,333,108193,90,390680,381,2492149,2752,2882829,3133,3,6313,18,8124,402,449386,29,14783,7647,"East TN",2455501,231.276631530592,0.131776212077341,127.591070009745,17.2266270712168,330.848979495427,13.1776212077341
2021-12-05,464208,385,355846,216,108362,169,390911,231,2494081,1932,2884992,2163,12,6325,-31,8093,404,449790,15,14798,7655,"East TN",2455501,234.168098485808,0.130397537992957,88.087929917357,15.6790813768758,329.586508007938,13.0397537992957
2021-12-06,465164,956,356491,645,108673,311,391602,691,2498265,4184,2889867,4875,69,6394,132,8225,755,450545,32,14830,7669,"East TN",2455501,228.344439688683,0.130605291073323,198.533822629272,38.9329916786839,334.962193051438,13.0605291073323
2021-12-07,466006,842,357025,534,108981,308,392143,541,2501742,3477,2893885,4018,8,6402,219,8444,615,451160,25,14855,7674,"East TN",2455501,228.507339235455,0.131147016477364,163.632594733213,34.2903545956609,343.880943237246,13.1147016477364
2021-12-08,467054,1048,357660,635,109394,413,392800,657,2506358,4616,2899158,5273,4,6406,448,8892,596,451756,28,14883,7690,"East TN",2455501,227.081968201194,0.129267733804707,214.742327533159,42.6796812544568,362.125692475792,12.9267733804707
2021-12-09,467973,919,358278,618,109695,301,393466,666,2511335,4977,2904801,5643,19,6425,526,9418,374,452130,28,14911,7704,"East TN",2455501,227.733566388285,0.12794427344889,229.810535609637,37.4261708710361,383.546982876407,12.794427344889
2021-12-10,468767,794,358826,548,109941,246,394067,601,2515845,4510,2909912,5111,5,6430,160,9578,629,452759,19,14930,7718,"East TN",2455501,218.570466882319,0.124702144559174,208.144895888863,32.3355600343881,390.062964747316,12.4702144559174
2021-12-11,469164,397,359112,286,110052,111,394392,325,2518767,2922,2913159,3247,0,6430,-174,9404,571,453330,18,14948,7727,"East TN",2455501,217.511619828296,0.122387075502803,132.233707092768,16.167780017194,382.976834462702,12.2387075502803
2021-12-12,469595,431,359375,263,110220,168,394686,294,2521286,2519,2915972,2813,9,6439,-136,9268,558,453888,17,14965,7734,"East TN",2455501,219.384964616182,0.121852808263396,114.559106267927,17.5524261647623,377.438249872429,12.1852808263396
2021-12-13,470478,883,359948,573,110530,310,395289,603,2525888,4602,2921177,5205,24,6463,-166,9102,1025,454913,20,14985,7743,"East TN",2455501,216.41204788758,0.11775790482274,211.973035238023,35.9600749500815,370.677918681361,11.775790482274
2021-12-14,471234,756,360404,456,110830,300,395772,483,2529911,4023,2925683,4506,36,6499,-125,8977,845,455758,18,15003,7751,"East TN",2455501,212.909707631966,0.114126674633625,183.506339439487,30.7880143400471,365.587307844713,11.4126674633625
2021-12-15,472105,871,360992,588,111113,283,396400,628,2534715,4804,2931115,5432,19,6518,5,8982,847,456605,20,15023,7766,"East TN",2455501,205.701402687272,0.11265137528554,221.217584517375,35.4713763097633,365.790932278179,11.265137528554
2021-12-16,472900,795,361501,509,111399,286,396945,545,2538535,3820,2935480,4365,19,6537,23,9005,753,457358,21,15044,7782,"East TN",2455501,200.651516737318,0.113400045633821,177.764130415748,32.3762849210813,366.727604672122,11.3400045633821
2021-12-17,473713,813,362039,538,111674,275,397530,585,2543203,4668,2940733,5253,24,6561,53,9058,736,458094,29,15073,7796,"East TN",2455501,201.425289584488,0.112358456896272,213.927829799296,33.1093328815586,368.886023666861,11.2358456896272
2021-12-18,474285,572,362420,381,111865,191,397956,426,2546548,3345,2944504,3771,0,6561,36,9094,536,458630,19,15092,7809,"East TN",2455501,208.552144755795,0.11370234487159,153.573547719997,23.2946351885012,370.352119587815,11.370234487159
2021-12-19,474706,421,362701,281,112005,140,398267,311,2549211,2663,2947478,2974,6,6567,-164,8930,579,459209,16,15108,7818,"East TN",2455501,208.144895888863,0.113660889989208,121.115813025529,17.1451772978305,363.673238170133,11.3660889989208
2021-12-20,475641,935,363325,624,112316,311,398905,638,2553173,3962,2952078,4600,40,6607,53,8983,842,460051,27,15135,7829,"East TN",2455501,210.262589996909,0.117018866703343,187.334478788646,38.077769058127,365.831657164872,11.7018866703343
2021-12-21,476651,1010,363982,657,112669,353,399574,669,2557556,4383,2957130,5052,30,6637,211,9194,769,460820,22,15157,7839,"East TN",2455501,220.606711216978,0.120901834833211,205.742127573966,41.1321355601158,374.424608257134,12.0901834833211
2021-12-22,478144,1493,364709,727,113435,766,400322,748,2561896,4340,2962218,5088,857,7494,-107,9087,743,461563,33,15190,7855,"East TN",2455501,245.937590740138,0.126097161045558,207.20822349492,60.8022558329237,370.067045380963,12.6097161045558
2021-12-23,479313,1169,365515,806,113798,363,401185,863,2566382,4486,2967567,5349,28,7522,395,9482,746,462309,25,15215,7872,"East TN",2455501,261.168698363389,0.132140742356718,217.837418921841,47.6073925443321,386.153375624771,13.2140742356718
2021-12-24,480253,940,366164,649,114089,291,401893,708,2570219,3837,2972112,4545,0,7522,286,9768,654,462963,13,15228,7894,"East TN",2455501,266.340758973423,0.13904203448166,185.094610020521,38.281393491593,397.800693219021,13.904203448166
2021-12-25,480734,481,366448,284,114286,197,402226,333,2572338,2119,2974564,2452,8,7530,-21,9747,494,463457,15,15243,7902,"East TN",2455501,262.634794284344,0.142049234863606,99.8574221716871,19.5886704994215,396.945470598464,14.2049234863606
2021-12-26,481077,343,366724,276,114353,67,402546,320,2574213,1875,2976759,2195,62,7592,-226,9521,507,463964,16,15259,7919,"East TN",2455501,259.458253122275,0.14613571940849,89.3911262915389,13.9686361357621,387.741646205805,14.613571940849
2021-12-27,482960,1883,367984,1260,114976,623,403857,1311,2578967,4754,2982824,6065,64,7656,937,10458,882,464846,29,15288,7936,"East TN",2455501,298.065445707414,0.161061601509139,246.996437794161,76.6849616432655,425.900865037318,16.1061601509139
2021-12-28,485389,2429,369427,1443,115962,986,405344,1487,2583346,4379,2988690,5866,18,7674,1657,12115,754,465600,21,15309,7948,"East TN",2455501,355.854059925042,0.182826362484157,238.892185342217,98.9207497777439,493.382002287924,18.2826362484157
2021-12-29,488283,2894,371354,1927,116929,967,407347,2003,2588635,5289,2995982,7292,37,7711,2077,14192,780,466380,27,15336,7963,"East TN",2455501,412.909626182193,0.208061841014098,296.965873766698,117.857822090074,577.967591949667,20.8061841014098
2021-12-30,491110,2827,373138,1784,117972,1043,409170,1823,2593098,4463,3002268,6286,14,7725,2056,16248,757,467137,30,15366,7977,"East TN",2455501,480.431488319492,0.230108642402236,255.996637753355,115.129254681631,661.697958990854,23.0108642402236
2021-12-31,493628,2518,374948,1810,118680,708,411112,1942,2597931,4833,3009043,6775,0,7725,1795,18043,723,467860,21,15387,7996,"East TN",2455501,544.695359521336,0.249627684059462,275.911107346322,102.545264693437,734.799130605119,24.9627684059462
2022-01-01,495086,1458,376174,1226,118912,232,412450,1338,2601581,3650,3014031,4988,0,7725,928,18971,530,468390,28,15415,8004,"East TN",2455501,584.483573820577,0.259051866115996,203.135734825602,59.3768847986623,772.591825456394,25.9051866115996
2022-01-02,496550,1464,377135,961,119415,503,413673,1223,2604597,3016,3018270,4239,6,7731,841,19812,617,469007,23,15438,8024,"East TN",2455501,630.136171803636,0.268049432680494,172.632794692407,59.6212341188214,806.841455165361,26.8049432680494
2022-01-03,499448,2898,379316,2181,120132,717,415896,2223,2608768,4171,3024664,6394,33,7764,1800,21612,1065,470072,29,15467,8038,"East TN",2455501,671.471931797218,0.287739005736138,260.394925516218,118.020721636847,880.146251213093,28.7739005736138
2022-01-04,503621,4173,381755,2439,121866,1734,418281,2385,2614005,5237,3032286,7622,14,7778,2932,24544,1227,471299,33,15500,8056,"East TN",2455501,742.496134190131,0.296747408019084,310.405086375448,169.944952170657,999.551618997508,29.6747408019084
2022-01-05,508552,4931,385162,3407,123390,1524,421778,3497,2619239,5234,3041017,8731,15,7793,3655,28199,1261,472560,40,15540,8081,"East TN",2455501,825.452728384146,0.320439658043744,355.568985718189,200.81441628409,1148.4010798611,32.0439658043744
2022-01-06,513723,5171,388629,3467,125094,1704,425424,3646,2624851,5612,3050275,9258,11,7804,3909,32108,1251,473811,34,15574,8101,"East TN",2455501,920.91186279297,0.33857562438811,377.031001005497,210.588389090454,1307.59466194475,33.857562438811
2022-01-07,518099,4376,391852,3223,126247,1153,428696,3272,2629535,4684,3058231,7956,12,7816,3536,35644,828,474639,29,15603,8123,"East TN",2455501,996.578702268906,0.357485565585102,324.007198530972,178.212104169373,1451.59786129185,35.7485565585102
2022-01-08,521247,3148,394277,2425,126970,723,431299,2603,2634297,4762,3065596,7365,1,7817,2782,38426,365,475004,33,15636,8142,"East TN",2455501,1065.40376078039,0.365538640550761,299.9387904953,128.201943310143,1564.89449607229,36.5538640550761
2022-01-09,524745,3498,396954,2677,127791,821,434188,2889,2639299,5002,3073487,7891,15,7832,2115,40541,1368,476372,28,15664,8160,"East TN",2455501,1148.23818031432,0.371534128982016,321.360080895915,142.455653652758,1651.02763142837,37.1534128982016
2022-01-10,529392,4647,400023,3069,129369,1578,437430,3242,2644078,4779,3081508,8021,29,7861,1638,42179,2980,479352,47,15711,8193,"East TN",2455501,1219.4660071407,0.378826261346844,326.654316166029,189.248548463226,1717.73499583181,37.8826261346844
2022-01-11,535002,5610,404063,4040,130939,1570,441564,4134,2649267,5189,3090831,9323,30,7891,2144,44323,3436,482788,41,15752,8216,"East TN",2455501,1277.98766931881,0.397694081475788,379.678118640554,228.466614348762,1805.04915290199,39.7694081475788
2022-01-12,540682,5680,408039,3976,132643,1704,445722,4158,2654037,4770,3099759,8928,16,7907,2305,46628,3359,486147,24,15776,8237,"East TN",2455501,1308.490609452,0.407612951550849,363.591788396747,231.317356417285,1898.92001672978,40.7612951550849
2022-01-13,548011,7329,413286,5247,134725,2082,451198,5476,2660964,6927,3112162,12403,65,7972,3720,50348,3544,489691,41,15817,8253,"East TN",2455501,1396.37491493589,0.416468725257324,505.110769655561,298.472694574346,2050.41659522843,41.6468725257324
2022-01-14,554527,6516,418072,4786,136455,1730,456126,4928,2666844,5880,3122970,10808,69,8041,4475,54823,1972,491663,26,15843,8285,"East TN",2455501,1483.52617245931,0.423701323777012,440.154575379933,265.363361692787,2232.66046318043,42.3701323777012
2022-01-15,559079,4552,421468,3396,137611,1156,459737,3611,2671933,5089,3131670,8700,10,8051,3330,58153,1212,492875,25,15868,8298,"East TN",2455501,1540.70391337654,0.43039622241729,354.306514230701,185.379684227374,2368.27433586873,43.039622241729
2022-01-16,562944,3865,424795,3327,138149,538,463233,3496,2676581,4648,3139814,8144,7,8058,1565,59718,2293,495168,21,15889,8315,"East TN",2455501,1555.64994679294,0.437906131741222,331.66347722929,157.401687069156,2432.00878354356,43.7906131741222
2022-01-17,567573,4629,428122,3327,139451,1302,466699,3466,2681316,4735,3148015,8201,15,8073,-421,59297,5035,500203,28,15917,8337,"East TN",2455501,1554.91689883246,0.440089013186582,333.984795770802,188.515500502749,2414.86360624573,44.0089013186582
2022-01-18,573531,5958,431796,3674,141735,2284,470435,3736,2684777,3461,3155212,7197,49,8122,-18,59279,5927,506130,29,15946,8366,"East TN",2455501,1569.08915940169,0.448439757071186,293.097009530845,242.63887491799,2414.13055828525,44.8439757071186
2022-01-19,581838,8307,437800,6004,144038,2303,476608,6173,2690625,5848,3167233,12021,22,8144,2639,61918,5646,511776,26,15972,8397,"East TN",2455501,1676.07343674468,0.457746687613006,489.553862938765,338.301633760279,2521.60353426857,45.7746687613006
2022-01-20,590121,8283,443854,6054,146267,2229,482873,6265,2696342,5717,3179215,11982,44,8188,3725,65643,4514,516290,28,16000,8430,"East TN",2455501,1714.92497864998,0.472387514354317,487.965592357731,337.324236479643,2673.30373720068,47.2387514354317
2022-01-21,597428,7307,449464,5610,147964,1697,488755,5882,2702065,5723,3190820,11605,53,8241,3141,68784,4113,520403,24,16024,8459,"East TN",2455501,1747.13836402429,0.480899042004422,472.6123100744,297.576747067095,2801.22060630397,48.0899042004421
2022-01-22,603436,6008,454332,4868,149104,1140,493917,5162,2708152,6087,3202069,11249,0,8241,2879,71663,3129,523532,37,16061,8485,"East TN",2455501,1806.43379904956,0.48551826020256,458.114250411627,244.675119252649,2918.46755509364,48.551826020256
2022-01-23,607038,3602,457309,2977,149729,625,497061,3144,2711421,3269,3208482,6413,6,8247,523,72186,3073,526605,21,16082,8516,"East TN",2455501,1795.72315384926,0.492631211044446,261.168698363389,146.691041868849,2939.76667083418,49.2631211044446
2022-01-24,613728,6690,461989,4680,151739,2010,502021,4960,2716801,5380,3218822,10340,37,8284,-635,71551,7288,533893,36,16118,8549,"East TN",2455501,1879.65714532391,0.498848983857528,421.095328407523,272.449491977401,2913.90636778401,49.8848983857528
2022-01-25,619434,5706,466059,4070,153375,1636,506282,4261,2721456,4655,3227738,8916,30,8314,-1539,70012,7215,541108,26,16144,8578,"East TN",2455501,1869.39447387722,0.494264125968618,363.103089756429,232.376203471308,2851.2307671632,49.4264125968618
2022-01-26,625237,5803,470482,4423,154755,1380,510957,4675,2726350,4894,3237307,9569,27,8341,-1744,68268,7520,548628,25,16169,8609,"East TN",2455501,1767.41935759749,0.490181807803179,389.696440767078,236.326517480547,2780.20656477029,49.0181807803179
2022-01-27,632496,7259,476249,5767,156247,1492,517098,6141,2733504,7154,3250602,13295,29,8370,-307,67961,7537,556165,39,16208,8648,"East TN",2455501,1725.71707362367,0.479429027694118,541.437368585881,295.621952505823,2767.70402455548,47.9429027694118
2022-01-28,637461,4965,479951,3702,157510,1263,521028,3930,2738343,4839,3259371,8769,38,8408,-2433,65528,7360,563525,33,16241,8678,"East TN",2455501,1630.33938898823,0.470788172309667,357.11653141253,202.199062431659,2668.62037523096,47.0788172309667
2022-01-29,641527,4066,483223,3272,158304,794,524574,3546,2743775,5432,3268349,8978,5,8413,241,65769,3820,567345,24,16265,8708,"East TN",2455501,1551.25165903007,0.462537718768859,365.628032731406,165.587389294486,2678.43507292402,46.2537718768859
2022-01-30,643597,2070,484731,1508,158866,562,526168,1594,2746254,2479,3272422,4073,17,8430,-1103,64666,3156,570501,16,16281,8741,"East TN",2455501,1488.86113261611,0.455223647169221,165.872463501338,84.3005154548909,2633.51552290144,45.5223647169221
2022-01-31,647505,3908,487190,2459,160315,1449,528735,2567,2749187,2933,3277922,5500,68,8498,-3001,61665,6841,577342,30,16311,8773,"East TN",2455501,1375.56449783568,0.452013536379019,223.986876812512,159.152857196963,2511.30013793519,45.2013536379019
2022-02-01,652481,4976,490711,3521,161770,1455,532641,3906,2754446,5259,3287087,9165,28,8526,-5005,56660,9953,587295,29,16340,8801,"East TN",2455501,1345.83533054965,0.444135537245783,373.243586543031,202.647036185284,2307.47208003581,44.4135537245783
2022-02-02,657202,4721,494222,3511,162980,1210,536394,3753,2759347,4901,3295741,8654,21,8547,-5030,51630,9730,597025,31,16371,8832,"East TN",2455501,1301.77100314763,0.435311633637951,352.433169442814,192.262190078522,2102.62589996909,43.5311633637951
2022-02-03,666142,8940,496895,2673,169247,6267,539218,2824,2763700,4353,3302918,7177,26,8573,468,52098,8446,605471,24,16395,8851,"East TN",2455501,1370.22953767887,0.422815199938833,292.282511796982,364.080487037065,2121.6851469415,42.2815199938833
2022-02-04,669684,3542,499417,2522,170267,1020,541961,2743,2768291,4591,3310252,7334,12,8585,-2924,49174,6454,611925,18,16413,8874,"East TN",2455501,1312.27802391447,0.411410939250408,298.676319007811,144.247548667258,2002.60557825063,41.1410939250408
2022-02-05,671361,1677,500602,1185,170759,492,543293,1332,2770916,2625,3314209,3957,3,8588,-1767,47407,3441,615366,12,16425,8908,"East TN",2455501,1214.98626960445,0.408177060619276,161.148376644929,68.2956349844696,1930.64470346377,40.8177060619276
2022-02-06,672666,1305,501546,944,171120,361,544378,1085,2773568,2652,3317946,3737,1,8589,-1939,45468,3243,618609,21,16446,8927,"East TN",2455501,1183.83173128417,0.400008786574115,152.188901572429,53.1459771346051,1851.67914816569,40.0008786574115
2022-02-07,675475,2809,503377,1831,172098,978,546350,1972,2776454,2886,3322804,4858,50,8639,-5560,39908,8319,626928,25,16471,8948,"East TN",2455501,1139.07508080836,0.392473597433269,197.841499555488,114.396206721154,1625.24877815159,39.2473597433269
2022-02-08,678146,2671,505087,1710,173059,961,548238,1888,2779121,2667,3327359,4555,21,8660,-4708,35200,7358,634286,26,16497,8969,"East TN",2455501,1045.20421698057,0.387291418355185,185.501858887453,108.776172357494,1433.51601160008,38.7291418355185
2022-02-09,681059,2913,507167,2080,173892,833,550549,2311,2782792,3671,3333341,5982,26,8686,-3037,32163,5924,640210,16,16513,8989,"East TN",2455501,971.573621839291,0.376462765957447,243.616272198627,118.631594937245,1309.83453071288,37.6462765957447
2022-02-10,683570,2511,508949,1782,174621,729,552520,1971,2786001,3209,3338521,5180,28,8714,-2854,29309,5337,645547,23,16536,9009,"East TN",2455501,709.753325288811,0.373620200544898,210.954913070693,102.260190486585,1193.60570409053,37.3620200544898
2022-02-11,685872,2302,510675,1726,175197,576,554419,1899,2789365,3364,3343784,5263,31,8745,-1949,27360,4220,649767,28,16564,9025,"East TN",2455501,659.254465789263,0.371525706787546,214.335078666227,93.7486891677096,1114.23289992551,37.1525706787546
2022-02-12,686805,933,511359,684,175446,249,555198,779,2791867,2502,3347065,3281,3,8748,-1250,26110,2180,651947,13,16577,9046,"East TN",2455501,628.955150089534,0.362338690041393,133.618353240337,37.9963192847407,1063.32679155903,36.2338690041393
2022-02-13,687380,575,511774,415,175606,160,555681,483,2793269,1402,3348950,1885,35,8783,-1504,24606,2044,653991,8,16585,9056,"East TN",2455501,599.225982803509,0.364565862469359,76.7664114166518,23.4168098485808,1002.07656197249,36.4565862469359
2022-02-14,689626,2246,513204,1430,176422,816,557300,1619,2796276,3007,3353576,4626,146,8929,-2751,21855,4851,658842,18,16603,9073,"East TN",2455501,576.297871595247,0.355842974132328,188.393325842669,91.4680955128913,890.042398679536,35.5842974132328
2022-02-15,691523,1897,514602,1398,176921,499,558832,1532,2799141,2865,3357973,4397,39,8968,-2272,19583,4130,662972,18,16621,9089,"East TN",2455501,544.776809294722,0.346050826419285,179.06732678993,77.2551100569701,797.515456112622,34.6050826419285
2022-02-16,693291,1768,515836,1234,177455,534,560205,1373,2802348,3207,3362553,4580,14,8982,-1704,17879,3458,666430,16,16637,9102,"East TN",2455501,498.146814031027,0.330549089415309,186.519981054783,72.0015996735493,728.120249187437,33.0549089415309
2022-02-17,695090,1799,517113,1277,177977,522,561611,1406,2805871,3523,3367482,4929,13,8995,-1364,16515,3150,669580,13,16650,9114,"East TN",2455501,469.15069470548,0.313904906598529,200.732966510704,73.264071161038,672.571503737934,31.3904906598529
2022-02-18,696269,1179,517834,721,178435,458,562448,837,2808836,2965,3371284,3802,8,9003,-1206,15309,2377,671957,6,16656,9132,"East TN",2455501,423.416646949034,0.291963636363636,154.836019207486,48.0146414112639,623.457290385954,29.1963636363636
2022-02-19,696806,537,518179,345,178627,192,562859,411,2810938,2102,3373797,2513,1,9004,-732,14577,1268,673225,7,16663,9150,"East TN",2455501,407.289591818533,0.286585365853659,102.341640259971,21.8692641542398,593.646673326543,28.6585365853659
2022-02-20,697175,369,518412,233,178763,136,563131,272,2812374,1436,3375505,1708,8,9012,-926,13651,1287,674512,2,16665,9160,"East TN",2455501,398.900265159737,0.280549802297119,69.5581064719583,15.0274831897849,555.935428248655,28.0549802297119
2022-02-21,697905,730,518819,407,179086,323,563576,445,2813925,1551,3377501,1996,7,9019,-2028,11623,2751,677263,5,16670,9169,"East TN",2455501,337.16133693287,0.262319749216301,81.2868738395953,29.7291672860243,473.345358034878,26.2319749216301
2022-02-22,699079,1174,519469,650,179610,524,564305,729,2816276,2351,3380581,3080,44,9063,-957,10666,2087,679350,14,16684,9176,"East TN",2455501,307.717243853698,0.242082448690729,125.432651015007,47.811016977798,434.371641469501,24.2082448690729
2022-02-23,699951,872,519941,472,180010,400,564842,537,2818873,2597,3383715,3134,80,9143,-939,9727,1731,681081,3,16687,9190,"East TN",2455501,271.227745376605,0.219119175881297,127.631794896439,35.5121011964564,396.130972864601,21.9119175881297
2022-02-24,700811,860,520427,486,180384,374,565409,567,2821373,2500,3386782,3067,50,9193,-778,8949,1588,682669,6,16693,9197,"East TN",2455501,232.987076771706,0.196787564766839,124.903227487995,35.0234025561382,364.447011017304,19.6787564766839
2022-02-25,701579,768,520910,483,180669,285,565913,504,2823750,2377,3389663,2881,5,9198,-465,8484,1228,683897,11,16704,9197,"East TN",2455501,216.249148340807,0.188530387942761,117.328398563063,31.2767129803653,345.509938704973,18.8530387942761
2022-02-26,701837,258,521094,184,180743,74,566126,213,2825487,1737,3391613,1950,NA,NA,NA,NA,648,684545,0,16704,9198,"East TN",2455501,204.886904953409,0.183374494836102,79.4135290517088,10.5070207668415,NA,18.3374494836102
