"DATE","TOTAL_CASES","NEW_CASES","TOTAL_CONFIRMED","NEW_CONFIRMED","TOTAL_PROBABLE","NEW_PROBABLE","POS_TESTS","NEW_POS_TESTS","NEG_TESTS","NEW_NEG_TESTS","TOTAL_TESTS","NEW_TESTS","NEW_DEATHS","TOTAL_DEATHS","NEW_HOSPITALIZED","TOTAL_HOSPITALIZED","TOTAL_DEATHS_BY_DOD","NEW_DEATHS_BY_DOD","Region","Population","New_cases_per_100k_per_week","PositivityRate_per_week","Tests_per_100k","New_cases_per_100k","PositivityPercentage_per_week"
2022-10-08,149224,31,112186,17,37038,14,121180,17,589799,125,710979,142,0,1515,0,2797,1515,0,"Knox County",470313,NA,NA,30.1926589313925,6.59135511882512,NA
2022-10-07,149193,55,112169,30,37024,25,121163,32,589674,257,710837,289,0,1515,0,2797,1515,0,"Knox County",470313,NA,NA,61.4484396561439,11.6943397269478,NA
2022-10-06,149138,99,112139,64,36999,35,121131,70,589417,275,710548,345,6,1515,0,2797,1515,0,"Knox County",470313,NA,NA,73.3554037417635,21.049811508506,NA
2022-10-05,149039,80,112075,40,36964,40,121061,41,589142,182,710203,223,0,1509,0,2797,1515,0,"Knox County",470313,NA,NA,47.4152319838065,17.0099486937423,NA
2022-10-04,148959,46,112035,30,36924,16,121020,33,588960,327,709980,360,0,1509,0,2797,1515,0,"Knox County",470313,NA,NA,76.5447691218401,9.7807204989018,NA
2022-10-03,148913,111,112005,36,36908,75,120987,36,588633,111,709620,147,1,1509,0,2797,1515,0,"Knox County",470313,NA,NA,31.2557807247514,23.6013038125674,NA
2022-10-02,148802,19,111969,10,36833,9,120951,12,588522,92,709473,104,0,1508,0,2797,1515,0,"Knox County",470313,93.7673421742542,0.149689440993789,22.1129333018649,4.03986281476378,14.9689440993789
2022-10-01,148783,29,111959,20,36824,9,120939,22,588430,81,709369,103,0,1508,0,2797,1515,0,"Knox County",470313,93.3420934569106,0.156588160407384,21.9003089431931,6.16610640148157,15.6588160407384
2022-09-30,148754,76,111939,44,36815,32,120917,50,588349,166,709266,216,1,1508,0,2797,1515,1,"Knox County",470313,97.807204989018,0.176234979973298,45.9268614731041,16.1594512590551,17.6234979973298
2022-09-29,148678,64,111895,38,36783,26,120867,42,588183,226,709050,268,2,1507,0,2797,1514,0,"Knox County",470313,90.3653524355057,0.166080225193526,56.9833281240365,13.6079589549938,16.6080225193526
2022-09-28,148614,76,111857,45,36757,31,120825,48,587957,241,708782,289,4,1505,0,2797,1514,0,"Knox County",470313,89.5148550008186,0.163416274377942,61.4484396561439,16.1594512590551,16.3416274377942
2022-09-27,148538,92,111812,54,36726,38,120777,56,587716,171,708493,227,1,1501,0,2797,1514,0,"Knox County",470313,99.2955754997204,0.196454948301329,48.2657294184936,19.5614409978036,19.6454948301329
2022-09-26,148446,69,111758,29,36688,40,120721,33,587545,92,708266,125,0,1500,0,2797,1514,0,"Knox County",470313,90.3653524355057,0.197447447447447,26.5780448339723,14.6710807483527,19.7447447447447
2022-09-25,148377,28,111729,17,36648,11,120688,16,587453,89,708141,105,0,1500,0,2797,1514,0,"Knox County",470313,92.2789716635517,0.200300075018755,22.3255576605367,5.95348204280979,20.0300075018755
2022-09-24,148349,14,111712,10,36637,4,120672,10,587364,65,708036,75,0,1500,0,2797,1514,1,"Knox County",470313,89.089606283475,0.195402298850575,15.9468269003834,2.97674102140489,19.5402298850575
2022-09-23,148335,75,111702,46,36633,29,120662,50,587299,192,707961,242,5,1500,0,2797,1513,3,"Knox County",470313,88.8769819248033,0.191585274229902,51.4550947985703,15.9468269003834,19.1585274229902
2022-09-22,148260,97,111656,66,36604,31,120612,73,587107,233,707719,306,4,1495,1,2797,1510,0,"Knox County",470313,95.893585760972,0.20891161431702,65.0630537535641,20.6245627911625,20.891161431702
2022-09-21,148163,89,111590,54,36573,35,120539,59,586874,226,707413,285,3,1491,0,2796,1510,0,"Knox County",470313,98.6577024237051,0.217582417582418,60.5979422214568,18.9235679217883,21.7582417582418
2022-09-20,148074,84,111536,35,36538,49,120480,38,586648,168,707128,206,1,1488,0,2796,1510,3,"Knox County",470313,96.9567075543308,0.207589285714286,43.8006178863863,17.8604461284294,20.7589285714286
2022-09-19,147990,113,111501,46,36489,67,120442,51,586480,152,706922,203,0,1487,0,2796,1507,0,"Knox County",470313,106.312179335889,0.208860759493671,43.162744810371,24.0265525299109,20.8860759493671
2022-09-18,147877,49,111455,37,36422,12,120391,40,586328,95,706719,135,0,1487,1,2796,1507,1,"Knox County",470313,110.777290867996,0.221074380165289,28.70428842069,10.4185935749171,22.1074380165289
2022-09-17,147828,41,111418,16,36410,25,120351,18,586233,117,706584,135,0,1487,0,2795,1506,0,"Knox County",470313,116.518148552134,0.217592592592593,28.70428842069,8.7175987055429,21.7592592592593
2022-09-16,147787,91,111402,33,36385,58,120333,39,586116,295,706449,334,0,1487,0,2795,1506,0,"Knox County",470313,119.920138290883,0.198254364089776,71.0165357963739,19.3488166391318,19.8254364089776
2022-09-15,147696,146,111369,82,36327,64,120294,87,585821,288,706115,375,2,1487,0,2795,1506,1,"Knox County",470313,130.3387318658,0.198445905558876,79.7341345019168,31.0431563660796,19.8445905558876
2022-09-14,147550,126,111287,67,36263,59,120207,74,585533,220,705740,294,4,1485,0,2795,1505,1,"Knox County",470313,138.205833136656,0.206302021403092,62.5115614495028,26.790669192644,20.6302021403092
2022-09-13,147424,106,111220,62,36204,44,120133,65,585313,213,705446,278,0,1481,0,2795,1504,1,"Knox County",470313,142.883569027435,0.213226909920182,59.1095717107543,22.5381820192085,21.3226909920182
2022-09-12,147318,116,111158,49,36160,67,120068,57,585100,137,705168,194,0,1481,0,2795,1503,1,"Knox County",470313,143.52144210345,0.217765042979943,41.249125582325,24.6644256059263,21.7765042979943
2022-09-11,147202,48,111109,26,36093,22,120011,27,584963,77,704974,104,0,1481,0,2795,1502,1,"Knox County",470313,143.308817744778,0.214119019836639,22.1129333018649,10.2059692162454,21.4119019836639
2022-09-10,147154,72,111083,50,36071,22,119984,54,584886,139,704870,193,0,1481,0,2795,1501,0,"Knox County",470313,149.900172863604,0.227426636568849,41.0365012236532,15.308953824368,22.7426636568849
2022-09-09,147082,154,111033,103,36049,51,119930,112,584747,259,704677,371,0,1481,0,2795,1501,4,"Knox County",470313,163.295507459926,0.263128800442233,78.8836370672297,32.7441512354538,26.3128800442233
2022-09-08,146928,178,110930,115,35998,63,119818,122,584488,336,704306,458,0,1481,0,2795,1497,1,"Knox County",470313,170.099486937423,0.270084566596195,97.3819562716744,37.8471358435765,27.0084566596195
2022-09-07,146750,181,110815,96,35935,85,119696,105,584152,263,703848,368,0,1481,0,2795,1496,1,"Knox County",470313,181.79382666437,0.275686673448627,78.2457639912144,38.4850089195918,27.5686673448627
2022-09-06,146569,167,110719,97,35850,70,119591,98,583889,162,703480,260,-1,1481,0,2795,1495,0,"Knox County",470313,194.763912543349,0.29517453798768,55.2823332546623,35.508267898187,29.517453798768
2022-09-05,146402,45,110622,14,35780,31,119493,16,583727,56,703220,72,0,1482,1,2795,1495,2,"Knox County",470313,179.667583077653,0.292442497261774,15.308953824368,9.56809614023002,29.2442497261774
2022-09-04,146357,87,110608,56,35749,31,119477,58,583671,130,703148,188,0,1482,0,2794,1493,1,"Knox County",470313,187.959933065852,0.295811518324607,39.9733794302943,18.4983192044447,29.5811518324607
2022-09-03,146270,90,110552,58,35718,32,119419,68,583541,155,702960,223,0,1482,0,2794,1492,0,"Knox County",470313,191.787171521944,0.298453608247423,47.4152319838065,19.13619228046,29.8453608247423
2022-09-02,146180,227,110494,167,35686,60,119351,178,583386,396,702737,574,1,1482,1,2794,1492,1,"Knox County",470313,207.308749704984,0.300979934671022,122.046381877601,48.2657294184936,30.0979934671022
2022-09-01,145953,168,110327,88,35626,80,119173,95,582990,227,702163,322,3,1481,0,2793,1491,0,"Knox County",470313,205.182506118266,0.307922272047833,68.4650434923126,35.7208922568587,30.7922272047833
2022-08-31,145785,277,110239,168,35546,109,119078,182,582763,301,701841,483,1,1478,0,2793,1491,2,"Knox County",470313,225.594444550757,0.327521206409048,102.697565238469,58.8969473520825,32.7521206409048
2022-08-30,145508,249,110071,148,35437,101,118896,158,582462,216,701358,374,-1,1477,0,2793,1489,0,"Knox County",470313,243.029641961842,0.337656529516995,79.521510143245,52.9434653092728,33.7656529516995
2022-08-29,145259,241,109923,112,35336,129,118738,118,582246,123,700984,241,0,1478,0,2793,1489,2,"Knox County",470313,284.704016261511,0.356340956340956,51.2424704398985,51.2424704398985,35.6340956340956
2022-08-28,145018,105,109811,76,35207,29,118620,82,582123,137,700743,219,1,1478,0,2793,1487,1,"Knox County",470313,288.531254717603,0.361658456486043,46.5647345491194,22.3255576605367,36.1658456486043
2022-08-27,144913,135,109735,73,35178,62,118538,77,581986,211,700524,288,0,1477,0,2793,1486,0,"Knox County",470313,298.099350857833,0.355857656937225,61.2358152974721,28.70428842069,35.5857656937225
2022-08-26,144778,230,109662,154,35116,76,118461,167,581775,352,700236,519,0,1477,0,2793,1486,0,"Knox County",470313,298.737223933848,0.359362224039248,110.352042150653,48.903602494509,35.9362224039248
2022-08-25,144548,255,109508,145,35040,110,118294,155,581423,326,699717,481,3,1477,0,2793,1486,1,"Knox County",470313,317.235543138293,0.360460652591171,102.272316521125,54.2192114613034,36.0460652591171
2022-08-24,144293,281,109363,162,34930,119,118139,169,581097,272,699236,441,2,1474,0,2793,1485,0,"Knox County",470313,318.08604057298,0.361295357003512,93.7673421742542,59.7474447867697,36.1295357003511
2022-08-23,144012,285,109201,173,34811,112,117970,187,580825,292,698795,479,4,1472,0,2793,1485,0,"Knox County",470313,325.740517485164,0.357946026986507,101.847067803782,60.5979422214568,35.7946026986507
2022-08-22,143727,281,109028,150,34699,131,117783,155,580533,276,698316,431,0,1468,0,2793,1485,0,"Knox County",470313,334.245491832035,0.347095871238628,91.6410985875364,59.7474447867697,34.7095871238628
2022-08-21,143446,129,108878,90,34568,39,117628,104,580257,196,697885,300,0,1468,0,2793,1485,0,"Knox County",470313,339.348476440158,0.345015311330384,63.7873076015334,27.4285422686594,34.5015311330384
2022-08-20,143317,75,108788,52,34529,23,117524,60,580061,123,697585,183,0,1468,0,2793,1485,2,"Knox County",470313,326.591014919851,0.351799576570219,38.9102576369354,15.9468269003834,35.1799576570219
2022-08-19,143242,211,108736,146,34506,65,117464,149,579938,248,697402,397,0,1468,0,2793,1483,0,"Knox County",470313,322.551152105087,0.36098820058997,84.4118703926959,44.8637396797452,36.098820058997
2022-08-18,143031,616,108590,212,34441,404,117315,222,579690,286,697005,508,0,1468,1,2793,1483,3,"Knox County",470313,399.308545585599,0.38189120116831,108.013174205263,130.976604941815,38.189120116831
2022-08-17,142415,199,108378,135,34037,64,117093,149,579404,266,696497,415,3,1468,0,2792,1480,1,"Knox County",470313,381.873348174514,0.378179137486178,88.2391088487879,42.3122473756839,37.8179137486178
2022-08-16,142216,260,108243,175,33973,85,116944,191,579138,191,696082,382,4,1465,0,2792,1479,1,"Knox County",470313,376.557739207719,0.393730886850153,81.2225050126193,55.2823332546623,39.3730886850153
2022-08-15,141956,236,108068,145,33888,91,116753,147,578947,154,695700,301,1,1461,0,2792,1478,0,"Knox County",470313,366.989643067489,0.411102172164119,63.9999319602052,50.1793486465396,41.1102172164119
2022-08-14,141720,90,107923,69,33797,21,116606,79,578793,122,695399,201,1,1460,0,2792,1478,1,"Knox County",470313,358.69729307929,0.41767909509845,42.7374960930274,19.13619228046,41.767909509845
2022-08-13,141630,98,107854,67,33776,31,116527,79,578671,154,695198,233,0,1459,0,2792,1477,0,"Knox County",470313,363.587653328741,0.416906032006565,49.5414755705243,20.8371871498343,41.6906032006565
2022-08-12,141532,210,107787,144,33745,66,116448,150,578517,338,694965,488,1,1459,0,2792,1477,1,"Knox County",470313,363.375028970069,0.402294303797468,103.760687031828,44.6511153210734,40.2294303797468
2022-08-11,141322,178,107643,128,33679,50,116298,133,578179,188,694477,321,0,1458,0,2792,1476,2,"Knox County",470313,270.24555987183,0.396411789833405,68.2524191336408,37.8471358435765,39.6411789833405
2022-08-10,141144,222,107515,158,33629,64,116165,168,577991,255,694156,423,1,1458,0,2792,1474,1,"Knox County",470313,275.135920121281,0.403150276713495,89.9401037181622,47.2026076251348,40.3150276713495
2022-08-09,140922,272,107357,192,33565,80,115997,199,577736,349,693733,548,5,1457,0,2792,1473,3,"Knox County",470313,277.687412425342,0.379721669980119,116.518148552134,57.8338255587237,37.9721669980119
2022-08-08,140650,237,107165,150,33485,87,115798,156,577387,327,693185,483,2,1452,0,2792,1470,0,"Knox County",470313,277.900036784014,0.35743418613274,102.697565238469,50.3919730052114,35.743418613274
2022-08-07,140413,84,107015,58,33398,26,115642,61,577060,115,692702,176,1,1450,0,2792,1470,1,"Knox County",470313,276.624290631983,0.354041916167665,37.421887126233,17.8604461284294,35.4041916167665
2022-08-06,140329,96,106957,69,33372,27,115581,74,576945,102,692526,176,0,1449,1,2792,1469,1,"Knox County",470313,276.19904191464,0.359847036328872,37.421887126233,20.4119384324907,35.9847036328872
2022-08-05,140233,205,106888,121,33345,84,115507,120,576843,281,692350,401,2,1449,1,2791,1468,2,"Knox County",470313,275.135920121281,0.360363924050633,85.262367827383,43.5879935277145,36.0363924050633
2022-08-04,140028,190,106767,127,33261,63,115387,135,576562,239,691949,374,5,1447,0,2790,1466,3,"Knox County",470313,277.687412425342,0.353738860906625,79.521510143245,40.3986281476379,35.3738860906625
2022-08-03,139838,205,106640,121,33198,84,115252,126,576323,289,691575,415,-2,1442,0,2790,1463,1,"Knox County",470313,274.072798327922,0.338515351729499,88.2391088487879,43.5879935277145,33.8515351729499
2022-08-02,139633,283,106519,173,33114,110,115126,181,576034,308,691160,489,0,1444,0,2790,1462,0,"Knox County",470313,276.411666273312,0.339299920445505,103.9733113905,60.1726935041132,33.9299920445505
2022-08-01,139350,175,106346,99,33004,76,114945,110,575726,133,690671,243,4,1444,1,2790,1462,1,"Knox County",470313,263.228956035661,0.354881266490765,51.6677191572421,37.2092627675612,35.4881266490765
2022-07-31,139175,99,106247,64,32928,35,114835,73,575593,153,690428,226,0,1440,0,2789,1461,1,"Knox County",470313,266.418321415738,0.352409638554217,48.0531050598219,21.049811508506,35.2409638554217
2022-07-30,139076,116,106183,85,32893,31,114762,95,575440,203,690202,298,0,1440,0,2789,1460,1,"Knox County",470313,270.670808589174,0.343417825020442,63.3620588841899,24.6644256059263,34.3417825020442
2022-07-29,138960,218,106098,151,32862,67,114667,154,575237,298,689904,452,0,1440,0,2789,1459,1,"Knox County",470313,273.434925251907,0.350020024028835,96.1062101196437,46.3521101904476,35.0020024028835
2022-07-28,138742,282,105947,187,32795,95,114513,203,574939,319,689452,522,1,1440,0,2789,1458,1,"Knox County",470313,292.99636624971,0.356143667296786,110.989915226668,59.9600691454414,35.6143667296786
2022-07-27,138460,198,105760,129,32700,69,114310,134,574620,248,688930,382,4,1439,0,2789,1457,0,"Knox County",470313,291.507995739008,0.363705972434916,81.2225050126193,42.0996230170121,36.3705972434916
2022-07-26,138262,300,105631,229,32631,71,114176,237,574372,239,688548,476,1,1435,1,2789,1457,1,"Knox County",470313,295.122609836428,0.387071950750289,101.209194727766,63.7873076015334,38.7071950750289
2022-07-25,137962,289,105402,172,32560,117,113939,181,574133,249,688072,430,1,1434,0,2788,1456,1,"Knox County",470313,319.361786725011,0.386575735821967,91.4284742288646,61.4484396561439,38.6575735821967
2022-07-24,137673,112,105230,68,32443,44,113758,73,573884,178,687642,251,0,1433,0,2788,1455,1,"Knox County",470313,322.125903387744,0.383137673425827,53.3687140266163,23.8139281712392,38.3137673425827
2022-07-23,137561,110,105162,53,32399,57,113685,59,573706,143,687391,202,0,1433,0,2788,1454,0,"Knox County",470313,320.850157235713,0.383425414364641,42.9501204516992,23.3886794538956,38.3425414364641
2022-07-22,137451,262,105109,183,32342,79,113626,190,573563,309,687189,499,0,1433,0,2788,1454,1,"Knox County",470313,330.205629017271,0.389934829833454,106.099554977217,55.7075819720059,38.9934829833454
2022-07-21,137189,286,104926,175,32263,111,113436,179,573254,354,686690,533,0,1433,2,2788,1453,2,"Knox County",470313,331.056126451959,0.379733141002524,113.328783172058,60.8105665801286,37.9733141002524
2022-07-20,136903,222,104751,141,32152,81,113257,152,572900,318,686157,470,5,1433,0,2786,1451,0,"Knox County",470313,336.159111060081,0.374344634743097,99.9334485757357,47.2026076251348,37.4344634743097
2022-07-19,136681,226,104610,144,32071,82,113105,148,572582,234,685687,382,1,1428,1,2786,1451,2,"Knox County",470313,320.42490851837,0.354897000361402,81.2225050126193,48.0531050598219,35.4897000361402
2022-07-18,136455,347,104466,205,31989,142,112957,231,572348,382,685305,613,1,1427,0,2785,1449,1,"Knox County",470313,332.757121321333,0.349830508474576,130.3387318658,73.780652459107,34.9830508474576
2022-07-17,136108,76,104261,62,31847,14,112726,69,571966,87,684692,156,0,1426,0,2785,1448,1,"Knox County",470313,325.102644409149,0.360070052539405,33.1693999527974,16.1594512590551,36.0070052539405
2022-07-16,136032,102,104199,65,31833,37,112657,67,571879,123,684536,190,1,1426,0,2785,1447,2,"Knox County",470313,323.401649539775,0.36440379880408,40.3986281476379,21.6876845845214,36.440379880408
2022-07-15,135930,191,104134,119,31796,72,112590,129,571756,326,684346,455,0,1425,2,2785,1445,2,"Knox County",470313,308.305320074078,0.348338692390139,96.7440831956591,40.6112525063096,34.8338692390139
2022-07-14,135739,205,104015,143,31724,62,112461,145,571430,239,683891,384,1,1425,0,2783,1443,5,"Knox County",470313,291.082747021664,0.355094339622642,81.6477537299628,43.5879935277145,35.5094339622642
2022-07-13,135534,267,103872,171,31662,96,112316,179,571191,320,683507,499,0,1424,0,2783,1438,1,"Knox County",470313,300.650843161894,0.361328854050019,106.099554977217,56.7707037653648,36.1328854050019
2022-07-12,135267,236,103701,162,31566,74,112137,171,570871,293,683008,464,4,1424,0,2783,1437,1,"Knox County",470313,302.777086748612,0.358927924664976,98.6577024237051,50.1793486465396,35.8927924664976
2022-07-11,135031,200,103539,136,31492,64,111966,143,570578,253,682544,396,0,1420,1,2783,1436,0,"Knox County",470313,271.521306023861,0.354952830188679,84.1992460340241,42.5248717343556,35.4952830188679
2022-07-10,134831,83,103403,43,31428,40,111823,42,570325,87,682148,129,0,1420,1,2782,1436,1,"Knox County",470313,273.009676534563,0.34803337306317,27.4285422686594,17.6478217697576,34.803337306317
2022-07-09,134748,118,103360,78,31388,40,111781,78,570238,104,682019,182,0,1420,0,2781,1435,2,"Knox County",470313,276.411666273312,0.35352730171383,38.6976332782636,25.0896743232698,35.352730171383
2022-07-08,134630,193,103282,125,31348,68,111703,132,570134,304,681837,436,1,1420,0,2781,1433,0,"Knox County",470313,276.836914990655,0.357429718875502,92.7042203808953,41.0365012236532,35.7429718875502
2022-07-07,134437,181,103157,105,31280,76,111571,109,569830,205,681401,314,0,1419,0,2781,1433,4,"Knox County",470313,271.733930382532,0.352892561983471,66.7640486229383,38.4850089195918,35.2892561983471
2022-07-06,134256,227,103052,156,31204,71,111462,157,569625,228,681087,385,3,1419,1,2781,1429,0,"Knox County",470313,263.228956035661,0.360797918473547,81.8603780886346,48.2657294184936,36.0797918473547
2022-07-05,134029,164,102896,118,31133,46,111305,122,569397,118,680702,240,0,1416,1,2780,1429,1,"Knox County",470313,247.920002211293,0.376080691642651,51.0298460812268,34.8703948221716,37.6080691642651
2022-07-04,133865,79,102778,44,31087,35,111183,47,569279,123,680462,170,1,1416,1,2779,1428,0,"Knox County",470313,222.192454812008,0.370150862068966,36.1461409742023,16.7973243350705,37.0150862068966
2022-07-03,133786,105,102734,65,31052,40,111136,69,569156,159,680292,228,0,1415,0,2778,1428,0,"Knox County",470313,226.870190702787,0.365217391304348,48.4783537771654,22.3255576605367,36.5217391304348
2022-07-02,133681,108,102669,75,31012,33,111067,79,568997,200,680064,279,0,1415,0,2778,1428,2,"Knox County",470313,224.74394711607,0.348440545808967,59.3221960694261,22.963430736552,34.8440545808967
2022-07-01,133573,184,102594,124,30979,60,110988,130,568797,318,679785,448,0,1415,1,2778,1426,1,"Knox County",470313,222.830327888024,0.345445736434109,95.2557126849566,39.1228819956072,34.5445736434108
2022-06-30,133389,195,102470,118,30919,77,110858,124,568479,308,679337,432,1,1415,2,2777,1425,1,"Knox County",470313,225.807068909428,0.333638863428048,91.8537229462082,41.4617499409967,33.3638863428048
2022-06-29,133194,184,102352,120,30842,64,110734,131,568171,244,678905,375,2,1414,0,2775,1424,1,"Knox County",470313,216.664221486542,0.323204419889503,79.7341345019168,39.1228819956072,32.3204419889503
2022-06-28,133010,183,102232,116,30778,67,110603,122,567927,265,678530,387,1,1412,0,2775,1423,0,"Knox County",470313,220.704084301306,0.302716688227684,82.2856268059781,38.9102576369354,30.2716688227684
2022-06-27,132827,142,102116,100,30711,42,110481,102,567662,167,678143,269,0,1411,0,2775,1423,0,"Knox County",470313,234.099418897628,0.313068651778329,57.1959524827083,30.1926589313925,31.3068651778329
2022-06-26,132685,89,102016,57,30669,32,110379,62,567495,168,677874,230,0,1411,0,2775,1423,0,"Knox County",470313,230.697429158879,0.309917355371901,48.903602494509,18.9235679217883,30.9917355371901
2022-06-25,132596,104,101959,60,30637,44,110317,71,567327,203,677644,274,0,1411,0,2775,1423,0,"Knox County",470313,229.846931724192,0.307246376811594,58.2590742760672,22.1129333018649,30.7246376811594
2022-06-24,132492,145,101899,119,30593,26,110246,128,567124,386,677370,514,0,1411,1,2775,1423,2,"Knox County",470313,221.554581735993,0.298266827891979,109.288920357294,30.8305320074078,29.8266827891979
2022-06-23,132347,185,101780,128,30567,57,110118,136,566738,304,676856,440,1,1411,1,2774,1421,0,"Knox County",470313,219.428338149275,0.302129369224588,93.5547178155824,39.335506354279,30.2129369224588
2022-06-22,132162,182,101652,127,30510,55,109982,131,566434,332,676416,463,0,1410,0,2773,1421,0,"Knox County",470313,219.003089431931,0.291812184710904,98.4450780650333,38.6976332782636,29.1812184710904
2022-06-21,131980,177,101525,88,30455,89,109851,95,566102,175,675953,270,1,1410,1,2773,1421,0,"Knox County",470313,217.727343279901,0.294715447154472,57.4085768413801,37.6345114849047,29.4715447154472
2022-06-20,131803,120,101437,84,30366,36,109756,91,565927,157,675683,248,0,1409,0,2772,1421,1,"Knox County",470313,213.049607389122,0.292742927429274,52.730840950601,25.5149230406134,29.2742927429274
2022-06-19,131683,89,101353,59,30330,30,109665,65,565770,198,675435,263,0,1409,0,2772,1420,0,"Knox County",470313,213.049607389122,0.29004854368932,55.9202063306777,18.9235679217883,29.004854368932
2022-06-18,131594,99,101294,81,30300,18,109600,87,565572,194,675172,281,-1,1409,0,2772,1420,0,"Knox County",470313,211.986485595763,0.295683743444937,59.7474447867697,21.049811508506,29.5683743444937
2022-06-17,131495,133,101213,85,30282,48,109513,89,565378,254,674891,343,3,1410,2,2772,1420,1,"Knox County",470313,209.434993291701,0.300693240901213,72.9301550244199,28.2790397033465,30.0693240901213
2022-06-16,131362,138,101128,104,30234,34,109424,108,565124,301,674548,409,1,1407,0,2770,1419,0,"Knox County",470313,199.441648434128,0.292490118577075,86.9633626967573,29.3421614967054,29.2490118577075
2022-06-15,131224,113,101024,81,30200,32,109316,85,564823,264,674139,349,0,1406,0,2770,1419,1,"Knox County",470313,184.770567685775,0.286638927415626,74.2059011764506,24.0265525299109,28.6638927415626
2022-06-14,131111,170,100943,106,30168,64,109231,114,564559,244,673790,358,2,1406,0,2770,1418,0,"Knox County",470313,183.282197175073,0.283873833851622,76.1195204044966,36.1461409742023,28.3873833851622
2022-06-13,130941,117,100837,71,30104,46,109117,71,564315,150,673432,221,1,1404,0,2770,1418,2,"Knox County",470313,182.644324099057,0.278327338129496,46.989983266463,24.877049964598,27.8327338129496
2022-06-12,130824,79,100766,44,30058,35,109046,48,564165,129,673211,177,1,1403,1,2770,1416,1,"Knox County",470313,180.51808051234,0.281571562207671,37.6345114849047,16.7973243350705,28.1571562207671
2022-06-11,130745,102,100722,82,30023,20,108998,93,564036,227,673034,320,0,1402,0,2769,1415,0,"Knox County",470313,181.155953588355,0.279283417547083,68.039794774969,21.6876845845214,27.9283417547083
2022-06-10,130643,122,100640,77,30003,45,108905,88,563809,368,672714,456,0,1402,1,2769,1415,0,"Knox County",470313,178.817085642965,0.265065502183406,96.9567075543308,25.9401717579569,26.5065502183406
2022-06-09,130521,161,100563,107,29958,54,108817,114,563441,330,672258,444,1,1402,0,2768,1415,0,"Knox County",470313,183.707445892416,0.263655913978495,94.4052152502695,34.2325217461563,26.3655913978495
2022-06-08,130360,150,100456,100,29904,50,108703,116,563111,324,671814,440,0,1401,0,2768,1415,0,"Knox County",470313,191.574547163272,0.266556291390728,93.5547178155824,31.8936538007667,26.6556291390728
2022-06-07,130210,121,100356,70,29854,51,108587,71,562787,169,671374,240,0,1401,0,2768,1415,0,"Knox County",470313,181.155953588355,0.261531766753699,51.0298460812268,25.7275473992852,26.1531766753699
2022-06-06,130089,116,100286,79,29803,37,108516,81,562618,280,671134,361,0,1401,1,2768,1415,0,"Knox County",470313,180.943329229683,0.250615258408532,76.7573934805119,24.6644256059263,25.0615258408532
2022-06-05,129973,75,100207,54,29766,21,108435,57,562338,233,670773,290,3,1401,1,2767,1415,0,"Knox County",470313,180.092831794996,0.243041944335555,61.6610640148157,15.9468269003834,24.3041944335555
2022-06-04,129898,86,100153,72,29745,14,108378,76,562105,300,670483,376,0,1398,0,2766,1415,1,"Knox County",470313,176.690842056248,0.231300345224396,79.9467588605886,18.2856948457729,23.1300345224396
2022-06-03,129812,132,100081,90,29731,42,108302,96,561805,346,670107,442,0,1398,1,2766,1414,3,"Knox County",470313,178.817085642965,0.235634400308523,93.9799665329259,28.0664153446747,23.5634400308523
2022-06-02,129680,114,99991,88,29689,26,108206,96,561459,284,669665,380,0,1398,0,2765,1411,0,"Knox County",470313,168.823740785392,0.234480031633057,80.7972562952757,24.2391768885827,23.4480031633057
2022-06-01,129566,169,99903,90,29663,79,108110,105,561175,303,669285,408,1,1398,1,2765,1411,0,"Knox County",470313,172.863603600156,0.233079695634762,86.7507383380855,35.9335166155305,23.3079695634762
2022-05-31,129397,129,99813,94,29584,35,108005,96,560872,214,668877,310,0,1397,2,2764,1411,0,"Knox County",470313,174.56459846953,0.236462797039346,65.9135511882512,27.4285422686594,23.6462797039346
2022-05-30,129268,57,99719,32,29549,25,107909,36,560658,118,668567,154,0,1397,3,2762,1411,0,"Knox County",470313,162.019761307895,0.238135593220339,32.7441512354538,12.1195884442914,23.8135593220339
2022-05-29,129211,56,99687,43,29524,13,107873,46,560540,200,668413,246,0,1397,0,2759,1411,1,"Knox County",470313,157.979898493131,0.237910189982729,52.3055922332574,11.9069640856196,23.7910189982729
2022-05-28,129155,69,99644,56,29511,13,107827,58,560340,229,668167,287,0,1397,0,2759,1410,0,"Knox County",470313,154.365284395711,0.23933542882802,61.0231909388003,14.6710807483527,23.933542882802
2022-05-27,129086,98,99588,66,29498,32,107769,67,560111,417,667880,484,2,1397,2,2759,1410,0,"Knox County",470313,147.13605620087,0.222124283825474,102.910189597141,20.8371871498343,22.2124283825474
2022-05-26,128988,102,99522,78,29466,24,107702,82,559694,367,667396,449,1,1395,3,2757,1410,1,"Knox County",470313,144.584563896809,0.209580838323353,95.4683370436284,21.6876845845214,20.9580838323353
2022-05-25,128886,108,99444,79,29442,29,107620,86,559327,264,666947,350,2,1394,0,2754,1409,1,"Knox County",470313,131.614478017831,0.206578947368421,74.4185255351224,22.963430736552,20.6578947368421
2022-05-24,128778,106,99365,68,29413,38,107534,73,559063,281,666597,354,0,1392,1,2754,1408,0,"Knox County",470313,126.72411776838,0.192771084337349,75.2690229698095,22.5381820192085,19.2771084337349
2022-05-23,128672,107,99297,71,29375,36,107461,70,558782,337,666243,407,1,1392,2,2753,1408,0,"Knox County",470313,137.355335701969,0.187039192859915,86.5381139794137,22.7508063778803,18.7039192859915
2022-05-22,128565,47,99226,38,29339,9,107391,40,558445,180,665836,220,1,1391,2,2751,1408,0,"Knox County",470313,135.441716473923,0.186593492747942,46.7773589077912,9.99334485757357,18.6593492747942
2022-05-21,128518,55,99188,45,29330,10,107351,49,558265,208,665616,257,0,1390,3,2749,1408,0,"Knox County",470313,132.464975452518,0.185243950813169,54.644460178647,11.6943397269478,18.5243950813169
2022-05-20,128463,87,99143,59,29320,28,107302,63,558057,225,665359,288,0,1390,1,2746,1408,0,"Knox County",470313,130.126107507128,0.199139784946237,61.2358152974721,18.4983192044447,19.9139784946237
2022-05-19,128376,95,99084,67,29292,28,107239,69,557832,254,665071,323,6,1390,1,2745,1408,0,"Knox County",470313,128.637736996426,0.204638472032742,68.6776678509843,20.1993140738189,20.4638472032742
2022-05-18,128281,82,99017,54,29264,28,107170,56,557578,239,664748,295,1,1384,1,2744,1408,0,"Knox County",470313,123.10950367096,0.19589552238806,62.7241858081746,17.4351974110858,19.589552238806
2022-05-17,128199,80,98963,51,29236,29,107114,54,557339,315,664453,369,2,1383,0,2743,1408,0,"Knox County",470313,117.581270345493,0.185734136174155,78.4583883498861,17.0099486937423,18.5734136174155
2022-05-16,128119,64,98912,40,29207,24,107060,39,557024,254,664084,293,0,1381,1,2743,1408,1,"Knox County",470313,108.438422922607,0.180929095354523,62.298937090831,13.6079589549938,18.0929095354523
2022-05-15,128055,39,98872,25,29183,14,107021,27,556770,174,663791,201,0,1381,1,2742,1407,0,"Knox County",470313,106.737428053233,0.176209279368213,42.7374960930274,8.29234998819935,17.6209279368213
2022-05-14,128016,29,98847,21,29169,8,106994,22,556596,145,663590,167,0,1381,1,2741,1407,0,"Knox County",470313,101.209194727766,0.170454545454545,35.508267898187,6.16610640148157,17.0454545454545
2022-05-13,127987,77,98826,55,29161,22,106972,58,556451,251,663423,309,-3,1381,0,2740,1407,1,"Knox County",470313,99.0829511410486,0.166070516096065,65.7009268295794,16.3720756177269,16.6070516096065
2022-05-12,127910,72,98771,45,29139,27,106914,49,556200,301,663114,350,1,1384,0,2740,1406,1,"Knox County",470313,94.1925908915977,0.153729838709677,74.4185255351224,15.308953824368,15.3729838709677
2022-05-11,127838,47,98726,33,29112,14,106865,35,555899,177,662764,212,0,1383,0,2740,1405,0,"Knox County",470313,86.7507383380855,0.149395055234087,45.076364038417,9.99334485757357,14.9395055234087
2022-05-10,127791,78,98693,40,29098,38,106830,43,555722,322,662552,365,1,1383,3,2740,1405,1,"Knox County",470313,86.3254896207419,0.143911439114391,77.607890915199,16.5846999763987,14.3911439114391
2022-05-09,127713,54,98653,31,29060,23,106787,32,555400,181,662187,213,0,1382,1,2737,1404,0,"Knox County",470313,84.1992460340242,0.146395156851954,45.2889883970888,11.481715368276,14.6395156851954
2022-05-08,127659,31,98622,23,29037,8,106755,24,555219,133,661974,157,0,1382,0,2736,1404,0,"Knox County",470313,82.4982511646499,0.148336153412296,33.3820243114692,6.59135511882512,14.8336153412296
2022-05-07,127628,17,98599,10,29029,7,106731,13,555086,174,661817,187,0,1382,0,2736,1404,0,"Knox County",470313,79.9467588605886,0.141662018962632,39.7607550716225,3.61461409742023,14.1662018962632
2022-05-06,127611,51,98589,30,29022,21,106718,34,554912,209,661630,243,0,1382,1,2736,1404,1,"Knox County",470313,74.4185255351224,0.13317892298784,51.6677191572421,10.8438422922607,13.317892298784
2022-05-05,127560,48,98559,31,29001,17,106684,34,554703,185,661387,219,1,1382,0,2735,1403,0,"Knox County",470313,69.3155409269997,0.134711779448622,46.5647345491194,10.2059692162454,13.4711779448622
2022-05-04,127512,54,98528,35,28984,19,106650,38,554518,249,661168,287,1,1381,0,2735,1403,0,"Knox County",470313,70.8039114377021,0.130460801915021,61.0231909388003,11.481715368276,13.0460801915021
2022-05-03,127458,34,98493,21,28965,13,106612,24,554269,145,660881,169,0,1380,0,2735,1403,1,"Knox County",470313,61.4484396561439,0.134915254237288,35.9335166155305,7.22922819484046,13.4915254237288
2022-05-02,127424,37,98472,28,28952,9,106588,32,554124,190,660712,222,3,1380,2,2735,1402,0,"Knox County",470313,57.8338255587237,0.134097035040431,47.2026076251348,7.86710127085579,13.4097035040431
2022-05-01,127387,14,98444,9,28943,5,106556,9,553934,82,660490,91,0,1377,0,2733,1402,0,"Knox County",470313,54.2192114613034,0.129760225669958,19.3488166391318,2.97674102140489,12.9760225669958
2022-04-30,127373,19,98435,14,28938,5,106547,15,553852,141,660399,156,0,1377,0,2733,1402,0,"Knox County",470313,54.644460178647,0.134102379235761,33.1693999527974,4.03986281476378,13.4102379235761
2022-04-29,127354,24,98421,14,28933,10,106532,13,553711,200,660243,213,0,1377,0,2733,1402,1,"Knox County",470313,48.903602494509,0.121591746499632,45.2889883970888,5.10298460812268,12.1591746499632
2022-04-28,127330,32,98407,25,28923,7,106519,26,553511,226,660030,252,1,1377,0,2733,1401,0,"Knox County",470313,45.5016127557605,0.11294964028777,53.5813383852881,6.8039794774969,11.294964028777
2022-04-27,127298,35,98382,25,28916,10,106493,27,553285,181,659778,208,0,1376,0,2733,1401,0,"Knox County",470313,41.4617499409967,0.111365369946606,44.2258666037299,7.44185255351224,11.1365369946606
2022-04-26,127263,39,98357,21,28906,18,106466,21,553104,240,659570,261,0,1376,0,2733,1401,0,"Knox County",470313,42.5248717343556,0.101924447612259,55.4949576133341,8.29234998819935,10.1924447612259
2022-04-25,127224,60,98336,16,28888,44,106445,17,552864,101,659309,118,0,1376,2,2733,1401,1,"Knox County",470313,47.4152319838065,0.0985373364126251,25.0896743232698,12.7574615203067,9.85373364126251
2022-04-24,127164,15,98320,11,28844,4,106428,12,552763,148,659191,160,1,1376,0,2731,1400,1,"Knox County",470313,47.6278563424783,0.0957602339181287,34.0198973874845,3.18936538007667,9.57602339181287
2022-04-23,127149,12,98309,5,28840,7,106416,7,552615,197,659031,204,0,1375,0,2731,1399,0,"Knox County",470313,46.1394858317759,0.086864406779661,43.3753691690427,2.55149230406134,8.6864406779661
2022-04-22,127137,26,98304,19,28833,7,106409,21,552418,210,658827,231,0,1375,0,2731,1399,0,"Knox County",470313,46.5647345491194,0.0913528591352859,49.1162268531808,5.52823332546623,9.13528591352859
2022-04-21,127111,32,98285,23,28826,9,106388,23,552208,231,658596,254,0,1375,0,2731,1399,0,"Knox County",470313,46.5647345491194,0.0891364902506964,54.0065871026317,6.8039794774969,8.91364902506964
2022-04-20,127079,55,98262,32,28817,23,106365,34,551977,247,658342,281,1,1375,0,2731,1399,1,"Knox County",470313,50.817221722555,0.0894632206759443,59.7474447867697,11.6943397269478,8.94632206759443
2022-04-19,127024,29,98230,16,28794,13,106331,17,551730,151,658061,168,0,1374,0,2731,1398,0,"Knox County",470313,48.6909781358372,0.0925141242937853,35.7208922568587,6.16610640148157,9.25141242937853
2022-04-18,126995,38,98214,21,28781,17,106314,21,551579,117,657893,138,0,1374,1,2731,1398,0,"Knox County",470313,44.0132422450581,0.0940111420612813,29.3421614967054,8.07972562952757,9.40111420612813
2022-04-17,126957,16,98193,10,28764,6,106293,9,551462,101,657755,110,0,1374,0,2730,1398,1,"Knox County",470313,44.2258666037299,0.0952380952380952,23.3886794538956,3.40198973874845,9.52380952380952
2022-04-16,126941,10,98183,10,28758,0,106284,12,551361,126,657645,138,0,1374,0,2730,1397,0,"Knox County",470313,43.8006178863863,0.103787878787879,29.3421614967054,2.12624358671778,10.3787878787879
2022-04-15,126931,18,98173,13,28758,5,106272,13,551235,198,657507,211,0,1374,0,2730,1397,0,"Knox County",470313,42.0996230170121,0.0992307692307692,44.8637396797452,3.82723845609201,9.92307692307692
2022-04-14,126913,18,98160,5,28753,13,106259,6,551037,158,657296,164,1,1374,0,2730,1397,1,"Knox County",470313,39.1228819956072,0.0925619834710744,34.8703948221716,3.82723845609201,9.25619834710744
2022-04-13,126895,39,98155,26,28740,13,106253,28,550879,209,657132,237,-1,1373,0,2730,1396,1,"Knox County",470313,35.7208922568587,0.0909090909090909,50.3919730052114,8.29234998819935,9.09090909090909
2022-04-12,126856,23,98129,6,28727,17,106225,8,550670,192,656895,200,5,1374,0,2730,1395,0,"Knox County",470313,34.4451461048281,0.0809682804674457,42.5248717343556,4.8903602494509,8.09682804674457
2022-04-11,126833,22,98123,13,28710,9,106217,13,550478,173,656695,186,1,1369,2,2730,1395,1,"Knox County",470313,31.0431563660796,0.0714285714285714,39.5481307129507,4.67773589077912,7.14285714285714
2022-04-10,126811,9,98110,7,28701,2,106204,7,550305,110,656509,117,0,1368,1,2728,1394,0,"Knox County",470313,29.5547858553772,0.0694333599361532,24.877049964598,1.913619228046,6.94333599361532
2022-04-09,126802,7,98103,5,28699,2,106197,5,550195,148,656392,153,0,1368,0,2727,1394,0,"Knox County",470313,28.9169127793618,0.0630914826498423,32.5315268767821,1.48837051070245,6.30914826498423
2022-04-08,126795,18,98098,15,28697,3,106192,16,550047,176,656239,192,1,1368,0,2727,1394,0,"Knox County",470313,28.9169127793618,0.066453162530024,40.8238768649814,3.82723845609201,6.6453162530024
2022-04-07,126777,16,98083,7,28694,9,106176,10,549871,181,656047,191,5,1367,0,2727,1394,0,"Knox County",470313,28.4916640620183,0.0681818181818182,40.6112525063096,3.40198973874845,6.81818181818182
2022-04-06,126761,21,98076,14,28685,7,106166,16,549690,204,655856,220,-1,1362,0,2727,1394,2,"Knox County",470313,24.6644256059263,0.0595710881652105,46.7773589077912,4.46511153210734,5.95710881652105
2022-04-05,126740,15,98062,12,28678,3,106150,13,549486,198,655636,211,4,1363,0,2727,1392,2,"Knox County",470313,22.963430736552,0.062992125984252,44.8637396797452,3.18936538007667,6.2992125984252
2022-04-04,126725,16,98050,5,28675,11,106137,7,549288,158,655425,165,8,1359,2,2727,1390,0,"Knox County",470313,21.6876845845214,0.0592473979183347,35.0830191808434,3.40198973874845,5.92473979183347
2022-04-03,126709,5,98045,4,28664,1,106130,3,549130,75,655260,78,1,1351,0,2725,1390,1,"Knox County",470313,20.8371871498343,0.0578512396694215,16.5846999763987,1.06312179335889,5.78512396694215
2022-04-02,126704,2,98041,2,28663,0,106127,3,549055,116,655182,119,0,1350,0,2725,1389,1,"Knox County",470313,19.7740653564754,0.0578231292517007,25.3022986819416,0.425248717343556,5.78231292517007
2022-04-01,126702,19,98039,8,28663,11,106124,8,548939,231,655063,239,4,1350,0,2725,1388,0,"Knox County",470313,19.9866897151471,0.0490596892886345,50.817221722555,4.03986281476378,4.90596892886345
2022-03-31,126683,17,98031,7,28652,10,106116,8,548708,238,654824,246,3,1346,0,2725,1388,0,"Knox County",470313,20.1993140738189,0.0453834115805947,52.3055922332574,3.61461409742023,4.53834115805947
2022-03-30,126666,22,98024,10,28642,12,106108,9,548470,256,654578,265,0,1343,1,2725,1388,0,"Knox County",470313,20.4119384324907,0.0385487528344671,56.3454550480212,4.67773589077912,3.85487528344671
2022-03-29,126644,20,98014,8,28630,12,106099,9,548214,192,654313,201,2,1343,0,2724,1388,3,"Knox County",470313,21.4750602258496,0.0357958872810358,42.7374960930274,4.25248717343556,3.57958872810358
2022-03-28,126624,19,98006,12,28618,7,106090,16,548022,332,654112,348,3,1341,0,2724,1385,0,"Knox County",470313,22.1129333018649,0.0374331550802139,73.9932768177788,4.03986281476378,3.74331550802139
2022-03-27,126605,4,97994,3,28611,1,106074,3,547690,73,653764,76,0,1338,0,2724,1385,1,"Knox County",470313,21.9003089431931,0.037483266398929,16.1594512590551,0.850497434687113,3.7483266398929
2022-03-26,126601,8,97991,5,28610,3,106071,5,547617,166,653688,171,0,1338,1,2724,1384,1,"Knox County",470313,23.1760550952238,0.03751617076326,36.3587653328741,1.70099486937423,3.751617076326
2022-03-25,126593,14,97986,7,28607,7,106066,8,547451,244,653517,252,0,1338,1,2723,1383,1,"Knox County",470313,22.1129333018649,0.0372033354714561,53.5813383852881,2.97674102140489,3.72033354714561
2022-03-24,126579,56,97979,9,28600,47,106058,10,547207,187,653265,197,1,1338,0,2722,1382,2,"Knox County",470313,30.4052832900643,0.0397350993377483,41.8869986583403,11.9069640856196,3.97350993377483
2022-03-23,126523,11,97970,6,28553,5,106048,6,547020,201,653068,207,0,1337,0,2722,1380,1,"Knox County",470313,28.0664153446747,0.0392561983471074,44.0132422450581,2.33886794538956,3.92561983471074
2022-03-22,126512,16,97964,11,28548,5,106042,11,546819,150,652861,161,0,1337,1,2722,1379,4,"Knox County",470313,27.2159179099876,0.0417847025495751,34.2325217461563,3.40198973874845,4.17847025495751
2022-03-21,126496,12,97953,6,28543,6,106031,6,546669,125,652700,131,7,1337,1,2721,1375,0,"Knox County",470313,25.7275473992852,0.0410041841004184,27.8537909860029,2.55149230406134,4.10041841004184
2022-03-20,126484,11,97947,8,28537,3,106025,10,546544,98,652569,108,1,1330,0,2720,1375,0,"Knox County",470313,27.2159179099876,0.045639771801141,22.963430736552,2.33886794538956,4.5639771801141
2022-03-19,126473,11,97939,10,28534,1,106015,11,546446,175,652461,186,0,1329,0,2720,1375,0,"Knox County",470313,27.8537909860029,0.0499194847020934,39.5481307129507,2.33886794538956,4.99194847020934
2022-03-18,126462,24,97929,15,28533,9,106004,14,546271,219,652275,233,0,1329,1,2720,1375,2,"Knox County",470313,29.9800345727207,0.0556009811937858,49.5414755705243,5.10298460812268,5.56009811937858
2022-03-17,126438,36,97914,25,28524,11,105990,31,546052,209,652042,240,1,1329,0,2719,1373,2,"Knox County",470313,25.7275473992852,0.0703001579778831,51.0298460812268,7.65447691218401,7.03001579778831
2022-03-16,126402,21,97889,8,28513,13,105959,12,545843,236,651802,248,3,1328,2,2719,1371,2,"Knox County",470313,27.8537909860029,0.0726855394032135,52.730840950601,4.46511153210734,7.26855394032135
2022-03-15,126381,55,97881,18,28500,37,105947,19,545607,257,651554,276,1,1325,1,2717,1369,2,"Knox County",470313,36.1461409742023,0.0724331926863572,58.6843229934108,11.6943397269478,7.24331926863572
2022-03-14,126326,21,97863,16,28463,5,105928,22,545350,228,651278,250,10,1324,0,2716,1367,3,"Knox County",470313,38.0597602022483,0.0772225827384815,53.1560896679445,4.46511153210734,7.72225827384815
2022-03-13,126305,5,97847,5,28458,0,105906,10,545122,484,651028,494,2,1314,0,2716,1364,1,"Knox County",470313,36.7840140502176,0.0617540217955371,105.036433183858,1.06312179335889,6.17540217955371
2022-03-12,126300,9,97842,8,28458,1,105896,9,544638,293,650534,302,0,1312,3,2716,1363,2,"Knox County",470313,36.3587653328741,0.0572687224669604,64.212556318877,1.913619228046,5.72687224669604
2022-03-11,126291,20,97834,13,28457,7,105887,15,544345,467,650232,482,9,1312,0,2713,1361,4,"Knox County",470313,35.508267898187,0.0514834205933682,102.484940879797,4.25248717343556,5.14834205933682
2022-03-10,126271,28,97821,20,28450,8,105872,23,543878,459,649750,482,4,1303,1,2713,1357,2,"Knox County",470313,33.8072730288127,0.0434096290449882,102.484940879797,5.95348204280979,4.34096290449882
2022-03-09,126243,64,97801,20,28442,44,105849,23,543419,419,649268,442,1,1299,2,2712,1355,2,"Knox County",470313,42.9501204516992,0.0443548387096774,93.9799665329259,13.6079589549938,4.43548387096774
2022-03-08,126179,35,97781,18,28398,17,105826,19,543000,311,648826,330,1,1298,1,2710,1353,3,"Knox County",470313,38.6976332782636,0.0434938892882818,70.1660383616868,7.44185255351224,4.34938892882818
2022-03-07,126144,26,97763,21,28381,5,105807,25,542689,267,648496,292,4,1297,2,2709,1350,0,"Knox County",470313,39.7607550716225,0.0439093484419263,62.0863127321592,5.52823332546623,4.39093484419263
2022-03-06,126118,14,97742,11,28376,3,105782,13,542422,212,648204,225,2,1293,2,2707,1350,0,"Knox County",470313,41.6743742996685,0.049706457925636,47.8404807011501,2.97674102140489,4.9706457925636
2022-03-05,126104,19,97731,10,28373,9,105769,11,542210,266,647979,277,0,1291,1,2705,1350,2,"Knox County",470313,43.8006178863863,0.0509881422924901,58.8969473520825,4.03986281476378,5.09881422924901
2022-03-04,126085,53,97721,29,28364,24,105758,30,541944,380,647702,410,1,1291,1,2704,1348,2,"Knox County",470313,50.817221722555,0.0585842148087876,87.175987055429,11.2690910096042,5.85842148087876
2022-03-03,126032,45,97692,29,28340,16,105728,34,541564,326,647292,360,8,1290,4,2703,1346,2,"Knox County",470313,54.4318358199752,0.0663527397260274,76.5447691218401,9.56809614023002,6.63527397260274
2022-03-02,125987,37,97663,29,28324,8,105694,36,541238,338,646932,374,-2,1282,1,2699,1344,7,"Knox County",470313,48.6909781358372,0.0740740740740741,79.521510143245,7.86710127085579,7.40740740740741
2022-03-01,125950,91,97634,48,28316,43,105658,60,540900,391,646558,451,3,1284,3,2698,1337,2,"Knox County",470313,60.5979422214568,0.0874843030556718,95.893585760972,19.3488166391318,8.74843030556718
2022-02-28,125859,132,97586,88,28273,44,105598,96,540509,549,646107,645,10,1281,4,2695,1335,5,"Knox County",470313,83.1361242406653,0.102115244347192,137.142711343297,28.0664153446747,10.2115244347192
2022-02-27,125727,3,97498,3,28229,0,105502,5,539960,75,645462,80,1,1271,1,2691,1330,5,"Knox County",470313,80.7972562952757,0.104736234116288,17.0099486937423,0.637873076015334,10.4736234116288
2022-02-26,125724,46,97495,32,28229,14,105497,35,539885,275,645382,310,0,1270,2,2690,1325,0,"Knox County",470313,86.5381139794137,0.11254752851711,65.9135511882512,9.7807204989018,11.254752851711
2022-02-25,125678,105,97463,66,28215,39,105462,74,539610,406,645072,480,2,1270,5,2688,1325,6,"Knox County",470313,97.5945806303462,0.125925925925926,102.059692162454,22.3255576605367,12.5925925925926
2022-02-24,125573,141,97397,84,28176,57,105388,94,539204,463,644592,557,1,1268,4,2683,1319,3,"Knox County",470313,118.006519062837,0.138073869520193,118.43176778018,29.9800345727207,13.8073869520193
2022-02-23,125432,139,97313,95,28119,44,105294,114,538741,413,644035,527,6,1267,1,2679,1316,4,"Knox County",470313,139.694203647358,0.15672131147541,112.053037020027,29.5547858553772,15.672131147541
2022-02-22,125293,141,97218,86,28075,55,105180,99,538328,356,643508,455,11,1261,7,2678,1312,3,"Knox County",470313,150.325421580947,0.16928618205632,96.7440831956591,29.9800345727207,16.928618205632
2022-02-21,125152,72,97132,47,28020,25,105081,50,537972,290,643053,340,0,1250,1,2671,1309,5,"Knox County",470313,137.56796006064,0.171335030920335,72.2922819484046,15.308953824368,17.1335030920335
2022-02-20,125080,72,97085,48,27995,24,105031,57,537682,289,642713,346,0,1250,1,2670,1304,2,"Knox County",470313,152.239040808993,0.17346600331675,73.5680281004352,15.308953824368,17.346600331675
2022-02-19,125008,89,97037,54,27971,35,104974,68,537393,322,642367,390,0,1250,1,2669,1302,4,"Knox County",470313,161.38188823188,0.179644588045234,82.9234998819935,18.9235679217883,17.9644588045234
2022-02-18,124919,139,96983,91,27936,48,104906,112,537071,498,641977,610,0,1250,3,2668,1298,4,"Knox County",470313,168.61111642672,0.184186046511628,129.700858789785,29.5547858553772,18.4186046511628
2022-02-17,124780,270,96892,208,27888,62,104794,252,536573,1208,641367,1460,1,1250,2,2665,1294,2,"Knox County",470313,196.039658695379,0.182170542635659,310.431563660796,57.4085768413801,18.2170542635659
2022-02-16,124510,224,96684,145,27826,79,104542,160,535365,546,639907,706,3,1249,3,2663,1292,3,"Knox County",470313,214.112729182481,0.185279777107035,150.112797222275,47.6278563424783,18.5279777107035
2022-02-15,124286,270,96539,213,27747,57,104382,241,534819,592,639201,833,5,1246,6,2660,1289,4,"Knox County",470313,241.54127145114,0.200640341515475,177.116090773591,57.4085768413801,20.0640341515475
2022-02-14,124016,341,96326,205,27690,136,104141,246,534227,602,638368,848,19,1241,8,2654,1285,1,"Knox County",470313,298.737223933848,0.218756017716156,180.305456153668,72.5049063070764,21.8756017716156
2022-02-13,123675,119,96121,100,27554,19,103895,116,533625,283,637520,399,1,1222,1,2646,1284,3,"Knox County",470313,308.730568791422,0.227792603888677,84.8371191100395,25.3022986819416,22.7792603888677
2022-02-12,123556,153,96021,109,27535,44,103779,127,533342,414,637121,541,0,1221,3,2645,1281,6,"Knox County",470313,322.338527746416,0.232351306281267,115.029778041432,32.5315268767821,23.2351306281267
2022-02-11,123403,339,95912,249,27491,90,103652,278,532928,631,636580,909,3,1221,10,2642,1275,5,"Knox County",470313,364.863399480771,0.249297752808989,193.275542032646,72.0796575897328,24.9297752808989
2022-02-10,123064,420,95663,272,27401,148,103374,302,532297,555,635671,857,7,1218,12,2632,1270,3,"Knox County",470313,396.757053281538,0.28863145493815,182.219075381714,89.3022306421468,28.863145493815
2022-02-09,122644,435,95391,305,27253,130,103072,369,531742,606,634814,975,8,1211,4,2620,1267,6,"Knox County",470313,441.620792961283,0.313129429317419,207.308749704984,92.4915960222235,31.3129429317419
2022-02-08,122209,451,95086,331,27123,120,102703,389,531136,462,633839,851,6,1203,8,2616,1261,12,"Knox County",470313,480.105801880875,0.339591078066915,180.943329229683,95.893585760972,33.9591078066914
2022-02-07,121758,588,94755,409,27003,179,102314,441,530674,624,632988,1065,10,1197,11,2608,1249,5,"Knox County",470313,532.624018472804,0.361264963373236,226.444941985444,125.023122899006,36.1264963373236
2022-02-06,121170,250,94346,184,26824,66,101873,214,530050,435,631923,649,0,1187,13,2597,1244,5,"Knox County",470313,560.477809458807,0.362579100393364,137.993208777984,53.1560896679445,36.2579100393364
2022-02-05,120920,269,94162,192,26758,77,101659,220,529615,496,631274,716,0,1187,7,2584,1239,11,"Knox County",470313,585.142235064734,0.367485885088011,152.239040808993,57.1959524827083,36.7485885088011
2022-02-04,120651,649,93970,510,26681,139,101439,581,529119,963,630558,1544,3,1187,3,2577,1228,0,"Knox County",470313,651.055786252985,0.377948024635722,328.292009789225,137.993208777984,37.7948024635722
2022-02-03,120002,1638,93460,502,26542,1136,100858,505,528156,741,629014,1246,1,1184,13,2574,1228,2,"Knox County",470313,910.03225511521,0.385892705080897,264.929950905036,348.278699504373,38.5892705080897
2022-02-02,118364,715,92958,536,25406,179,100353,602,527415,904,627768,1506,7,1183,6,2561,1226,9,"Knox County",470313,969.567075543308,0.389600105582684,320.212284159698,152.026416450321,38.9600105582684
2022-02-01,117649,931,92422,733,25227,198,99751,830,526511,1139,626262,1969,5,1176,12,2555,1217,7,"Knox County",470313,1071.62676770576,0.390224266820011,418.657362224731,197.953277923425,39.0224266820011
2022-01-31,116718,713,91689,517,25029,196,98921,522,525372,605,624293,1127,11,1171,13,2543,1210,2,"Knox County",470313,1098.20481253973,0.396711202466598,239.627652223094,151.601167732978,39.6711202466598
2022-01-30,116005,387,91172,319,24833,68,98399,336,524767,569,623166,905,1,1160,7,2530,1208,6,"Knox County",470313,1127.33434967777,0.398979252191279,192.425044597959,82.2856268059781,39.8979252191279
2022-01-29,115618,677,90853,588,24765,89,98063,644,524198,912,622261,1556,0,1159,5,2523,1202,3,"Knox County",470313,1214.08508801585,0.407997564193647,330.843502093287,143.946690820794,40.7997564193647
2022-01-28,114941,932,90265,770,24676,162,97419,832,523286,1040,620705,1872,3,1159,15,2518,1199,6,"Knox County",470313,1274.25778151997,0.419506924663589,398.032799433569,198.165902282097,41.9506924663589
2022-01-27,114009,1428,89495,1198,24514,230,96587,1272,522246,1472,618833,2744,7,1156,13,2503,1193,8,"Knox County",470313,1229.60666619889,0.431372549019608,583.441240195359,303.627584183299,43.1372549019608
2022-01-26,112581,990,88297,800,24284,190,95315,850,520774,965,616089,1815,4,1149,4,2490,1185,8,"Knox County",470313,1288.07836483363,0.440940940940941,385.913210989277,210.49811508506,44.0940940940941
2022-01-25,111591,1018,87497,766,24094,252,94465,804,519809,930,614274,1734,7,1145,11,2486,1177,6,"Knox County",470313,1306.57668403808,0.447545307581043,368.690637936863,216.45159712787,44.7545307581043
2022-01-24,110573,1316,86731,1082,23842,234,93661,1161,518879,1550,612540,2711,13,1138,15,2475,1171,5,"Knox County",470313,1434.78917231716,0.442303366574192,576.424636359191,279.81365601206,44.2303366574192
2022-01-23,109257,768,85649,679,23608,89,92500,709,517329,818,609829,1527,0,1125,7,2460,1166,10,"Knox County",470313,1515.79905297111,0.449315853571173,324.677395691805,163.295507459926,44.9315853571173
2022-01-22,108489,899,84970,737,23519,162,91791,770,516511,1056,608302,1826,0,1125,14,2453,1156,3,"Knox County",470313,1563.00166059624,0.449645091011315,388.252078934667,191.149298445929,44.9645091011315
2022-01-21,107590,1514,84233,1230,23357,284,91021,1290,515455,1348,606476,2638,1,1125,6,2439,1153,6,"Knox County",470313,1686.74903734322,0.457219073024341,560.903058176151,321.913279029072,45.7219073024341
2022-01-20,106076,1406,83003,1164,23073,242,89731,1214,514107,1152,603838,2366,11,1124,11,2433,1147,2,"Knox County",470313,1682.07130145244,0.465074912772799,503.069232617427,298.94984829252,46.5074912772799
2022-01-19,104670,1662,81839,1302,22831,360,88517,1339,512955,1331,601472,2670,4,1113,7,2422,1145,2,"Knox County",470313,1824.95487047987,0.470979834539814,567.707037653648,353.381684112495,47.0979834539814
2022-01-18,103008,1042,80537,663,22471,379,87178,691,511624,686,598802,1377,6,1109,7,2415,1143,4,"Knox County",470313,1830.05785508799,0.474627853126034,292.783741891039,221.554581735993,47.4627853126034
2022-01-17,101966,1090,79874,859,22092,231,86487,903,510938,1279,597425,2182,7,1103,13,2408,1139,3,"Knox County",470313,1782.00475002817,0.47415329768271,463.94635062182,231.760550952238,47.415329768271
2022-01-16,100876,769,79015,689,21861,80,85584,716,509659,1073,595243,1789,0,1096,7,2395,1136,4,"Knox County",470313,1782.21737438684,0.466258081896552,380.384977663811,163.508131818597,46.6258081896552
2022-01-15,100107,751,78326,597,21781,154,84868,626,508586,816,593454,1442,1,1096,12,2388,1132,2,"Knox County",470313,1750.74896930342,0.468680862831858,306.604325204704,159.680893362505,46.8680862831858
2022-01-14,99356,1300,77729,1048,21627,252,84242,1093,507770,1188,592012,2281,6,1095,10,2376,1130,6,"Knox County",470313,1705.24735654766,0.466576876727866,484.996162130326,276.411666273312,46.6576876727866
2022-01-13,98056,1398,76681,1053,21375,345,83149,1104,506582,1401,589731,2505,6,1089,11,2366,1124,6,"Knox County",470313,1703.54636167829,0.454302962235013,532.624018472804,297.248853423146,45.4302962235013
2022-01-12,96658,1163,75628,887,21030,276,82045,935,505181,1058,587226,1993,1,1083,4,2355,1118,0,"Knox County",470313,1597.44680670107,0.447195813987766,423.760346832854,247.282129135278,44.7195813987766
2022-01-11,95495,1362,74741,1058,20754,304,81110,1093,504123,1283,585233,2376,2,1082,10,2351,1118,3,"Knox County",470313,1665.48660147604,0.444124107633169,505.195476204145,289.594376510962,44.4124107633169
2022-01-10,94133,1000,73683,685,20450,315,80017,714,502840,812,582857,1526,3,1080,5,2341,1115,1,"Knox County",470313,1646.35040919558,0.451480736055204,324.464771333133,212.624358671778,45.1480736055204
2022-01-09,93133,739,72998,626,20135,113,79303,664,502028,1205,581331,1869,5,1077,2,2336,1114,2,"Knox County",470313,1639.97167843543,0.445182961692396,397.394926357553,157.129401058444,44.5182961692396
2022-01-08,92394,620,72372,475,20022,145,78639,509,500823,912,579462,1421,0,1072,10,2334,1112,4,"Knox County",470313,1612.11788744942,0.437477632238208,302.139213672597,131.827102376502,43.7477632238208
2022-01-07,91774,964,71897,747,19877,217,78130,769,499911,1091,578041,1860,0,1072,7,2324,1108,0,"Knox County",470313,1540.6761029357,0.427158671586716,395.481307129507,204.969881759594,42.7158671586716
2022-01-06,90810,1157,71150,739,19660,418,77361,778,498820,1010,576181,1788,2,1072,7,2317,1108,4,"Knox County",470313,1489.43363249581,0.42562144471285,380.172353305139,246.006382983247,42.562144471285
2022-01-05,89653,1210,70411,898,19242,312,76583,941,497810,1255,574393,2196,1,1070,8,2310,1104,1,"Knox County",470313,1499.42697735338,0.419453820190242,466.923091643225,257.275473992852,41.9453820190242
2022-01-04,88443,922,69513,576,18930,346,75642,566,496555,1040,572197,1606,0,1069,6,2302,1103,5,"Knox County",470313,1405.8722595378,0.402820805478559,341.474720026876,196.039658695379,40.2820805478559
2022-01-03,87521,714,68937,537,18584,177,75076,504,495515,820,570591,1324,6,1069,7,2296,1098,2,"Knox County",470313,1345.06169295767,0.39215848806366,281.514650881434,151.81379209165,39.215848806366
2022-01-02,86807,288,68400,206,18407,82,74572,264,494695,651,569267,915,3,1063,9,2289,1096,4,"Knox County",470313,1249.1681071967,0.38982898289829,194.551288184677,61.2358152974721,38.982898289829
2022-01-01,86519,265,68194,217,18325,48,74308,237,494044,767,568352,1004,0,1060,15,2280,1092,0,"Knox County",470313,1173.68645986822,0.379594126998971,213.474856106465,56.3454550480212,37.9594126998971
2021-12-31,86254,591,67977,429,18277,162,74071,470,493277,1008,567348,1478,0,1060,5,2265,1092,3,"Knox County",470313,1094.37757408364,0.364659101929978,314.258802116888,125.660995975021,36.4659101929978
2021-12-30,85663,577,67548,401,18115,176,73601,403,492269,918,565870,1321,2,1060,6,2260,1089,2,"Knox County",470313,971.055446054011,0.343864282811865,280.876777805419,122.684254953616,34.3864282811865
2021-12-29,85086,631,67147,476,17939,155,73198,504,491351,1195,564549,1699,1,1058,5,2254,1087,2,"Knox County",470313,847.945942383051,0.315395314004493,361.248785383351,134.165970321892,31.5395314004493
2021-12-28,84455,427,66671,261,17784,166,72694,281,490156,977,562850,1258,1,1057,5,2249,1085,0,"Knox County",470313,742.696884840521,0.295921769085454,267.481443209097,90.7906011528493,29.5921769085454
2021-12-27,84028,313,66410,233,17618,80,72413,254,489179,905,561592,1159,2,1056,1,2244,1085,1,"Knox County",470313,657.434517013138,0.273149196287073,246.431631700591,66.5514242642666,27.3149196287073
2021-12-26,83715,61,66177,49,17538,12,72159,60,488274,426,560433,486,7,1054,1,2243,1084,0,"Knox County",470313,609.168787594644,0.262819750148721,103.335438314484,12.9700858789785,26.2819750148721
2021-12-25,83654,85,66128,63,17526,22,72099,74,487848,489,559947,563,1,1047,1,2242,1084,0,"Knox County",470313,570.896403033724,0.256906077348066,119.707513932211,18.0730704871011,25.6906077348066
2021-12-24,83569,175,66065,124,17504,51,72025,138,487359,848,559384,986,0,1046,2,2241,1084,0,"Knox County",470313,482.444669826265,0.229389721627409,209.647617650373,37.2092627675612,22.9389721627409
2021-12-23,83394,218,65941,159,17453,59,71887,166,486511,959,558398,1125,4,1046,5,2239,1084,1,"Knox County",470313,406.112525063096,0.202996151731721,239.20240350575,46.3521101904476,20.2996151731721
2021-12-22,83176,175,65782,102,17394,73,71721,101,485552,812,557273,913,46,1042,10,2234,1083,2,"Knox County",470313,309.155817508765,0.165485362095532,194.126039467333,37.2092627675612,16.5485362095532
2021-12-21,83001,176,65680,123,17321,53,71620,120,484740,912,556360,1032,3,996,6,2224,1081,2,"Knox County",470313,255.787103482149,0.145753512132822,219.428338149275,37.421887126233,14.5753512132822
2021-12-20,82825,112,65557,78,17268,34,71500,84,483828,622,555328,706,1,993,3,2218,1079,1,"Knox County",470313,213.049607389122,0.127860953364309,150.112797222275,23.8139281712392,12.7860953364309
2021-12-19,82713,69,65479,49,17234,20,71416,58,483206,556,554622,614,3,992,6,2215,1078,1,"Knox County",470313,214.750602258496,0.12476847954201,130.551356224472,14.6710807483527,12.476847954201
2021-12-18,82644,88,65430,57,17214,31,71358,65,482650,660,554008,725,0,989,3,2209,1077,2,"Knox County",470313,215.388475334511,0.119980331093263,154.152660037039,18.7109435631165,11.9980331093263
2021-12-17,82556,118,65373,76,17183,42,71293,83,481990,1034,553283,1117,2,989,6,2206,1075,2,"Knox County",470313,203.26888689022,0.108632862644416,237.501408636376,25.0896743232698,10.8632862644416
2021-12-16,82438,138,65297,108,17141,30,71210,108,480956,661,552166,769,2,987,3,2200,1073,2,"Knox County",470313,186.258938196478,0.105343771272975,163.508131818597,29.3421614967054,10.5343771272975
2021-12-15,82300,156,65189,113,17111,43,71102,125,480295,841,551397,966,0,985,5,2197,1071,3,"Knox County",470313,182.219075381714,0.108449991566875,205.395130476938,33.1693999527974,10.8449991566875
2021-12-14,82144,101,65076,62,17068,39,70977,66,479454,811,550431,877,3,985,5,2192,1068,3,"Knox County",470313,166.27224848133,0.102009005888466,186.471562555149,21.4750602258496,10.2009005888466
2021-12-13,82043,110,65014,74,17029,36,70911,78,478643,627,549554,705,4,982,3,2187,1065,0,"Knox County",470313,165.846999763987,0.100987354928114,149.900172863604,23.3886794538956,10.0987354928114
2021-12-12,81933,54,64940,29,16993,25,70833,41,478016,493,548849,534,6,978,5,2184,1065,1,"Knox County",470313,162.65763438391,0.0994203407693659,113.54140753073,11.481715368276,9.94203407693659
2021-12-11,81879,65,64911,45,16968,20,70792,51,477523,541,548315,592,0,972,1,2179,1064,3,"Knox County",470313,157.767274134459,0.0992805755395683,125.873620333693,13.8205833136656,9.92805755395683
2021-12-10,81814,85,64866,48,16948,37,70741,57,476982,855,547723,912,0,972,3,2178,1061,2,"Knox County",470313,150.750670298291,0.0982259570494865,193.913415108662,18.0730704871011,9.82259570494865
2021-12-09,81729,164,64818,96,16911,68,70684,107,476127,1017,546811,1124,3,972,2,2175,1059,1,"Knox County",470313,156.278903623757,0.0919439579684764,238.989779147079,34.8703948221716,9.19439579684764
2021-12-08,81565,130,64722,67,16843,63,70577,65,475110,751,545687,816,0,969,7,2173,1058,1,"Knox County",470313,150.750670298291,0.0836330935251798,173.501476676171,27.6411666273312,8.36330935251799
2021-12-07,81435,126,64655,69,16780,57,70512,76,474359,631,544871,707,2,969,2,2166,1057,0,"Knox County",470313,156.066279265085,0.088126159554731,150.325421580947,26.790669192644,8.8126159554731
2021-12-06,81309,148,64586,107,16723,41,70436,115,473728,759,544164,874,8,967,4,2164,1057,3,"Knox County",470313,164.146004894613,0.0921028962043533,185.833689479134,31.4684050834232,9.21028962043533
2021-12-05,81161,43,64479,28,16682,15,70321,33,472969,342,543290,375,2,959,1,2160,1054,0,"Knox County",470313,161.807136949223,0.0933333333333333,79.7341345019168,9.14284742288646,9.33333333333333
2021-12-04,81118,69,64451,50,16667,19,70288,55,472627,499,542915,554,0,957,3,2159,1054,2,"Knox County",470313,162.65763438391,0.0947407683700112,117.793894704165,14.6710807483527,9.47407683700112
2021-12-03,81049,147,64401,103,16648,44,70233,108,472128,1009,542361,1117,3,957,2,2156,1052,2,"Knox County",470313,175.840344621561,0.100413148913239,237.501408636376,31.2557807247514,10.0413148913239
2021-12-02,80902,133,64298,86,16604,47,70125,85,471119,794,541244,879,0,954,4,2154,1050,2,"Knox County",470313,169.248989502735,0.100901916572717,186.896811272493,28.2790397033465,10.0901916572717
2021-12-01,80769,184,64212,141,16557,43,70040,146,470325,1008,540365,1154,4,954,7,2150,1048,1,"Knox County",470313,180.730704871011,0.109187279151943,245.368509907232,39.1228819956072,10.9187279151943
2021-11-30,80585,116,64071,67,16514,49,69894,68,469317,693,539211,761,3,950,6,2143,1047,3,"Knox County",470313,178.604461284294,0.106755337766888,161.807136949223,24.6644256059263,10.6755337766888
2021-11-29,80469,165,64004,128,16465,37,69826,139,468624,967,538450,1106,2,947,5,2137,1044,1,"Knox County",470313,182.219075381714,0.106626303397242,235.162540690987,35.0830191808434,10.6626303397242
2021-11-28,80304,34,63876,22,16428,12,69687,22,467657,270,537344,292,3,945,5,2132,1043,2,"Knox County",470313,180.305456153668,0.106259594064472,62.0863127321592,7.22922819484046,10.6259594064472
2021-11-27,80270,59,63854,31,16416,28,69665,32,467387,266,537052,298,0,942,1,2127,1041,2,"Knox County",470313,178.17921256695,0.107009095773141,63.3620588841899,12.5448371616349,10.7009095773141
2021-11-26,80211,20,63823,18,16388,2,69633,20,467121,298,536754,318,0,942,4,2126,1039,1,"Knox County",470313,151.175919015634,0.10648918469218,67.6145460576254,4.25248717343556,10.648918469218
2021-11-25,80191,52,63805,26,16386,26,69613,30,466823,331,536436,361,0,942,4,2122,1038,5,"Knox County",470313,133.95334596322,0.106526806526807,76.7573934805119,11.0564666509325,10.6526806526807
2021-11-24,80139,105,63779,66,16360,39,69583,73,466492,742,536075,815,0,942,3,2118,1033,4,"Knox County",470313,117.15602162815,0.0971905846621109,173.288852317499,22.3255576605367,9.71905846621109
2021-11-23,80034,98,63713,64,16321,34,69510,64,465750,674,535260,738,0,942,2,2115,1029,0,"Knox County",470313,113.328783172058,0.0967413441955193,156.916776699772,20.8371871498343,9.67413441955193
2021-11-22,79936,107,63649,84,16287,23,69446,82,465076,740,534522,822,0,942,3,2113,1029,0,"Knox County",470313,100.996570369095,0.0886388583973655,174.777222828202,22.7508063778803,8.86388583973655
2021-11-21,79829,44,63565,32,16264,12,69364,37,464336,284,533700,321,0,942,2,2110,1029,2,"Knox County",470313,103.122813955812,0.0920228695888919,68.2524191336408,9.35547178155824,9.20228695888919
2021-11-20,79785,54,63533,37,16252,17,69327,44,464052,537,533379,581,0,942,1,2108,1027,1,"Knox County",470313,102.059692162454,0.0884732052578362,123.534752388303,11.481715368276,8.84732052578362
2021-11-19,79731,112,63496,83,16235,29,69283,81,463515,825,532798,906,0,942,0,2107,1026,0,"Knox County",470313,121.621133160257,0.0904489436619718,192.637668956631,23.8139281712392,9.04489436619718
2021-11-18,79619,81,63413,45,16206,36,69202,50,462690,937,531892,987,3,942,2,2107,1026,0,"Knox County",470313,127.787239561739,0.0833655705996132,209.860242009045,17.222573052414,8.33655705996132
2021-11-17,79538,105,63368,65,16170,40,69152,66,461753,833,530905,899,0,939,1,2105,1026,1,"Knox County",470313,127.787239561739,0.0807004187285877,191.149298445929,22.3255576605367,8.07004187285877
2021-11-16,79433,72,63303,50,16130,22,69086,67,460920,777,530006,844,0,939,2,2104,1025,3,"Knox County",470313,122.259006236272,0.0796641791044776,179.454958718981,15.308953824368,7.96641791044776
2021-11-15,79361,84,63253,45,16108,39,69019,34,460143,459,529162,493,3,939,0,2102,1022,0,"Knox County",470313,117.368645986822,0.0753329357980521,104.823808825187,17.8604461284294,7.53329357980521
2021-11-14,79277,72,63208,62,16069,10,68985,68,459684,624,528669,692,0,936,2,2102,1022,2,"Knox County",470313,123.322128029631,0.075897815623843,147.13605620087,15.308953824368,7.5897815623843
2021-11-13,79205,29,63146,13,16059,16,68917,12,459060,317,527977,329,0,936,2,2100,1020,0,"Knox County",470313,118.006519062837,0.0733980582524272,69.953414003015,6.16610640148157,7.33980582524272
2021-11-12,79176,65,63133,48,16043,17,68905,50,458743,687,527648,737,0,936,4,2098,1020,2,"Knox County",470313,108.013174205263,0.0696647259586428,156.7041523411,13.8205833136656,6.96647259586428
2021-11-11,79111,66,63085,47,16026,19,68855,54,458056,962,526911,1016,0,936,0,2094,1018,0,"Knox County",470313,104.823808825187,0.070059880239521,216.026348410527,14.0332076723374,7.0059880239521
2021-11-10,79045,72,63038,49,16007,23,68801,68,457094,854,525895,922,1,936,2,2094,1018,0,"Knox County",470313,97.807204989018,0.0701370951718657,196.039658695379,15.308953824368,7.01370951718657
2021-11-09,78973,103,62989,73,15984,30,68733,130,456240,1173,524973,1303,1,935,1,2092,1018,1,"Knox County",470313,104.398560107843,0.0757465404224326,277.049539349327,21.9003089431931,7.57465404224326
2021-11-08,78870,78,62916,58,15954,20,68603,70,455067,687,523670,757,6,934,1,2091,1017,3,"Knox County",470313,103.122813955812,0.0785267546907575,160.956639514536,16.5846999763987,7.85267546907575
2021-11-07,78792,30,62858,19,15934,11,68533,22,454380,390,522913,412,0,928,1,2090,1014,3,"Knox County",470313,94.1925908915977,0.0741417092768444,87.6012357727726,6.37873076015334,7.41417092768444
2021-11-06,78762,41,62839,27,15923,14,68511,30,453990,453,522501,483,0,928,2,2089,1011,1,"Knox County",470313,96.7440831956591,0.0753108348134991,102.697565238469,8.7175987055429,7.53108348134991
2021-11-05,78721,52,62812,32,15909,20,68481,36,453537,605,522018,641,0,928,2,2087,1010,0,"Knox County",470313,93.9799665329259,0.0740874593422479,136.29221390861,11.0564666509325,7.40874593422479
2021-11-04,78669,67,62780,45,15889,22,68445,49,452932,667,521377,716,0,928,1,2085,1010,1,"Knox County",470313,94.1925908915977,0.0773786778754299,152.239040808993,14.2458320310091,7.73786778754299
2021-11-03,78602,80,62735,60,15867,20,68396,66,452265,969,520661,1035,0,928,2,2084,1009,2,"Knox County",470313,95.893585760972,0.075369365999626,220.06621122529,17.0099486937423,7.5369365999626
2021-11-02,78522,41,62675,19,15847,22,68330,22,451296,301,519626,323,4,928,1,2082,1007,3,"Knox County",470313,82.7108755233217,0.0675520952599038,68.6776678509843,8.7175987055429,6.75520952599038
2021-11-01,78481,95,62656,71,15825,24,68308,83,450995,661,519303,744,1,924,3,2081,1004,1,"Knox County",470313,86.3254896207419,0.0707395498392283,158.192522851803,20.1993140738189,7.07395498392283
2021-10-31,78386,26,62585,20,15801,6,68225,19,450334,278,518559,297,0,923,1,2078,1003,1,"Knox County",470313,85.4749921860548,0.0719509318235433,63.1494345255181,5.52823332546623,7.19509318235433
2021-10-30,78360,56,62565,41,15795,15,68206,43,450056,523,518262,566,0,923,4,2077,1002,0,"Knox County",470313,88.6643575661315,0.0735770476631189,120.345387008226,11.9069640856196,7.35770476631189
2021-10-29,78304,73,62524,59,15780,14,68163,66,449533,846,517696,912,1,923,1,2073,1002,1,"Knox County",470313,93.1294690982388,0.0757674722403658,193.913415108662,15.5215781830398,7.57674722403658
2021-10-28,78231,55,62465,32,15766,23,68097,39,448687,561,516784,600,4,922,3,2072,1001,2,"Knox County",470313,90.5779767941775,0.0754969845878937,127.574615203067,11.6943397269478,7.54969845878937
2021-10-27,78176,87,62433,57,15743,30,68058,65,448126,759,516184,824,1,918,3,2069,999,3,"Knox County",470313,92.0663473048799,0.0789967182372246,175.202471545545,18.4983192044447,7.89967182372246
2021-10-26,78089,95,62376,57,15713,38,67993,55,447367,554,515360,609,0,917,5,2066,996,2,"Knox County",470313,103.548062673156,0.0812829525483304,129.488234431113,20.1993140738189,8.12829525483304
2021-10-25,77994,70,62319,46,15675,24,67938,53,446813,491,514751,544,6,917,3,2061,994,1,"Knox County",470313,98.2324537063615,0.078125,115.667651117447,14.8837051070245,7.8125
2021-10-24,77924,38,62273,20,15651,18,67885,23,446322,337,514207,360,1,911,5,2058,993,3,"Knox County",470313,100.783946010423,0.077916194790487,76.5447691218401,8.07972562952757,7.7916194790487
2021-10-23,77886,59,62253,40,15633,19,67862,42,445985,471,513847,513,0,910,1,2053,990,2,"Knox County",470313,101.421819086438,0.0786336542870243,109.076295998622,12.5448371616349,7.86336542870243
2021-10-22,77827,89,62213,55,15614,34,67820,54,445514,551,513334,605,0,910,2,2052,988,2,"Knox County",470313,104.823808825187,0.0816276202219482,128.637736996426,18.9235679217883,8.16276202219482
2021-10-21,77738,125,62158,71,15580,54,67766,78,444963,712,512729,790,3,910,2,2050,986,2,"Knox County",470313,119.707513932211,0.0871613663133098,167.973243350705,26.5780448339723,8.71613663133098
2021-10-20,77613,147,62087,82,15526,65,67688,89,444251,959,511939,1048,3,907,3,2048,984,2,"Knox County",470313,132.464975452518,0.0881628999776236,222.830327888024,31.2557807247514,8.81628999776236
2021-10-19,77466,130,62005,85,15461,45,67599,92,443292,724,510891,816,4,904,3,2045,982,2,"Knox County",470313,139.90682800603,0.0921727972626176,173.501476676171,27.6411666273312,9.21727972626176
2021-10-18,77336,119,61920,88,15416,31,67507,104,442568,607,510075,711,9,900,8,2042,980,3,"Knox County",470313,150.325421580947,0.0995250877555234,151.175919015634,25.3022986819416,9.95250877555234
2021-10-17,77217,63,61832,56,15385,7,67403,61,441961,303,509364,364,1,891,4,2034,977,2,"Knox County",470313,155.641030547742,0.107282855374458,77.3952665565272,13.395334596322,10.7282855374458
2021-10-16,77154,54,61776,39,15378,15,67342,42,441658,372,509000,414,0,890,1,2030,975,4,"Knox County",470313,154.577908754383,0.109519797809604,88.0264844901162,11.481715368276,10.9519797809604
2021-10-15,77100,125,61737,90,15363,35,67300,99,441286,794,508586,893,9,890,5,2029,971,2,"Knox County",470313,162.232385666567,0.11219221604448,189.873552293898,26.5780448339723,11.219221604448
2021-10-14,76975,190,61647,135,15328,55,67201,143,440492,699,507693,842,0,881,7,2024,969,5,"Knox County",470313,176.052968980232,0.123820754716981,179.029710001637,40.3986281476379,12.3820754716981
2021-10-13,76785,119,61512,88,15273,31,67058,99,439793,764,506851,863,7,881,5,2017,964,1,"Knox County",470313,170.099486937423,0.130532327146645,183.494821533745,25.3022986819416,13.0532327146645
2021-10-12,76666,135,61424,103,15242,32,66959,108,439029,821,505988,929,4,874,3,2012,963,9,"Knox County",470313,171.162608730781,0.130781499202552,197.528029206082,28.70428842069,13.0781499202552
2021-10-11,76531,191,61321,136,15210,55,66851,149,438208,581,505059,730,3,870,12,2009,954,1,"Knox County",470313,186.471562555149,0.13922542204568,155.215781830398,40.6112525063096,13.922542204568
2021-10-10,76340,53,61185,40,15155,13,66702,52,437627,489,504329,541,0,867,4,1997,953,3,"Knox County",470313,184.345318968432,0.132770529547199,115.029778041432,11.2690910096042,13.2770529547199
2021-10-09,76287,64,61145,34,15142,30,66650,46,437138,490,503788,536,0,867,7,1993,950,4,"Knox County",470313,186.471562555149,0.130483689538808,113.966656248073,13.6079589549938,13.0483689538808
2021-10-08,76223,281,61111,115,15112,166,66604,123,436648,936,503252,1059,-1,867,5,1986,946,4,"Knox County",470313,219.640962507947,0.130909090909091,225.169195833413,59.7474447867697,13.0909090909091
2021-10-07,75942,256,60996,169,14946,87,66481,175,435712,1106,502193,1281,6,868,9,1981,942,1,"Knox County",470313,233.674170180284,0.126620643205927,272.371803458548,54.4318358199752,12.6620643205927
2021-10-06,75686,137,60827,101,14859,36,66306,112,434606,835,500912,947,1,862,4,1972,941,5,"Knox County",470313,237.501408636376,0.127013116387182,201.355267662174,29.1295371380336,12.7013116387182
2021-10-05,75549,208,60726,118,14823,90,66194,138,433771,915,499965,1053,3,861,4,1968,936,4,"Knox County",470313,253.022986819416,0.129331381161542,223.893449681382,44.2258666037299,12.9331381161542
2021-10-04,75341,307,60608,219,14733,88,66056,245,432856,829,498912,1074,3,858,4,1964,932,2,"Knox County",470313,277.687412425342,0.137266985056232,228.35856121349,65.2756781122359,13.7266985056232
2021-10-03,75034,100,60389,91,14645,9,65811,105,432027,677,497838,782,1,855,6,1960,930,1,"Knox County",470313,287.680757282916,0.140225787284611,166.27224848133,21.2624358671778,14.0225787284611
2021-10-02,74934,67,60298,43,14636,24,65706,50,431350,472,497056,522,5,854,2,1954,929,4,"Knox County",470313,288.318630358931,0.141113426615064,110.989915226668,14.2458320310091,14.1113426615064
2021-10-01,74867,219,60255,148,14612,71,65656,164,430878,965,496534,1129,0,849,8,1952,925,3,"Knox County",470313,275.135920121281,0.145698291101945,240.052900940438,46.5647345491194,14.5698291101945
2021-09-30,74648,239,60107,165,14541,74,65492,185,429913,1104,495405,1289,1,849,8,1944,922,2,"Knox County",470313,271.521306023861,0.146998234255444,274.072798327922,50.817221722555,14.6998234255444
2021-09-29,74409,352,59942,164,14467,188,65307,186,428809,1110,494116,1296,6,848,8,1936,920,3,"Knox County",470313,317.235543138293,0.150174947515745,275.561168838624,74.8437742524659,15.0174947515745
2021-09-28,74057,337,59778,239,14279,98,65121,259,427699,777,492820,1036,2,842,1,1928,917,3,"Knox County",470313,344.664085406952,0.167508417508417,220.278835583962,71.6544088723892,16.7508417508418
2021-09-27,73720,237,59539,160,14181,77,64862,185,426922,760,491784,945,7,840,12,1927,914,6,"Knox County",470313,329.780380299928,0.162023146163738,200.93001894483,50.3919730052114,16.2023146163738
2021-09-26,73483,123,59379,99,14104,24,64677,117,426162,703,490839,820,2,833,1,1915,908,5,"Knox County",470313,334.670740549379,0.162853488702572,174.351974110858,26.1527961166287,16.2853488702572
2021-09-25,73360,110,59280,90,14080,20,64560,102,425459,705,490019,807,0,831,3,1914,903,7,"Knox County",470313,343.813587972265,0.163616498224529,171.587857448125,23.3886794538956,16.3616498224529
2021-09-24,73250,245,59190,166,14060,79,64458,183,424754,938,489212,1121,13,831,5,1911,896,3,"Knox County",470313,349.341821297731,0.166393218485097,238.351906071063,52.0929678745856,16.6393218485097
2021-09-23,73005,350,59024,243,13981,107,64275,268,423816,1370,488091,1638,14,818,9,1906,893,3,"Knox County",470313,372.943125110299,0.169646352603419,348.278699504373,74.4185255351224,16.9646352603419
2021-09-22,72655,250,58781,186,13874,64,64007,201,422446,1260,486453,1461,3,804,4,1897,890,9,"Knox County",470313,351.255440525777,0.167986714358712,310.644188019468,53.1560896679445,16.7986714358712
2021-09-21,72405,392,58595,213,13810,179,63806,226,421186,996,484992,1222,10,801,7,1893,881,4,"Knox County",470313,362.949780252725,0.159970052408285,259.826966296913,83.348748599337,15.9970052408285
2021-09-20,72013,426,58382,304,13631,122,63580,339,420190,1295,483770,1634,5,791,9,1886,877,7,"Knox County",470313,403.135784041691,0.165000574514535,347.428202069686,90.5779767941775,16.5000574514535
2021-09-19,71587,119,58078,87,13509,32,63241,96,418895,432,482136,528,1,786,8,1877,870,8,"Knox County",470313,402.285286607004,0.168232077041969,112.265661378699,25.3022986819416,16.8232077041969
2021-09-18,71468,221,57991,178,13477,43,63145,193,418463,1075,481608,1268,0,785,7,1869,862,13,"Knox County",470313,425.886590419572,0.169747520288548,269.607686795815,46.989983266463,16.9747520288548
2021-09-17,71247,541,57813,417,13434,124,62952,444,417388,1310,480340,1754,5,785,11,1862,849,5,"Knox County",470313,488.823400586418,0.1859021567596,372.943125110299,115.029778041432,18.59021567596
2021-09-16,70706,577,57396,452,13310,125,62508,483,416078,1518,478586,2001,7,780,16,1851,844,3,"Knox County",470313,537.089130004912,0.200851236319416,425.461341702228,122.684254953616,20.0851236319416
2021-09-15,70129,338,56944,249,13185,89,62025,267,414560,807,476585,1074,6,773,5,1835,841,4,"Knox County",470313,555.800073568028,0.216010969307035,228.35856121349,71.867033231061,21.6010969307035
2021-09-14,69791,551,56695,440,13096,111,61758,474,413753,1406,475511,1880,12,767,8,1830,837,3,"Knox County",470313,589.607346596841,0.226452312851366,399.733794302943,117.15602162815,22.6452312851366
2021-09-13,69240,393,56255,292,12985,101,61284,327,412347,1134,473631,1461,20,755,15,1822,834,9,"Knox County",470313,582.590742760672,0.22917920931166,310.644188019468,83.5613729580088,22.917920931166
2021-09-12,68847,383,55963,355,12884,28,60957,373,411213,1460,472170,1833,0,735,5,1807,825,8,"Knox County",470313,638.723573450022,0.22722029988466,389.740449445369,81.435129371291,22.722029988466
2021-09-11,68464,852,55608,694,12856,158,60584,755,409753,2620,470337,3375,4,735,25,1802,817,10,"Knox County",470313,772.889543771914,0.233442966063687,717.607210517251,181.155953588355,23.3442966063687
2021-09-10,67612,1018,54914,744,12698,274,59829,801,407133,2512,466962,3313,1,731,24,1777,807,7,"Knox County",470313,874.311362858352,0.232978509740912,704.424500279601,216.45159712787,23.2978509740912
2021-09-09,66594,309,54170,167,12424,142,59028,172,404621,685,463649,857,1,730,18,1753,800,5,"Knox County",470313,817.328034734315,0.229754223156674,182.219075381714,65.7009268295794,22.9754223156674
2021-09-08,66285,291,54003,225,12282,66,58856,247,403936,837,462792,1084,5,729,11,1735,795,6,"Knox County",470313,807.334689876742,0.228138810403535,230.484804800208,61.8736883734874,22.8138810403535
2021-09-07,65994,404,53778,296,12216,108,58609,308,403099,979,461708,1287,3,724,12,1724,789,1,"Knox County",470313,776.07890915199,0.225813777441332,273.647549610578,85.9002409033984,22.5813777441332
2021-09-06,65590,979,53482,782,12108,197,58301,838,402120,3220,460421,4058,1,721,19,1712,788,3,"Knox County",470313,900.676783333652,0.221041310811666,862.829647490076,208.159247139671,22.1041310811666
2021-09-05,64611,966,52700,801,11911,165,57463,833,398900,2998,456363,3831,2,720,15,1693,785,6,"Knox County",470313,1024.6367844393,0.222072451558551,814.563918071582,205.395130476938,22.2072451558551
2021-09-04,63645,535,51899,382,11746,153,56630,404,395902,1502,452532,1906,2,718,10,1678,779,4,"Knox County",470313,957.234862740345,0.22055582761998,405.262027628409,113.754031889401,22.055582761998
2021-09-03,63110,331,51517,237,11593,94,56226,249,394400,909,450626,1158,5,716,8,1668,775,5,"Knox County",470313,811.161928332834,0.215147027713137,246.219007341919,70.3786627203586,21.5147027713137
2021-09-02,62779,316,51280,178,11499,138,55977,197,393491,680,449468,877,3,711,5,1660,770,3,"Knox County",470313,812.650298843536,0.216604464474333,186.471562555149,67.1892973402819,21.6604464474333
2021-09-01,62463,270,51102,208,11361,62,55780,220,392811,645,448591,865,2,708,2,1655,767,3,"Knox County",470313,808.185187311429,0.218066084966385,183.920070251088,57.4085768413801,21.8066084966385
2021-08-31,62193,592,50894,431,11299,161,55560,477,392166,1894,447726,2371,2,706,9,1653,764,4,"Knox County",470313,848.158566741723,0.213593521837249,504.132354410786,125.873620333693,21.3593521837249
2021-08-30,61601,509,50463,404,11138,105,55083,429,390272,1629,445355,2058,9,704,13,1644,760,6,"Knox County",470313,748.225118165987,0.214985458441757,437.580930146519,108.225798563935,21.4985458441757
2021-08-29,61092,481,50059,407,11033,74,54654,441,388643,1484,443297,1925,1,695,5,1631,754,7,"Knox County",470313,645.102304210175,0.2165770609319,409.301890443173,102.272316521125,21.65770609319
2021-08-28,60611,394,49652,301,10959,93,54213,319,387159,1065,441372,1384,0,694,4,1626,747,3,"Knox County",470313,615.122269637454,0.219214137995864,294.272112401741,83.7739973166806,21.9214137995864
2021-08-27,60217,466,49351,370,10866,96,53894,386,386094,1166,439988,1552,5,694,5,1622,744,1,"Knox County",470313,643.826558058144,0.223803480783176,329.9930046586,99.0829511410486,22.3803480783176
2021-08-26,59751,446,48981,344,10770,102,53508,365,384928,1426,438436,1791,5,689,0,1617,743,5,"Knox County",470313,671.467724685475,0.220743345052737,380.810226381155,94.8304639676131,22.0743345052737
2021-08-25,59305,346,48637,224,10668,122,53143,235,383502,642,436645,877,2,684,4,1617,738,10,"Knox County",470313,687.627175944531,0.221776216758655,186.471562555149,73.5680281004352,22.1776216758655
2021-08-24,58959,333,48413,221,10546,112,52908,233,382860,677,435768,910,4,682,5,1613,728,0,"Knox County",470313,632.55746704854,0.229398875869296,193.488166391318,70.8039114377021,22.9398875869296
2021-08-23,58626,284,48192,206,10434,78,52675,226,382183,825,434858,1051,1,678,1,1608,728,4,"Knox County",470313,584.71698634739,0.232349841938883,223.468200964039,60.385317862785,23.2349841938883
2021-08-22,58342,239,47986,218,10356,21,52449,234,381358,889,433807,1123,2,677,0,1607,724,2,"Knox County",470313,533.26189154882,0.229972375690608,238.777154788407,50.817221722555,22.9972375690608
2021-08-21,58103,497,47768,375,10335,122,52215,409,380469,1903,432684,2312,0,675,8,1607,722,3,"Knox County",470313,555.162200492013,0.217138103161398,491.587517249151,105.674306259874,21.7138103161398
2021-08-20,57606,424,47393,330,10213,94,51806,356,378566,1148,430372,1504,0,675,6,1599,719,3,"Knox County",470313,546.231977427798,0.215091973244147,319.787035442354,90.1527280768339,21.5091973244147
2021-08-19,57182,367,47063,253,10119,114,51450,262,377418,952,428868,1214,1,675,6,1593,716,0,"Knox County",470313,529.434653092728,0.217439661884106,258.125971427539,78.0331396325426,21.7439661884106
2021-08-18,56815,262,46810,192,10005,70,51188,198,376466,914,427654,1112,2,674,5,1587,716,0,"Knox County",470313,511.574206964298,0.207890743550835,236.438286843017,55.7075819720059,20.7890743550835
2021-08-17,56553,260,46618,179,9935,81,50990,197,375552,1042,426542,1239,0,672,5,1582,716,3,"Knox County",470313,496.052628781258,0.196964939822083,263.441580394333,55.2823332546623,19.6964939822083
2021-08-16,56293,181,46439,126,9854,55,50793,131,374510,421,425303,552,2,672,4,1577,713,0,"Knox County",470313,474.152319838065,0.197327738515901,117.368645986822,38.4850089195918,19.7327738515901
2021-08-15,56112,203,46313,180,9799,23,50662,198,374089,953,424751,1151,3,670,6,1573,713,1,"Knox County",470313,466.497842925881,0.192756494936151,244.730636831217,43.162744810371,19.2756494936151
2021-08-14,55909,220,46133,148,9776,72,50464,155,373136,795,423600,950,0,667,4,1567,712,2,"Knox County",470313,407.600895573799,0.193861693861694,201.993140738189,46.7773589077912,19.3861693861694
2021-08-13,55689,265,45985,205,9704,60,50309,219,372341,1470,422650,1689,1,667,5,1563,710,3,"Knox County",470313,373.793622544986,0.171999494119135,359.122541796633,56.3454550480212,17.1999494119135
2021-08-12,55424,220,45780,144,9644,76,50090,150,370871,643,420961,793,2,666,8,1558,707,2,"Knox County",470313,342.537841820235,0.166711194229228,168.61111642672,46.7773589077912,16.6711194229228
2021-08-11,55204,315,45636,236,9568,79,49940,247,370228,989,420168,1236,1,664,10,1550,705,3,"Knox County",470313,353.806932829839,0.170433639947438,262.803707318318,66.9766729816101,17.0433639947438
2021-08-10,54889,172,45400,108,9489,64,49693,120,369239,621,418932,741,1,663,2,1540,702,4,"Knox County",470313,335.095989266722,0.171541057367829,157.554649775788,36.5713896915458,17.1541057367829
2021-08-09,54717,199,45292,162,9425,37,49573,170,368618,752,418191,922,1,662,5,1538,698,1,"Knox County",470313,338.923227722814,0.168270515904838,196.039658695379,42.3122473756839,16.8270515904838
2021-08-08,54518,89,45130,67,9388,22,49403,75,367866,418,417269,493,1,661,5,1533,697,0,"Knox County",470313,314.684050834232,0.166471277842907,104.823808825187,18.9235679217883,16.6471277842907
2021-08-07,54429,103,45063,74,9366,29,49328,78,367448,638,416776,716,0,660,2,1528,697,0,"Knox County",470313,289.807000869634,0.160698027314112,152.239040808993,21.9003089431931,16.0698027314112
2021-08-06,54326,202,44989,147,9337,55,49250,163,366810,879,416060,1042,0,660,10,1526,697,1,"Knox County",470313,276.411666273312,0.16876998149083,221.554581735993,42.9501204516992,16.876998149083
2021-08-05,54124,173,44842,130,9282,43,49087,146,365931,850,415018,996,2,660,4,1516,696,2,"Knox County",470313,266.418321415738,0.1625447445493,211.773861237091,36.7840140502176,16.25447445493
2021-08-04,53951,144,44712,101,9239,43,48941,104,365081,656,414022,760,1,658,4,1512,694,1,"Knox County",470313,230.059556082864,0.150970017636684,161.594512590551,30.6179076487361,15.0970017636684
2021-08-03,53807,237,44611,176,9196,61,48837,182,364425,812,413262,994,0,657,6,1508,693,3,"Knox County",470313,243.88013939653,0.154989025831504,211.348612519747,50.3919730052114,15.4989025831504
2021-08-02,53570,97,44435,75,9135,22,48655,82,363613,532,412268,614,2,657,3,1502,690,0,"Knox County",470313,222.192454812008,0.147818343722173,130.551356224472,20.6245627911625,14.7818343722173
2021-08-01,53473,105,44360,89,9113,16,48573,99,363081,526,411654,625,0,655,2,1499,690,2,"Knox County",470313,225.594444550757,0.148599269183922,132.890224169861,22.3255576605367,14.8599269183922
2021-07-31,53368,103,44271,63,9097,40,48474,68,362555,399,411029,467,1,655,6,1497,688,0,"Knox County",470313,225.594444550757,0.15351036740633,99.2955754997204,21.9003089431931,15.351036740633
2021-07-30,53265,118,44208,83,9057,35,48406,91,362156,339,410562,430,1,654,0,1491,688,1,"Knox County",470313,207.733998422327,0.158002455996725,91.4284742288646,25.0896743232698,15.8002455996725
2021-07-29,53147,118,44125,67,9022,51,48315,69,361817,483,410132,552,0,653,2,1491,687,1,"Knox County",470313,196.039658695379,0.156461053579469,117.368645986822,25.0896743232698,15.6461053579469
2021-07-28,53029,130,44058,89,8971,41,48246,94,361334,536,409580,630,0,653,4,1489,686,0,"Knox County",470313,193.062917673975,0.158858998144712,133.95334596322,27.6411666273312,15.8858998144712
2021-07-27,52899,117,43969,78,8930,39,48152,84,360798,499,408950,583,0,653,4,1485,686,0,"Knox County",470313,167.547994633361,0.150474237375032,123.960001105647,24.877049964598,15.0474237375032
2021-07-26,52782,97,43891,73,8891,24,48068,78,360299,371,408367,449,1,653,4,1481,686,0,"Knox County",470313,167.547994633361,0.156049250535332,95.4683370436284,20.6245627911625,15.6049250535332
2021-07-25,52685,51,43818,43,8867,8,47990,44,359928,320,407918,364,3,652,5,1477,686,1,"Knox County",470313,156.066279265085,0.151942446043165,77.3952665565272,10.8438422922607,15.1942446043165
2021-07-24,52634,65,43775,44,8859,21,47946,45,359608,348,407554,393,0,649,1,1472,685,2,"Knox County",470313,147.986553635558,0.148485739488386,83.5613729580088,13.8205833136656,14.8485739488386
2021-07-23,52569,55,43731,30,8838,25,47901,32,359260,321,407161,353,1,649,3,1471,683,1,"Knox County",470313,134.591219039236,0.134175691937425,75.0563986111377,11.6943397269478,13.4175691937425
2021-07-22,52514,95,43701,70,8813,25,47869,79,358939,474,406808,553,0,648,3,1468,682,0,"Knox County",470313,129.700858789785,0.137142857142857,117.581270345493,20.1993140738189,13.7142857142857
2021-07-21,52419,61,43631,47,8788,14,47790,46,358465,411,406255,457,1,648,1,1465,682,0,"Knox County",470313,115.029778041432,0.129441624365482,97.1693319130026,12.9700858789785,12.9441624365482
2021-07-20,52358,77,43584,42,8774,35,47744,44,358054,299,405798,343,0,647,3,1464,682,0,"Knox County",470313,106.524803694561,0.126373626373626,72.9301550244199,16.3720756177269,12.6373626373626
2021-07-19,52281,48,43542,36,8739,12,47700,41,357755,348,405455,389,0,647,0,1461,682,0,"Knox County",470313,96.1062101196437,0.116058906030856,82.7108755233217,10.2059692162454,11.6058906030856
2021-07-18,52233,36,43506,30,8727,6,47659,31,357407,271,405066,302,0,647,1,1461,682,1,"Knox County",470313,92.916844739567,0.113978494623656,64.212556318877,7.65447691218401,11.3978494623656
2021-07-17,52197,29,43476,22,8721,7,47628,23,357136,202,404764,225,0,647,1,1460,681,0,"Knox County",470313,85.262367827383,0.112890922959573,47.8404807011501,6.16610640148157,11.2890922959573
2021-07-16,52168,37,43454,21,8714,16,47605,22,356934,291,404539,313,0,647,1,1459,681,0,"Knox County",470313,81.435129371291,0.110766847405112,66.5514242642666,7.86710127085579,11.0766847405112
2021-07-15,52131,55,43433,42,8698,13,47583,44,356643,364,404226,408,-1,647,1,1458,681,0,"Knox County",470313,72.9301550244199,0.10299548625359,86.7507383380855,11.6943397269478,10.299548625359
2021-07-14,52076,21,43391,17,8685,4,47539,16,356279,269,403818,285,0,648,2,1457,681,0,"Knox County",470313,64.4251806775488,0.0975717439293598,60.5979422214568,4.46511153210734,9.75717439293598
2021-07-13,52055,42,43374,26,8681,16,47523,29,356010,355,403533,384,3,648,3,1455,681,0,"Knox County",470313,56.9833281240365,0.0893321769297485,81.6477537299628,8.93022306421468,8.93321769297485
2021-07-12,52013,28,43348,22,8665,6,47494,24,355655,270,403149,294,0,645,1,1452,681,1,"Knox County",470313,52.730840950601,0.0854816824966079,62.5115614495028,5.95348204280979,8.54816824966079
2021-07-11,51985,8,43326,3,8659,5,47470,4,355385,136,402855,140,0,645,0,1451,680,0,"Knox County",470313,46.7773589077912,0.0790629575402635,29.7674102140489,1.70099486937423,7.90629575402635
2021-07-10,51977,20,43323,16,8654,4,47466,16,355249,191,402715,207,0,645,2,1451,680,0,"Knox County",470313,44.8637396797452,0.0763170851797144,44.0132422450581,4.25248717343556,7.63170851797144
2021-07-09,51957,26,43307,20,8650,6,47450,20,355058,338,402508,358,0,645,0,1449,680,1,"Knox County",470313,42.5248717343556,0.0736994219653179,76.1195204044966,5.52823332546623,7.36994219653179
2021-07-08,51931,19,43287,14,8644,5,47430,16,354720,317,402150,333,0,645,0,1449,679,2,"Knox County",470313,34.8703948221716,0.0624687656171914,70.8039114377021,4.03986281476378,6.24687656171914
2021-07-07,51912,18,43273,5,8639,13,47414,5,354403,333,401817,338,1,645,1,1449,677,0,"Knox County",470313,34.2325217461563,0.0555014605647517,71.867033231061,3.82723845609201,5.55014605647517
2021-07-06,51894,24,43268,9,8626,15,47409,13,354070,263,401479,276,0,644,2,1448,677,0,"Knox County",470313,30.4052832900643,0.0503597122302158,58.6843229934108,5.10298460812268,5.03597122302158
2021-07-05,51870,10,43259,7,8611,3,47396,6,353807,105,401203,111,0,644,1,1446,677,0,"Knox County",470313,26.5780448339723,0.0453771979580261,23.6013038125674,2.12624358671778,4.53771979580261
2021-07-04,51860,8,43252,7,8608,1,47390,7,353702,143,401092,150,0,644,1,1445,677,0,"Knox County",470313,26.5780448339723,0.0468133107727016,31.8936538007667,1.70099486937423,4.68133107727016
2021-07-03,51852,9,43245,7,8607,2,47383,7,353559,184,400942,191,0,644,1,1444,677,0,"Knox County",470313,24.2391768885827,0.0421172453044963,40.6112525063096,1.913619228046,4.21172453044963
2021-07-02,51843,17,43238,13,8605,4,47376,17,353375,342,400751,359,-1,644,0,1443,677,0,"Knox County",470313,22.3255576605367,0.040386803185438,76.3321447631684,3.61461409742023,4.0386803185438
2021-07-01,51826,18,43225,15,8601,3,47359,17,353033,248,400392,265,-1,645,1,1443,677,0,"Knox County",470313,22.1129333018649,0.042603550295858,56.3454550480212,3.82723845609201,4.2603550295858
2021-06-30,51808,18,43210,12,8598,6,47342,11,352785,299,400127,310,0,646,0,1442,677,0,"Knox County",470313,22.1129333018649,0.0469314079422383,65.9135511882512,3.82723845609201,4.69314079422383
2021-06-29,51790,21,43198,16,8592,5,47331,19,352486,437,399817,456,0,646,1,1442,677,0,"Knox County",470313,21.4750602258496,0.0456026058631922,96.9567075543308,4.46511153210734,4.56026058631922
2021-06-28,51769,9,43182,2,8587,7,47312,2,352049,113,399361,115,0,646,0,1441,677,0,"Knox County",470313,21.2624358671778,0.0433369447453954,24.4518012472545,1.913619228046,4.33369447453954
2021-06-27,51760,5,43180,3,8580,2,47310,3,351936,151,399246,154,0,646,0,1441,677,0,"Knox County",470313,20.6245627911625,0.0410810810810811,32.7441512354538,1.06312179335889,4.10810810810811
2021-06-26,51755,3,43177,2,8578,1,47307,2,351785,206,399092,208,0,646,0,1441,677,0,"Knox County",470313,19.3488166391318,0.0380289234065345,44.2258666037299,0.637873076015334,3.80289234065345
2021-06-25,51752,13,43175,9,8577,4,47305,11,351579,311,398884,322,0,646,0,1441,677,0,"Knox County",470313,18.4983192044447,0.0355191256830601,68.4650434923126,2.76411666273312,3.55191256830601
2021-06-24,51739,14,43166,9,8573,5,47294,10,351268,364,398562,374,1,646,1,1441,677,1,"Knox County",470313,17.6478217697576,0.0299123259412068,79.521510143245,2.97674102140489,2.99123259412068
2021-06-23,51725,13,43157,6,8568,7,47284,8,350904,282,398188,290,0,645,0,1440,676,1,"Knox County",470313,16.5846999763987,0.0286607608129234,61.6610640148157,2.76411666273312,2.86607608129234
2021-06-22,51712,14,43151,5,8561,9,47276,5,350622,247,397898,252,2,645,1,1440,675,1,"Knox County",470313,15.0963294656962,0.0239067055393586,53.5813383852881,2.97674102140489,2.39067055393586
2021-06-21,51698,9,43146,8,8552,1,47271,9,350375,289,397646,298,0,643,1,1439,674,0,"Knox County",470313,15.0963294656962,0.0252897787144362,63.3620588841899,1.913619228046,2.52897787144363
2021-06-20,51689,3,43138,2,8551,1,47262,3,350086,161,397348,164,1,643,0,1438,674,0,"Knox County",470313,14.6710807483527,0.0251572327044025,34.8703948221716,0.637873076015334,2.51572327044025
2021-06-19,51686,3,43136,1,8550,2,47259,1,349925,191,397184,192,0,642,0,1438,674,0,"Knox County",470313,14.6710807483527,0.0248414376321353,40.8238768649814,0.637873076015334,2.48414376321353
2021-06-18,51683,5,43135,3,8548,2,47258,3,349734,283,396992,286,1,642,0,1438,674,0,"Knox County",470313,12.9700858789785,0.0210129310344828,60.8105665801286,1.06312179335889,2.10129310344828
2021-06-17,51678,12,43132,8,8546,4,47255,9,349451,515,396706,524,0,641,0,1438,674,1,"Knox County",470313,12.5448371616349,0.0189431704885344,111.415163944012,2.55149230406134,1.89431704885344
2021-06-16,51666,7,43124,4,8542,3,47246,4,348936,362,396182,366,1,641,0,1438,673,0,"Knox County",470313,11.2690910096042,0.0163304514889529,77.8205152738708,1.48837051070245,1.63304514889529
2021-06-15,51659,13,43120,9,8539,4,47242,14,348574,428,395816,442,0,640,0,1438,673,0,"Knox County",470313,11.0564666509325,0.0189260563380282,93.9799665329259,2.76411666273312,1.89260563380282
2021-06-14,51646,7,43111,2,8535,5,47228,3,348146,259,395374,262,1,640,0,1438,673,0,"Knox County",470313,10.6312179335889,0.0165474060822898,55.7075819720059,1.48837051070245,1.65474060822898
2021-06-13,51639,3,43109,3,8530,0,47225,4,347887,128,395112,132,0,639,1,1438,673,0,"Knox County",470313,10.6312179335889,0.0172413793103448,28.0664153446747,0.637873076015334,1.72413793103448
2021-06-12,51636,2,43106,1,8530,1,47221,1,347759,226,394980,227,0,639,0,1437,673,1,"Knox County",470313,10.4185935749171,0.0169718624385887,48.2657294184936,0.425248717343556,1.69718624385887
2021-06-11,51634,7,43105,3,8529,4,47220,2,347533,317,394753,319,0,639,0,1437,672,1,"Knox County",470313,10.8438422922607,0.0162852112676056,67.8271704162972,1.48837051070245,1.62852112676056
2021-06-10,51627,7,43102,4,8525,3,47218,5,347216,358,394434,363,0,639,0,1437,671,0,"Knox County",470313,9.7807204989018,0.0156324017053529,77.1826421978555,1.48837051070245,1.56324017053529
2021-06-09,51620,2,43098,1,8522,1,47213,1,346858,367,394071,368,1,639,0,1437,671,1,"Knox County",470313,8.7175987055429,0.0141978230004733,78.2457639912144,0.425248717343556,1.41978230004733
2021-06-08,51618,5,43097,3,8521,2,47212,4,346491,266,393703,270,1,638,0,1437,670,1,"Knox County",470313,7.01660383616868,0.0103039670273055,57.4085768413801,1.06312179335889,1.03039670273055
2021-06-07,51613,16,43094,10,8519,6,47208,10,346225,316,393433,326,0,637,2,1437,669,0,"Knox County",470313,8.93022306421468,0.0134663341645885,69.3155409269997,3.40198973874845,1.34663341645885
2021-06-06,51597,4,43084,2,8513,2,47198,2,345909,178,393107,180,0,637,0,1435,669,1,"Knox County",470313,9.14284742288646,0.0121773015099854,38.2723845609201,0.850497434687113,1.21773015099854
2021-06-05,51593,5,43082,2,8511,3,47196,3,345731,258,392927,261,0,637,0,1435,668,0,"Knox County",470313,9.7807204989018,0.0129372304743651,55.4949576133341,1.06312179335889,1.29372304743651
2021-06-04,51588,7,43080,2,8508,5,47193,3,345473,325,392666,328,1,637,0,1435,668,0,"Knox County",470313,9.7807204989018,0.0133587786259542,69.7407896443432,1.48837051070245,1.33587786259542
2021-06-03,51581,7,43078,4,8503,3,47190,6,345148,458,392338,464,0,636,0,1435,668,0,"Knox County",470313,9.7807204989018,0.0131998179335457,98.6577024237051,1.48837051070245,1.31998179335457
2021-06-02,51574,20,43074,7,8500,13,47184,6,344690,282,391874,288,0,636,1,1435,668,0,"Knox County",470313,13.6079589549938,0.0160604629192253,61.2358152974721,4.25248717343556,1.60604629192253
2021-06-01,51554,12,43067,9,8487,3,47178,10,344408,291,391586,301,0,636,1,1434,668,0,"Knox County",470313,15.0963294656962,0.0186219739292365,63.9999319602052,2.55149230406134,1.86219739292365
2021-05-31,51542,17,43058,14,8484,3,47168,12,344117,353,391285,365,0,636,0,1433,668,0,"Knox County",470313,15.308953824368,0.0192043895747599,77.607890915199,3.61461409742023,1.92043895747599
2021-05-30,51525,3,43044,1,8481,2,47156,1,343764,203,390920,204,0,636,0,1433,668,1,"Knox County",470313,15.0963294656962,0.018543645409317,43.3753691690427,0.637873076015334,1.8543645409317
2021-05-29,51522,14,43043,8,8479,6,47155,6,343561,199,390716,205,0,636,1,1433,667,2,"Knox County",470313,17.0099486937423,0.0204176334106729,43.5879935277145,2.97674102140489,2.04176334106729
2021-05-28,51508,10,43035,6,8473,4,47149,10,343362,390,390511,400,0,636,1,1432,665,0,"Knox County",470313,17.6478217697576,0.0229007633587786,85.0497434687113,2.12624358671778,2.29007633587786
2021-05-27,51498,23,43029,8,8469,15,47139,9,342972,341,390111,350,0,636,1,1431,665,0,"Knox County",470313,21.049811508506,0.0255560814008519,74.4185255351224,4.8903602494509,2.55560814008519
2021-05-26,51475,16,43021,8,8454,8,47130,11,342631,572,389761,583,0,636,0,1430,665,0,"Knox County",470313,20.1993140738189,0.0245016611295681,123.960001105647,3.40198973874845,2.45016611295681
2021-05-25,51459,18,43013,8,8446,10,47119,7,342059,311,389178,318,0,636,1,1430,665,0,"Knox County",470313,21.4750602258496,0.0230927835051546,67.6145460576254,3.82723845609201,2.30927835051546
2021-05-24,51441,25,43005,21,8436,4,47112,24,341748,425,388860,449,0,636,1,1429,665,1,"Knox County",470313,23.1760550952238,0.027102431247509,95.4683370436284,5.31560896679445,2.7102431247509
2021-05-23,51416,16,42984,8,8432,8,47088,8,341323,225,388411,233,1,636,1,1428,664,1,"Knox County",470313,25.9401717579569,0.0295508274231678,49.5414755705243,3.40198973874845,2.95508274231678
2021-05-22,51400,8,42976,4,8424,4,47080,4,341098,269,388178,273,0,635,0,1427,663,0,"Knox County",470313,24.6644256059263,0.0280122793553338,58.0464499173954,1.70099486937423,2.80122793553338
2021-05-21,51392,15,42972,11,8420,4,47076,13,340829,377,387905,390,0,635,1,1427,663,1,"Knox County",470313,25.7275473992852,0.0292758089368259,82.9234998819935,3.18936538007667,2.92758089368259
2021-05-20,51377,34,42961,26,8416,8,47063,27,340452,594,387515,621,0,635,1,1426,662,1,"Knox County",470313,28.0664153446747,0.0327868852459016,132.039726735174,7.22922819484046,3.27868852459016
2021-05-19,51343,14,42935,6,8408,8,47036,6,339858,544,386894,550,0,635,1,1425,661,0,"Knox County",470313,27.6411666273312,0.0314043754410727,116.943397269478,2.97674102140489,3.14043754410727
2021-05-18,51329,24,42929,14,8400,10,47030,14,339314,444,386344,458,1,635,0,1424,661,1,"Knox County",470313,28.9169127793618,0.0322797579018157,97.3819562716744,5.10298460812268,3.22797579018157
2021-05-17,51305,15,42915,8,8390,7,47016,8,338870,420,385886,428,0,634,0,1424,660,0,"Knox County",470313,26.790669192644,0.0270910938029123,91.003225511521,3.18936538007667,2.70910938029123
2021-05-16,51290,22,42907,13,8383,9,47008,12,338450,272,385458,284,1,634,1,1424,660,1,"Knox County",470313,28.0664153446747,0.0279627163781625,60.385317862785,4.67773589077912,2.79627163781625
2021-05-15,51268,23,42894,13,8374,10,46996,17,338178,336,385174,353,0,633,2,1423,659,1,"Knox County",470313,31.2557807247514,0.0314526588845655,75.0563986111377,4.8903602494509,3.14526588845655
2021-05-14,51245,36,42881,25,8364,11,46979,26,337842,498,384821,524,0,633,4,1421,658,0,"Knox County",470313,35.7208922568587,0.0341827221876942,111.415163944012,7.65447691218401,3.41827221876942
2021-05-13,51209,31,42856,17,8353,14,46953,17,337344,376,384297,393,0,633,0,1417,658,0,"Knox County",470313,35.0830191808434,0.0334448160535117,83.5613729580088,6.59135511882512,3.34448160535117
2021-05-12,51178,34,42839,28,8339,6,46936,26,336968,506,383904,532,0,633,0,1417,658,0,"Knox County",470313,39.335506354279,0.0403768506056528,113.116158813386,7.22922819484046,4.03768506056528
2021-05-11,51144,36,42811,30,8333,6,46910,31,336462,555,383372,586,0,633,4,1417,658,0,"Knox County",470313,41.8869986583403,0.0441935483870968,124.597874181662,7.65447691218401,4.41935483870968
2021-05-10,51108,21,42781,14,8327,7,46879,13,335907,277,382786,290,1,633,1,1413,658,1,"Knox County",470313,43.162744810371,0.0479405806887238,61.6610640148157,4.46511153210734,4.79405806887238
2021-05-09,51087,17,42767,14,8320,3,46866,17,335630,369,382496,386,0,632,1,1412,657,0,"Knox County",470313,42.0996230170121,0.047976501305483,82.0730024473064,3.61461409742023,4.7976501305483
2021-05-08,51070,20,42753,11,8317,9,46849,14,335261,307,382110,321,0,632,1,1411,657,0,"Knox County",470313,41.4617499409967,0.0474934036939314,68.2524191336408,4.25248717343556,4.74934036939314
2021-05-07,51050,43,42742,31,8308,12,46835,33,334954,576,381789,609,0,632,0,1410,657,0,"Knox County",470313,42.9501204516992,0.0484440166827077,129.488234431113,9.14284742288646,4.84440166827077
2021-05-06,51007,40,42711,26,8296,14,46802,28,334378,340,381180,368,1,632,0,1410,657,1,"Knox County",470313,44.8637396797452,0.0523932729624838,78.2457639912144,8.50497434687113,5.23932729624838
2021-05-05,50967,51,42685,32,8282,19,46774,38,334038,585,380812,623,0,631,4,1410,656,0,"Knox County",470313,48.4783537771654,0.0546654099905749,132.464975452518,10.8438422922607,5.46654099905749
2021-05-04,50916,50,42653,32,8263,18,46736,34,333453,536,380189,570,0,631,0,1406,656,0,"Knox County",470313,51.4550947985703,0.0558888538048626,121.195884442914,10.6312179335889,5.58888538048626
2021-05-03,50866,24,42621,9,8245,15,46702,7,332917,309,379619,316,1,631,1,1406,656,1,"Knox County",470313,52.0929678745856,0.053554650798622,67.1892973402819,5.10298460812268,5.3554650798622
2021-05-02,50842,25,42612,18,8230,7,46695,20,332608,288,379303,308,0,630,2,1405,655,0,"Knox County",470313,53.7939627439599,0.0558587479935795,65.4883024709077,5.31560896679445,5.58587479935795
2021-05-01,50817,45,42594,35,8223,10,46675,37,332320,450,378995,487,0,630,2,1403,655,0,"Knox County",470313,59.1095717107543,0.060042669917708,103.548062673156,9.56809614023002,6.0042669917708
2021-04-30,50772,57,42559,30,8213,27,46638,29,331870,567,378508,596,0,630,3,1401,655,1,"Knox County",470313,62.0863127321592,0.0590575275397797,126.72411776838,12.1195884442914,5.90575275397797
2021-04-29,50715,54,42529,34,8186,20,46609,35,331303,571,377912,606,0,630,2,1398,654,0,"Knox County",470313,65.0630537535641,0.0570450656018254,128.850361355098,11.481715368276,5.70450656018254
2021-04-28,50661,47,42495,28,8166,19,46574,34,330732,543,377306,577,4,630,1,1396,654,2,"Knox County",470313,64.212556318877,0.0566473988439306,122.684254953616,9.99334485757357,5.66473988439306
2021-04-27,50614,39,42467,17,8147,22,46540,20,330189,392,376729,412,1,626,2,1395,652,1,"Knox County",470313,61.8736883734874,0.0551181102362205,87.6012357727726,8.29234998819935,5.51181102362205
2021-04-26,50575,69,42450,36,8125,33,46520,40,329797,480,376317,520,1,625,0,1393,651,2,"Knox County",470313,71.4417845137175,0.0613234455219624,110.564666509325,14.6710807483527,6.13234455219624
2021-04-25,50506,37,42414,24,8092,13,46480,25,329317,341,375797,366,0,624,3,1393,649,0,"Knox County",470313,73.9932768177788,0.0617283950617284,77.8205152738708,7.86710127085579,6.17283950617284
2021-04-24,50469,35,42390,22,8079,13,46455,28,328976,509,375431,537,0,624,3,1390,649,1,"Knox County",470313,71.867033231061,0.0583840619811843,114.179280606745,7.44185255351224,5.83840619811843
2021-04-23,50434,42,42368,31,8066,11,46427,36,328467,553,374894,589,0,624,2,1387,648,1,"Knox County",470313,68.6776678509843,0.0604380371499861,125.235747257677,8.93022306421468,6.04380371499861
2021-04-22,50392,78,42337,61,8055,17,46391,64,327914,787,374305,851,1,624,1,1385,647,1,"Knox County",470313,73.780652459107,0.064122533748702,180.943329229683,16.5846999763987,6.4122533748702
2021-04-21,50314,62,42276,34,8038,28,46327,34,327127,479,373454,513,1,623,1,1384,646,1,"Knox County",470313,76.9700178391837,0.0652059134107709,109.076295998622,13.1827102376502,6.52059134107709
2021-04-20,50252,38,42242,34,8010,4,46293,38,326648,474,372941,512,1,622,1,1383,645,1,"Knox County",470313,76.7573934805119,0.0681584362139918,108.86367163995,8.07972562952757,6.81584362139918
2021-04-19,50214,64,42208,40,8006,24,46255,39,326174,336,372429,375,0,621,0,1382,644,0,"Knox County",470313,75.694271687153,0.070531659096981,79.7341345019168,13.6079589549938,7.0531659096981
2021-04-18,50150,38,42168,27,7982,11,46216,32,325838,364,372054,396,0,621,1,1382,644,1,"Knox County",470313,75.9068960458248,0.0718261330506229,84.1992460340241,8.07972562952757,7.18261330506229
2021-04-17,50112,37,42141,18,7971,19,46184,23,325474,335,371658,358,0,621,1,1381,643,0,"Knox County",470313,76.3321447631684,0.0740122426265999,76.1195204044966,7.86710127085579,7.40122426265999
2021-04-16,50075,345,42123,329,7952,16,46161,369,325139,2088,371300,2457,1,621,4,1380,643,1,"Knox County",470313,140.757325440717,0.10966678872208,522.418049256559,73.3554037417635,10.966678872208
2021-04-15,49730,86,41794,54,7936,32,45792,55,323051,577,368843,632,1,620,0,1376,642,1,"Knox County",470313,142.458320310091,0.112530993705894,134.378594680564,18.2856948457729,11.2530993705894
2021-04-14,49644,84,41740,59,7904,25,45737,61,322474,684,368211,745,0,619,3,1376,641,0,"Knox County",470313,147.13605620087,0.112694063926941,158.405147210475,17.8604461284294,11.2694063926941
2021-04-13,49560,68,41681,38,7879,30,45676,43,321790,339,367466,382,-5,619,1,1373,641,0,"Knox County",470313,153.514786961024,0.116370439663237,81.2225050126193,14.4584563896809,11.6370439663237
2021-04-12,49492,63,41643,43,7849,20,45633,50,321451,360,367084,410,1,624,0,1372,641,1,"Knox County",470313,153.302162602352,0.117657992565056,87.175987055429,13.395334596322,11.7657992565056
2021-04-11,49429,26,41600,15,7829,11,45583,14,321091,296,366674,310,2,623,0,1372,640,0,"Knox County",470313,150.750670298291,0.116169248205516,65.9135511882512,5.52823332546623,11.6169248205516
2021-04-10,49403,50,41585,33,7818,17,45569,41,320795,571,366364,612,0,621,1,1372,640,1,"Knox County",470313,153.514786961024,0.114095169430425,130.126107507128,10.6312179335889,11.4095169430425
2021-04-09,49353,82,41552,62,7801,20,45528,71,320224,620,365752,691,5,621,2,1371,639,0,"Knox County",470313,97.5945806303462,0.0885774722369117,146.923431842199,17.4351974110858,8.85774722369117
2021-04-08,49271,49,41490,26,7781,23,45457,25,319604,465,365061,490,-6,616,0,1369,639,1,"Knox County",470313,89.7274793594904,0.0837912087912088,104.185935749171,10.4185935749171,8.37912087912088
2021-04-07,49222,76,41464,53,7758,23,45432,57,319139,767,364571,824,2,622,1,1369,638,0,"Knox County",470313,88.0264844901162,0.0809357354127454,175.202471545545,16.1594512590551,8.09357354127454
2021-04-06,49146,73,41411,40,7735,33,45375,44,318372,419,363747,463,2,620,0,1368,638,0,"Knox County",470313,89.089606283475,0.0794736842105263,98.4450780650333,15.5215781830398,7.94736842105263
2021-04-05,49073,44,41371,32,7702,12,45331,35,317953,266,363284,301,0,618,3,1368,638,2,"Knox County",470313,85.0497434687113,0.0777567054998645,63.9999319602052,9.35547178155824,7.77567054998645
2021-04-04,49029,49,41339,31,7690,18,45296,40,317687,341,362983,381,3,618,0,1365,636,1,"Knox County",470313,89.9401037181622,0.0832004253056885,81.0098806539475,10.4185935749171,8.32004253056885
2021-04-03,48980,80,41308,63,7672,17,45256,70,317346,593,362602,663,0,615,0,1365,635,3,"Knox County",470313,96.3188344783155,0.0896931549960661,140.969949799389,17.0099486937423,8.96931549960661
2021-04-02,48900,73,41245,43,7655,30,45186,44,316753,529,361939,573,0,615,2,1365,632,2,"Knox County",470313,94.4052152502695,0.0852503382949932,121.833757518929,15.5215781830398,8.52503382949932
2021-04-01,48827,76,41202,64,7625,12,45142,67,316224,580,361366,647,1,615,1,1363,630,0,"Knox County",470313,100.146072934408,0.0926791277258567,137.56796006064,16.1594512590551,9.26791277258567
2021-03-31,48751,86,41138,65,7613,21,45075,71,315644,765,360719,836,3,614,2,1362,630,2,"Knox County",470313,102.272316521125,0.0960144927536232,177.753963849607,18.2856948457729,9.60144927536232
2021-03-30,48665,56,41073,32,7592,24,45004,38,314879,460,359883,498,1,611,2,1360,628,2,"Knox County",470313,98.6577024237051,0.0936137471146448,105.886930618546,11.9069640856196,9.36137471146448
2021-03-29,48609,42,41041,21,7568,21,44966,22,314419,399,359385,421,5,610,0,1358,626,1,"Knox County",470313,98.2324537063615,0.087583976113461,89.5148550008186,8.93022306421468,8.7583976113461
2021-03-28,48567,80,41020,46,7547,34,44944,49,314020,484,358964,533,2,605,5,1358,625,2,"Knox County",470313,104.823808825187,0.086549988012467,113.328783172058,17.0099486937423,8.6549988012467
2021-03-27,48487,43,40974,40,7513,3,44895,42,313536,442,358431,484,0,603,2,1353,623,2,"Knox County",470313,96.9567075543308,0.0834168336673347,102.910189597141,9.14284742288646,8.34168336673347
2021-03-26,48444,79,40934,54,7510,25,44853,60,313094,416,357947,476,0,603,2,1351,621,2,"Knox County",470313,98.2324537063615,0.089602053915276,101.209194727766,16.7973243350705,8.9602053915276
2021-03-25,48365,87,40880,63,7485,24,44793,67,312678,570,357471,637,0,603,4,1349,619,1,"Knox County",470313,100.571321651751,0.0898326898326898,135.441716473923,18.4983192044447,8.98326898326898
2021-03-24,48278,123,40817,93,7461,30,44726,95,312108,780,356834,875,1,603,3,1345,618,1,"Knox County",470313,108.438422922607,0.0950560652395515,186.046313837806,26.1527961166287,9.50560652395515
2021-03-23,48155,88,40724,58,7431,30,44631,63,311328,530,355959,593,1,602,3,1342,617,1,"Knox County",470313,115.242402400104,0.0990296093555611,126.086244692364,18.7109435631165,9.90296093555611
2021-03-22,48067,111,40666,77,7401,34,44568,79,310798,516,355366,595,2,601,1,1339,616,0,"Knox County",470313,129.913483148456,0.108514190317195,126.511493409708,23.6013038125674,10.8514190317195
2021-03-21,47956,50,40589,33,7367,17,44489,34,310282,330,354771,364,-3,599,1,1338,616,1,"Knox County",470313,123.534752388303,0.10934393638171,77.3952665565272,10.6312179335889,10.934393638171
2021-03-20,47906,59,40556,29,7350,30,44455,33,309952,315,354407,348,0,602,4,1337,615,0,"Knox County",470313,126.936742127052,0.110853909465021,73.9932768177788,12.5448371616349,11.0853909465021
2021-03-19,47847,146,40527,102,7320,44,44422,116,309637,955,354059,1071,3,602,3,1333,615,1,"Knox County",470313,141.182574158061,0.108632612090118,227.720688137474,31.0431563660796,10.8632612090118
2021-03-18,47701,68,40425,50,7276,18,44306,66,308682,627,352988,693,2,599,1,1330,614,0,"Knox County",470313,137.142711343297,0.107072042300066,147.348680559542,14.4584563896809,10.7072042300066
2021-03-17,47633,46,40375,36,7258,10,44240,41,308055,498,352295,539,1,597,3,1329,614,2,"Knox County",470313,120.77063572557,0.102783725910064,114.604529324088,9.7807204989018,10.2783725910064
2021-03-16,47587,128,40339,84,7248,44,44199,100,307557,698,351756,798,0,596,3,1326,612,1,"Knox County",470313,129.275610072441,0.106397459165154,169.674238220079,27.2159179099876,10.6397459165154
2021-03-15,47459,43,40255,28,7204,15,44099,39,306859,290,350958,329,1,596,1,1323,611,1,"Knox County",470313,114.81715368276,0.103573153066152,69.953414003015,9.14284742288646,10.3573153066152
2021-03-14,47416,59,40227,37,7189,22,44060,46,306569,405,350629,451,0,595,0,1322,610,0,"Knox County",470313,116.730772910806,0.104279971624498,95.893585760972,12.5448371616349,10.4279971624498
2021-03-13,47357,70,40190,33,7167,37,44014,40,306164,623,350178,663,1,595,1,1322,610,2,"Knox County",470313,119.069640856196,0.0985915492957746,140.969949799389,14.8837051070245,9.85915492957746
2021-03-12,47287,63,40157,60,7130,3,43974,67,305541,691,349515,758,0,594,1,1321,608,2,"Knox County",470313,101.421819086438,0.0943039470574332,161.169263873208,13.395334596322,9.43039470574332
2021-03-11,47224,80,40097,53,7127,27,43907,64,304850,627,348757,691,2,594,0,1320,606,1,"Knox County",470313,103.9733113905,0.0938756207141168,146.923431842199,17.0099486937423,9.38756207141168
2021-03-10,47144,94,40044,71,7100,23,43843,81,304223,1001,348066,1082,2,592,0,1320,605,0,"Knox County",470313,114.179280606745,0.0915758591785415,230.059556082864,19.9866897151471,9.15758591785415
2021-03-09,47050,80,39973,50,7077,30,43762,55,303222,597,346984,652,0,590,2,1320,605,5,"Knox County",470313,103.9733113905,0.0847384349329875,138.631081853999,17.0099486937423,8.47384349329875
2021-03-08,46970,85,39923,57,7047,28,43707,62,302625,412,346332,474,1,590,0,1318,600,2,"Knox County",470313,112.903534454714,0.0869838608258227,100.783946010423,18.0730704871011,8.69838608258227
2021-03-07,46885,62,39866,39,7019,23,43645,41,302213,327,345858,368,0,589,0,1318,598,0,"Knox County",470313,113.54140753073,0.087457337883959,78.2457639912144,13.1827102376502,8.7457337883959
2021-03-06,46823,122,39827,85,6996,37,43604,94,301886,848,345490,942,0,589,1,1318,598,0,"Knox County",470313,124.597874181662,0.0934165492248842,200.292145868815,25.9401717579569,9.34165492248842
2021-03-05,46701,69,39742,43,6959,26,43510,48,301038,520,344548,568,2,589,2,1317,598,2,"Knox County",470313,125.873620333693,0.0931546996022608,120.77063572557,14.6710807483527,9.31546996022608
2021-03-04,46632,112,39699,85,6933,27,43462,99,300518,1094,343980,1193,5,587,2,1315,596,2,"Knox County",470313,132.67759981119,0.0909263118014775,253.660859895431,23.8139281712392,9.09263118014776
2021-03-03,46520,70,39614,29,6906,41,43363,36,299424,497,342787,533,1,582,4,1313,594,1,"Knox County",470313,127.574615203067,0.0919661733615222,113.328783172058,14.8837051070245,9.19661733615222
2021-03-02,46450,133,39585,91,6865,42,43327,99,298927,807,342254,906,-1,581,2,1309,593,5,"Knox County",470313,138.843706212671,0.096107544141252,192.637668956631,28.2790397033465,9.6107544141252
2021-03-01,46317,56,39494,30,6823,26,43228,33,298120,165,341348,198,1,582,1,1307,588,0,"Knox County",470313,132.67759981119,0.0955819881053526,42.0996230170121,11.9069640856196,9.55819881053526
2021-02-28,46261,77,39464,53,6797,24,43195,63,297955,563,341150,626,2,581,2,1306,588,1,"Knox County",470313,135.866965191266,0.0950463149416029,133.102848528533,16.3720756177269,9.50463149416029
2021-02-27,46184,82,39411,47,6773,35,43132,59,297392,670,340524,729,1,579,3,1304,587,1,"Knox County",470313,127.361990844395,0.09194193141174,155.003157471726,17.4351974110858,9.194193141174
2021-02-26,46102,105,39364,69,6738,36,43073,80,296722,505,339795,585,5,578,1,1301,586,0,"Knox County",470313,135.016467756579,0.0983228511530398,124.38524982299,22.3255576605367,9.83228511530398
2021-02-25,45997,131,39295,92,6702,39,42993,98,296217,1028,339210,1126,2,573,5,1300,586,1,"Knox County",470313,139.056330571343,0.099510950457155,239.415027864422,27.8537909860029,9.9510950457155
2021-02-24,45866,100,39203,70,6663,30,42895,78,295189,969,338084,1047,2,571,2,1295,585,1,"Knox County",470313,145.435061331496,0.097757331799885,222.617703529352,21.2624358671778,9.7757331799885
2021-02-23,45766,115,39133,61,6633,54,42817,68,294220,758,337037,826,5,569,6,1293,584,2,"Knox County",470313,141.607822875404,0.0932450846797742,175.627720262889,24.4518012472545,9.32450846797742
2021-02-22,45651,60,39072,31,6579,29,42749,37,293462,306,336211,343,3,564,3,1287,582,2,"Knox County",470313,142.458320310091,0.0914426353653919,72.9301550244199,12.7574615203067,9.14426353653919
2021-02-21,45591,82,39041,41,6550,41,42712,45,293156,499,335868,544,2,561,3,1284,580,3,"Knox County",470313,143.52144210345,0.0894230769230769,115.667651117447,17.4351974110858,8.94230769230769
2021-02-20,45509,137,39000,98,6509,39,42667,115,292657,1007,335324,1122,1,559,2,1281,577,1,"Knox County",470313,155.215781830398,0.0931521544788128,238.564530429735,29.1295371380336,9.31521544788128
2021-02-19,45372,93,38902,41,6470,52,42552,46,291650,274,334202,320,1,558,2,1279,576,2,"Knox County",470313,152.664289526337,0.0914039039039039,68.039794774969,19.7740653564754,9.14039039039039
2021-02-18,45279,147,38861,104,6418,43,42506,113,291376,987,333882,1100,4,557,5,1277,574,6,"Knox County",470313,156.066279265085,0.0946812523576009,233.886794538956,31.2557807247514,9.46812523576009
2021-02-17,45132,113,38757,68,6375,45,42393,76,290389,891,332782,967,1,553,4,1272,568,3,"Knox County",470313,158.830395927818,0.0957487552661815,205.607754835609,24.0265525299109,9.57487552661815
2021-02-16,45019,145,38689,90,6330,55,42317,102,289498,818,331815,920,2,552,4,1268,565,0,"Knox County",470313,165.209126687972,0.100451467268623,195.614409978036,30.8305320074078,10.0451467268623
2021-02-15,44874,74,38599,35,6275,39,42215,44,288680,312,330895,356,2,550,1,1264,565,1,"Knox County",470313,168.185867709377,0.101519984987803,75.694271687153,15.7342025417116,10.1519984987803
2021-02-14,44800,162,38564,132,6236,30,42171,134,288368,706,330539,840,2,548,5,1263,564,1,"Knox County",470313,185.195816403119,0.112,178.604461284294,34.4451461048281,11.2
2021-02-13,44638,133,38432,89,6206,44,42037,105,287662,870,329699,975,4,546,7,1258,563,4,"Knox County",470313,184.345318968432,0.113179992698065,207.308749704984,28.2790397033465,11.3179992698065
2021-02-12,44505,174,38343,109,6162,65,41932,119,286792,996,328724,1115,3,542,3,1251,559,1,"Knox County",470313,201.567892020846,0.110473457675753,237.076159919033,36.9966384088894,11.0473457675753
2021-02-11,44331,162,38234,112,6097,50,41813,117,285796,1132,327609,1249,5,539,5,1248,558,2,"Knox County",470313,204.757257400922,0.108533167237621,265.567823981051,34.4451461048281,10.8533167237621
2021-02-10,44169,147,38122,105,6047,42,41696,111,284664,1032,326360,1143,7,534,6,1243,556,2,"Knox County",470313,211.986485595763,0.110942709912095,243.029641961842,31.2557807247514,11.0942709912095
2021-02-09,44022,204,38017,149,6005,55,41585,160,283632,1022,325217,1182,0,527,6,1237,554,5,"Knox County",470313,224.531322757398,0.115160349854227,251.321991950042,43.3753691690427,11.5160349854227
2021-02-08,43818,103,37868,68,5950,35,41425,71,282610,371,324035,442,4,527,2,1231,549,3,"Knox County",470313,230.697429158879,0.117621652749784,93.9799665329259,21.9003089431931,11.7621652749784
2021-02-07,43715,109,37800,76,5915,33,41354,83,282239,716,323593,799,1,523,2,1229,546,1,"Knox County",470313,219.428338149275,0.110934105720492,169.886862578751,23.1760550952238,11.0934105720492
2021-02-06,43606,299,37724,173,5882,126,41271,194,281523,1396,322794,1590,2,522,6,1227,545,4,"Knox County",470313,254.72398168879,0.113696808510638,338.072730288127,63.5746832428617,11.3696808510638
2021-02-05,43307,173,37551,128,5756,45,41077,142,280127,727,321204,869,8,520,4,1221,541,3,"Knox County",470313,254.511357330118,0.120703876821556,184.770567685775,36.7840140502176,12.0703876821556
2021-02-04,43134,198,37423,148,5711,50,40935,158,279400,1581,320335,1739,2,512,7,1217,538,8,"Knox County",470313,262.165834242302,0.118366821226172,369.753759730222,42.0996230170121,11.8366821226172
2021-02-03,42936,228,37275,164,5661,64,40777,170,277819,1634,318596,1804,5,510,7,1210,530,0,"Knox County",470313,279.388407294717,0.116083086053412,383.574343043888,48.4783537771654,11.6083086053412
2021-02-02,42708,89,37111,68,5597,21,40607,76,276185,291,316792,367,7,505,1,1203,530,2,"Knox County",470313,254.936606047462,0.117477003942181,78.0331396325426,18.9235679217883,11.7477003942181
2021-02-01,42619,152,37043,83,5576,69,40531,97,275894,425,316425,522,4,498,2,1202,528,3,"Knox County",470313,265.355199622379,0.11963589076723,110.989915226668,32.3189025181103,11.963589076723
2021-01-31,42467,173,36960,119,5507,54,40434,127,275469,939,315903,1066,7,494,4,1200,525,2,"Knox County",470313,278.963158577373,0.12115118763353,226.657566344116,36.7840140502176,12.115118763353
2021-01-30,42294,275,36841,233,5453,42,40307,251,274530,1518,314837,1769,7,487,9,1196,523,6,"Knox County",470313,273.86017396925,0.125491642084562,376.132490490376,58.471698634739,12.5491642084562
2021-01-29,42019,101,36608,52,5411,49,40056,62,273012,376,313068,438,4,480,1,1187,517,5,"Knox County",470313,258.551220144882,0.122128487994809,93.1294690982388,21.4750602258496,12.2128487994809
2021-01-28,41918,156,36556,116,5362,40,39994,127,272636,656,312630,783,9,476,6,1186,512,4,"Knox County",470313,249.620997080668,0.13483479033931,166.484872840002,33.1693999527974,13.483479033931
2021-01-27,41762,169,36440,124,5322,45,39867,125,271980,893,311847,1018,12,467,3,1180,508,4,"Knox County",470313,237.076159919033,0.145061210799933,216.45159712787,35.9335166155305,14.5061210799933
2021-01-26,41593,230,36316,169,5277,61,39742,191,271087,1041,310829,1232,3,455,8,1177,504,7,"Knox County",470313,267.056194491753,0.143526654950205,261.953209883631,48.903602494509,14.3526654950205
2021-01-25,41363,157,36147,106,5216,51,39551,115,270046,415,309597,530,9,452,1,1169,497,4,"Knox County",470313,268.119316285112,0.145991808074898,112.690910096042,33.3820243114692,14.5991808074898
2021-01-24,41206,152,36041,101,5165,51,39436,109,269631,790,309067,899,4,443,2,1168,493,5,"Knox County",470313,263.654204753005,0.1469485680012,191.149298445929,32.3189025181103,14.69485680012
2021-01-23,41054,307,35940,220,5114,87,39327,231,268841,1492,308168,1723,7,439,7,1166,488,4,"Knox County",470313,270.458184230502,0.144949418692435,366.351769991474,65.2756781122359,14.4949418692435
2021-01-22,40747,178,35720,142,5027,36,39096,175,267349,1172,306445,1347,3,432,8,1159,484,8,"Knox County",470313,286.830259848229,0.142458842272969,286.405011130885,37.8471358435765,14.2458842272969
2021-01-21,40569,257,35578,187,4991,70,38921,199,266177,1078,305098,1277,11,429,5,1151,476,6,"Knox County",470313,308.305320074078,0.142661350610516,271.521306023861,54.644460178647,14.2661350610516
2021-01-20,40312,193,35391,132,4921,61,38722,131,265099,736,303821,867,10,418,8,1146,470,10,"Knox County",470313,313.408304682201,0.14615873015873,184.345318968432,41.0365012236532,14.615873015873
2021-01-19,40119,310,35259,195,4860,115,38591,218,264363,956,302954,1174,8,408,14,1138,460,4,"Knox County",470313,330.418253375943,0.150697198413714,249.620997080668,65.9135511882512,15.0697198413714
2021-01-18,39809,128,35064,79,4745,49,38373,85,263407,472,301780,557,7,400,4,1124,456,9,"Knox County",470313,324.252146974462,0.146353901070882,118.43176778018,27.2159179099876,14.6353901070882
2021-01-17,39681,180,34985,137,4696,43,38288,150,262935,690,301223,840,3,393,8,1120,447,6,"Knox County",470313,330.205629017271,0.152729608220938,178.604461284294,38.2723845609201,15.2729608220938
2021-01-16,39501,418,34848,338,4653,80,38138,387,262245,1757,300383,2144,1,390,7,1112,441,8,"Knox County",470313,353.806932829839,0.163904460151109,455.866624992292,88.8769819248033,16.3904460151109
2021-01-15,39083,187,34510,149,4573,38,37751,153,260488,755,298239,908,0,389,4,1105,433,10,"Knox County",470313,355.720552057885,0.170336037079954,193.062917673975,39.7607550716225,17.0336037079954
2021-01-14,38896,334,34361,264,4535,70,37598,288,259733,1480,297331,1768,6,389,8,1101,423,7,"Knox County",470313,372.092627675612,0.170985710825866,375.919866131704,71.0165357963739,17.0985710825866
2021-01-13,38562,243,34097,195,4465,48,37310,201,258253,946,295563,1147,12,383,6,1093,416,2,"Knox County",470313,382.723845609201,0.173576950105411,243.88013939653,51.6677191572421,17.3576950105411
2021-01-12,38319,330,33902,259,4417,71,37109,281,257307,1180,294416,1461,10,371,6,1087,414,5,"Knox County",470313,386.976332782636,0.175070821529745,310.644188019468,70.1660383616868,17.5070821529745
2021-01-11,37989,243,33643,196,4346,47,36828,228,256127,726,292955,954,4,361,5,1081,409,6,"Knox County",470313,411.428134029891,0.183040555194101,202.843638172876,51.6677191572421,18.3040555194101
2021-01-10,37746,324,33447,203,4299,121,36600,220,255401,1013,292001,1233,5,357,17,1076,403,6,"Knox County",470313,442.046041678627,0.182839313572543,262.165834242302,68.8902922096561,18.2839313572543
2021-01-09,37422,467,33244,386,4178,81,36380,421,254388,1383,290768,1804,5,352,11,1059,397,2,"Knox County",470313,452.464635253544,0.193207547169811,383.574343043888,99.2955754997204,19.3207547169811
2021-01-08,36955,453,32858,365,4097,88,35959,387,253005,1432,288964,1819,7,347,6,1048,395,8,"Knox County",470313,509.022714660237,0.198900451600236,386.763708423964,96.3188344783155,19.8900451600236
2021-01-07,36502,379,32493,337,4009,42,35572,348,251573,1309,287145,1657,10,340,9,1042,387,3,"Knox County",470313,518.590810800467,0.207047146401985,352.318562319136,80.5846319366039,20.7047146401985
2021-01-06,36123,487,32156,357,3967,130,35224,374,250264,1187,285488,1561,9,330,15,1033,384,9,"Knox County",470313,570.471154316381,0.215368481266088,331.906623886646,103.548062673156,21.5368481266088
2021-01-05,35636,514,31799,323,3837,191,34850,342,249077,1192,283927,1534,14,321,14,1018,375,6,"Knox County",470313,609.594036311988,0.219655368301458,326.165766202508,109.288920357294,21.9655368301458
2021-01-04,35122,321,31476,228,3646,93,34508,249,247885,654,282393,903,6,307,6,1004,369,8,"Knox County",470313,626.178736288387,0.22271905622681,191.999795880616,68.2524191336408,22.271905622681
2021-01-03,34801,283,31248,182,3553,101,34259,195,247231,608,281490,803,2,301,9,998,361,9,"Knox County",470313,617.461137582844,0.229739113183216,170.737360013438,60.1726935041132,22.9739113183216
2021-01-02,34518,420,31066,318,3452,102,34064,342,246623,1095,280687,1437,0,299,23,989,352,4,"Knox County",470313,607.46779272527,0.230286184887791,305.541203411345,89.3022306421468,23.0286184887791
2021-01-01,34098,416,30748,346,3350,70,33722,373,245528,1297,279250,1670,2,299,9,966,348,6,"Knox County",470313,599.600691454414,0.232409827496079,355.08267898187,88.4517332074597,23.2409827496079
2020-12-31,33682,449,30402,312,3280,137,33349,322,244231,929,277580,1251,12,297,8,957,342,3,"Knox County",470313,614.484396561439,0.239873348618845,265.993072698394,95.4683370436284,23.9873348618845
2020-12-30,33233,363,30090,248,3143,115,33027,271,243302,931,276329,1202,6,285,9,949,339,4,"Knox County",470313,588.118976086138,0.237954545454545,255.574479123477,77.1826421978555,23.7954545454545
2020-12-29,32870,590,29842,398,3028,192,32756,420,242371,1081,275127,1501,7,279,14,940,335,8,"Knox County",470313,604.278427345194,0.247747233945477,319.149162366339,125.448371616349,24.7747233945477
2020-12-28,32280,252,29444,174,2836,78,32336,185,241290,565,273626,750,4,272,4,926,327,5,"Knox County",470313,589.607346596841,0.244717901091247,159.468269003834,53.5813383852881,24.4717901091247
2020-12-27,32028,230,29270,156,2758,74,32151,172,240725,489,272876,661,3,268,8,922,322,7,"Knox County",470313,578.338255587237,0.246104815864023,140.544701082045,48.903602494509,24.6104815864023
2020-12-26,31798,359,29114,289,2684,70,31979,329,240236,1063,272215,1392,0,265,10,914,315,6,"Knox County",470313,565.368169708258,0.245876349827934,295.973107271115,76.3321447631684,24.5876349827934
2020-12-25,31439,353,28825,287,2614,66,31650,308,239173,1070,270823,1378,1,265,5,904,309,7,"Knox County",470313,551.972835111936,0.246711739397664,292.99636624971,75.0563986111377,24.6711739397664
2020-12-24,31086,351,28538,277,2548,74,31342,311,238103,1273,269445,1584,5,264,8,899,302,7,"Knox County",470313,531.135647962102,0.235710911667454,336.796984136097,74.6311498937941,23.5710911667454
2020-12-23,30735,472,28261,351,2474,121,31031,371,236830,1411,267861,1782,6,259,9,891,295,6,"Knox County",470313,554.311703057326,0.231653404067197,378.896607153109,100.358697293079,23.1653404067197
2020-12-22,30263,530,27910,392,2353,138,30660,432,235419,1470,266079,1902,7,253,15,882,289,6,"Knox County",470313,541.554241537019,0.223092390729178,404.411530193722,112.690910096042,22.3092390729178
2020-12-21,29733,442,27518,361,2215,81,30228,391,233949,1422,264177,1813,2,246,5,867,283,3,"Knox County",470313,581.952869684657,0.220129375951294,385.487962271934,93.9799665329259,22.0129375951294
2020-12-20,29291,514,27157,431,2134,83,29837,478,232527,2245,262364,2723,2,244,7,862,280,6,"Knox County",470313,642.338187547442,0.208366470494672,578.976128663252,109.288920357294,20.8366470494672
2020-12-19,28777,525,26726,441,2051,84,29359,489,230282,1445,259641,1934,6,242,14,855,274,7,"Knox County",470313,677.633831086957,0.211954864287893,411.215509671219,111.627788302684,21.1954864287893
2020-12-18,28252,480,26285,420,1967,60,28870,430,228837,1358,257707,1788,4,236,11,841,267,6,"Knox County",470313,704.637124638273,0.214549756025432,380.172353305139,102.059692162454,21.4549756025433
2020-12-17,27772,733,25865,635,1907,98,28440,663,227479,1898,255919,2561,11,232,11,830,261,4,"Knox County",470313,785.859629650892,0.224367372267807,544.530982558424,155.853654906413,22.4367372267807
2020-12-16,27039,564,25230,453,1809,111,27777,472,225581,1729,253358,2201,8,221,11,819,257,4,"Knox County",470313,805.421070648696,0.224835812893714,467.986213436584,119.920138290883,22.4835812893714
2020-12-15,26475,765,24777,675,1698,90,27305,716,223852,2415,251157,3131,2,213,15,808,253,8,"Knox County",470313,855.387794936564,0.225311126246053,665.726867001337,162.65763438391,22.5311126246053
2020-12-14,25710,472,24102,411,1608,61,26589,461,221437,1624,248026,2085,6,211,7,793,245,8,"Knox County",470313,861.766525696717,0.225841807221579,443.321787830657,100.358697293079,22.584180722158
2020-12-13,25238,628,23691,572,1547,56,26128,754,219813,2935,245941,3689,2,205,10,786,237,6,"Knox County",470313,886.0057025853,0.229167864742078,784.37125914019,133.528097245877,22.9167864742078
2020-12-12,24610,464,23119,392,1491,72,25374,454,216878,2171,242252,2625,3,203,19,776,231,4,"Knox County",470313,873.035616706321,0.218473451327434,558.138941513418,98.6577024237051,21.8473451327434
2020-12-11,24146,557,22727,523,1419,34,24920,429,214707,1406,239627,1835,6,200,10,757,227,2,"Knox County",470313,889.407692324048,0.21785182324709,390.165698162713,118.43176778018,21.785182324709
2020-12-10,23589,473,22204,415,1385,58,24491,538,213301,1910,237792,2448,8,194,9,747,225,10,"Knox County",470313,834.125359069386,0.212279338292439,520.504430028513,100.571321651751,21.2279338292439
2020-12-09,23116,407,21789,337,1327,70,23953,359,211391,924,235344,1283,2,186,13,738,215,3,"Knox County",470313,800.743334757917,0.217068320074871,272.797052175891,86.5381139794137,21.7068320074871
2020-12-08,22709,491,21452,446,1257,45,23594,538,210467,2077,234061,2615,9,184,10,725,212,2,"Knox County",470313,742.484260481849,0.213088057901086,556.0126979267,104.398560107843,21.3088057901086
2020-12-07,22218,323,21006,271,1212,52,23056,317,208390,1135,231446,1452,3,175,6,715,210,3,"Knox County",470313,710.803231039754,0.212516460776322,308.730568791422,68.6776678509843,21.2516460776322
2020-12-06,21895,332,20735,291,1160,41,22739,187,207255,668,229994,855,6,172,6,709,207,4,"Knox County",470313,647.866420872908,0.215206283840464,181.79382666437,70.5912870790304,21.5206283840464
2020-12-05,21563,289,20444,263,1119,26,22552,213,206587,714,229139,927,2,166,8,703,203,2,"Knox County",470313,610.657158105347,0.22610600087604,197.102780488738,61.4484396561439,22.610600087604
2020-12-04,21274,354,20181,322,1093,32,22339,297,205873,1091,228212,1388,5,164,11,695,201,5,"Knox County",470313,567.494413294976,0.223285922684172,295.122609836428,75.2690229698095,22.3285922684172
2020-12-03,20920,441,19859,424,1061,17,22042,448,204782,1215,226824,1663,2,159,10,684,196,2,"Knox County",470313,560.690433817479,0.231660610821958,353.594308471167,93.7673421742542,23.1660610821958
2020-12-02,20479,192,19435,170,1044,22,21594,185,203567,575,225161,760,2,157,7,674,194,5,"Knox County",470313,514.976196703047,0.226190476190476,161.594512590551,40.8238768649814,22.6190476190476
2020-12-01,20287,403,19265,380,1022,23,21409,409,202992,1832,224401,2241,5,155,7,667,189,3,"Knox County",470313,496.26525313993,0.221408572043937,476.491187783455,85.6876165447266,22.1408572043937
2020-11-30,19884,385,18885,371,999,14,21000,436,201160,1815,222160,2251,1,150,3,660,186,3,"Knox County",470313,509.44796337758,0.215666831928607,478.617431370173,81.8603780886346,21.5666831928607
2020-11-29,19499,226,18514,218,985,8,20564,260,199345,1464,219909,1724,0,149,5,657,183,6,"Knox County",470313,486.909781358372,0.205221836771955,366.564394350146,48.0531050598219,20.5221836771955
2020-11-28,19273,270,18296,256,977,14,20304,299,197881,1967,218185,2266,0,149,8,652,177,4,"Knox County",470313,482.869918543608,0.189864150329456,481.806796750249,57.4085768413801,18.9864150329456
2020-11-27,19003,235,18040,215,963,20,20005,249,195914,1247,215919,1496,3,149,12,644,173,3,"Knox County",470313,457.567619861667,0.184339972582856,318.08604057298,49.9667242878679,18.4339972582856
2020-11-26,18768,344,17825,341,943,3,19756,441,194667,1429,214423,1870,4,146,5,632,170,6,"Knox County",470313,436.943057070504,0.180758248730964,397.607550716225,73.1427793830917,18.0758248730964
2020-11-25,18424,219,17484,193,940,26,19315,123,193238,325,212553,448,0,142,3,627,164,2,"Knox County",470313,442.683914754642,0.18030253741054,95.2557126849566,46.5647345491194,18.030253741054
2020-11-24,18205,153,17291,130,914,23,19192,116,192913,673,212105,789,2,142,6,624,162,2,"Knox County",470313,389.527825086698,0.177425304315751,167.760618992033,32.5315268767821,17.7425304315751
2020-11-23,18052,167,17161,147,891,20,19076,100,192240,391,211316,491,3,140,7,618,160,7,"Knox County",470313,343.17571489625,0.174812857771907,104.398560107843,35.508267898187,17.4812857771907
2020-11-22,17885,220,17014,212,871,8,18976,258,191849,1804,210825,2062,2,137,5,611,153,2,"Knox County",470313,341.899968744219,0.168329441732116,438.431427581207,46.7773589077912,16.8329441732116
2020-11-21,17665,173,16802,169,863,4,18718,198,190045,1465,208763,1663,0,135,4,606,151,2,"Knox County",470313,321.275405953057,0.168386438371697,353.594308471167,36.7840140502176,16.8386438371697
2020-11-20,17492,178,16633,169,859,9,18520,163,188580,791,207100,954,7,135,5,602,149,4,"Knox County",470313,309.155817508765,0.169022592726833,202.843638172876,37.8471358435765,16.9022592726833
2020-11-19,17314,166,16464,148,850,18,18357,128,187789,663,206146,791,2,128,4,597,145,5,"Knox County",470313,271.308681665189,0.15087524312309,168.185867709377,35.2956435395152,15.087524312309
2020-11-18,17148,168,16316,163,832,5,18229,179,187126,874,205355,1053,0,126,7,593,140,2,"Knox County",470313,260.464839372928,0.146353966423171,223.893449681382,35.7208922568587,14.6353966423171
2020-11-17,16980,248,16153,240,827,8,18050,260,186252,1033,204302,1293,9,126,7,586,138,1,"Knox County",470313,280.664153446747,0.154809197062718,274.923295762609,52.730840950601,15.4809197062718
2020-11-16,16732,272,15913,261,819,11,17790,286,185219,1409,203009,1695,2,117,6,579,137,2,"Knox County",470313,302.989711107284,0.154768163179476,360.398287948664,57.8338255587237,15.4768163179476
2020-11-15,16460,274,15652,247,808,27,17504,295,183810,2278,201314,2573,2,115,3,573,135,4,"Knox County",470313,314.47142647556,0.150568748752744,547.082474862485,58.2590742760672,15.0568748752744
2020-11-14,16186,306,15405,293,781,13,17209,321,181532,1699,198741,2020,0,113,7,570,131,3,"Knox County",470313,342.750466178906,0.157240581944311,429.501204516992,65.0630537535641,15.7240581944311
2020-11-13,15880,219,15112,200,768,19,16888,190,179833,965,196721,1155,4,113,6,563,128,1,"Knox County",470313,351.468064884449,0.156805293005671,245.581134265904,46.5647345491194,15.6805293005671
2020-11-12,15661,143,14912,130,749,13,16698,136,178868,955,195566,1091,1,109,3,557,127,2,"Knox County",470313,346.577704634998,0.153216911764706,231.97317531091,30.4052832900643,15.3216911764706
2020-11-11,15518,191,14782,177,736,14,16562,191,177913,1229,194475,1420,3,108,7,554,125,2,"Knox County",470313,351.468064884449,0.149284253578732,301.926589313925,40.6112525063096,14.9284253578732
2020-11-10,15327,168,14605,163,722,5,16371,186,176684,1131,193055,1317,2,105,4,547,123,2,"Knox County",470313,334.458116190707,0.142400851743412,280.026280370732,35.7208922568587,14.2400851743412
2020-11-09,15159,135,14442,121,717,14,16185,131,175553,490,191738,621,1,103,2,543,121,2,"Knox County",470313,305.328579052673,0.142198685888006,132.039726735174,28.70428842069,14.2198685888006
2020-11-08,15024,215,14321,203,703,12,16054,252,175063,2624,191117,2876,1,102,3,541,119,5,"Knox County",470313,292.783741891039,0.134,611.507655540034,45.7142371144323,13.4
2020-11-07,14809,169,14118,161,691,8,15802,187,172439,1918,188241,2105,1,101,5,538,114,0,"Knox County",470313,263.654204753005,0.120264525271611,447.574275004093,35.9335166155305,12.0264525271611
2020-11-06,14640,155,13957,138,683,17,15615,160,170521,1235,186136,1395,0,100,5,533,114,3,"Knox County",470313,250.046245798011,0.114826789838337,296.61098034713,32.9567755941256,11.4826789838337
2020-11-05,14485,158,13819,142,666,16,15455,151,169286,613,184741,764,1,100,6,528,111,1,"Knox County",470313,253.235611178088,0.119832349018861,162.445010025239,33.594648670141,11.9832349018861
2020-11-04,14327,145,13677,133,650,12,15304,148,168673,934,183977,1082,-1,99,5,522,110,2,"Knox County",470313,243.454890679186,0.119586614173228,230.059556082864,30.8305320074078,11.9586614173228
2020-11-03,14182,196,13544,183,638,13,15156,195,167739,837,182895,1032,3,100,5,517,108,1,"Knox County",470313,249.408372721996,0.123949367088608,219.428338149275,41.6743742996685,12.3949367088608
2020-11-02,13986,116,13361,110,625,6,14961,115,166902,806,181863,921,1,97,2,512,107,2,"Knox County",470313,245.368509907232,0.118722358722359,195.827034336708,24.6644256059263,11.8722358722359
2020-11-01,13870,124,13251,116,619,8,14846,131,166096,1273,180942,1404,0,96,3,510,105,2,"Knox County",470313,226.0196932681,0.124899459956337,298.524599575177,26.3654204753005,12.4899459956337
2020-10-31,13746,5,13135,5,611,0,14715,7,164823,4,179538,11,0,96,0,507,103,1,"Knox County",470313,191.149298445929,0.137237100922984,2.33886794538956,1.06312179335889,13.7237100922984
2020-10-30,13741,156,13130,146,611,10,14708,148,164819,854,179527,1002,1,96,4,507,102,0,"Knox County",470313,191.3619228046,0.143983268983269,213.049607389122,33.1693999527974,14.3983268983269
2020-10-29,13585,152,12984,138,601,14,14560,136,163965,1569,178525,1705,0,95,4,503,102,1,"Knox County",470313,190.08617665257,0.122956546038843,362.524531535382,32.3189025181103,12.2956546038843
2020-10-28,13433,103,12846,96,587,7,14424,102,162396,1055,176820,1157,3,95,8,499,101,1,"Knox County",470313,181.155953588355,0.115320796460177,246.006382983247,21.9003089431931,11.5320796460177
2020-10-27,13330,119,12750,113,580,6,14322,127,161341,799,175663,926,1,92,3,491,100,2,"Knox County",470313,164.783877970628,0.107493685096829,196.890156130067,25.3022986819416,10.7493685096829
2020-10-26,13211,81,12637,74,574,7,14195,73,160542,372,174737,445,2,91,2,488,98,0,"Knox County",470313,157.342025417116,0.108872180451128,94.6178396089413,17.222573052414,10.8872180451128
2020-10-25,13130,132,12563,121,567,11,14122,151,160170,1365,174292,1516,0,89,3,486,98,1,"Knox County",470313,159.04302028649,0.11002661934339,322.338527746416,28.0664153446747,11.002661934339
2020-10-24,12998,172,12442,167,556,5,13971,202,158805,1788,172776,1990,0,89,5,483,97,1,"Knox County",470313,194.551288184677,0.107424779773481,423.122473756839,36.5713896915458,10.7424779773481
2020-10-23,12826,159,12275,148,551,11,13769,172,157017,1239,170786,1411,1,89,5,478,96,0,"Knox County",470313,195.189161260692,0.105245901639344,300.012970085879,33.8072730288127,10.5245901639344
2020-10-22,12667,182,12127,168,540,14,13597,169,155778,1607,169375,1776,1,88,5,473,96,0,"Knox County",470313,201.567892020846,0.108014315150201,377.620861001078,38.6976332782636,10.8014315150201
2020-10-21,12485,72,11959,68,526,4,13428,74,154171,682,167599,756,0,87,1,468,96,1,"Knox County",470313,194.976536902021,0.109750566893424,160.744015155864,15.308953824368,10.9750566893424
2020-10-20,12413,127,11891,121,522,6,13354,150,153489,739,166843,889,0,87,7,467,95,1,"Knox County",470313,196.677531771395,0.112831606512581,189.023054859211,27.0032935513158,11.2831606512581
2020-10-19,12286,112,11770,107,516,5,13204,117,152750,939,165954,1056,1,87,6,460,94,0,"Knox County",470313,203.26888689022,0.110176708537364,224.531322757398,23.8139281712392,11.0176708537364
2020-10-18,12174,140,11663,135,511,5,13087,168,151811,1431,164898,1599,0,86,7,454,94,1,"Knox County",470313,204.969881759594,0.111005592487074,339.986349516173,29.7674102140489,11.1005592487074
2020-10-17,12034,128,11528,125,506,3,12919,154,150380,1458,163299,1612,1,86,3,447,93,1,"Knox County",470313,195.614409978036,0.110341795801736,342.750466178906,27.2159179099876,11.0341795801736
2020-10-16,11906,72,11403,71,503,1,12765,61,148922,390,161687,451,1,85,3,444,92,2,"Knox County",470313,177.116090773591,0.109718638653397,95.893585760972,15.308953824368,10.9718638653397
2020-10-15,11834,74,11332,62,502,12,12704,66,148532,941,161236,1007,1,84,3,441,90,2,"Knox County",470313,154.152660037039,0.10719131614654,214.112729182481,15.7342025417116,10.719131614654
2020-10-14,11760,149,11270,143,490,6,12638,150,147591,1086,160229,1236,0,83,5,438,88,0,"Knox County",470313,170.524735654766,0.11031847133758,262.803707318318,31.6810294420949,11.031847133758
2020-10-13,11611,71,11127,68,484,3,12488,63,146505,581,158993,644,1,83,6,433,88,1,"Knox County",470313,158.617771569146,0.102432610124918,136.930086984625,15.0963294656962,10.2432610124918
2020-10-12,11540,79,11059,66,481,13,12425,87,145924,806,158349,893,0,82,5,427,87,2,"Knox County",470313,151.601167732978,0.100644987906477,189.873552293898,16.7973243350705,10.0644987906477
2020-10-11,11461,170,10993,163,468,7,12338,179,145118,1612,157456,1791,0,82,8,422,85,0,"Knox County",470313,157.979898493131,0.0995546240503013,380.810226381155,36.1461409742023,9.95546240503013
2020-10-10,11291,130,10830,122,461,8,12159,132,143506,1393,155665,1525,0,82,3,414,85,0,"Knox County",470313,158.405147210475,0.0977872002120048,324.252146974462,27.6411666273312,9.77872002120048
2020-10-09,11161,120,10708,118,453,2,12027,134,142113,1336,154140,1470,0,82,3,411,85,0,"Knox County",470313,168.61111642672,0.0946766285314032,312.557807247514,25.5149230406134,9.46766285314032
2020-10-08,11041,110,10590,102,451,8,11893,103,140777,943,152670,1046,1,82,4,408,85,0,"Knox County",470313,176.265593338904,0.0985473561882626,222.40507917068,23.3886794538956,9.85473561882626
2020-10-07,10931,104,10488,88,443,16,11790,95,139834,1649,151624,1744,0,81,5,404,85,1,"Knox County",470313,166.697497198674,0.087018544935806,370.816881523581,22.1129333018649,8.7018544935806
2020-10-06,10827,115,10400,102,427,13,11695,114,138185,1392,149880,1506,0,81,4,399,84,0,"Knox County",470313,176.052968980232,0.0846115288220551,320.212284159698,24.4518012472545,8.46115288220551
2020-10-05,10712,118,10298,109,414,9,11581,123,136793,1238,148374,1361,0,81,5,395,84,2,"Knox County",470313,184.345318968432,0.0842669730920234,289.38175215229,25.0896743232698,8.42669730920234
2020-10-04,10594,96,10189,89,405,7,11458,99,135555,1827,147013,1926,1,81,2,390,82,0,"Knox County",470313,168.61111642672,0.0756286632633768,409.514514801845,20.4119384324907,7.56286632633768
2020-10-03,10498,77,10100,76,398,1,11359,92,133728,1864,145087,1956,0,80,2,388,82,0,"Knox County",470313,157.342025417116,0.0690344263784177,415.893245561998,16.3720756177269,6.90344263784177
2020-10-02,10421,82,10024,79,397,3,11267,82,131864,602,143131,684,0,80,1,386,82,0,"Knox County",470313,149.262299787588,0.0692556001173824,145.435061331496,17.4351974110858,6.92556001173824
2020-10-01,10339,71,9945,68,394,3,11185,73,131262,683,142447,756,0,80,1,385,82,0,"Knox County",470313,140.969949799389,0.0682573240712776,160.744015155864,15.0963294656962,6.82573240712776
2020-09-30,10268,75,9877,72,391,3,11112,70,130579,675,141691,745,1,80,2,384,82,0,"Knox County",470313,134.803843397907,0.0730915603313186,158.405147210475,15.9468269003834,7.30915603313186
2020-09-29,10193,80,9805,75,388,5,11042,87,129904,1140,140946,1227,-1,79,2,382,82,1,"Knox County",470313,127.361990844395,0.0723281340265742,260.890088090272,17.0099486937423,7.23281340265742
2020-09-28,10113,57,9730,51,383,6,10955,49,128764,431,139719,480,1,80,3,380,81,2,"Knox County",470313,114.391904965417,0.0710059171597633,102.059692162454,12.1195884442914,7.10059171597633
2020-09-27,10056,72,9679,67,377,5,10906,79,128333,978,139239,1057,0,79,3,377,79,0,"Knox County",470313,109.288920357294,0.0770456191165822,224.74394711607,15.308953824368,7.70456191165822
2020-09-26,9984,127,9612,122,372,5,10827,136,127355,2087,138182,2223,4,79,5,374,79,0,"Knox County",470313,119.920138290883,0.0803123257110987,472.663949327363,27.0032935513158,8.03123257110987
2020-09-25,9857,102,9490,100,367,2,10691,103,125268,1439,135959,1542,0,75,1,369,79,3,"Knox County",470313,124.172625464318,0.074346201743462,327.866761071882,21.6876845845214,7.4346201743462
2020-09-24,9755,92,9390,89,365,3,10588,105,123829,1715,134417,1820,0,75,3,368,76,0,"Knox County",470313,128.637736996426,0.0691664833956455,386.976332782636,19.5614409978036,6.91664833956455
2020-09-23,9663,53,9301,52,362,1,10483,49,122114,432,132597,481,2,75,2,365,76,0,"Knox County",470313,123.960001105647,0.0688561721404304,102.272316521125,11.2690910096042,6.88561721404304
2020-09-22,9610,82,9249,75,361,7,10434,88,121682,1141,132116,1229,1,73,3,363,76,0,"Knox County",470313,124.38524982299,0.0689538043478261,261.315336807615,17.4351974110858,6.89538043478261
2020-09-21,9528,34,9174,30,354,4,10346,32,120541,379,130887,411,0,72,2,360,76,0,"Knox County",470313,119.494889573539,0.067556772794705,87.3886114141008,7.22922819484046,6.7556772794705
2020-09-20,9494,97,9144,78,350,19,10314,88,120162,707,130476,795,0,72,1,358,76,2,"Knox County",470313,124.810498540334,0.0706975649923538,169.036365144064,20.6245627911625,7.06975649923538
2020-09-19,9397,132,9066,129,331,3,10226,136,119455,1466,129681,1602,1,72,5,357,74,0,"Knox County",470313,125.873620333693,0.0762690355329949,340.624222592189,28.0664153446747,7.62690355329949
2020-09-18,9265,118,8937,114,328,4,10090,129,117989,1606,128079,1735,3,71,3,352,74,0,"Knox County",470313,129.275610072441,0.0776662950575994,368.903262295535,25.0896743232698,7.76662950575994
2020-09-17,9147,126,8823,119,324,7,9961,124,116383,1516,126344,1640,0,68,6,349,74,2,"Knox County",470313,136.504838267282,0.0818446724946155,348.703948221716,26.790669192644,8.18446724946155
2020-09-16,9021,99,8704,77,317,22,9837,117,114867,768,124704,885,1,68,3,343,72,1,"Knox County",470313,146.285558766183,0.0860552006749428,188.172557424524,21.049811508506,8.60552006749428
2020-09-15,8922,132,8627,126,295,6,9720,136,114099,1338,123819,1474,0,67,3,340,71,0,"Knox County",470313,156.916776699772,0.089206274877078,313.408304682201,28.0664153446747,8.9206274877078
2020-09-14,8790,127,8501,124,289,3,9584,136,112761,901,122345,1037,0,67,5,337,71,0,"Knox County",470313,176.690842056248,0.0944589877835951,220.491459942634,27.0032935513158,9.44589877835951
2020-09-13,8663,143,8377,136,286,7,9448,148,111860,1008,121308,1156,0,67,0,332,71,0,"Knox County",470313,186.471562555149,0.0971770385140099,245.793758624576,30.4052832900643,9.71770385140099
2020-09-12,8520,130,8241,123,279,7,9300,141,110852,1178,120152,1319,1,67,1,332,71,2,"Knox County",470313,186.046313837806,0.100692191217824,280.451529088075,27.6411666273312,10.0692191217824
2020-09-11,8390,103,8118,94,272,9,9159,105,109674,773,118833,878,0,66,5,331,69,2,"Knox County",470313,182.856948457729,0.108117773274526,186.684186913821,21.9003089431931,10.8117773274526
2020-09-10,8287,192,8024,189,263,3,9054,192,108901,1501,117955,1693,0,66,5,326,67,0,"Knox County",470313,196.890156130067,0.115493958777541,359.97303923132,40.8238768649814,11.5493958777541
2020-09-09,8095,91,7835,82,260,9,8862,93,107400,1710,116262,1803,0,66,2,321,67,0,"Knox County",470313,195.189161260692,0.101602564102564,383.361718685216,19.3488166391318,10.1602564102564
2020-09-08,8004,126,7753,124,251,2,8769,133,105690,702,114459,835,1,66,8,319,67,0,"Knox County",470313,193.913415108662,0.108703130374957,177.541339490935,26.790669192644,10.8703130374957
2020-09-07,7878,95,7629,92,249,3,8636,98,104988,347,113624,445,1,65,0,311,67,0,"Knox County",470313,187.109435631165,0.111944888670193,94.6178396089413,20.1993140738189,11.1944888670193
2020-09-06,7783,96,7537,92,246,4,8538,94,104641,476,113179,570,0,64,1,311,67,3,"Knox County",470313,177.116090773591,0.113482699191303,121.195884442914,20.4119384324907,11.3482699191303
2020-09-05,7687,284,7445,282,242,2,8444,295,104165,1506,112609,1801,0,64,4,310,64,0,"Knox County",470313,209.860242009045,0.125856697819315,382.936469967872,60.385317862785,12.5856697819315
2020-09-04,7403,93,7163,89,240,4,8149,97,102659,565,110808,662,1,64,0,306,64,0,"Knox County",470313,207.733998422327,0.12831348444103,140.757325440717,19.7740653564754,12.831348444103
2020-09-03,7310,190,7074,184,236,6,8052,198,102094,1798,110146,1996,2,63,6,306,64,1,"Knox County",470313,207.308749704984,0.124260355029586,424.398219908869,40.3986281476379,12.4260355029586
2020-09-02,7120,124,6890,120,230,4,7854,121,100296,1461,108150,1582,2,61,5,300,63,1,"Knox County",470313,214.325353541152,0.131288810036751,336.371735418753,26.3654204753005,13.1288810036751
2020-09-01,6996,153,6770,146,226,7,7733,158,98835,660,106568,818,2,59,4,295,62,3,"Knox County",470313,220.06621122529,0.134747269494539,173.926725393515,32.5315268767821,13.4747269494539
2020-08-31,6843,99,6624,93,219,6,7575,94,98175,431,105750,525,0,57,3,291,59,0,"Knox County",470313,220.916708659978,0.132889112396279,111.627788302684,21.049811508506,13.2889112396279
2020-08-30,6744,72,6531,71,213,1,7481,76,97744,423,105225,499,1,57,1,288,59,2,"Knox County",470313,215.813724051855,0.131802613218318,106.099554977217,15.308953824368,13.1802613218318
2020-08-29,6672,118,6460,113,212,5,7405,125,97321,1391,104726,1516,5,56,3,287,57,0,"Knox County",470313,180.51808051234,0.114372203211371,322.338527746416,25.0896743232698,11.4372203211371
2020-08-28,6554,89,6347,85,207,4,7280,91,95930,309,103210,400,0,51,3,284,57,0,"Knox County",470313,179.667583077653,0.117639040348964,85.0497434687113,18.9235679217883,11.7639040348964
2020-08-27,6465,116,6262,112,203,4,7189,134,95621,1986,102810,2120,0,51,2,281,57,1,"Knox County",470313,163.933380535941,0.107104557640751,450.76364038417,24.6644256059263,10.7104557640751
2020-08-26,6349,77,6150,76,199,1,7055,86,93635,794,100690,880,0,51,3,279,56,1,"Knox County",470313,153.940035678367,0.113051198579461,187.109435631165,16.3720756177269,11.3051198579461
2020-08-25,6272,87,6074,82,198,5,6969,96,92841,896,99810,992,2,51,3,276,55,0,"Knox County",470313,139.90682800603,0.101269474899019,210.923363802404,18.4983192044447,10.1269474899019
2020-08-24,6185,32,5992,28,193,4,6873,29,91945,261,98818,290,0,49,1,273,55,0,"Knox County",470313,125.660995975021,0.095117216664178,61.6610640148157,6.8039794774969,9.5117216664178
2020-08-23,6153,76,5964,75,189,1,6844,74,91684,565,98528,639,0,49,3,272,55,0,"Knox County",470313,126.511493409708,0.092876992833114,135.866965191266,16.1594512590551,9.28769928331139
2020-08-22,6077,136,5889,135,188,1,6770,153,91119,1892,97889,2045,0,49,4,269,55,0,"Knox County",470313,130.3387318658,0.0900081455335325,434.816813483786,28.9169127793618,9.00081455335325
2020-08-21,5941,30,5754,30,187,0,6617,41,89227,262,95844,303,1,49,1,265,55,0,"Knox County",470313,117.793894704165,0.0843307194937405,64.4251806775488,6.37873076015334,8.43307194937405
2020-08-20,5911,119,5724,117,187,2,6576,130,88965,2068,95541,2198,3,48,3,264,55,0,"Knox County",470313,118.43176778018,0.0828909759085341,467.348340360568,25.3022986819416,8.28909759085341
2020-08-19,5792,46,5607,41,185,5,6446,48,86897,608,93343,656,2,45,4,261,55,0,"Knox County",470313,111.840412661355,0.080162852730591,139.481579288686,9.7807204989018,8.0162852730591
2020-08-18,5746,134,5566,132,180,2,6398,152,86289,1163,92687,1315,0,43,4,257,55,1,"Knox County",470313,121.833757518929,0.0842062852538276,279.601031653388,28.4916640620183,8.42062852538276
2020-08-17,5612,50,5434,42,178,8,6246,50,85126,289,91372,339,1,43,0,253,54,1,"Knox County",470313,125.660995975021,0.0864576384256171,72.0796575897328,10.6312179335889,8.64576384256171
2020-08-16,5562,83,5392,78,170,5,6196,82,84837,587,91033,669,0,42,1,253,53,1,"Knox County",470313,127.149366485723,0.0871760797342193,142.24569595142,17.6478217697576,8.71760797342193
2020-08-15,5479,119,5314,116,165,3,6114,132,84250,1223,90364,1355,1,42,2,252,52,0,"Knox County",470313,123.534752388303,0.0929041697147037,288.106006000259,25.3022986819416,9.29041697147037
2020-08-14,5360,91,5198,83,162,8,5982,96,83027,1024,89009,1120,0,41,2,250,52,1,"Knox County",470313,136.504838267282,0.0901725039205436,238.139281712392,19.3488166391318,9.01725039205436
2020-08-13,5269,127,5115,126,154,1,5886,229,82003,1778,87889,2007,1,41,4,248,51,1,"Knox County",470313,138.205833136656,0.105749899477282,426.737087854259,27.0032935513158,10.5749899477282
2020-08-12,5142,79,4989,72,153,7,5657,88,80225,892,85882,980,0,40,1,244,50,0,"Knox County",470313,145.222436972824,0.106486833654464,208.371871498343,16.7973243350705,10.6486833654464
2020-08-11,5063,111,4917,108,146,3,5569,117,79333,1121,84902,1238,0,40,5,243,50,2,"Knox County",470313,140.332076723374,0.103009859885833,263.228956035661,23.6013038125674,10.3009859885833
2020-08-10,4952,37,4809,35,143,2,5452,35,78212,365,83664,400,1,40,0,238,48,0,"Knox County",470313,137.56796006064,0.100270305058566,85.0497434687113,7.86710127085579,10.0270305058566
2020-08-09,4915,85,4774,81,141,4,5417,109,77847,826,83264,935,1,39,4,238,48,1,"Knox County",470313,137.993208777984,0.10031113876789,198.803775358113,18.0730704871011,10.031113876789
2020-08-08,4830,157,4693,156,137,1,5308,176,77021,2284,82329,2460,1,38,4,234,47,2,"Knox County",470313,146.072934407512,0.0929978118161926,523.055922332574,33.3820243114692,9.29978118161926
2020-08-07,4673,50,4537,46,136,4,5132,44,74737,403,79869,447,0,37,0,230,45,2,"Knox County",470313,137.355335701969,0.0942482579426007,95.0430883262848,10.6312179335889,9.42482579426007
2020-08-06,4623,113,4491,105,132,8,5088,121,74334,1463,79422,1584,-1,37,5,230,43,1,"Knox County",470313,134.378594680564,0.0857782197911487,336.796984136097,24.0265525299109,8.57782197911487
2020-08-05,4510,99,4386,99,124,0,4967,100,72871,1107,77838,1207,1,38,3,225,42,1,"Knox County",470313,138.631081853999,0.0848748639825898,256.637600916836,21.049811508506,8.48748639825898
2020-08-04,4411,112,4287,111,124,1,4867,106,71764,1082,76631,1188,1,37,9,222,41,0,"Knox County",470313,138.843706212671,0.0840530349105948,252.597738102072,23.8139281712392,8.40530349105948
2020-08-03,4299,50,4176,50,123,0,4761,81,70682,593,75443,674,2,36,1,213,41,1,"Knox County",470313,141.607822875404,0.0867569158328429,143.308817744778,10.6312179335889,8.67569158328429
2020-08-02,4249,97,4126,91,123,6,4680,95,70089,692,74769,787,3,34,2,212,40,0,"Knox County",470313,144.159315179466,0.0866179465676291,167.335370274689,20.6245627911625,8.66179465676291
2020-08-01,4152,118,4035,110,117,8,4585,118,69397,1417,73982,1535,1,31,1,210,40,1,"Knox County",470313,135.866965191266,0.0895984909727836,326.37839056118,25.0896743232698,8.95984909727836
2020-07-31,4034,117,3925,114,109,3,4467,116,67980,1060,72447,1176,2,30,1,209,39,3,"Knox County",470313,150.112797222275,0.0904183535762483,250.046245798011,24.877049964598,9.04183535762483
2020-07-30,3917,189,3811,186,106,3,4351,227,66920,2420,71271,2647,1,28,7,208,36,2,"Knox County",470313,166.27224848133,0.0914912090297374,562.816677404197,40.1860037889661,9.14912090297373
2020-07-29,3728,75,3625,71,103,4,4124,60,64500,438,68624,498,0,27,3,201,34,4,"Knox County",470313,161.169263873208,0.0944150499706055,105.886930618546,15.9468269003834,9.44150499706055
2020-07-28,3653,154,3554,152,99,2,4064,186,64062,1211,68126,1397,1,27,3,198,30,0,"Knox County",470313,170.099486937423,0.101331191186596,297.036229064474,32.7441512354538,10.1331191186596
2020-07-27,3499,83,3402,76,97,7,3878,85,62851,677,66729,762,3,26,2,195,30,1,"Knox County",470313,177.116090773591,0.100772551692797,162.019761307895,17.6478217697576,10.0772551692797
2020-07-26,3416,118,3326,113,90,5,3793,132,62174,1472,65967,1604,0,23,2,193,29,1,"Knox County",470313,181.581202305699,0.0960598814845618,341.049471309532,25.0896743232698,9.60598814845618
2020-07-25,3298,175,3213,172,85,3,3661,197,60702,1949,64363,2146,2,23,3,191,28,3,"Knox County",470313,193.70079074999,0.0980449657869013,456.291873709636,37.2092627675612,9.80449657869013
2020-07-24,3123,106,3041,99,82,7,3464,113,58753,916,62217,1029,0,21,4,188,25,0,"Knox County",470313,191.3619228046,0.0991768322919766,218.79046507326,22.5381820192085,9.91768322919766
2020-07-23,3017,205,2942,197,75,8,3351,254,57837,2389,61188,2643,0,21,4,184,25,1,"Knox County",470313,194.763912543349,0.101895029268777,561.96617996951,43.5879935277145,10.1895029268777
2020-07-22,2812,69,2745,61,67,8,3097,63,55448,437,58545,500,3,21,3,180,24,0,"Knox County",470313,193.488166391318,0.102172403531396,106.312179335889,14.6710807483527,10.2172403531396
2020-07-21,2743,232,2684,228,59,4,3034,280,55011,1691,58045,1971,0,18,12,177,24,1,"Knox County",470313,210.072866367717,0.105490380103238,419.082610942075,49.3288512118525,10.5490380103238
2020-07-20,2511,74,2456,70,55,4,2754,57,53320,364,56074,421,0,18,4,165,23,1,"Knox County",470313,208.159247139671,0.106263331394221,89.5148550008186,15.7342025417116,10.6263331394221
2020-07-19,2437,84,2386,74,51,10,2697,74,52956,577,55653,651,0,18,0,161,22,2,"Knox County",470313,200.93001894483,0.110885589146459,138.418457495328,17.8604461284294,11.0885589146459
2020-07-18,2353,112,2312,109,41,3,2623,146,52379,2258,55002,2404,1,18,8,161,20,1,"Knox County",470313,187.534684348508,0.102609418858509,511.148958246955,23.8139281712392,10.2609418858509
2020-07-17,2241,74,2203,74,38,0,2477,80,50121,347,52598,427,0,17,6,153,19,2,"Knox County",470313,180.730704871011,0.105800155262282,90.7906011528493,15.7342025417116,10.5800155262282
2020-07-16,2167,187,2129,185,38,2,2397,228,49774,2033,52171,2261,2,17,3,147,17,0,"Knox County",470313,176.903466414919,0.107469600463231,480.74367495689,39.7607550716225,10.7469600463231
2020-07-15,1980,78,1944,78,36,0,2169,80,47741,511,49910,591,3,15,4,144,17,1,"Knox County",470313,178.817085642965,0.108297043318817,125.660995975021,16.5846999763987,10.8297043318817
2020-07-14,1902,95,1866,95,36,0,2089,127,47230,777,49319,904,2,12,1,140,16,1,"Knox County",470313,149.687548504932,0.103407755581669,192.212420239287,20.1993140738189,10.3407755581669
2020-07-13,1807,94,1771,92,36,2,1962,59,46453,655,48415,714,1,10,2,139,15,3,"Knox County",470313,153.940035678367,0.0998490945674044,151.81379209165,19.9866897151471,9.98490945674044
2020-07-12,1713,69,1679,67,34,2,1903,87,45798,916,47701,1003,0,9,4,137,12,1,"Knox County",470313,150.750670298291,0.0971820809248555,213.262231747793,14.6710807483527,9.71820809248555
2020-07-11,1644,28,1612,27,32,1,1816,36,44882,883,46698,919,0,9,2,133,11,1,"Knox County",470313,132.890224169861,0.102214400938554,195.401785619364,5.95348204280979,10.2214400938554
2020-07-10,1616,78,1585,74,31,4,1780,68,43999,418,45779,486,0,9,6,131,10,0,"Knox County",470313,133.740721604548,0.0995929049142193,103.335438314484,16.5846999763987,9.95929049142192
2020-07-09,1538,70,1511,66,27,4,1712,88,43581,1652,45293,1740,0,9,8,125,10,0,"Knox County",470313,108.86367163995,0.0857322636463741,369.966384088894,14.8837051070245,8.57322636463741
2020-07-08,1468,70,1445,65,23,5,1624,63,41929,594,43553,657,1,9,5,117,10,0,"Knox County",470313,107.162676770576,0.082204577300327,139.694203647358,14.8837051070245,8.2204577300327
2020-07-07,1398,79,1380,79,18,0,1561,104,41335,1303,42896,1407,0,8,7,112,10,1,"Knox County",470313,103.760687031828,0.0729136586774473,299.162472651192,16.7973243350705,7.29136586774473
2020-07-06,1319,35,1301,35,18,0,1457,34,40032,658,41489,692,1,8,6,105,9,0,"Knox County",470313,91.2158498701928,0.0695249130938586,147.13605620087,7.44185255351224,6.95249130938586
2020-07-05,1284,77,1266,77,18,0,1423,109,39374,1079,40797,1188,2,7,6,99,9,1,"Knox County",470313,92.916844739567,0.0708139370856256,252.597738102072,16.3720756177269,7.08139370856256
2020-07-04,1207,41,1189,40,18,1,1314,50,38295,1141,39609,1191,0,5,1,93,8,2,"Knox County",470313,95.6809614023002,0.0700991713082462,253.235611178088,8.7175987055429,7.00991713082462
2020-07-03,1166,62,1149,61,17,1,1264,49,37154,910,38418,959,0,5,4,92,6,0,"Knox County",470313,92.2789716635517,0.0634414092417667,203.906759966235,13.1827102376502,6.34414092417667
2020-07-02,1104,68,1088,68,16,0,1215,102,36244,1228,37459,1330,0,5,2,88,6,0,"Knox County",470313,91.8537229462082,0.0688308189655172,282.790397033465,14.4584563896809,6.88308189655172
2020-07-01,1036,49,1020,49,16,0,1113,34,35016,737,36129,771,0,5,4,86,6,1,"Knox County",470313,87.3886114141008,0.0639426903687981,163.933380535941,10.4185935749171,6.39426903687981
2020-06-30,987,40,971,39,16,1,1079,73,34279,1514,35358,1587,0,5,3,82,5,0,"Knox County",470313,79.0962614259015,0.0584348276755636,337.434857212112,8.50497434687113,5.84348276755636
2020-06-29,947,51,932,51,15,0,1006,79,32765,1333,33771,1412,0,5,3,79,5,0,"Knox County",470313,82.4982511646499,0.058781701825077,300.225594444551,10.8438422922607,5.8781701825077
2020-06-28,896,10,881,10,15,0,927,30,31432,684,32359,714,0,5,1,76,5,0,"Knox County",470313,68.2524191336408,0.0523606228026118,151.81379209165,2.12624358671778,5.23606228026117
2020-06-27,886,29,871,29,15,0,897,16,30748,111,31645,127,0,5,3,75,5,0,"Knox County",470313,65.7009268295794,0.0555072463768116,27.0032935513158,6.16610640148157,5.55072463768116
2020-06-26,857,37,842,37,15,0,881,14,30637,319,31518,333,0,5,8,72,5,0,"Knox County",470313,60.385317862785,0.0554670066942939,70.8039114377021,7.86710127085579,5.54670066942939
2020-06-25,820,32,805,32,15,0,867,52,30318,702,31185,754,0,5,1,64,5,0,"Knox County",470313,52.730840950601,0.0522990522990523,160.318766438521,6.8039794774969,5.22990522990523
2020-06-24,788,35,773,34,15,1,815,32,29616,272,30431,304,0,5,1,63,5,0,"Knox County",470313,49.7540999291961,0.0565857388644619,64.6378050362206,7.44185255351224,5.65857388644619
2020-06-23,753,27,739,24,14,3,783,25,29344,215,30127,240,0,5,4,62,5,0,"Knox County",470313,46.989983266463,0.0638516992790937,51.0298460812268,5.74085768413801,6.38516992790937
2020-06-22,726,36,715,36,11,0,758,31,29129,572,29887,603,0,5,0,58,5,0,"Knox County",470313,43.8006178863863,0.0650406504065041,128.212488279082,7.65447691218401,6.50406504065041
2020-06-21,690,31,679,31,11,0,727,37,28557,815,29284,852,0,5,1,58,5,0,"Knox County",470313,48.2657294184936,0.0644257703081232,181.155953588355,6.59135511882512,6.44257703081232
2020-06-20,659,17,648,17,11,0,690,9,27742,437,28432,446,0,5,2,57,5,0,"Knox County",470313,45.7142371144323,0.0566251415628539,94.8304639676131,3.61461409742023,5.66251415628539
2020-06-19,642,30,631,28,11,2,681,10,27305,334,27986,344,0,5,1,55,5,0,"Knox County",470313,44.2258666037299,0.0553203499858877,73.1427793830917,6.37873076015334,5.53203499858877
2020-06-18,612,15,603,15,9,0,671,18,26971,804,27642,822,0,5,0,54,5,0,"Knox County",470313,40.6112525063096,0.0448629188590418,174.777222828202,3.18936538007667,4.48629188590418
2020-06-17,597,17,588,17,9,0,653,13,26167,282,26820,295,0,5,0,54,5,0,"Knox County",470313,36.7840140502176,0.0397001665741255,62.7241858081746,3.61461409742023,3.97001665741255
2020-06-16,580,9,571,8,9,1,640,9,25885,178,26525,187,0,5,0,54,5,0,"Knox County",470313,32.9567755941256,0.0357847280924204,39.7607550716225,1.913619228046,3.57847280924204
2020-06-15,571,8,563,8,8,0,631,9,25707,218,26338,227,0,5,0,54,5,0,"Knox County",470313,27.0032935513158,0.0330917113142137,48.2657294184936,1.70099486937423,3.30917113142137
2020-06-14,563,8,555,8,8,0,622,9,25489,624,26111,633,0,5,0,54,5,0,"Knox County",470313,22.1129333018649,0.0260663507109005,134.591219039236,1.70099486937423,2.60663507109005
2020-06-13,555,10,547,8,8,2,613,9,24865,213,25478,222,0,5,3,54,5,0,"Knox County",470313,20.6245627911625,0.0282051282051282,47.2026076251348,2.12624358671778,2.82051282051282
2020-06-12,545,19,539,19,6,0,604,19,24652,750,25256,769,0,5,0,51,5,0,"Knox County",470313,18.2856948457729,0.0272583201267829,163.508131818597,4.03986281476378,2.72583201267829
2020-06-11,526,7,520,7,6,0,585,10,23902,379,24487,389,0,5,2,51,5,0,"Knox County",470313,16.5846999763987,0.0286554004408523,82.7108755233217,1.48837051070245,2.86554004408523
2020-06-10,519,12,513,12,6,0,575,12,23523,705,24098,717,0,5,0,49,5,0,"Knox County",470313,15.5215781830398,0.0244910941475827,152.451665167665,2.55149230406134,2.44910941475827
2020-06-09,507,16,501,16,6,0,563,19,22818,508,23381,527,0,5,1,49,5,0,"Knox County",470313,17.0099486937423,0.0249712973593571,112.053037020027,3.40198973874845,2.49712973593571
2020-06-08,491,8,485,8,6,0,544,8,22310,336,22854,344,0,5,1,48,5,0,"Knox County",470313,17.0099486937423,0.0238822549291863,73.1427793830917,1.70099486937423,2.38822549291863
2020-06-07,483,7,477,7,6,0,536,8,21974,847,22510,855,0,5,1,47,5,0,"Knox County",470313,16.7973243350705,0.0222338477635365,181.79382666437,1.48837051070245,2.22338477635365
2020-06-06,476,11,470,11,6,0,528,12,21127,478,21655,490,0,5,0,46,5,0,"Knox County",470313,17.0099486937423,0.0215106330970423,104.185935749171,2.33886794538956,2.15106330970423
2020-06-05,465,18,459,18,6,0,516,17,20649,518,21165,535,0,5,1,46,5,0,"Knox County",470313,16.7973243350705,0.0222971221156339,113.754031889401,3.82723845609201,2.22971221156339
2020-06-04,447,4,441,4,6,0,499,4,20131,338,20630,342,0,5,0,45,5,0,"Knox County",470313,16.1594512590551,0.020997375328084,72.7175306657481,0.850497434687113,2.0997375328084
2020-06-03,443,4,437,4,6,0,495,4,19793,399,20288,403,0,5,0,45,5,0,"Knox County",470313,14.4584563896809,0.0205949656750572,85.6876165447266,0.850497434687113,2.05949656750572
2020-06-02,439,26,433,25,6,1,491,24,19394,939,19885,963,0,5,2,45,5,0,"Knox County",470313,16.5846999763987,0.0195829094608342,204.757257400922,5.52823332546623,1.95829094608342
2020-06-01,413,17,408,17,5,0,467,20,18455,972,18922,992,0,5,0,43,5,0,"Knox County",470313,18.4983192044447,0.0194323144104804,210.923363802404,3.61461409742023,1.94323144104803
2020-05-31,396,7,391,7,5,0,447,7,17483,317,17930,324,0,5,0,43,5,0,"Knox County",470313,18.4983192044447,0.0217337614225735,68.8902922096561,1.48837051070245,2.17337614225735
2020-05-30,389,6,384,6,5,0,440,6,17166,294,17606,300,0,5,2,43,5,0,"Knox County",470313,17.4351974110858,0.0212490282456595,63.7873076015334,1.27574615203067,2.12490282456595
2020-05-29,383,8,378,8,5,0,434,7,16872,205,17306,212,0,5,0,41,5,0,"Knox County",470313,15.308953824368,0.0203619909502262,45.076364038417,1.70099486937423,2.03619909502262
2020-05-28,375,11,370,11,5,0,427,11,16667,336,17094,347,0,5,0,41,5,0,"Knox County",470313,16.7973243350705,0.022310081897769,73.780652459107,2.33886794538956,2.2310081897769
2020-05-27,364,5,359,5,5,0,416,6,16331,420,16747,426,0,5,1,41,5,0,"Knox County",470313,17.0099486937423,0.0227272727272727,90.5779767941775,1.06312179335889,2.27272727272727
2020-05-26,359,9,354,9,5,0,410,10,15911,1142,16321,1152,0,5,0,40,5,0,"Knox County",470313,13.395334596322,0.0178523847588596,244.943261189888,1.913619228046,1.78523847588596
2020-05-25,350,9,345,9,5,0,400,11,14769,381,15169,392,0,5,1,40,5,0,"Knox County",470313,11.6943397269478,0.018395179194418,83.348748599337,1.913619228046,1.8395179194418
2020-05-24,341,2,336,2,5,0,389,3,14388,273,14777,276,0,5,0,39,5,0,"Knox County",470313,10.6312179335889,0.0173913043478261,58.6843229934108,0.425248717343556,1.73913043478261
2020-05-23,339,7,334,7,5,0,386,10,14115,360,14501,370,0,5,2,39,5,0,"Knox County",470313,10.8438422922607,0.0182677165354331,78.6710127085579,1.48837051070245,1.82677165354331
2020-05-22,332,1,327,1,5,0,376,1,13755,253,14131,254,0,5,0,37,5,0,"Knox County",470313,9.35547178155824,0.0161641280696301,54.0065871026317,0.212624358671778,1.61641280696301
2020-05-21,331,0,326,0,5,0,375,0,13502,250,13877,250,0,5,0,37,5,0,"Knox County",470313,7.01660383616868,0.0131410256410256,53.1560896679445,0,1.31410256410256
2020-05-20,331,7,326,7,5,0,375,7,13252,360,13627,367,0,5,0,37,5,0,"Knox County",470313,7.44185255351224,0.0137210062071219,78.0331396325426,1.48837051070245,1.37210062071219
2020-05-19,324,7,319,7,5,0,368,7,12892,369,13260,376,0,5,2,37,5,0,"Knox County",470313,7.01660383616868,0.0170678336980306,79.9467588605886,1.48837051070245,1.70678336980306
2020-05-18,317,3,312,3,5,0,361,4,12523,478,12884,482,0,5,0,35,5,0,"Knox County",470313,5.74085768413801,0.0134736842105263,102.484940879797,0.637873076015334,1.34736842105263
2020-05-17,314,3,309,3,5,0,357,5,12045,216,12402,221,0,5,1,35,5,0,"Knox County",470313,5.95348204280979,0.0146551724137931,46.989983266463,0.637873076015334,1.46551724137931
2020-05-16,311,0,306,0,5,0,352,0,11829,349,12181,349,0,5,0,34,5,0,"Knox County",470313,4.46511153210734,0.0104393214441061,74.2059011764506,0,1.04393214441061
2020-05-15,311,1,306,1,5,0,352,4,11480,540,11832,544,0,5,0,34,5,0,"Knox County",470313,4.46511153210734,0.0104287369640788,115.667651117447,0.212624358671778,1.04287369640788
2020-05-14,310,3,305,3,5,0,348,7,10940,458,11288,465,0,5,0,34,5,0,"Knox County",470313,5.10298460812268,0.0121255349500713,98.8703267823768,0.637873076015334,1.21255349500713
2020-05-13,307,7,302,7,5,0,341,5,10482,341,10823,346,0,5,0,34,5,0,"Knox County",470313,5.10298460812268,0.011498383039885,73.5680281004352,1.48837051070245,1.1498383039885
2020-05-12,300,6,295,6,5,0,336,8,10141,401,10477,409,0,5,0,34,5,0,"Knox County",470313,4.8903602494509,0.01171875,86.9633626967573,1.27574615203067,1.171875
2020-05-11,294,16,289,16,5,0,328,12,9740,254,10068,266,0,5,1,34,5,0,"Knox County",470313,7.65447691218401,0.0157692307692308,56.558079406693,3.40198973874845,1.57692307692308
2020-05-10,278,5,273,5,5,0,316,5,9486,221,9802,226,0,5,1,33,5,0,"Knox County",470313,8.07972562952757,0.0157389635316699,48.0531050598219,1.06312179335889,1.57389635316699
2020-05-09,273,2,268,2,5,0,311,4,9265,352,9576,356,0,5,0,32,5,0,"Knox County",470313,8.50497434687113,0.0172281776416539,75.694271687153,0.425248717343556,1.72281776416539
2020-05-08,271,3,266,3,5,0,307,4,8913,265,9220,269,0,5,0,32,5,0,"Knox County",470313,8.93022306421468,0.0192554557124519,57.1959524827083,0.637873076015334,1.92554557124519
2020-05-07,268,3,263,3,5,0,303,3,8648,220,8951,223,0,5,0,32,5,0,"Knox County",470313,8.93022306421468,0.0195704057279236,47.4152319838065,0.637873076015334,1.95704057279236
2020-05-06,265,1,260,1,5,0,300,1,8428,185,8728,186,0,5,0,32,5,0,"Knox County",470313,7.65447691218401,0.0191214470284238,39.5481307129507,0.212624358671778,1.91214470284238
2020-05-05,264,4,259,4,5,0,299,5,8243,305,8542,310,0,5,0,32,5,0,"Knox County",470313,7.22922819484046,0.0185185185185185,65.9135511882512,0.850497434687113,1.85185185185185
2020-05-04,260,4,255,4,5,0,294,7,7938,259,8232,266,0,5,0,32,5,0,"Knox County",470313,4.67773589077912,0.0157952069716776,56.558079406693,0.850497434687113,1.57952069716776
2020-05-03,256,7,251,5,5,2,287,6,7679,290,7966,296,0,5,2,32,5,0,"Knox County",470313,5.10298460812268,0.0157397691500525,62.9368101668463,1.48837051070245,1.57397691500525
2020-05-02,249,3,246,3,3,0,281,5,7389,308,7670,313,0,5,1,30,5,0,"Knox County",470313,5.31560896679445,0.0166398282340311,66.5514242642666,0.637873076015334,1.66398282340311
2020-05-01,246,9,243,8,3,1,276,7,7081,354,7357,361,0,5,0,29,5,0,"Knox County",470313,6.59135511882512,0.0173913043478261,76.7573934805119,1.913619228046,1.73913043478261
2020-04-30,237,4,235,4,2,0,269,3,6727,119,6996,122,0,5,0,29,5,0,"Knox County",470313,6.8039794774969,0.0183387270765912,25.9401717579569,0.850497434687113,1.83387270765912
2020-04-29,233,8,231,8,2,0,266,10,6608,671,6874,681,0,5,0,29,5,0,"Knox County",470313,8.29234998819935,0.0183056619838229,144.797188255481,1.70099486937423,1.83056619838229
2020-04-28,225,8,223,8,2,0,256,10,5937,391,6193,401,1,5,0,29,5,0,"Knox County",470313,9.14284742288646,0.019672131147541,85.262367827383,1.70099486937423,1.9672131147541
2020-04-27,217,2,215,2,2,0,246,4,5546,161,5792,165,0,4,0,29,5,1,"Knox County",470313,8.7175987055429,0.0192389910218042,35.0830191808434,0.425248717343556,1.92389910218042
2020-04-26,215,1,213,1,2,0,242,1,5385,172,5627,173,0,4,0,29,4,0,"Knox County",470313,7.44185255351224,0.0180505415162455,36.7840140502176,0.212624358671778,1.80505415162455
2020-04-25,214,0,212,0,2,0,241,0,5213,53,5454,53,0,4,0,29,4,0,"Knox County",470313,6.8039794774969,0.0178936605316973,11.2690910096042,0,1.78936605316973
2020-04-24,214,8,212,8,2,0,241,10,5160,836,5401,846,0,4,1,29,4,0,"Knox County",470313,6.59135511882512,0.0155673904137649,179.880207436324,1.70099486937423,1.55673904137648
2020-04-23,206,1,204,1,2,0,231,2,4324,137,4555,139,0,4,0,28,4,0,"Knox County",470313,5.95348204280979,0.0150528885272579,29.5547858553772,0.212624358671778,1.50528885272579
2020-04-22,205,5,203,3,2,2,229,2,4187,189,4416,191,0,4,0,28,4,0,"Knox County",470313,5.31560896679445,0.0147357723577236,40.6112525063096,1.06312179335889,1.47357723577236
2020-04-21,200,4,200,4,0,0,227,5,3998,475,4225,480,0,4,1,28,4,0,"Knox County",470313,4.46511153210734,0.0117244748412311,102.059692162454,0.850497434687113,1.17244748412311
2020-04-20,196,3,196,3,0,0,222,2,3523,175,3745,177,0,4,1,27,4,0,"Knox County",470313,4.67773589077912,0.0106847984458475,37.6345114849047,0.637873076015334,1.06847984458475
2020-04-19,193,0,193,0,0,0,220,0,3348,72,3568,72,0,4,0,26,4,0,"Knox County",470313,4.46511153210734,0.0107252298263534,15.308953824368,0,1.07252298263534
2020-04-18,193,0,193,0,0,0,220,1,3276,135,3496,136,0,4,0,26,4,0,"Knox County",470313,4.46511153210734,0.0107790298873101,28.9169127793618,0,1.07790298873101
2020-04-17,193,2,193,2,0,0,219,3,3141,104,3360,107,0,4,1,26,4,0,"Knox County",470313,3.18936538007667,0.0115207373271889,22.7508063778803,0.425248717343556,1.15207373271889
2020-04-16,191,7,191,7,0,0,216,9,3037,213,3253,222,0,4,2,25,4,0,"Knox County",470313,4.46511153210734,0.015884476534296,47.2026076251348,1.48837051070245,1.5884476534296
2020-04-15,184,9,184,9,0,0,207,10,2824,84,3031,94,0,4,1,23,4,0,"Knox County",470313,5.31560896679445,0.0232919254658385,19.9866897151471,1.913619228046,2.32919254658385
2020-04-14,175,4,175,4,0,0,197,4,2740,102,2937,106,0,4,1,22,4,0,"Knox County",470313,5.31560896679445,0.0317286652078775,22.5381820192085,0.850497434687113,3.17286652078775
2020-04-13,171,4,171,4,0,0,193,9,2638,242,2831,251,0,4,1,21,4,0,"Knox County",470313,5.52823332546623,0.0364372469635627,53.3687140266163,0.850497434687113,3.64372469635628
2020-04-12,167,5,167,5,0,0,184,6,2396,166,2580,172,0,4,0,20,4,0,"Knox County",470313,6.59135511882512,0.0386029411764706,36.5713896915458,1.06312179335889,3.86029411764706
2020-04-11,162,5,162,5,0,0,178,8,2230,313,2408,321,1,4,1,20,4,0,"Knox County",470313,7.65447691218401,0.0384917517674784,68.2524191336408,1.06312179335889,3.84917517674784
2020-04-10,157,4,157,4,0,0,170,5,1917,123,2087,128,0,3,0,19,4,0,"Knox County",470313,8.07972562952757,0.0394126738794436,27.2159179099876,0.850497434687113,3.94126738794436
2020-04-09,153,1,153,1,0,0,165,1,1794,81,1959,82,0,3,0,19,4,0,"Knox County",470313,6.8039794774969,0.037261698440208,17.4351974110858,0.212624358671778,3.7261698440208
2020-04-08,152,8,152,8,0,0,164,12,1713,111,1877,123,0,3,1,19,4,1,"Knox County",470313,6.59135511882512,0.0380388841927303,26.1527961166287,1.70099486937423,3.80388841927303
2020-04-07,144,20,144,20,0,0,152,25,1602,366,1754,391,0,3,2,18,3,0,"Knox County",470313,9.99334485757357,0.0449591280653951,83.1361242406653,4.25248717343556,4.49591280653951
2020-04-06,124,8,124,8,0,0,127,14,1236,54,1363,68,2,3,1,16,3,0,"Knox County",470313,10.8438422922607,0.0552529182879377,14.4584563896809,1.70099486937423,5.52529182879377
2020-04-05,116,4,116,4,0,0,113,10,1182,75,1295,85,0,1,0,15,3,1,"Knox County",470313,10.6312179335889,0.0626043405676127,18.0730704871011,0.850497434687113,6.26043405676127
2020-04-04,112,15,112,15,0,0,103,6,1107,127,1210,133,0,1,1,15,2,1,"Knox County",470313,12.7574615203067,0.0722772277227723,28.2790397033465,3.18936538007667,7.22772277227723
2020-04-03,97,4,97,4,0,0,97,3,980,51,1077,54,0,1,1,14,1,0,"Knox County",470313,12.7574615203067,0.0758547008547008,11.481715368276,0.850497434687113,7.58547008547009
2020-04-02,93,7,93,7,0,0,94,7,929,106,1023,113,0,1,0,13,1,0,"Knox County",470313,14.0332076723374,0.0796277145811789,24.0265525299109,1.48837051070245,7.96277145811789
2020-04-01,86,15,86,15,0,0,87,15,823,140,910,155,0,0,1,13,1,0,"Knox County",470313,15.5215781830398,0.0800800800800801,32.9567755941256,3.18936538007667,8.00800800800801
2020-03-31,71,8,71,8,0,0,72,11,683,58,755,69,0,0,1,12,1,0,"Knox County",470313,12.9700858789785,0.0974889217134417,14.6710807483527,1.70099486937423,9.74889217134417
2020-03-30,63,13,63,13,0,0,61,15,625,130,686,145,0,0,2,11,1,0,"Knox County",470313,14.0332076723374,0.0888594164456233,30.8305320074078,2.76411666273312,8.88594164456233
2020-03-29,50,8,50,8,0,0,46,8,495,55,541,63,0,0,1,9,1,1,"Knox County",470313,14.8837051070245,0.0887978142076503,13.395334596322,1.70099486937423,8.87978142076503
2020-03-28,42,7,42,7,0,0,38,6,440,62,478,68,0,0,1,8,0,0,"Knox County",470313,13.1827102376502,0.0974512743628186,14.4584563896809,1.48837051070245,9.74512743628186
2020-03-27,35,2,35,2,0,0,32,2,378,54,410,56,0,0,1,7,0,0,"Knox County",470313,12.7574615203067,0.0956651718983558,11.9069640856196,0.425248717343556,9.56651718983558
2020-03-26,33,7,33,7,0,0,30,7,324,82,354,89,0,0,2,6,0,0,"Knox County",470313,12.7574615203067,0.0992248062015504,18.9235679217883,1.48837051070245,9.92248062015504
2020-03-25,26,6,26,6,0,0,23,7,242,68,265,75,0,0,1,4,0,0,"Knox County",470313,10.8438422922607,0.0991150442477876,15.9468269003834,1.27574615203067,9.91150442477876
2020-03-24,20,7,20,7,0,0,16,7,174,43,190,50,0,0,0,3,0,0,"Knox County",470313,10.6312179335889,0.0952380952380952,10.6312179335889,1.48837051070245,9.52380952380952
2020-03-23,13,4,13,4,0,0,9,4,131,22,140,26,0,0,2,3,0,0,"Knox County",470313,8.7175987055429,0.0960187353629977,5.52823332546623,0.850497434687113,9.60187353629976
2020-03-22,9,2,9,2,0,0,5,0,109,9,114,9,0,0,1,1,0,0,"Knox County",470313,7.44185255351224,0.0884718498659517,1.913619228046,0.425248717343556,8.84718498659517
2020-03-21,7,1,7,1,0,0,5,2,100,17,105,19,0,0,0,0,0,0,"Knox County",470313,6.16610640148157,0.0895061728395062,4.03986281476378,0.212624358671778,8.95061728395062
2020-03-20,6,5,6,5,0,0,3,2,83,38,86,40,0,0,0,0,0,0,"Knox County",470313,6.8039794774969,0.0941558441558442,8.50497434687113,1.06312179335889,9.41558441558442
2020-03-19,1,0,1,0,0,0,1,0,45,11,46,11,0,0,0,0,0,0,"Knox County",470313,5.31560896679445,0.0956521739130435,2.33886794538956,0,9.56521739130435
2020-03-18,1,0,1,0,0,0,1,0,34,15,35,15,0,0,0,0,0,0,"Knox County",470313,4.03986281476378,0.0882352941176471,3.18936538007667,0,8.82352941176471
2020-03-17,1,0,1,0,0,0,1,0,19,5,20,5,0,0,0,0,0,0,"Knox County",470313,2.55149230406134,0.064,1.06312179335889,0,6.4
2020-03-16,1,1,1,1,0,0,1,1,14,3,15,4,0,0,0,0,0,0,"Knox County",470313,1.913619228046,0.0485436893203883,0.850497434687113,0.212624358671778,4.85436893203883
2020-03-15,0,0,0,0,0,0,0,0,11,1,11,1,0,0,0,0,0,0,"Knox County",470313,1.48837051070245,0.0526315789473684,0.212624358671778,0,5.26315789473684
2020-03-14,0,0,0,0,0,0,0,0,10,8,10,8,0,0,0,0,0,0,"Knox County",470313,1.27574615203067,0.0357142857142857,1.70099486937423,0,3.57142857142857
2020-03-13,0,0,0,0,0,0,0,0,2,0,2,0,0,0,0,0,0,0,"Knox County",470313,0.212624358671778,0.0227272727272727,0,0,2.27272727272727
2020-03-12,0,0,0,0,0,0,0,0,2,2,2,2,0,0,0,0,0,0,"Knox County",470313,0.212624358671778,0.0285714285714286,0.425248717343556,0,2.85714285714286
2020-03-12,0,0,0,0,0,0,0,0,0,0,0,0,0,0,0,0,0,0,"Anderson",76978,NA,NA,0,0,NA
2020-03-13,0,0,0,0,0,0,0,0,1,1,1,1,0,0,0,0,0,0,"Anderson",76978,NA,NA,1.29907246226194,0,NA
2020-03-14,0,0,0,0,0,0,0,0,1,0,1,0,0,0,0,0,0,0,"Anderson",76978,NA,NA,0,0,NA
2020-03-15,0,0,0,0,0,0,0,0,1,0,1,0,0,0,0,0,0,0,"Anderson",76978,NA,NA,0,0,NA
2020-03-16,0,0,0,0,0,0,0,0,2,1,2,1,0,0,0,0,0,0,"Anderson",76978,NA,NA,1.29907246226194,0,NA
2020-03-17,0,0,0,0,0,0,0,0,4,2,4,2,0,0,0,0,0,0,"Anderson",76978,NA,NA,2.59814492452389,0,NA
2020-03-18,0,0,0,0,0,0,0,0,4,0,4,0,0,0,0,0,0,0,"Anderson",76978,0,0,0,0,0
2020-03-19,1,1,1,1,0,0,2,2,5,1,7,3,0,0,0,0,0,0,"Anderson",76978,1.29907246226194,0.285714285714286,3.89721738678583,1.29907246226194,28.5714285714286
2020-03-20,1,0,1,0,0,0,2,0,7,2,9,2,0,0,0,0,0,0,"Anderson",76978,1.29907246226194,0.25,2.59814492452389,0,25
2020-03-21,1,0,1,0,0,0,2,0,7,0,9,0,0,0,0,0,0,0,"Anderson",76978,1.29907246226194,0.25,0,0,25
2020-03-22,1,0,1,0,0,0,2,0,10,3,12,3,0,0,0,0,0,0,"Anderson",76978,1.29907246226194,0.181818181818182,3.89721738678583,0,18.1818181818182
2020-03-23,1,0,1,0,0,0,2,0,15,5,17,5,0,0,0,0,0,0,"Anderson",76978,1.29907246226194,0.133333333333333,6.49536231130973,0,13.3333333333333
2020-03-24,1,0,1,0,0,0,2,0,20,5,22,5,0,0,0,0,0,0,"Anderson",76978,1.29907246226194,0.111111111111111,6.49536231130973,0,11.1111111111111
2020-03-25,2,1,2,1,0,0,4,2,29,9,33,11,0,0,0,0,0,0,"Anderson",76978,2.59814492452389,0.137931034482759,14.2897970848814,1.29907246226194,13.7931034482759
2020-03-26,3,1,3,1,0,0,5,1,44,15,49,16,0,0,1,1,0,0,"Anderson",76978,2.59814492452389,0.0714285714285714,20.7851593961911,1.29907246226194,7.14285714285714
2020-03-27,4,1,4,1,0,0,6,1,53,9,59,10,0,0,0,1,0,0,"Anderson",76978,3.89721738678583,0.08,12.9907246226195,1.29907246226194,8
2020-03-28,7,3,7,3,0,0,9,3,72,19,81,22,0,0,1,2,0,0,"Anderson",76978,7.79443477357167,0.0972222222222222,28.5795941697628,3.89721738678583,9.72222222222222
2020-03-29,7,0,7,0,0,0,9,0,83,11,92,11,0,0,0,2,0,0,"Anderson",76978,7.79443477357167,0.0875,14.2897970848814,0,8.75
2020-03-30,8,1,8,1,0,0,10,1,127,44,137,45,0,0,0,2,0,0,"Anderson",76978,9.09350723583361,0.0666666666666667,58.4582608017875,1.29907246226194,6.66666666666667
2020-03-31,9,1,9,1,0,0,11,1,142,15,153,16,0,0,0,2,0,0,"Anderson",76978,10.3925796980956,0.0687022900763359,20.7851593961911,1.29907246226194,6.87022900763359
2020-04-01,9,0,9,0,0,0,11,0,163,21,174,21,0,0,0,2,0,0,"Anderson",76978,9.09350723583361,0.049645390070922,27.2805217075008,0,4.9645390070922
2020-04-02,9,0,9,0,0,0,11,0,179,16,190,16,0,0,0,2,0,0,"Anderson",76978,7.79443477357167,0.0425531914893617,20.7851593961911,0,4.25531914893617
2020-04-03,9,0,9,0,0,0,11,0,192,13,203,13,0,0,0,2,0,0,"Anderson",76978,6.49536231130972,0.0347222222222222,16.8879420094053,0,3.47222222222222
2020-04-04,9,0,9,0,0,0,11,0,219,27,230,27,0,0,0,2,0,0,"Anderson",76978,2.59814492452389,0.0134228187919463,35.0749564810725,0,1.34228187919463
2020-04-05,9,0,9,0,0,0,11,0,248,29,259,29,0,0,0,2,0,0,"Anderson",76978,2.59814492452389,0.0119760479041916,37.6731014055964,0,1.19760479041916
2020-04-06,9,0,9,0,0,0,11,0,262,14,273,14,0,0,0,2,0,0,"Anderson",76978,1.29907246226194,0.00735294117647059,18.1870144716672,0,0.735294117647059
2020-04-07,10,1,10,1,0,0,12,1,304,42,316,43,0,0,0,2,0,0,"Anderson",76978,1.29907246226194,0.00613496932515337,55.8601158772636,1.29907246226194,0.613496932515337
2020-04-08,10,0,10,0,0,0,12,0,322,18,334,18,1,1,0,2,1,1,"Anderson",76978,1.29907246226194,0.00625,23.383304320715,0,0.625
2020-04-09,10,0,10,0,0,0,12,0,350,28,362,28,0,1,0,2,1,0,"Anderson",76978,1.29907246226194,0.00581395348837209,36.3740289433345,0,0.581395348837209
2020-04-10,10,0,10,0,0,0,12,0,366,16,378,16,0,1,0,2,1,0,"Anderson",76978,1.29907246226194,0.00571428571428571,20.7851593961911,0,0.571428571428571
2020-04-11,10,0,10,0,0,0,12,0,439,73,451,73,0,1,0,2,1,0,"Anderson",76978,1.29907246226194,0.00452488687782805,94.832289745122,0,0.452488687782805
2020-04-12,12,2,12,2,0,0,14,2,477,38,491,40,0,1,0,2,1,0,"Anderson",76978,3.89721738678583,0.0129310344827586,51.9628984904778,2.59814492452389,1.29310344827586
2020-04-13,13,1,13,1,0,0,15,1,514,37,529,38,0,1,0,2,1,0,"Anderson",76978,5.19628984904778,0.015625,49.3647535659539,1.29907246226194,1.5625
2020-04-14,13,0,13,0,0,0,15,0,526,12,541,12,0,1,0,2,1,0,"Anderson",76978,3.89721738678583,0.0133333333333333,15.5888695471433,0,1.33333333333333
2020-04-15,13,0,13,0,0,0,15,0,544,18,559,18,0,1,0,2,1,0,"Anderson",76978,3.89721738678583,0.0133333333333333,23.383304320715,0,1.33333333333333
2020-04-16,13,0,13,0,0,0,15,0,566,22,581,22,0,1,0,2,1,0,"Anderson",76978,3.89721738678583,0.0136986301369863,28.5795941697628,0,1.36986301369863
2020-04-17,13,0,13,0,0,0,15,0,586,20,601,20,0,1,0,2,1,0,"Anderson",76978,3.89721738678583,0.0134529147982063,25.9814492452389,0,1.34529147982063
2020-04-18,13,0,13,0,0,0,15,0,616,30,631,30,0,1,0,2,1,0,"Anderson",76978,3.89721738678583,0.0166666666666667,38.9721738678584,0,1.66666666666667
2020-04-19,14,1,14,1,0,0,16,1,628,12,644,13,0,1,0,2,1,0,"Anderson",76978,2.59814492452389,0.0130718954248366,16.8879420094053,1.29907246226194,1.30718954248366
2020-04-20,19,5,18,4,1,1,19,3,648,20,667,23,0,1,0,2,1,0,"Anderson",76978,7.79443477357167,0.0289855072463768,29.8786666320247,6.49536231130973,2.89855072463768
2020-04-21,20,1,19,1,1,0,22,3,1071,423,1093,426,0,1,0,2,1,0,"Anderson",76978,9.09350723583361,0.0126811594202899,553.404868923589,1.29907246226194,1.26811594202899
2020-04-22,21,1,20,1,1,0,24,2,1141,70,1165,72,0,1,0,2,1,0,"Anderson",76978,10.3925796980956,0.0148514851485149,93.53321728286,1.29907246226194,1.48514851485149
2020-04-23,21,0,20,0,1,0,24,0,1191,50,1215,50,0,1,0,2,1,0,"Anderson",76978,10.3925796980956,0.0141955835962145,64.9536231130973,0,1.41955835962145
2020-04-24,22,1,21,1,1,0,25,1,1299,108,1324,109,0,1,0,2,1,0,"Anderson",76978,11.6916521603575,0.0138312586445367,141.598898386552,1.29907246226194,1.38312586445367
2020-04-25,22,0,21,0,1,0,25,0,1336,37,1361,37,0,1,0,2,1,0,"Anderson",76978,11.6916521603575,0.0136986301369863,48.065681103692,0,1.36986301369863
2020-04-26,22,0,21,0,1,0,25,0,1372,36,1397,36,0,1,0,2,1,0,"Anderson",76978,10.3925796980956,0.0119521912350598,46.76660864143,0,1.19521912350598
2020-04-27,22,0,21,0,1,0,25,0,1411,39,1436,39,0,1,0,2,1,0,"Anderson",76978,3.89721738678583,0.00780234070221066,50.6638260282159,0,0.780234070221066
2020-04-28,22,0,21,0,1,0,25,0,1690,279,1715,279,0,1,0,2,1,0,"Anderson",76978,2.59814492452389,0.00482315112540193,362.441216971083,0,0.482315112540193
2020-04-29,26,4,25,4,1,0,28,3,2068,378,2096,381,0,1,0,2,1,0,"Anderson",76978,6.49536231130972,0.00429645542427497,494.946608121801,5.19628984904778,0.429645542427497
2020-04-30,26,0,25,0,1,0,29,1,2100,32,2129,33,0,1,0,2,1,0,"Anderson",76978,6.49536231130972,0.00547045951859956,42.8693912546442,0,0.547045951859956
2020-05-01,26,0,25,0,1,0,29,0,2152,52,2181,52,0,1,0,2,1,0,"Anderson",76978,5.19628984904778,0.00466744457409568,67.5517680376211,0,0.466744457409568
2020-05-02,26,0,25,0,1,0,29,0,2219,67,2248,67,0,1,0,2,1,0,"Anderson",76978,5.19628984904778,0.00450958286358512,87.0378549715503,0,0.450958286358512
2020-05-03,27,1,26,1,1,0,30,1,2312,93,2342,94,0,1,0,2,1,0,"Anderson",76978,6.49536231130972,0.00529100529100529,122.112811452623,1.29907246226194,0.529100529100529
2020-05-04,27,0,26,0,1,0,30,0,2404,92,2434,92,0,1,0,2,1,0,"Anderson",76978,6.49536231130972,0.00501002004008016,119.514666528099,0,0.501002004008016
2020-05-05,28,1,27,1,1,0,30,0,2473,69,2503,69,0,1,0,2,1,0,"Anderson",76978,7.79443477357167,0.00634517766497462,89.6359998960742,1.29907246226194,0.634517766497462
2020-05-06,30,2,29,2,1,0,31,1,2523,50,2554,51,0,1,0,2,1,0,"Anderson",76978,5.19628984904778,0.00655021834061135,66.2526955753592,2.59814492452389,0.655021834061135
2020-05-07,30,0,29,0,1,0,33,2,2595,72,2628,74,0,1,0,2,1,0,"Anderson",76978,5.19628984904778,0.00801603206412826,96.1313622073839,0,0.801603206412826
2020-05-08,30,0,29,0,1,0,33,0,2650,55,2683,55,0,1,0,2,1,0,"Anderson",76978,5.19628984904778,0.00796812749003984,71.448985424407,0,0.796812749003984
2020-05-09,30,0,29,0,1,0,33,0,2732,82,2765,82,0,1,0,2,1,0,"Anderson",76978,5.19628984904778,0.00773694390715667,106.523941905479,0,0.773694390715667
2020-05-10,30,0,29,0,1,0,33,0,2825,93,2858,93,0,1,0,2,1,0,"Anderson",76978,3.89721738678583,0.00581395348837209,120.813738990361,0,0.581395348837209
2020-05-11,32,2,31,2,1,0,33,0,2907,82,2940,82,0,1,0,2,1,0,"Anderson",76978,6.49536231130972,0.00592885375494071,106.523941905479,2.59814492452389,0.592885375494071
2020-05-12,33,1,32,1,1,0,35,2,3040,133,3075,135,0,1,0,2,1,0,"Anderson",76978,6.49536231130972,0.00874125874125874,175.374782405363,1.29907246226194,0.874125874125874
2020-05-13,35,2,34,2,1,0,38,3,3218,178,3256,181,0,1,1,3,1,0,"Anderson",76978,6.49536231130972,0.00997150997150997,235.132115669412,2.59814492452389,0.997150997150997
2020-05-14,35,0,34,0,1,0,39,1,3344,126,3383,127,0,1,0,3,1,0,"Anderson",76978,6.49536231130972,0.00794701986754967,164.982202707267,0,0.794701986754967
2020-05-15,36,1,35,1,1,0,39,0,3415,71,3454,71,0,1,0,3,1,0,"Anderson",76978,7.79443477357167,0.00778210116731518,92.2341448205981,1.29907246226194,0.778210116731518
2020-05-16,36,0,35,0,1,0,41,2,3655,240,3696,242,0,1,0,3,1,0,"Anderson",76978,7.79443477357167,0.00859291084854995,314.375535867391,0,0.859291084854995
2020-05-17,36,0,35,0,1,0,41,0,3725,70,3766,70,0,1,0,3,1,0,"Anderson",76978,7.79443477357167,0.00881057268722467,90.9350723583361,0,0.881057268722467
2020-05-18,37,1,36,1,1,0,42,1,3802,77,3844,78,0,1,0,3,1,0,"Anderson",76978,6.49536231130972,0.00995575221238938,101.327652056432,1.29907246226194,0.995575221238938
2020-05-19,37,0,36,0,1,0,42,0,3854,52,3896,52,0,1,0,3,1,0,"Anderson",76978,5.19628984904778,0.00852618757612668,67.5517680376211,0,0.852618757612667
2020-05-20,37,0,36,0,1,0,43,1,3919,65,3962,66,0,1,0,3,1,0,"Anderson",76978,2.59814492452389,0.00708215297450425,85.7387825092884,0,0.708215297450425
2020-05-21,37,0,36,0,1,0,44,1,3999,80,4043,81,0,1,0,3,1,0,"Anderson",76978,2.59814492452389,0.00757575757575758,105.224869443218,0,0.757575757575758
2020-05-22,38,1,37,1,1,0,45,1,4027,28,4072,29,0,1,1,4,1,0,"Anderson",76978,2.59814492452389,0.00970873786407767,37.6731014055964,1.29907246226194,0.970873786407767
2020-05-23,38,0,37,0,1,0,46,1,4190,163,4236,164,0,1,0,4,1,0,"Anderson",76978,2.59814492452389,0.00925925925925926,213.047883810959,0,0.925925925925926
2020-05-24,38,0,37,0,1,0,46,0,4245,55,4291,55,0,1,0,4,1,0,"Anderson",76978,2.59814492452389,0.00952380952380952,71.448985424407,0,0.952380952380952
2020-05-25,38,0,37,0,1,0,47,1,4279,34,4326,35,0,1,0,4,1,0,"Anderson",76978,1.29907246226194,0.0103734439834025,45.4675361791681,0,1.03734439834025
2020-05-26,38,0,37,0,1,0,47,0,4410,131,4457,131,0,1,0,4,1,0,"Anderson",76978,1.29907246226194,0.0089126559714795,170.178492556315,0,0.89126559714795
2020-05-27,38,0,37,0,1,0,47,0,4513,103,4560,103,0,1,0,4,1,0,"Anderson",76978,1.29907246226194,0.00668896321070234,133.80446361298,0,0.668896321070234
2020-05-28,38,0,37,0,1,0,47,0,4561,48,4608,48,0,1,0,4,1,0,"Anderson",76978,1.29907246226194,0.00530973451327434,62.3554781885734,0,0.530973451327434
2020-05-29,39,1,38,1,1,0,47,0,4611,50,4658,50,0,1,0,4,1,0,"Anderson",76978,1.29907246226194,0.00341296928327645,64.9536231130973,1.29907246226194,0.341296928327645
2020-05-30,39,0,38,0,1,0,48,1,4663,52,4711,53,0,1,0,4,1,0,"Anderson",76978,1.29907246226194,0.00421052631578947,68.8508404998831,0,0.421052631578947
2020-05-31,40,1,39,1,1,0,49,1,4729,66,4778,67,0,1,0,4,1,0,"Anderson",76978,2.59814492452389,0.00616016427104723,87.0378549715503,1.29907246226194,0.616016427104723
2020-06-01,40,0,39,0,1,0,49,0,4853,124,4902,124,0,1,0,4,1,0,"Anderson",76978,2.59814492452389,0.00347222222222222,161.084985320481,0,0.347222222222222
2020-06-02,40,0,39,0,1,0,49,0,4980,127,5029,127,0,1,0,4,1,0,"Anderson",76978,2.59814492452389,0.0034965034965035,164.982202707267,0,0.34965034965035
2020-06-03,41,1,40,1,1,0,50,1,5040,60,5090,61,0,1,0,4,2,1,"Anderson",76978,3.89721738678583,0.00566037735849057,79.2434201979787,1.29907246226194,0.566037735849057
2020-06-04,41,0,40,0,1,0,50,0,5088,48,5138,48,1,2,0,4,2,0,"Anderson",76978,3.89721738678583,0.00566037735849057,62.3554781885734,0,0.566037735849057
2020-06-05,42,1,41,1,1,0,53,3,5145,57,5198,60,0,2,0,4,2,0,"Anderson",76978,3.89721738678583,0.0111111111111111,77.9443477357167,1.29907246226194,1.11111111111111
2020-06-06,43,1,42,1,1,0,54,1,5198,53,5252,54,0,2,0,4,2,0,"Anderson",76978,5.19628984904778,0.011090573012939,70.149912962145,1.29907246226194,1.1090573012939
2020-06-07,45,2,43,1,2,1,57,3,5293,95,5350,98,0,2,0,4,2,0,"Anderson",76978,6.49536231130972,0.013986013986014,127.309101301671,2.59814492452389,1.3986013986014
2020-06-08,46,1,44,1,2,0,57,0,5334,41,5391,41,0,2,0,4,2,0,"Anderson",76978,7.79443477357167,0.016359918200409,53.2619709527397,1.29907246226194,1.6359918200409
2020-06-09,47,1,45,1,2,0,60,3,5515,181,5575,184,0,2,0,4,2,0,"Anderson",76978,9.09350723583361,0.0201465201465201,239.029333056198,1.29907246226194,2.01465201465201
2020-06-10,52,5,50,5,2,0,63,3,5723,208,5786,211,0,2,0,4,2,0,"Anderson",76978,14.2897970848814,0.0186781609195402,274.10428953727,6.49536231130973,1.86781609195402
2020-06-11,55,3,53,3,2,0,66,3,5868,145,5934,148,0,2,1,5,2,0,"Anderson",76978,18.1870144716672,0.0201005025125628,192.262724414768,3.89721738678583,2.01005025125628
2020-06-12,57,2,55,2,2,0,70,4,5950,82,6020,86,0,2,0,5,2,0,"Anderson",76978,19.4860869339292,0.0206812652068127,111.720231754527,2.59814492452389,2.06812652068127
2020-06-13,58,1,55,0,3,1,70,0,5993,43,6063,43,0,2,0,5,2,0,"Anderson",76978,19.4860869339292,0.0197287299630086,55.8601158772636,1.29907246226194,1.97287299630086
2020-06-14,60,2,57,2,3,0,70,0,6168,175,6238,175,0,2,1,6,2,0,"Anderson",76978,19.4860869339292,0.0146396396396396,227.33768089584,2.59814492452389,1.46396396396396
2020-06-15,60,0,57,0,3,0,71,1,6226,58,6297,59,0,2,0,6,2,0,"Anderson",76978,18.1870144716672,0.0154525386313466,76.6452752734548,0,1.54525386313466
2020-06-16,64,4,61,4,3,0,75,4,6287,61,6362,65,0,2,0,6,2,0,"Anderson",76978,22.0842318584531,0.0190597204574333,84.4397100470264,5.19628984904778,1.90597204574333
2020-06-17,66,2,63,2,3,0,79,4,6324,37,6403,41,0,2,0,6,2,0,"Anderson",76978,18.1870144716672,0.0259319286871961,53.2619709527397,2.59814492452389,2.59319286871961
2020-06-18,70,4,67,4,3,0,84,5,6454,130,6538,135,0,2,0,6,2,0,"Anderson",76978,19.4860869339292,0.0298013245033113,175.374782405363,5.19628984904778,2.98013245033113
2020-06-19,72,2,69,2,3,0,86,2,6519,65,6605,67,0,2,0,6,2,0,"Anderson",76978,19.4860869339292,0.0273504273504274,87.0378549715503,2.59814492452389,2.73504273504274
2020-06-20,73,1,70,1,3,0,87,1,6557,38,6644,39,0,2,0,6,2,0,"Anderson",76978,19.4860869339292,0.0292598967297762,50.6638260282159,1.29907246226194,2.92598967297762
2020-06-21,74,1,71,1,3,0,88,1,6617,60,6705,61,0,2,0,6,2,0,"Anderson",76978,18.1870144716672,0.0385438972162741,79.2434201979787,1.29907246226194,3.85438972162741
2020-06-22,76,2,73,2,3,0,90,2,6709,92,6799,94,0,2,1,7,2,0,"Anderson",76978,20.7851593961911,0.0378486055776892,122.112811452623,2.59814492452389,3.78486055776892
2020-06-23,76,0,73,0,3,0,90,0,6798,89,6888,89,0,2,0,7,2,0,"Anderson",76978,15.5888695471433,0.0285171102661597,115.617449141313,0,2.85171102661597
2020-06-24,77,1,74,1,3,0,91,1,6829,31,6920,32,0,2,0,7,2,0,"Anderson",76978,14.2897970848814,0.02321083172147,41.5703187923822,1.29907246226194,2.321083172147
2020-06-25,81,4,78,4,3,0,92,1,6942,113,7034,114,0,2,0,7,2,0,"Anderson",76978,14.2897970848814,0.0161290322580645,148.094260697862,5.19628984904778,1.61290322580645
2020-06-26,86,5,83,5,3,0,98,6,6970,28,7068,34,0,2,0,7,2,0,"Anderson",76978,18.1870144716672,0.0259179265658747,44.1684637169061,6.49536231130973,2.59179265658747
2020-06-27,87,1,83,0,4,1,98,0,6982,12,7080,12,0,2,0,7,2,0,"Anderson",76978,18.1870144716672,0.0252293577981651,15.5888695471433,1.29907246226194,2.52293577981651
2020-06-28,91,4,87,4,4,0,106,8,7091,109,7197,117,0,2,0,7,2,0,"Anderson",76978,22.0842318584531,0.0365853658536585,151.991478084648,5.19628984904778,3.65853658536585
2020-06-29,97,6,92,5,5,1,114,8,7313,222,7427,230,0,2,1,8,2,0,"Anderson",76978,27.2805217075008,0.0382165605095541,298.786666320247,7.79443477357167,3.82165605095541
2020-06-30,102,5,96,4,6,1,120,6,7477,164,7597,170,0,2,0,8,2,0,"Anderson",76978,33.7758840188106,0.0423131170662905,220.842318584531,6.49536231130973,4.23131170662905
2020-07-01,104,2,98,2,6,0,124,4,7598,121,7722,125,0,2,0,8,2,0,"Anderson",76978,35.0749564810725,0.0411471321695761,162.384057782743,2.59814492452389,4.11471321695761
2020-07-02,110,6,104,6,6,0,130,6,7837,239,7967,245,0,2,0,8,2,0,"Anderson",76978,37.6731014055964,0.0407288317256163,318.272753254177,7.79443477357167,4.07288317256163
2020-07-03,120,10,113,9,7,1,142,12,7961,124,8103,136,0,2,0,8,2,0,"Anderson",76978,44.1684637169061,0.042512077294686,176.673854867625,12.9907246226195,4.2512077294686
2020-07-04,131,11,124,11,7,0,156,14,8145,184,8301,198,0,2,2,10,2,0,"Anderson",76978,57.1591883395256,0.0475020475020475,257.216347527865,14.2897970848814,4.75020475020475
2020-07-05,140,9,133,9,7,0,169,13,8301,156,8470,169,0,2,1,11,2,0,"Anderson",76978,63.6545506508353,0.0494893951296151,219.543246122269,11.6916521603575,4.94893951296151
2020-07-06,141,1,134,1,7,0,170,1,8328,27,8498,28,0,2,0,11,2,0,"Anderson",76978,57.1591883395256,0.0522875816993464,36.3740289433345,1.29907246226194,5.22875816993464
2020-07-07,157,16,150,16,7,0,190,20,8561,233,8751,253,0,2,0,11,2,0,"Anderson",76978,71.448985424407,0.0606585788561525,328.665332952272,20.7851593961911,6.06585788561525
2020-07-08,173,16,165,15,8,1,206,16,8701,140,8907,156,0,2,0,11,2,0,"Anderson",76978,89.6359998960742,0.0691983122362869,202.655304112863,20.7851593961911,6.91983122362869
2020-07-09,187,14,179,14,8,0,220,14,8969,268,9189,282,0,2,0,11,2,0,"Anderson",76978,100.02857959417,0.0736497545008183,366.338434357868,18.1870144716672,7.36497545008183
2020-07-10,193,6,185,6,8,0,227,7,8999,30,9226,37,0,2,1,12,2,0,"Anderson",76978,94.832289745122,0.0756901157613535,48.065681103692,7.79443477357167,7.56901157613535
2020-07-11,201,8,193,8,8,0,235,8,9168,169,9403,177,0,2,1,13,2,0,"Anderson",76978,90.9350723583361,0.0716878402903811,229.935825820364,10.3925796980956,7.16878402903811
2020-07-12,212,11,204,11,8,0,248,13,9351,183,9599,196,0,2,0,13,2,0,"Anderson",76978,93.53321728286,0.0699734278122232,254.618202603341,14.2897970848814,6.99734278122232
2020-07-13,218,6,209,5,9,1,255,7,9390,39,9645,46,0,2,2,15,2,0,"Anderson",76978,100.02857959417,0.0741063644289451,59.7573332640495,7.79443477357167,7.41063644289451
2020-07-14,229,11,219,10,10,1,266,11,9530,140,9796,151,0,2,0,15,2,0,"Anderson",76978,93.53321728286,0.0727272727272727,196.159941801554,14.2897970848814,7.27272727272727
2020-07-15,245,16,234,15,11,1,285,19,9632,102,9917,121,0,2,0,15,2,0,"Anderson",76978,93.53321728286,0.0782178217821782,157.187767933695,20.7851593961911,7.82178217821782
2020-07-16,263,18,252,18,11,0,308,23,9921,289,10229,312,0,2,1,16,2,0,"Anderson",76978,98.7295071319078,0.0846153846153846,405.310608225727,23.383304320715,8.46153846153846
2020-07-17,270,7,259,7,11,0,317,9,9992,71,10309,80,0,2,1,17,3,1,"Anderson",76978,100.02857959417,0.0831024930747922,103.925796980956,9.09350723583361,8.31024930747922
2020-07-18,277,7,266,7,11,0,328,11,10206,214,10534,225,0,2,0,17,3,0,"Anderson",76978,98.7295071319078,0.0822281167108753,292.291304008938,9.09350723583361,8.22281167108753
2020-07-19,285,8,274,8,11,0,337,9,10287,81,10624,90,0,2,2,19,3,0,"Anderson",76978,94.832289745122,0.0868292682926829,116.916521603575,10.3925796980956,8.68292682926829
2020-07-20,313,28,302,28,11,0,367,30,10456,169,10823,199,1,3,0,19,3,0,"Anderson",76978,123.411883914885,0.0950764006791171,258.515419990127,36.3740289433345,9.50764006791171
2020-07-21,336,23,324,22,12,1,391,24,10748,292,11139,316,0,3,1,20,3,0,"Anderson",76978,139.000753462028,0.0930752047654505,410.506898074775,29.8786666320247,9.30752047654505
2020-07-22,365,29,353,29,12,0,424,33,10883,135,11307,168,0,3,0,20,3,0,"Anderson",76978,155.888695471433,0.1,218.244173660007,37.6731014055964,10
2020-07-23,388,23,376,23,12,0,455,31,11310,427,11765,458,0,3,2,22,3,0,"Anderson",76978,162.384057782743,0.095703125,594.975187715971,29.8786666320247,9.5703125
2020-07-24,394,6,382,6,12,0,463,8,11422,112,11885,120,0,3,0,22,4,1,"Anderson",76978,161.084985320481,0.0926395939086294,155.888695471433,7.79443477357167,9.26395939086294
2020-07-25,426,32,413,31,13,1,499,36,11679,257,12178,293,1,4,1,23,4,0,"Anderson",76978,193.56179687703,0.104014598540146,380.62823144275,41.5703187923822,10.4014598540146
2020-07-26,465,39,451,38,14,1,541,42,12082,403,12623,445,0,4,2,25,4,0,"Anderson",76978,233.83304320715,0.102051025512756,578.087245706565,50.6638260282159,10.2051025512756
2020-07-27,483,18,468,17,15,1,562,21,12262,180,12824,201,0,4,1,26,4,0,"Anderson",76978,220.842318584531,0.0974512743628186,261.113564914651,23.383304320715,9.74512743628186
2020-07-28,523,40,508,40,15,0,608,46,12642,380,13250,426,0,4,1,27,5,1,"Anderson",76978,242.926550442984,0.10279488394126,553.404868923589,51.9628984904778,10.279488394126
2020-07-29,527,4,512,4,15,0,612,4,12678,36,13290,40,1,5,0,27,5,0,"Anderson",76978,210.449738886435,0.0948058497226425,51.9628984904778,5.19628984904778,9.48058497226425
2020-07-30,564,37,549,37,15,0,666,54,13163,485,13829,539,0,5,0,27,5,0,"Anderson",76978,228.636753358102,0.102228682170543,700.200057159188,48.065681103692,10.2228682170543
2020-07-31,576,12,561,12,15,0,680,14,13345,182,14025,196,0,5,0,27,5,0,"Anderson",76978,236.431188131674,0.101401869158878,254.618202603341,15.5888695471433,10.1401869158878
2020-08-01,599,23,584,23,15,0,705,25,13754,409,14459,434,0,5,1,28,5,0,"Anderson",76978,224.739535971316,0.0903112669881631,563.797448621684,29.8786666320247,9.03112669881631
2020-08-02,606,7,591,7,15,0,712,7,13882,128,14594,135,0,5,1,29,6,1,"Anderson",76978,183.169217178934,0.0867579908675799,175.374782405363,9.09350723583361,8.67579908675799
2020-08-03,631,25,615,24,16,1,743,31,14109,227,14852,258,0,5,0,29,6,0,"Anderson",76978,192.262724414768,0.0892504930966469,335.160695263582,32.4768115565486,8.92504930966469
2020-08-04,638,7,622,7,16,0,751,8,14352,243,15103,251,2,7,0,29,6,0,"Anderson",76978,149.393333160124,0.0771721532649757,326.067188027748,9.09350723583361,7.71721532649757
2020-08-05,653,15,637,15,16,0,770,19,14561,209,15331,228,-1,6,0,29,6,0,"Anderson",76978,163.683130245005,0.0774130328270456,296.188521395723,19.4860869339292,7.74130328270456
2020-08-06,675,22,659,22,16,0,800,30,14882,321,15682,351,0,6,1,30,6,0,"Anderson",76978,144.197043311076,0.0723151645979493,455.974434253943,28.5795941697628,7.23151645979493
2020-08-07,679,4,663,4,16,0,804,4,14963,81,15767,85,0,6,0,30,6,0,"Anderson",76978,133.80446361298,0.0711825487944891,110.421159292265,5.19628984904778,7.11825487944891
2020-08-08,690,11,674,11,16,0,820,16,15283,320,16103,336,0,6,0,30,6,0,"Anderson",76978,118.215594065837,0.0699513381995134,436.488347320014,14.2897970848814,6.99513381995134
2020-08-09,697,7,681,7,16,0,829,9,15420,137,16249,146,0,6,0,30,6,0,"Anderson",76978,118.215594065837,0.0706948640483384,189.664579490244,9.09350723583361,7.06948640483384
2020-08-10,702,5,686,5,16,0,835,6,15559,139,16394,145,0,6,0,30,6,0,"Anderson",76978,92.2341448205981,0.059662775616083,188.365507027982,6.49536231130973,5.9662775616083
2020-08-11,723,21,707,21,16,0,857,22,15762,203,16619,225,0,6,1,31,6,0,"Anderson",76978,110.421159292265,0.0699208443271768,292.291304008938,27.2805217075008,6.99208443271768
2020-08-12,731,8,715,8,16,0,865,8,16001,239,16866,247,0,6,0,31,6,0,"Anderson",76978,101.327652056432,0.0618892508143322,320.8708981787,10.3925796980956,6.18892508143322
2020-08-13,749,18,733,18,16,0,889,24,16229,228,17118,252,1,7,2,33,6,0,"Anderson",76978,96.1313622073839,0.0619777158774373,327.36626049001,23.383304320715,6.19777158774373
2020-08-14,766,17,749,16,17,1,911,22,16558,329,17469,351,0,7,0,33,6,0,"Anderson",76978,113.019304216789,0.0628672150411281,455.974434253943,22.0842318584531,6.28672150411281
2020-08-15,776,10,759,10,17,0,923,12,16781,223,17704,235,-1,6,0,33,6,0,"Anderson",76978,111.720231754527,0.0643347907557776,305.282028631557,12.9907246226195,6.43347907557776
2020-08-16,788,12,771,12,17,0,937,14,16923,142,17860,156,0,6,0,33,7,1,"Anderson",76978,118.215594065837,0.0670391061452514,202.655304112863,15.5888695471433,6.70391061452514
2020-08-17,792,4,775,4,17,0,940,3,16966,43,17906,46,0,6,0,33,7,0,"Anderson",76978,116.916521603575,0.0694444444444444,59.7573332640495,5.19628984904778,6.94444444444444
2020-08-18,806,14,789,14,17,0,957,17,17129,163,18086,180,0,6,0,33,7,0,"Anderson",76978,107.823014367741,0.0681663258350375,233.83304320715,18.1870144716672,6.81663258350375
2020-08-19,820,14,803,14,17,0,971,14,17303,174,18274,188,0,6,0,33,7,0,"Anderson",76978,115.617449141313,0.0752840909090909,244.225622905246,18.1870144716672,7.52840909090909
2020-08-20,835,15,818,15,17,0,987,16,17745,442,18732,458,0,6,0,33,8,1,"Anderson",76978,111.720231754527,0.0607187112763321,594.975187715971,19.4860869339292,6.07187112763321
2020-08-21,838,3,821,3,17,0,990,3,17781,36,18771,39,1,7,0,33,8,0,"Anderson",76978,93.53321728286,0.0606758832565284,50.6638260282159,3.89721738678583,6.06758832565284
2020-08-22,856,18,839,18,17,0,1009,19,18325,544,19334,563,1,8,1,34,8,0,"Anderson",76978,103.925796980956,0.052760736196319,731.377796253475,23.383304320715,5.2760736196319
2020-08-23,857,1,840,1,17,0,1010,1,18409,84,19419,85,0,8,0,34,8,0,"Anderson",76978,89.6359998960742,0.0468248877485568,110.421159292265,1.29907246226194,4.68248877485568
2020-08-24,858,1,840,0,18,1,1010,0,18448,39,19458,39,0,8,0,34,8,0,"Anderson",76978,85.7387825092884,0.0451030927835052,50.6638260282159,1.29907246226194,4.51030927835052
2020-08-25,866,8,848,8,18,0,1018,8,18600,152,19618,160,0,8,1,35,8,0,"Anderson",76978,77.9443477357167,0.0398172323759791,207.851593961911,10.3925796980956,3.98172323759791
2020-08-26,872,6,854,6,18,0,1024,6,18780,180,19804,186,0,8,0,35,8,0,"Anderson",76978,67.5517680376211,0.034640522875817,241.627477980722,7.79443477357167,3.4640522875817
2020-08-27,875,3,857,3,18,0,1027,3,19191,411,20218,414,0,8,0,35,8,0,"Anderson",76978,51.9628984904778,0.0269179004037685,537.815999376445,3.89721738678583,2.69179004037685
2020-08-28,875,0,857,0,18,0,1027,0,19229,38,20256,38,0,8,0,35,8,0,"Anderson",76978,48.065681103692,0.0249158249158249,49.3647535659539,0,2.49158249158249
2020-08-29,884,9,865,8,19,1,1035,8,19491,262,20526,270,0,8,0,35,8,0,"Anderson",76978,36.3740289433345,0.0218120805369128,350.749564810725,11.6916521603575,2.18120805369128
2020-08-30,900,16,881,16,19,0,1051,16,19574,83,20625,99,0,8,0,35,8,0,"Anderson",76978,55.8601158772636,0.0339966832504146,128.608173763933,20.7851593961911,3.39966832504146
2020-08-31,902,2,883,2,19,0,1053,2,19632,58,20685,60,0,8,0,35,8,0,"Anderson",76978,57.1591883395256,0.0350448247758761,77.9443477357167,2.59814492452389,3.50448247758761
2020-09-01,909,7,889,6,20,1,1059,6,19743,111,20802,117,0,8,0,35,8,0,"Anderson",76978,55.8601158772636,0.0346283783783784,151.991478084648,9.09350723583361,3.46283783783784
2020-09-02,917,8,895,6,22,2,1069,10,20059,316,21128,326,0,8,0,35,8,0,"Anderson",76978,58.4582608017875,0.033987915407855,423.497622697394,10.3925796980956,3.3987915407855
2020-09-03,933,16,909,14,24,2,1085,16,20383,324,21468,340,0,8,0,35,9,1,"Anderson",76978,75.3462028111928,0.0464,441.684637169061,20.7851593961911,4.64
2020-09-04,942,9,917,8,25,1,1095,10,20572,189,21667,199,0,8,0,35,9,0,"Anderson",76978,87.0378549715503,0.0481927710843374,258.515419990127,11.6916521603575,4.81927710843374
2020-09-05,961,19,936,19,25,0,1116,21,20841,269,21957,290,0,8,1,36,10,1,"Anderson",76978,100.02857959417,0.0566037735849057,376.731014055964,24.682376782977,5.66037735849057
2020-09-06,963,2,938,2,25,0,1118,2,20897,56,22015,58,0,8,0,36,10,0,"Anderson",76978,81.8415651225025,0.0482014388489209,75.3462028111928,2.59814492452389,4.82014388489209
2020-09-07,966,3,941,3,25,0,1123,5,20985,88,22108,93,0,8,0,36,10,0,"Anderson",76978,83.1406375847645,0.0491918482080112,120.813738990361,3.89721738678583,4.91918482080112
2020-09-08,975,9,944,3,31,6,1127,4,21160,175,22287,179,1,9,0,36,10,0,"Anderson",76978,85.7387825092884,0.0457912457912458,232.533970744888,11.6916521603575,4.57912457912458
2020-09-09,984,9,953,9,31,0,1136,9,21401,241,22537,250,0,9,1,37,11,1,"Anderson",76978,87.0378549715503,0.0475514549325763,324.768115565486,11.6916521603575,4.75514549325763
2020-09-10,1013,29,981,28,32,1,1166,30,21770,369,22936,399,1,10,0,37,11,0,"Anderson",76978,103.925796980956,0.0551771117166213,518.329912442516,37.6731014055964,5.51771117166213
2020-09-11,1014,1,982,1,32,0,1168,2,21903,133,23071,135,0,10,0,37,11,0,"Anderson",76978,93.53321728286,0.051994301994302,175.374782405363,1.29907246226194,5.1994301994302
2020-09-12,1017,3,985,3,32,0,1173,5,22045,142,23218,147,0,10,0,37,11,0,"Anderson",76978,72.7480578866689,0.0452022204599524,190.963651952506,3.89721738678583,4.52022204599524
2020-09-13,1038,21,1005,20,33,1,1194,21,22289,244,23483,265,0,10,1,38,11,0,"Anderson",76978,97.4304346696459,0.0517711171662125,344.254202499415,27.2805217075008,5.17711171662125
2020-09-14,1044,6,1010,5,34,1,1200,6,22395,106,23595,112,0,10,1,39,11,0,"Anderson",76978,101.327652056432,0.0517821116341627,145.496115773338,7.79443477357167,5.17821116341627
2020-09-15,1060,16,1026,16,34,0,1217,17,22635,240,23852,257,1,11,1,40,12,1,"Anderson",76978,110.421159292265,0.0575079872204473,333.86162280132,20.7851593961911,5.75079872204473
2020-09-16,1068,8,1034,8,34,0,1229,12,22771,136,24000,148,0,11,0,40,12,0,"Anderson",76978,109.122086830003,0.063568010936432,192.262724414768,10.3925796980956,6.3568010936432
2020-09-17,1090,22,1054,20,36,2,1249,20,23192,421,24441,441,0,11,1,41,12,0,"Anderson",76978,100.02857959417,0.0551495016611296,572.890955857518,28.5795941697628,5.51495016611296
2020-09-18,1109,19,1073,19,36,0,1267,18,23416,224,24683,242,0,11,0,41,12,0,"Anderson",76978,123.411883914885,0.0614143920595533,314.375535867391,24.682376782977,6.14143920595533
2020-09-19,1124,15,1088,15,36,0,1288,21,23698,282,24986,303,0,11,1,42,12,0,"Anderson",76978,139.000753462028,0.0650452488687783,393.618956065369,19.4860869339292,6.50452488687783
2020-09-20,1131,7,1095,7,36,0,1298,10,23850,152,25148,162,0,11,0,42,13,1,"Anderson",76978,120.813738990361,0.0624624624624625,210.449738886435,9.09350723583361,6.24624624624625
2020-09-21,1133,2,1097,2,36,0,1300,2,23883,33,25183,35,0,11,0,42,13,0,"Anderson",76978,115.617449141313,0.0629722921914358,45.4675361791681,2.59814492452389,6.29722921914358
2020-09-22,1147,14,1111,14,36,0,1317,17,24131,248,25448,265,0,11,1,43,13,0,"Anderson",76978,113.019304216789,0.06265664160401,344.254202499415,18.1870144716672,6.265664160401
2020-09-23,1147,0,1111,0,36,0,1317,0,24172,41,25489,41,0,11,0,43,13,0,"Anderson",76978,102.626724518694,0.0591000671591672,53.2619709527397,0,5.91000671591672
2020-09-24,1160,13,1124,13,36,0,1332,15,24496,324,25828,339,1,12,0,43,13,0,"Anderson",76978,90.9350723583361,0.0598413842826244,440.385564706799,16.8879420094053,5.98413842826244
2020-09-25,1174,14,1137,13,37,1,1345,13,24732,236,26077,249,1,13,0,43,13,0,"Anderson",76978,84.4397100470264,0.0559540889526542,323.469043103224,18.1870144716672,5.59540889526542
2020-09-26,1188,14,1151,14,37,0,1362,17,25031,299,26393,316,0,13,0,43,13,0,"Anderson",76978,83.1406375847645,0.0525941719971571,410.506898074775,18.1870144716672,5.25941719971571
2020-09-27,1207,19,1168,17,39,2,1378,16,25238,207,26616,223,0,13,0,43,13,0,"Anderson",76978,98.7295071319078,0.0544959128065395,289.693159084414,24.682376782977,5.44959128065395
2020-09-28,1210,3,1170,2,40,1,1380,2,25275,37,26655,39,0,13,0,43,13,0,"Anderson",76978,100.02857959417,0.0543478260869565,50.6638260282159,3.89721738678583,5.43478260869565
2020-09-29,1221,11,1180,10,41,1,1390,10,25569,294,26959,304,0,13,0,43,13,0,"Anderson",76978,96.1313622073839,0.0483123759099934,394.918028527631,14.2897970848814,4.83123759099934
2020-09-30,1233,12,1190,10,43,2,1400,10,25635,66,27035,76,0,13,0,43,13,0,"Anderson",76978,111.720231754527,0.0536869340232859,98.7295071319078,15.5888695471433,5.36869340232859
2020-10-01,1249,16,1204,14,45,2,1415,15,25915,280,27330,295,0,13,0,43,13,0,"Anderson",76978,115.617449141313,0.0552596537949401,383.226376367274,20.7851593961911,5.52596537949401
2020-10-02,1256,7,1210,6,46,1,1422,7,25997,82,27419,89,0,13,0,43,13,0,"Anderson",76978,106.523941905479,0.0573770491803279,115.617449141313,9.09350723583361,5.73770491803279
2020-10-03,1272,16,1226,16,46,0,1446,24,26261,264,27707,288,0,13,0,43,13,0,"Anderson",76978,109.122086830003,0.0639269406392694,374.13286913144,20.7851593961911,6.39269406392694
2020-10-04,1288,16,1240,14,48,2,1462,16,26598,337,28060,353,0,13,0,43,13,0,"Anderson",76978,105.224869443218,0.0581717451523546,458.572579178467,20.7851593961911,5.81717451523546
2020-10-05,1314,26,1265,25,49,1,1489,27,26809,211,28298,238,0,13,1,44,13,0,"Anderson",76978,135.103536075242,0.0663420572124163,309.179246018343,33.7758840188106,6.63420572124163
2020-10-06,1342,28,1292,27,50,1,1520,31,27146,337,28666,368,0,13,1,45,13,0,"Anderson",76978,157.187767933695,0.0761570005858231,478.058666112396,36.3740289433345,7.61570005858231
2020-10-07,1348,6,1298,6,50,0,1528,8,27381,235,28909,243,0,13,0,45,13,0,"Anderson",76978,149.393333160124,0.0683030949839915,315.674608329653,7.79443477357167,6.83030949839915
2020-10-08,1358,10,1306,8,52,2,1537,9,27620,239,29157,248,0,13,1,46,13,0,"Anderson",76978,141.598898386552,0.066776135741653,322.169970640962,12.9907246226195,6.6776135741653
2020-10-09,1373,15,1319,13,54,2,1553,16,27793,173,29346,189,0,13,0,46,13,0,"Anderson",76978,151.991478084648,0.0679813181110535,245.524695367508,19.4860869339292,6.79813181110535
2020-10-10,1389,16,1335,16,54,0,1573,20,28005,212,29578,232,0,13,1,47,14,1,"Anderson",76978,151.991478084648,0.0678781400320684,301.384811244771,20.7851593961911,6.78781400320684
2020-10-11,1417,28,1363,28,54,0,1604,31,28294,289,29898,320,0,13,0,47,14,0,"Anderson",76978,167.580347631791,0.0772578890097933,415.703187923822,36.3740289433345,7.72578890097933
2020-10-12,1433,16,1378,15,55,1,1620,16,28373,79,29993,95,0,13,0,47,14,0,"Anderson",76978,154.589623009171,0.0772861356932153,123.411883914885,20.7851593961911,7.72861356932153
2020-10-13,1453,20,1396,18,57,2,1638,18,28494,121,30132,139,0,13,0,47,14,0,"Anderson",76978,144.197043311076,0.0804911323328786,180.57107225441,25.9814492452389,8.04911323328786
2020-10-14,1475,22,1418,22,57,0,1662,24,28794,300,30456,324,0,13,0,47,14,0,"Anderson",76978,164.982202707267,0.0866192630898513,420.89947777287,28.5795941697628,8.66192630898513
2020-10-15,1497,22,1434,16,63,6,1676,14,28945,151,30621,165,0,13,1,48,14,0,"Anderson",76978,180.57107225441,0.0949453551912568,214.346956273221,28.5795941697628,9.49453551912568
2020-10-16,1504,7,1437,3,67,4,1680,4,29044,99,30724,103,0,13,0,48,15,1,"Anderson",76978,170.178492556315,0.0921625544267054,133.80446361298,9.09350723583361,9.21625544267054
2020-10-17,1532,28,1464,27,68,1,1710,30,29292,248,31002,278,0,13,2,50,15,0,"Anderson",76978,185.767362103458,0.0962078651685393,361.142144508821,36.3740289433345,9.62078651685393
2020-10-18,1551,19,1483,19,68,0,1732,22,29531,239,31263,261,0,13,0,50,15,0,"Anderson",76978,174.075709943101,0.0937728937728938,339.057912650368,24.682376782977,9.37728937728938
2020-10-19,1555,4,1487,4,68,0,1737,5,29608,77,31345,82,0,13,1,51,15,0,"Anderson",76978,158.486840395957,0.0865384615384615,106.523941905479,5.19628984904778,8.65384615384615
2020-10-20,1582,27,1514,27,68,0,1772,35,29807,199,31579,234,0,13,0,51,15,0,"Anderson",76978,167.580347631791,0.092605390463027,303.982956169295,35.0749564810725,9.2605390463027
2020-10-21,1599,17,1531,17,68,0,1791,19,30023,216,31814,235,0,13,1,52,15,0,"Anderson",76978,161.084985320481,0.0949926362297496,305.282028631557,22.0842318584531,9.49926362297496
2020-10-22,1620,21,1552,21,68,0,1816,25,30355,332,32171,357,1,14,0,52,15,0,"Anderson",76978,159.785912858219,0.0903225806451613,463.768869027514,27.2805217075008,9.03225806451613
2020-10-23,1635,15,1566,14,69,1,1832,16,30630,275,32462,291,0,14,0,52,15,0,"Anderson",76978,170.178492556315,0.0874568469505178,378.030086518226,19.4860869339292,8.74568469505178
2020-10-24,1666,31,1596,30,70,1,1865,33,31006,376,32871,409,0,14,2,54,17,2,"Anderson",76978,174.075709943101,0.082932049224184,531.320637065136,40.2712463301203,8.29320492241841
2020-10-25,1683,17,1612,16,71,1,1884,19,31202,196,33086,215,0,14,4,58,17,0,"Anderson",76978,171.477565018577,0.0833790455293472,279.300579386318,22.0842318584531,8.33790455293472
2020-10-26,1699,16,1627,15,72,1,1902,18,31336,134,33238,152,-1,13,1,59,17,0,"Anderson",76978,187.06643456572,0.0871632329635499,197.459014263816,20.7851593961911,8.71632329635499
2020-10-27,1728,29,1651,24,77,5,1926,24,31491,155,33417,179,1,14,2,61,17,0,"Anderson",76978,189.664579490244,0.0837867247007617,232.533970744888,37.6731014055964,8.37867247007617
2020-10-28,1784,56,1705,54,79,2,1985,59,31925,434,33910,493,0,14,0,61,17,0,"Anderson",76978,240.32840551846,0.092557251908397,640.442723895139,72.7480578866689,9.25572519083969
2020-10-29,1813,29,1726,21,87,8,2004,19,32131,206,34135,225,0,14,2,63,17,0,"Anderson",76978,250.720985216555,0.0957230142566191,292.291304008938,37.6731014055964,9.57230142566191
2020-10-30,1850,37,1760,34,90,3,2042,38,32282,151,34324,189,2,16,1,64,17,0,"Anderson",76978,279.300579386318,0.112781954887218,245.524695367508,48.065681103692,11.2781954887218
2020-10-31,1850,0,1760,0,90,0,2042,0,32283,1,34325,1,0,16,0,64,19,2,"Anderson",76978,239.029333056198,0.121733149931224,1.29907246226194,0,12.1733149931224
2020-11-01,1855,5,1765,5,90,0,2050,8,32527,244,34577,252,0,16,0,64,19,0,"Anderson",76978,223.440463509055,0.111334674714956,327.36626049001,6.49536231130973,11.1334674714956
2020-11-02,1888,33,1796,31,92,2,2085,35,32794,267,34879,302,0,16,0,64,20,1,"Anderson",76978,245.524695367508,0.111517367458867,392.319883603107,42.8693912546442,11.1517367458867
2020-11-03,1914,26,1821,25,93,1,2110,25,32974,180,35084,205,0,16,0,64,21,1,"Anderson",76978,241.627477980722,0.110377924415117,266.309854763699,33.7758840188106,11.0377924415117
2020-11-04,1932,18,1836,15,96,3,2128,18,33052,78,35180,96,2,18,1,65,21,0,"Anderson",76978,192.262724414768,0.11259842519685,124.710956377147,23.383304320715,11.259842519685
2020-11-05,1956,24,1854,18,102,6,2148,20,33151,99,35299,119,0,18,0,65,22,1,"Anderson",76978,185.767362103458,0.123711340206186,154.589623009171,31.1777390942867,12.3711340206186
2020-11-06,2005,49,1900,46,105,3,2197,49,33518,367,35715,416,0,18,2,67,23,1,"Anderson",76978,201.356231650601,0.111430625449317,540.414144300969,63.6545506508353,11.1430625449317
2020-11-07,2085,80,1977,77,108,3,2274,77,33965,447,36239,524,0,18,0,67,23,0,"Anderson",76978,305.282028631557,0.121212121212121,680.713970225259,103.925796980956,12.1212121212121
2020-11-08,2139,54,2028,51,111,3,2336,62,34575,610,36911,672,0,18,1,68,23,0,"Anderson",76978,368.936579282392,0.122536418166238,872.976694640027,70.149912962145,12.2536418166238
2020-11-09,2147,8,2035,7,112,1,2345,9,34649,74,36994,83,0,18,0,68,23,0,"Anderson",76978,336.459767725844,0.122931442080378,107.823014367741,10.3925796980956,12.2931442080378
2020-11-10,2166,19,2053,18,113,1,2367,22,34820,171,37187,193,0,18,1,69,23,0,"Anderson",76978,327.36626049001,0.122206371849738,250.720985216555,24.682376782977,12.2206371849738
2020-11-11,2205,39,2089,36,116,3,2409,42,35093,273,37502,315,1,19,1,70,23,0,"Anderson",76978,354.646782197511,0.121016365202412,409.207825612513,50.6638260282159,12.1016365202412
2020-11-12,2212,7,2095,6,117,1,2417,8,35291,198,37708,206,0,19,0,70,24,1,"Anderson",76978,332.562550339058,0.111664591116646,267.608927225961,9.09350723583361,11.1664591116646
2020-11-13,2268,56,2148,53,120,3,2476,59,35552,261,38028,320,2,21,2,72,24,0,"Anderson",76978,341.656057574892,0.120622568093385,415.703187923822,72.7480578866689,12.0622568093385
2020-11-14,2309,41,2188,40,121,1,2521,45,35948,396,38469,441,1,22,1,73,25,1,"Anderson",76978,290.992231546676,0.110762331838565,572.890955857518,53.2619709527397,11.0762331838565
2020-11-15,2407,98,2286,98,121,0,2629,108,36530,582,39159,690,1,23,1,74,25,0,"Anderson",76978,348.151419886201,0.130338078291815,896.359998960742,127.309101301671,13.0338078291815
2020-11-16,2456,49,2315,29,141,20,2658,29,36807,277,39465,306,0,23,1,75,25,0,"Anderson",76978,401.413390838941,0.126669364629705,397.516173452155,63.6545506508353,12.6669364629705
2020-11-17,2472,16,2330,15,142,1,2674,16,37012,205,39686,221,2,25,1,76,26,1,"Anderson",76978,397.516173452155,0.122849139655862,287.09501415989,20.7851593961911,12.2849139655862
2020-11-18,2502,30,2356,26,146,4,2700,26,37306,294,40006,320,0,25,0,76,27,1,"Anderson",76978,385.824521291798,0.116214057507987,415.703187923822,38.9721738678584,11.6214057507987
2020-11-19,2560,58,2410,54,150,4,2762,62,37722,416,40484,478,0,25,1,77,27,0,"Anderson",76978,452.077216867157,0.124279538904899,620.95663696121,75.3462028111928,12.4279538904899
2020-11-20,2590,30,2437,27,153,3,2793,31,37835,113,40628,144,0,25,0,77,28,1,"Anderson",76978,418.301332848346,0.121923076923077,187.06643456572,38.9721738678584,12.1923076923077
2020-11-21,2647,57,2486,49,161,8,2841,48,38179,344,41020,392,0,25,1,78,28,0,"Anderson",76978,439.086492244537,0.125441003528028,509.236405206682,74.0471303489309,12.5441003528028
2020-11-22,2703,56,2535,49,168,7,2898,57,38662,483,41560,540,0,25,1,79,31,3,"Anderson",76978,384.525448829536,0.112036651395252,701.49912962145,72.7480578866689,11.2036651395252
2020-11-23,2710,7,2541,6,169,1,2904,6,38684,22,41588,28,0,25,0,79,32,1,"Anderson",76978,329.964405414534,0.115873763542157,36.3740289433345,9.09350723583361,11.5873763542157
2020-11-24,2723,13,2553,12,170,1,2916,12,38841,157,41757,169,2,27,0,79,32,0,"Anderson",76978,326.067188027748,0.116851762433607,219.543246122269,16.8879420094053,11.6851762433607
2020-11-25,2751,28,2574,21,177,7,2937,21,38878,37,41815,58,1,28,0,79,32,0,"Anderson",76978,323.469043103224,0.131011608623549,75.3462028111928,36.3740289433345,13.1011608623549
2020-11-26,2796,45,2616,42,180,3,2982,45,39228,350,42210,395,0,28,1,80,33,1,"Anderson",76978,306.581101093819,0.127462340672074,513.133622593468,58.4582608017875,12.7462340672074
2020-11-27,2895,99,2706,90,189,9,3077,95,39654,426,42731,521,0,28,3,83,35,2,"Anderson",76978,396.217100989893,0.135045173561579,676.816752838473,128.608173763933,13.5045173561579
2020-11-28,2926,31,2731,25,195,6,3107,30,39797,143,42904,173,1,29,2,85,35,0,"Anderson",76978,362.441216971083,0.141188959660297,224.739535971316,40.2712463301203,14.1188959660297
2020-11-29,3017,91,2820,89,197,2,3203,96,40234,437,43437,533,0,29,1,86,35,0,"Anderson",76978,407.908753150251,0.162493340436867,692.405622385617,118.215594065837,16.2493340436867
2020-11-30,3087,70,2886,66,201,4,3276,73,40486,252,43762,325,0,29,0,86,37,2,"Anderson",76978,489.750318272753,0.171113155473781,422.198550235132,90.9350723583361,17.1113155473781
2020-12-01,3163,76,2952,66,211,10,3348,72,40916,430,44264,502,1,30,6,92,38,1,"Anderson",76978,571.591883395256,0.172317510969286,652.134376055496,98.7295071319078,17.2317510969286
2020-12-02,3178,15,2966,14,212,1,3364,16,41024,108,44388,124,0,30,0,92,38,0,"Anderson",76978,554.70394138585,0.165954139137194,161.084985320481,19.4860869339292,16.5954139137194
2020-12-03,3219,41,2995,29,224,12,3397,33,41249,225,44646,258,1,31,1,93,39,1,"Anderson",76978,549.507651536803,0.170361247947455,335.160695263582,53.2619709527397,17.0361247947455
2020-12-04,3286,67,3055,60,231,7,3460,63,41407,158,44867,221,1,32,0,93,39,0,"Anderson",76978,507.93733274442,0.179307116104869,287.09501415989,87.0378549715503,17.9307116104869
2020-12-05,3317,31,3074,19,243,12,3478,18,41474,67,44952,85,0,32,0,93,39,0,"Anderson",76978,507.93733274442,0.18115234375,110.421159292265,40.2712463301203,18.115234375
2020-12-06,3353,36,3103,29,250,7,3506,28,41682,208,45188,236,0,32,2,95,40,1,"Anderson",76978,436.488347320014,0.173043974871502,306.581101093819,46.76660864143,17.3043974871502
2020-12-07,3493,140,3227,124,266,16,3642,136,42275,593,45917,729,2,34,4,99,41,1,"Anderson",76978,527.42341967835,0.169837587006961,947.023824988958,181.870144716672,16.9837587006961
2020-12-08,3564,71,3276,49,288,22,3694,52,42573,298,46267,350,1,35,2,101,43,2,"Anderson",76978,520.92805736704,0.172740888667,454.675361791681,92.2341448205981,17.2740888666999
2020-12-09,3669,105,3367,91,302,14,3798,104,42834,261,46632,365,0,35,3,104,44,1,"Anderson",76978,637.844578970615,0.193404634581105,474.16144872561,136.402608537504,19.3404634581105
2020-12-10,3763,94,3445,78,318,16,3885,87,43365,531,47250,618,3,38,3,107,45,1,"Anderson",76978,706.695419470498,0.187403993855607,802.826781677882,122.112811452623,18.7403993855607
2020-12-11,3836,73,3498,53,338,20,3936,51,43531,166,47467,217,1,39,2,109,45,0,"Anderson",76978,714.48985424407,0.183076923076923,281.898724310842,94.832289745122,18.3076923076923
2020-12-12,3924,88,3559,61,365,27,4001,65,44044,513,48045,578,0,39,2,111,45,0,"Anderson",76978,788.536984593001,0.169091496928548,750.863883187404,114.318376679051,16.9091496928548
2020-12-13,4156,232,3742,183,414,49,4205,204,44916,872,49121,1076,1,40,0,111,47,2,"Anderson",76978,1043.15518719634,0.177726926010679,1397.80196939385,301.384811244771,17.7726926010679
2020-12-14,4271,115,3828,86,443,29,4304,99,45206,290,49510,389,0,40,1,112,48,1,"Anderson",76978,1010.67837563979,0.184247147230726,505.339187819897,149.393333160124,18.4247147230726
2020-12-15,4406,135,3913,85,493,50,4400,96,45733,527,50133,623,1,41,6,118,51,3,"Anderson",76978,1093.81901322456,0.182617692705639,809.322143989192,175.374782405363,18.2617692705639
2020-12-16,4475,69,3943,30,532,39,4436,36,46056,323,50492,359,2,43,4,122,52,1,"Anderson",76978,1047.05240458313,0.165284974093264,466.367013952038,89.6359998960742,16.5284974093264
2020-12-17,4676,201,4117,174,559,27,4630,194,46584,528,51214,722,2,45,2,124,54,2,"Anderson",76978,1186.05315804516,0.187941473259334,937.930317753124,261.113564914651,18.7941473259334
2020-12-18,4774,98,4193,76,581,22,4717,87,46950,366,51667,453,1,46,2,126,54,0,"Anderson",76978,1218.5299696017,0.185952380952381,588.479825404661,127.309101301671,18.5952380952381
2020-12-19,4879,105,4274,81,605,24,4804,87,47208,258,52012,345,0,46,1,127,55,1,"Anderson",76978,1240.61420146016,0.202419964708848,448.179999480371,136.402608537504,20.2419964708848
2020-12-20,5019,140,4396,122,623,18,4941,137,47672,464,52613,601,2,48,3,130,56,1,"Anderson",76978,1121.09953493206,0.210767468499427,780.742549819429,181.870144716672,21.0767468499427
2020-12-21,5066,47,4414,18,652,29,4964,23,47892,220,52856,243,3,51,2,132,59,3,"Anderson",76978,1032.76260749825,0.197250448296473,315.674608329653,61.0564057263114,19.7250448296473
2020-12-22,5136,70,4458,44,678,26,5011,47,47998,106,53009,153,1,52,2,134,64,5,"Anderson",76978,948.32289745122,0.212447844228095,198.758086726078,90.9350723583361,21.2447844228095
2020-12-23,5210,74,4500,42,710,32,5054,43,48314,316,53368,359,2,54,2,136,66,2,"Anderson",76978,954.81825976253,0.214881780250348,466.367013952038,96.1313622073839,21.4881780250348
2020-12-24,5268,58,4524,24,744,34,5081,27,48466,152,53547,179,1,55,1,137,71,5,"Anderson",76978,769.050897659071,0.193313330475782,232.533970744888,75.3462028111928,19.3313330475782
2020-12-25,5361,93,4601,77,760,16,5173,92,48875,409,54048,501,0,55,1,138,72,1,"Anderson",76978,762.555535347762,0.191516169676606,650.835303593234,120.813738990361,19.1516169676606
2020-12-26,5417,56,4630,29,787,27,5201,28,48994,119,54195,147,0,55,3,141,74,2,"Anderson",76978,698.900984696926,0.181859825927623,190.963651952506,72.7480578866689,18.1859825927623
2020-12-27,5477,60,4667,37,810,23,5237,36,49130,136,54367,172,1,56,6,147,75,1,"Anderson",76978,594.975187715971,0.168757126567845,223.440463509055,77.9443477357167,16.8757126567845
2020-12-28,5524,47,4688,21,836,26,5257,20,49199,69,54456,89,2,58,4,151,82,7,"Anderson",76978,594.975187715971,0.183125,115.617449141313,61.0564057263114,18.3125
2020-12-29,5620,96,4740,52,880,44,5305,48,49294,95,54599,143,2,60,5,156,85,3,"Anderson",76978,628.751071734781,0.184905660377358,185.767362103458,124.710956377147,18.4905660377358
2020-12-30,5655,35,4758,18,897,17,5322,17,49422,128,54744,145,6,66,1,157,88,3,"Anderson",76978,578.087245706566,0.194767441860465,188.365507027982,45.4675361791681,19.4767441860465
2020-12-31,5818,163,4858,100,960,63,5424,102,49726,304,55150,406,6,72,1,158,93,5,"Anderson",76978,714.48985424407,0.213973799126638,527.42341967835,211.748811348697,21.3973799126638
2021-01-01,5883,65,4900,42,983,23,5479,55,50002,276,55481,331,0,72,2,160,94,1,"Anderson",76978,678.115825300735,0.213538032100488,429.992985008704,84.4397100470264,21.3538032100488
2021-01-02,5976,93,4941,41,1035,52,5521,42,50287,285,55808,327,0,72,2,162,96,2,"Anderson",76978,726.181506404427,0.198388096714197,424.796695159656,120.813738990361,19.8388096714197
2021-01-03,6001,25,4953,12,1048,13,5537,16,50339,52,55876,68,0,72,1,163,99,3,"Anderson",76978,680.713970225259,0.198807157057654,88.3369274338123,32.4768115565486,19.8807157057654
2021-01-04,6038,37,4977,24,1061,13,5568,31,50446,107,56014,138,1,73,0,163,104,5,"Anderson",76978,667.72324560264,0.199614890885751,179.271999792148,48.065681103692,19.9614890885751
2021-01-05,6110,72,5008,31,1102,41,5599,31,50564,118,56163,149,2,75,2,165,107,3,"Anderson",76978,636.545506508353,0.187979539641944,193.56179687703,93.53321728286,18.7979539641944
2021-01-06,6185,75,5049,41,1136,34,5643,44,50725,161,56368,205,5,80,2,167,109,2,"Anderson",76978,688.508404998831,0.197660098522167,266.309854763699,97.4304346696459,19.7660098522167
2021-01-07,6290,105,5129,80,1161,25,5735,92,50946,221,56681,313,1,81,1,168,112,3,"Anderson",76978,613.162202187638,0.203135205747877,406.609680687989,136.402608537504,20.3135205747877
2021-01-08,6373,83,5180,51,1193,32,5787,52,51145,199,56932,251,5,86,2,170,115,3,"Anderson",76978,636.545506508353,0.212267401791868,326.067188027748,107.823014367741,21.2267401791868
2021-01-09,6483,110,5249,69,1234,41,5863,76,51576,431,57439,507,2,88,0,170,117,2,"Anderson",76978,658.629738366806,0.209687308399755,658.629738366806,142.897970848814,20.9687308399755
2021-01-10,6543,60,5274,25,1269,35,5888,25,51670,94,57558,119,2,90,3,173,118,1,"Anderson",76978,704.097274545974,0.208680142687277,154.589623009171,77.9443477357167,20.8680142687277
2021-01-11,6576,33,5284,10,1292,23,5901,13,51741,71,57642,84,1,91,1,174,120,2,"Anderson",76978,698.900984696926,0.204545454545455,109.122086830003,42.8693912546442,20.4545454545455
2021-01-12,6629,53,5318,34,1311,19,5939,38,51913,172,57852,210,2,93,1,175,120,0,"Anderson",76978,674.218607913949,0.201302545885139,272.805217075008,68.8508404998831,20.1302545885139
2021-01-13,6655,26,5335,17,1320,9,5958,19,52003,90,57961,109,3,96,0,175,121,1,"Anderson",76978,610.564057263114,0.19774011299435,141.598898386552,33.7758840188106,19.774011299435
2021-01-14,6752,97,5397,62,1355,35,6032,74,52410,407,58442,481,5,101,2,177,123,2,"Anderson",76978,600.171477565019,0.168654173764906,624.853854347995,126.010028839409,16.8654173764906
2021-01-15,6786,34,5417,20,1369,14,6056,24,52565,155,58621,179,0,101,1,178,126,3,"Anderson",76978,536.516926914183,0.159265837773831,232.533970744888,44.1684637169061,15.9265837773831
2021-01-16,6851,65,5448,31,1403,34,6090,34,52808,243,58898,277,1,102,1,179,129,3,"Anderson",76978,478.058666112396,0.155586017820425,359.843072046559,84.4397100470264,15.5586017820425
2021-01-17,6888,37,5468,20,1420,17,6113,23,52912,104,59025,127,0,102,0,179,131,2,"Anderson",76978,448.179999480371,0.153374233128834,164.982202707267,48.065681103692,15.3374233128834
2021-01-18,6907,19,5476,8,1431,11,6123,10,53008,96,59131,106,1,103,0,179,132,1,"Anderson",76978,429.992985008704,0.149093351242445,137.701680999766,24.682376782977,14.9093351242445
2021-01-19,6949,42,5493,17,1456,25,6143,20,53120,112,59263,132,1,104,0,179,134,2,"Anderson",76978,415.703187923822,0.144578313253012,171.477565018577,54.5610434150017,14.4578313253012
2021-01-20,6977,28,5509,16,1468,12,6162,19,53272,152,59434,171,3,107,0,179,137,3,"Anderson",76978,418.301332848346,0.138492871690428,222.141391046793,36.3740289433345,13.8492871690428
2021-01-21,7033,56,5549,40,1484,16,6201,39,53513,241,59714,280,5,112,2,181,138,1,"Anderson",76978,365.039361895607,0.132861635220126,363.740289433345,72.7480578866689,13.2861635220126
2021-01-22,7071,38,5567,18,1504,20,6223,22,53658,145,59881,167,2,114,0,181,141,3,"Anderson",76978,370.235651744654,0.132539682539683,216.945101197745,49.3647535659539,13.2539682539683
2021-01-23,7109,38,5581,14,1528,24,6236,13,53918,260,60154,273,0,114,1,182,141,0,"Anderson",76978,335.160695263582,0.116242038216561,354.646782197511,49.3647535659539,11.6242038216561
2021-01-24,7122,13,5593,12,1529,1,6250,14,53985,67,60235,81,0,114,0,182,143,2,"Anderson",76978,303.982956169295,0.113223140495868,105.224869443218,16.8879420094053,11.3223140495868
2021-01-25,7139,17,5604,11,1535,6,6261,11,54045,60,60306,71,2,116,1,183,145,2,"Anderson",76978,301.384811244771,0.117446808510638,92.2341448205981,22.0842318584531,11.7446808510638
2021-01-26,7166,27,5625,21,1541,6,6286,25,54208,163,60494,188,0,116,1,184,148,3,"Anderson",76978,281.898724310842,0.116165718927701,244.225622905246,35.0749564810725,11.6165718927701
2021-01-27,7183,17,5633,8,1550,9,6295,9,54294,86,60589,95,4,120,0,184,150,2,"Anderson",76978,267.608927225961,0.115151515151515,123.411883914885,22.0842318584531,11.5151515151515
2021-01-28,7270,87,5673,40,1597,47,6342,47,54520,226,60862,273,4,124,0,184,151,1,"Anderson",76978,307.880173556081,0.122822299651568,354.646782197511,113.019304216789,12.2822299651568
2021-01-29,7283,13,5677,4,1606,9,6347,5,54565,45,60912,50,1,125,1,185,151,0,"Anderson",76978,275.403361999532,0.120271580989331,64.9536231130973,16.8879420094053,12.0271580989331
2021-01-30,7323,40,5712,35,1611,5,6383,36,54824,259,61207,295,2,127,2,187,152,1,"Anderson",76978,278.001506924056,0.13960113960114,383.226376367274,51.9628984904778,13.960113960114
2021-01-31,7339,16,5719,7,1620,9,6394,11,54993,169,61387,180,1,128,0,187,154,2,"Anderson",76978,281.898724310842,0.125,233.83304320715,20.7851593961911,12.5
2021-02-01,7359,20,5732,13,1627,7,6407,13,55046,53,61453,66,1,129,1,188,156,2,"Anderson",76978,285.795941697628,0.127288578901482,85.7387825092884,25.9814492452389,12.7288578901482
2021-02-02,7366,7,5738,6,1628,1,6412,5,55114,68,61526,73,5,134,0,188,157,1,"Anderson",76978,259.814492452389,0.122093023255814,94.832289745122,9.09350723583361,12.2093023255814
2021-02-03,7388,22,5744,6,1644,16,6422,10,55306,192,61728,202,4,138,0,188,158,1,"Anderson",76978,266.309854763699,0.111501316944688,262.412637376913,28.5795941697628,11.1501316944688
2021-02-04,7419,31,5759,15,1660,16,6439,17,55630,324,62069,341,2,140,0,188,158,0,"Anderson",76978,193.56179687703,0.0803645401822701,442.983709631323,40.2712463301203,8.03645401822701
2021-02-05,7437,18,5770,11,1667,7,6456,17,55787,157,62243,174,2,142,0,188,159,1,"Anderson",76978,200.05715918834,0.081893313298272,226.038608433578,23.383304320715,8.1893313298272
2021-02-06,7464,27,5786,16,1678,11,6476,20,56009,222,62485,242,1,143,1,189,159,0,"Anderson",76978,183.169217178934,0.0727699530516432,314.375535867391,35.0749564810725,7.27699530516432
2021-02-07,7477,13,5793,7,1684,6,6484,8,56116,107,62600,115,0,143,0,189,159,0,"Anderson",76978,179.271999792148,0.0741962077493817,149.393333160124,16.8879420094053,7.41962077493817
2021-02-08,7502,25,5799,6,1703,19,6489,5,56138,22,62627,27,2,145,0,189,159,0,"Anderson",76978,185.767362103458,0.0698466780238501,35.0749564810725,32.4768115565486,6.98466780238501
2021-02-09,7526,24,5809,10,1717,14,6500,11,56307,169,62807,180,2,147,2,191,159,0,"Anderson",76978,207.851593961911,0.068696330991413,233.83304320715,31.1777390942867,6.8696330991413
2021-02-10,7551,25,5824,15,1727,10,6519,19,56502,195,63021,214,1,148,1,192,159,0,"Anderson",76978,211.748811348697,0.0750193348801237,278.001506924056,32.4768115565486,7.50193348801237
2021-02-11,7564,13,5832,8,1732,5,6530,11,56682,180,63212,191,-1,147,0,192,160,1,"Anderson",76978,188.365507027982,0.0796150481189851,248.122840292031,16.8879420094053,7.96150481189851
2021-02-12,7591,27,5847,15,1744,12,6545,15,56876,194,63421,209,0,147,0,192,160,0,"Anderson",76978,200.05715918834,0.0755517826825127,271.506144612746,35.0749564810725,7.55517826825127
2021-02-13,7618,27,5858,11,1760,16,6555,10,57065,189,63620,199,0,147,0,192,160,0,"Anderson",76978,200.05715918834,0.0696035242290749,258.515419990127,35.0749564810725,6.96035242290749
2021-02-14,7631,13,5867,9,1764,4,6566,11,57126,61,63692,72,2,149,0,192,160,0,"Anderson",76978,200.05715918834,0.0750915750915751,93.53321728286,16.8879420094053,7.50915750915751
2021-02-15,7648,17,5875,8,1773,9,6575,9,57199,73,63774,82,0,149,1,193,161,1,"Anderson",76978,189.664579490244,0.0749782040104621,106.523941905479,22.0842318584531,7.49782040104621
2021-02-16,7677,29,5889,14,1788,15,6592,17,57283,84,63875,101,0,149,0,193,161,0,"Anderson",76978,196.159941801554,0.0861423220973783,131.206318688456,37.6731014055964,8.61423220973783
2021-02-17,7696,19,5901,12,1795,7,6604,12,57391,108,63995,120,0,149,0,193,163,2,"Anderson",76978,188.365507027982,0.0872689938398357,155.888695471433,24.682376782977,8.72689938398357
2021-02-18,7720,24,5923,22,1797,2,6630,26,57547,156,64177,182,0,149,0,193,163,0,"Anderson",76978,202.655304112863,0.103626943005181,236.431188131674,31.1777390942867,10.3626943005181
2021-02-19,7733,13,5934,11,1799,2,6645,15,57593,46,64238,61,0,149,0,193,164,1,"Anderson",76978,184.468289641196,0.122399020807834,79.2434201979787,16.8879420094053,12.2399020807834
2021-02-20,7752,19,5941,7,1811,12,6654,9,57715,122,64369,131,1,150,0,193,165,1,"Anderson",76978,174.075709943101,0.132176234979973,170.178492556315,24.682376782977,13.2176234979973
2021-02-21,7764,12,5948,7,1816,5,6661,7,57779,64,64440,71,2,152,1,194,165,0,"Anderson",76978,172.776637480839,0.127005347593583,92.2341448205981,15.5888695471433,12.7005347593583
2021-02-22,7769,5,5950,2,1819,3,6667,6,57816,37,64483,43,1,153,0,194,166,1,"Anderson",76978,157.187767933695,0.129760225669958,55.8601158772636,6.49536231130973,12.9760225669958
2021-02-23,7793,24,5959,9,1834,15,6675,8,57959,143,64634,151,2,155,0,194,168,2,"Anderson",76978,150.692405622386,0.10935441370224,196.159941801554,31.1777390942867,10.935441370224
2021-02-24,7825,32,5978,19,1847,13,6698,23,58133,174,64831,197,0,155,0,194,168,0,"Anderson",76978,167.580347631791,0.11244019138756,255.917275065603,41.5703187923822,11.244019138756
2021-02-25,7842,17,5986,8,1856,9,6709,11,58260,127,64969,138,1,156,0,194,168,0,"Anderson",76978,158.486840395957,0.0997474747474748,179.271999792148,22.0842318584531,9.97474747474748
2021-02-26,7854,12,5994,8,1860,4,6718,9,58359,99,65077,108,0,156,0,194,168,0,"Anderson",76978,157.187767933695,0.0870083432657926,140.29982592429,15.5888695471433,8.70083432657926
2021-02-27,7863,9,6001,7,1862,2,6724,6,58451,92,65175,98,0,156,0,194,168,0,"Anderson",76978,144.197043311076,0.086848635235732,127.309101301671,11.6916521603575,8.6848635235732
2021-02-28,7877,14,6011,10,1866,4,6735,11,58521,70,65256,81,0,156,0,194,168,0,"Anderson",76978,146.7951882356,0.0906862745098039,105.224869443218,18.1870144716672,9.06862745098039
2021-03-01,7885,8,6016,5,1869,3,6742,7,58556,35,65298,42,0,156,0,194,169,1,"Anderson",76978,150.692405622386,0.0920245398773006,54.5610434150017,10.3925796980956,9.20245398773006
2021-03-02,7908,23,6027,11,1881,12,6752,10,58672,116,65424,126,1,157,1,195,169,0,"Anderson",76978,149.393333160124,0.0974683544303798,163.683130245005,29.8786666320247,9.74683544303798
2021-03-03,7941,33,6048,21,1893,12,6777,25,58788,116,65565,141,1,158,0,195,170,1,"Anderson",76978,150.692405622386,0.107629427792916,183.169217178934,42.8693912546442,10.7629427792916
2021-03-04,7966,25,6061,13,1905,12,6794,17,58951,163,65745,180,0,158,0,195,170,0,"Anderson",76978,161.084985320481,0.109536082474227,233.83304320715,32.4768115565486,10.9536082474227
2021-03-05,7999,33,6078,17,1921,16,6816,22,59085,134,65901,156,0,158,2,197,170,0,"Anderson",76978,188.365507027982,0.118932038834951,202.655304112863,42.8693912546442,11.8932038834951
2021-03-06,8010,11,6083,5,1927,6,6824,8,59174,89,65998,97,0,158,0,197,170,0,"Anderson",76978,190.963651952506,0.121506682867558,126.010028839409,14.2897970848814,12.1506682867558
2021-03-07,8016,6,6086,3,1930,3,6827,3,59213,39,66040,42,0,158,0,197,170,0,"Anderson",76978,180.57107225441,0.11734693877551,54.5610434150017,7.79443477357167,11.734693877551
2021-03-08,8032,16,6093,7,1939,9,6836,9,59290,77,66126,86,1,159,0,197,170,0,"Anderson",76978,190.963651952506,0.113526570048309,111.720231754527,20.7851593961911,11.3526570048309
2021-03-09,8053,21,6101,8,1952,13,6844,8,59355,65,66199,73,0,159,3,200,171,1,"Anderson",76978,188.365507027982,0.118709677419355,94.832289745122,27.2805217075008,11.8709677419355
2021-03-10,8075,22,6114,13,1961,9,6860,16,59512,157,66372,173,0,159,1,201,171,0,"Anderson",76978,174.075709943101,0.102850061957869,224.739535971316,28.5795941697628,10.2850061957869
2021-03-11,8098,23,6124,10,1974,13,6870,10,59609,97,66479,107,0,159,1,202,172,1,"Anderson",76978,171.477565018577,0.103542234332425,139.000753462028,29.8786666320247,10.3542234332425
2021-03-12,8118,20,6141,17,1977,3,6890,20,59715,106,66605,126,0,159,0,202,172,0,"Anderson",76978,154.589623009171,0.105113636363636,163.683130245005,25.9814492452389,10.5113636363636
2021-03-13,8129,11,6145,4,1984,7,6894,4,59791,76,66685,80,0,159,1,203,172,0,"Anderson",76978,154.589623009171,0.101892285298399,103.925796980956,14.2897970848814,10.1892285298399
2021-03-14,8135,6,6149,4,1986,2,6900,6,59827,36,66727,42,0,159,1,204,172,0,"Anderson",76978,154.589623009171,0.106259097525473,54.5610434150017,7.79443477357167,10.6259097525473
2021-03-15,8154,19,6155,6,1999,13,6906,6,59859,32,66765,38,0,159,1,205,172,0,"Anderson",76978,158.486840395957,0.109546165884194,49.3647535659539,24.682376782977,10.9546165884194
2021-03-16,8187,33,6168,13,2019,20,6921,15,59952,93,66873,108,0,159,2,207,172,0,"Anderson",76978,174.075709943101,0.114243323442137,140.29982592429,42.8693912546442,11.4243323442136
2021-03-17,8205,18,6180,12,2025,6,6934,13,60039,87,66973,100,0,159,0,207,173,1,"Anderson",76978,168.879420094053,0.123128119800333,129.907246226195,23.383304320715,12.3128119800333
2021-03-18,8221,16,6192,12,2029,4,6949,15,60120,81,67069,96,1,160,0,207,173,0,"Anderson",76978,159.785912858219,0.133898305084746,124.710956377147,20.7851593961911,13.3898305084746
2021-03-19,8245,24,6206,14,2039,10,6962,13,60239,119,67201,132,0,160,1,208,173,0,"Anderson",76978,164.982202707267,0.120805369127517,171.477565018577,31.1777390942867,12.0805369127517
2021-03-20,8257,12,6212,6,2045,6,6970,8,60278,39,67248,47,0,160,1,209,173,0,"Anderson",76978,166.281275169529,0.134991119005329,61.0564057263114,15.5888695471433,13.4991119005329
2021-03-21,8267,10,6218,6,2049,4,6977,7,60340,62,67317,69,-1,159,0,209,173,0,"Anderson",76978,171.477565018577,0.130508474576271,89.6359998960742,12.9907246226195,13.0508474576271
2021-03-22,8275,8,6219,1,2056,7,6978,1,60406,66,67384,67,0,159,1,210,173,0,"Anderson",76978,157.187767933695,0.116316639741519,87.0378549715503,10.3925796980956,11.6316639741519
2021-03-23,8281,6,6220,1,2061,5,6979,1,60449,43,67428,44,0,159,0,210,174,1,"Anderson",76978,122.112811452623,0.104504504504505,57.1591883395256,7.79443477357167,10.4504504504505
2021-03-24,8289,8,6227,7,2062,1,6986,7,60569,120,67555,127,1,160,0,210,174,0,"Anderson",76978,109.122086830003,0.0893470790378007,164.982202707267,10.3925796980956,8.93470790378007
2021-03-25,8299,10,6232,5,2067,5,6992,6,60670,101,67662,107,0,160,0,210,174,0,"Anderson",76978,101.327652056432,0.0725126475548061,139.000753462028,12.9907246226195,7.25126475548061
2021-03-26,8316,17,6244,12,2072,5,7003,11,60736,66,67739,77,0,160,0,210,175,1,"Anderson",76978,92.2341448205981,0.0762081784386617,100.02857959417,22.0842318584531,7.62081784386617
2021-03-27,8320,4,6248,4,2072,0,7009,6,60800,64,67809,70,1,161,2,212,175,0,"Anderson",76978,81.8415651225025,0.0695187165775401,90.9350723583361,5.19628984904778,6.95187165775401
2021-03-28,8323,3,6248,0,2075,3,7009,0,60829,29,67838,29,1,162,0,212,176,1,"Anderson",76978,72.7480578866689,0.0614203454894434,37.6731014055964,3.89721738678583,6.14203454894434
2021-03-29,8338,15,6252,4,2086,11,7013,4,60915,86,67928,90,1,163,0,212,177,1,"Anderson",76978,81.8415651225025,0.0643382352941176,116.916521603575,19.4860869339292,6.43382352941176
2021-03-30,8343,5,6255,3,2088,2,7016,3,60973,58,67989,61,1,164,0,212,177,0,"Anderson",76978,80.5424926602406,0.0659536541889483,79.2434201979787,6.49536231130973,6.59536541889483
2021-03-31,8366,23,6269,14,2097,9,7032,16,61137,164,68169,180,1,165,1,213,177,0,"Anderson",76978,100.02857959417,0.0749185667752443,233.83304320715,29.8786666320247,7.49185667752443
2021-04-01,8376,10,6274,5,2102,5,7036,4,61194,57,68230,61,0,165,0,213,177,0,"Anderson",76978,100.02857959417,0.0774647887323944,79.2434201979787,12.9907246226195,7.74647887323944
2021-04-02,8384,8,6280,6,2104,2,7044,8,61264,70,68308,78,0,165,0,213,177,0,"Anderson",76978,88.3369274338123,0.0720562390158172,101.327652056432,10.3925796980956,7.20562390158172
2021-04-03,8390,6,6285,5,2105,1,7050,6,61314,50,68364,56,0,165,0,213,177,0,"Anderson",76978,90.9350723583361,0.0738738738738739,72.7480578866689,7.79443477357167,7.38738738738739
2021-04-04,8392,2,6287,2,2105,0,7052,2,61352,38,68404,40,0,165,0,213,177,0,"Anderson",76978,89.6359998960742,0.0759717314487632,51.9628984904778,2.59814492452389,7.59717314487632
2021-04-05,8406,14,6290,3,2116,11,7054,2,61410,58,68464,60,0,165,2,215,177,0,"Anderson",76978,88.3369274338123,0.0764925373134328,77.9443477357167,18.1870144716672,7.64925373134328
2021-04-06,8411,5,6294,4,2117,1,7060,6,61452,42,68512,48,0,165,0,215,177,0,"Anderson",76978,88.3369274338123,0.0841300191204589,62.3554781885734,6.49536231130973,8.41300191204589
2021-04-07,8431,20,6307,13,2124,7,7074,14,61610,158,68684,172,0,165,2,217,177,0,"Anderson",76978,84.4397100470264,0.0815533980582524,223.440463509055,25.9814492452389,8.15533980582524
2021-04-08,8434,3,6309,2,2125,1,7077,3,61701,91,68778,94,5,170,1,218,177,0,"Anderson",76978,75.3462028111928,0.0748175182481752,122.112811452623,3.89721738678583,7.48175182481752
2021-04-09,8442,8,6315,6,2127,2,7086,9,61788,87,68874,96,-4,166,0,218,177,0,"Anderson",76978,75.3462028111928,0.0742049469964664,124.710956377147,10.3925796980956,7.42049469964664
2021-04-10,8447,5,6320,5,2127,0,7091,5,61859,71,68950,76,0,166,0,218,177,0,"Anderson",76978,74.0471303489309,0.0699658703071672,98.7295071319078,6.49536231130973,6.99658703071672
2021-04-11,8454,7,6325,5,2129,2,7096,5,61903,44,68999,49,-1,165,0,218,177,0,"Anderson",76978,80.5424926602406,0.0739495798319328,63.6545506508353,9.09350723583361,7.39495798319328
2021-04-12,8457,3,6328,3,2129,0,7099,3,61972,69,69071,72,0,165,0,218,177,0,"Anderson",76978,66.2526955753592,0.0741350906095552,93.53321728286,3.89721738678583,7.41350906095552
2021-04-13,8467,10,6333,5,2134,5,7105,6,62033,61,69138,67,5,170,0,218,177,0,"Anderson",76978,72.7480578866689,0.0718849840255591,87.0378549715503,12.9907246226195,7.18849840255591
2021-04-14,8481,14,6342,9,2139,5,7116,11,62171,138,69287,149,0,170,0,218,177,0,"Anderson",76978,64.9536231130973,0.0696517412935323,193.56179687703,18.1870144716672,6.96517412935323
2021-04-15,8490,9,6347,5,2143,4,7121,5,62252,81,69373,86,0,170,0,218,177,0,"Anderson",76978,72.7480578866689,0.0739495798319328,111.720231754527,11.6916521603575,7.39495798319328
2021-04-16,8503,13,6358,11,2145,2,7134,13,62405,153,69539,166,0,170,0,218,177,0,"Anderson",76978,79.2434201979786,0.0721804511278196,215.646028735483,16.8879420094053,7.21804511278196
2021-04-17,8508,5,6361,3,2147,2,7138,4,62470,65,69608,69,0,170,0,218,177,0,"Anderson",76978,79.2434201979786,0.0714285714285714,89.6359998960742,6.49536231130973,7.14285714285714
2021-04-18,8515,7,6367,6,2148,1,7144,6,62515,45,69659,51,0,170,0,218,177,0,"Anderson",76978,79.2434201979786,0.0727272727272727,66.2526955753592,9.09350723583361,7.27272727272727
2021-04-19,8521,6,6370,3,2151,3,7147,3,62538,23,69685,26,0,170,0,218,178,1,"Anderson",76978,83.1406375847645,0.0781758957654723,33.7758840188106,7.79443477357167,7.81758957654723
2021-04-20,8527,6,6373,3,2154,3,7150,3,62637,99,69787,102,0,170,0,218,178,0,"Anderson",76978,77.9443477357167,0.0693374422187981,132.505391150718,7.79443477357167,6.93374422187981
2021-04-21,8539,12,6379,6,2160,6,7156,6,62791,154,69947,160,1,171,0,218,178,0,"Anderson",76978,75.3462028111928,0.0606060606060606,207.851593961911,15.5888695471433,6.06060606060606
2021-04-22,8557,18,6385,6,2172,12,7163,7,62935,144,70098,151,0,171,0,218,178,0,"Anderson",76978,87.0378549715503,0.0579310344827586,196.159941801554,23.383304320715,5.79310344827586
2021-04-23,8567,10,6390,5,2177,5,7169,6,63100,165,70269,171,0,171,0,218,178,0,"Anderson",76978,83.1406375847645,0.047945205479452,222.141391046793,12.9907246226195,4.7945205479452
2021-04-24,8579,12,6396,6,2183,6,7176,7,63167,67,70343,74,0,171,1,219,178,0,"Anderson",76978,92.2341448205981,0.0517006802721088,96.1313622073839,15.5888695471433,5.17006802721088
2021-04-25,8583,4,6398,2,2185,2,7178,2,63207,40,70385,42,0,171,0,219,178,0,"Anderson",76978,88.3369274338123,0.046831955922865,54.5610434150017,5.19628984904778,4.6831955922865
2021-04-26,8592,9,6402,4,2190,5,7182,4,63282,75,70464,79,0,171,0,219,179,1,"Anderson",76978,92.2341448205981,0.0449293966623877,102.626724518694,11.6916521603575,4.49293966623877
2021-04-27,8602,10,6408,6,2194,4,7188,6,63350,68,70538,74,0,171,0,219,179,0,"Anderson",76978,97.4304346696459,0.0505992010652463,96.1313622073839,12.9907246226195,5.05992010652463
2021-04-28,8619,17,6420,12,2199,5,7201,13,63488,138,70689,151,0,171,1,220,180,1,"Anderson",76978,103.925796980956,0.0606469002695418,196.159941801554,22.0842318584531,6.06469002695418
2021-04-29,8625,6,6422,2,2203,4,7204,3,63637,149,70841,152,0,171,0,220,180,0,"Anderson",76978,88.3369274338123,0.0551816958277254,197.459014263816,7.79443477357167,5.51816958277254
2021-04-30,8633,8,6425,3,2208,5,7208,4,63759,122,70967,126,0,171,0,220,180,0,"Anderson",76978,85.7387825092884,0.0558739255014327,163.683130245005,10.3925796980956,5.58739255014327
2021-05-01,8638,5,6428,3,2210,2,7211,3,63822,63,71033,66,0,171,1,221,180,0,"Anderson",76978,76.6452752734548,0.0507246376811594,85.7387825092884,6.49536231130973,5.07246376811594
2021-05-02,8641,3,6429,1,2212,2,7212,1,63873,51,71085,52,0,171,0,221,180,0,"Anderson",76978,75.3462028111928,0.0485714285714286,67.5517680376211,3.89721738678583,4.85714285714286
2021-05-03,8651,10,6434,5,2217,5,7217,5,63979,106,71196,111,0,171,0,221,180,0,"Anderson",76978,76.6452752734548,0.0478142076502732,144.197043311076,12.9907246226195,4.78142076502732
2021-05-04,8653,2,6434,0,2219,2,7218,1,64055,76,71273,77,0,171,0,221,180,0,"Anderson",76978,66.2526955753592,0.0408163265306122,100.02857959417,2.59814492452389,4.08163265306122
2021-05-05,8661,8,6438,4,2223,4,7221,3,64172,117,71393,120,0,171,0,221,180,0,"Anderson",76978,54.5610434150017,0.0284090909090909,155.888695471433,10.3925796980956,2.84090909090909
2021-05-06,8666,5,6441,3,2225,2,7227,6,64224,52,71451,58,0,171,1,222,180,0,"Anderson",76978,53.2619709527397,0.0377049180327869,75.3462028111928,6.49536231130973,3.77049180327869
2021-05-07,8671,5,6443,2,2228,3,7230,3,64344,120,71574,123,0,171,0,222,180,0,"Anderson",76978,49.3647535659539,0.0362438220757825,159.785912858219,6.49536231130973,3.62438220757825
2021-05-08,8677,6,6446,3,2231,3,7232,2,64413,69,71645,71,0,171,1,223,181,1,"Anderson",76978,50.6638260282159,0.0343137254901961,92.2341448205981,7.79443477357167,3.43137254901961
2021-05-09,8678,1,6446,0,2232,1,7233,1,64441,28,71674,29,0,171,0,223,181,0,"Anderson",76978,48.065681103692,0.0356536502546689,37.6731014055964,1.29907246226194,3.56536502546689
2021-05-10,8683,5,6446,0,2237,5,7233,0,64529,88,71762,88,0,171,0,223,181,0,"Anderson",76978,41.5703187923822,0.0282685512367491,114.318376679051,6.49536231130973,2.82685512367491
2021-05-11,8691,8,6447,1,2244,7,7235,2,64571,42,71806,44,0,171,0,223,182,1,"Anderson",76978,49.3647535659539,0.0318949343339587,57.1591883395256,10.3925796980956,3.18949343339587
2021-05-12,8704,13,6454,7,2250,6,7241,6,64674,103,71915,109,0,171,2,225,182,0,"Anderson",76978,55.8601158772636,0.0383141762452107,141.598898386552,16.8879420094053,3.83141762452107
2021-05-13,8708,4,6456,2,2252,2,7243,2,64777,103,72020,105,0,171,2,227,182,0,"Anderson",76978,54.5610434150017,0.0281195079086116,136.402608537504,5.19628984904778,2.81195079086116
2021-05-14,8716,8,6459,3,2257,5,7248,5,64864,87,72112,92,0,171,0,227,182,0,"Anderson",76978,58.4582608017875,0.033457249070632,119.514666528099,10.3925796980956,3.3457249070632
2021-05-15,8721,5,6461,2,2260,3,7250,2,64929,65,72179,67,0,171,0,227,182,0,"Anderson",76978,57.1591883395256,0.0337078651685393,87.0378549715503,6.49536231130973,3.37078651685393
2021-05-16,8723,2,6462,1,2261,1,7251,1,64965,36,72216,37,0,171,0,227,182,0,"Anderson",76978,58.4582608017875,0.033210332103321,48.065681103692,2.59814492452389,3.3210332103321
2021-05-17,8729,6,6467,5,2262,1,7256,5,65024,59,72280,64,1,172,0,227,182,0,"Anderson",76978,59.7573332640495,0.0444015444015444,83.1406375847645,7.79443477357167,4.44015444015444
2021-05-18,8733,4,6467,0,2266,4,7256,0,65115,91,72371,91,0,172,1,228,182,0,"Anderson",76978,54.5610434150017,0.0371681415929204,118.215594065837,5.19628984904778,3.71681415929204
2021-05-19,8740,7,6472,5,2268,2,7262,6,65233,118,72495,124,0,172,0,228,182,0,"Anderson",76978,46.76660864143,0.0362068965517241,161.084985320481,9.09350723583361,3.62068965517241
2021-05-20,8742,2,6474,2,2268,0,7264,2,65352,119,72616,121,0,172,0,228,182,0,"Anderson",76978,44.1684637169061,0.0352348993288591,157.187767933695,2.59814492452389,3.52348993288591
2021-05-21,8744,2,6474,0,2270,2,7264,0,65422,70,72686,70,0,172,0,228,182,0,"Anderson",76978,36.3740289433345,0.0278745644599303,90.9350723583361,2.59814492452389,2.78745644599303
2021-05-22,8749,5,6476,2,2273,3,7266,2,65462,40,72728,42,0,172,0,228,182,0,"Anderson",76978,36.3740289433345,0.029143897996357,54.5610434150017,6.49536231130973,2.9143897996357
2021-05-23,8749,0,6476,0,2273,0,7266,0,65491,29,72757,29,0,172,0,228,182,0,"Anderson",76978,33.7758840188106,0.0277264325323475,37.6731014055964,0,2.77264325323475
2021-05-24,8757,8,6480,4,2277,4,7269,3,65550,59,72819,62,0,172,0,228,182,0,"Anderson",76978,36.3740289433345,0.0241187384044527,80.5424926602406,10.3925796980956,2.41187384044527
2021-05-25,8759,2,6480,0,2279,2,7270,1,65595,45,72865,46,0,172,0,228,182,0,"Anderson",76978,33.7758840188106,0.0283400809716599,59.7573332640495,2.59814492452389,2.83400809716599
2021-05-26,8766,7,6485,5,2281,2,7276,6,65695,100,72971,106,0,172,0,228,182,0,"Anderson",76978,33.7758840188106,0.0294117647058824,137.701680999766,9.09350723583361,2.94117647058824
2021-05-27,8768,2,6486,1,2282,1,7277,1,65745,50,73022,51,0,172,1,229,182,0,"Anderson",76978,33.7758840188106,0.0320197044334975,66.2526955753592,2.59814492452389,3.20197044334975
2021-05-28,8773,5,6490,4,2283,1,7282,5,65828,83,73110,88,0,172,0,229,182,0,"Anderson",76978,37.6731014055964,0.0424528301886792,114.318376679051,6.49536231130973,4.24528301886792
2021-05-29,8774,1,6490,0,2284,1,7282,0,65865,37,73147,37,0,172,0,229,182,0,"Anderson",76978,32.4768115565486,0.0381861575178998,48.065681103692,1.29907246226194,3.81861575178998
2021-05-30,8777,3,6491,1,2286,2,7283,1,65915,50,73198,51,0,172,0,229,182,0,"Anderson",76978,36.3740289433345,0.0385487528344671,66.2526955753592,3.89721738678583,3.85487528344671
2021-05-31,8781,4,6494,3,2287,1,7286,3,65966,51,73252,54,0,172,0,229,182,0,"Anderson",76978,31.1777390942867,0.0392609699769053,70.149912962145,5.19628984904778,3.92609699769053
2021-06-01,8784,3,6496,2,2288,1,7287,1,66014,48,73301,49,0,172,1,230,182,0,"Anderson",76978,32.4768115565486,0.0389908256880734,63.6545506508353,3.89721738678583,3.89908256880734
2021-06-02,8788,4,6497,1,2291,3,7289,2,66055,41,73344,43,0,172,0,230,182,0,"Anderson",76978,28.5795941697628,0.0348525469168901,55.8601158772636,5.19628984904778,3.48525469168901
2021-06-03,8789,1,6497,0,2292,1,7292,3,66144,89,73436,92,1,173,0,230,183,1,"Anderson",76978,27.2805217075008,0.036231884057971,119.514666528099,1.29907246226194,3.6231884057971
2021-06-04,8790,1,6498,1,2292,0,7294,2,66197,53,73491,55,-1,172,0,230,183,0,"Anderson",76978,22.0842318584531,0.031496062992126,71.448985424407,1.29907246226194,3.1496062992126
2021-06-05,8791,1,6499,1,2292,0,7295,1,66254,57,73549,58,0,172,0,230,183,0,"Anderson",76978,22.0842318584531,0.0323383084577114,75.3462028111928,1.29907246226194,3.23383084577114
2021-06-06,8791,0,6499,0,2292,0,7295,0,66279,25,73574,25,0,172,0,230,183,0,"Anderson",76978,18.1870144716672,0.0319148936170213,32.4768115565486,0,3.19148936170213
2021-06-07,8792,1,6499,0,2293,1,7295,0,66343,64,73638,64,0,172,0,230,183,0,"Anderson",76978,14.2897970848814,0.0233160621761658,83.1406375847645,1.29907246226194,2.33160621761658
2021-06-08,8793,1,6499,0,2294,1,7295,0,66380,37,73675,37,0,172,1,231,184,1,"Anderson",76978,11.6916521603575,0.0213903743315508,48.065681103692,1.29907246226194,2.13903743315508
2021-06-09,8793,0,6499,0,2294,0,7295,0,66461,81,73756,81,0,172,0,231,184,0,"Anderson",76978,6.49536231130972,0.0145631067961165,105.224869443218,0,1.45631067961165
2021-06-10,8797,4,6500,1,2297,3,7296,1,66518,57,73814,58,0,172,0,231,184,0,"Anderson",76978,10.3925796980956,0.0105820105820106,75.3462028111928,5.19628984904778,1.05820105820106
2021-06-11,8798,1,6500,0,2298,1,7297,1,66573,55,73870,56,1,173,0,231,184,0,"Anderson",76978,10.3925796980956,0.0079155672823219,72.7480578866689,1.29907246226194,0.79155672823219
2021-06-12,8799,1,6500,0,2299,1,7298,1,66628,55,73926,56,2,175,0,231,184,0,"Anderson",76978,10.3925796980956,0.00795755968169761,72.7480578866689,1.29907246226194,0.795755968169761
2021-06-13,8800,1,6500,0,2300,1,7299,1,66666,38,73965,39,0,175,0,231,184,0,"Anderson",76978,11.6916521603575,0.010230179028133,50.6638260282159,1.29907246226194,1.0230179028133
2021-06-14,8802,2,6502,2,2300,0,7301,2,66752,86,74053,88,0,175,0,231,184,0,"Anderson",76978,12.9907246226194,0.0144578313253012,114.318376679051,2.59814492452389,1.44578313253012
2021-06-15,8802,0,6502,0,2300,0,7302,1,66783,31,74085,32,0,175,0,231,184,0,"Anderson",76978,11.6916521603575,0.0170731707317073,41.5703187923822,0,1.70731707317073
2021-06-16,8803,1,6503,1,2300,0,7303,1,66826,43,74129,44,0,175,0,231,184,0,"Anderson",76978,12.9907246226194,0.0214477211796247,57.1591883395256,1.29907246226194,2.14477211796247
2021-06-17,8803,0,6503,0,2300,0,7303,0,66912,86,74215,86,0,175,0,231,184,0,"Anderson",76978,7.79443477357167,0.0174563591022444,111.720231754527,0,1.74563591022444
2021-06-18,8805,2,6504,1,2301,1,7307,4,66962,50,74269,54,0,175,0,231,184,0,"Anderson",76978,9.09350723583361,0.025062656641604,70.149912962145,2.59814492452389,2.5062656641604
2021-06-19,8805,0,6504,0,2301,0,7307,0,67010,48,74317,48,0,175,0,231,184,0,"Anderson",76978,7.79443477357167,0.0230179028132992,62.3554781885734,0,2.30179028132992
2021-06-20,8805,0,6504,0,2301,0,7308,1,67033,23,74341,24,0,175,0,231,184,0,"Anderson",76978,6.49536231130972,0.023936170212766,31.1777390942867,0,2.3936170212766
2021-06-21,8806,1,6504,0,2302,1,7308,0,67073,40,74381,40,0,175,0,231,184,0,"Anderson",76978,5.19628984904778,0.0213414634146341,51.9628984904778,1.29907246226194,2.13414634146341
2021-06-22,8810,4,6505,1,2305,3,7308,0,67115,42,74423,42,0,175,1,232,184,0,"Anderson",76978,10.3925796980956,0.0177514792899408,54.5610434150017,5.19628984904778,1.77514792899408
2021-06-23,8811,1,6506,1,2305,0,7309,1,67163,48,74472,49,0,175,0,232,184,0,"Anderson",76978,10.3925796980956,0.0174927113702624,63.6545506508353,1.29907246226194,1.74927113702624
2021-06-24,8811,0,6506,0,2305,0,7310,1,67207,44,74517,45,0,175,0,232,184,0,"Anderson",76978,10.3925796980956,0.0231788079470199,58.4582608017875,0,2.31788079470199
2021-06-25,8812,1,6507,1,2305,0,7311,1,67243,36,74554,37,0,175,0,232,184,0,"Anderson",76978,9.09350723583361,0.0140350877192982,48.065681103692,1.29907246226194,1.40350877192982
2021-06-26,8813,1,6508,1,2305,0,7312,1,67276,33,74588,34,0,175,0,232,184,0,"Anderson",76978,10.3925796980956,0.018450184501845,44.1684637169061,1.29907246226194,1.8450184501845
2021-06-27,8813,0,6508,0,2305,0,7312,0,67308,32,74620,32,0,175,0,232,184,0,"Anderson",76978,10.3925796980956,0.014336917562724,41.5703187923822,0,1.4336917562724
2021-06-28,8814,1,6508,0,2306,1,7313,1,67324,16,74637,17,0,175,0,232,184,0,"Anderson",76978,10.3925796980956,0.01953125,22.0842318584531,1.29907246226194,1.953125
2021-06-29,8817,3,6511,3,2306,0,7316,3,67382,58,74698,61,0,175,0,232,184,0,"Anderson",76978,9.09350723583361,0.0290909090909091,79.2434201979787,3.89721738678583,2.90909090909091
2021-06-30,8817,0,6511,0,2306,0,7316,0,67428,46,74744,46,0,175,0,232,184,0,"Anderson",76978,7.79443477357167,0.0257352941176471,59.7573332640495,0,2.57352941176471
2021-07-01,8818,1,6512,1,2306,0,7317,1,67465,37,74782,38,0,175,0,232,184,0,"Anderson",76978,9.09350723583361,0.0264150943396226,49.3647535659539,1.29907246226194,2.64150943396226
2021-07-02,8818,0,6512,0,2306,0,7317,0,67508,43,74825,43,0,175,0,232,184,0,"Anderson",76978,7.79443477357167,0.022140221402214,55.8601158772636,0,2.2140221402214
2021-07-03,8818,0,6512,0,2306,0,7317,0,67529,21,74846,21,0,175,0,232,184,0,"Anderson",76978,6.49536231130972,0.0193798449612403,27.2805217075008,0,1.93798449612403
2021-07-04,8819,1,6512,0,2307,1,7318,1,67554,25,74872,26,0,175,0,232,184,0,"Anderson",76978,7.79443477357167,0.0238095238095238,33.7758840188106,1.29907246226194,2.38095238095238
2021-07-05,8819,0,6512,0,2307,0,7319,1,67569,15,74888,16,0,175,0,232,184,0,"Anderson",76978,6.49536231130972,0.0239043824701195,20.7851593961911,0,2.39043824701195
2021-07-06,8820,1,6512,0,2308,1,7319,0,67599,30,74918,30,1,176,0,232,184,0,"Anderson",76978,3.89721738678583,0.0136363636363636,38.9721738678584,1.29907246226194,1.36363636363636
2021-07-07,8821,1,6512,0,2309,1,7319,0,67645,46,74964,46,0,176,0,232,184,0,"Anderson",76978,5.19628984904778,0.0136363636363636,59.7573332640495,1.29907246226194,1.36363636363636
2021-07-08,8822,1,6513,1,2309,0,7320,1,67686,41,75006,42,0,176,0,232,184,0,"Anderson",76978,5.19628984904778,0.0133928571428571,54.5610434150017,1.29907246226194,1.33928571428571
2021-07-09,8824,2,6514,1,2310,1,7321,1,67730,44,75051,45,0,176,0,232,184,0,"Anderson",76978,7.79443477357167,0.0176991150442478,58.4582608017875,2.59814492452389,1.76991150442478
2021-07-10,8826,2,6515,1,2311,1,7322,1,67752,22,75074,23,0,176,1,233,184,0,"Anderson",76978,10.3925796980956,0.0219298245614035,29.8786666320247,2.59814492452389,2.19298245614035
2021-07-11,8826,0,6515,0,2311,0,7322,0,67767,15,75089,15,0,176,0,233,184,0,"Anderson",76978,9.09350723583361,0.0184331797235023,19.4860869339292,0,1.84331797235023
2021-07-12,8834,8,6519,4,2315,4,7326,4,67803,36,75129,40,0,176,1,234,184,0,"Anderson",76978,19.4860869339292,0.029045643153527,51.9628984904778,10.3925796980956,2.9045643153527
2021-07-13,8835,1,6519,0,2316,1,7326,0,67824,21,75150,21,0,176,0,234,186,2,"Anderson",76978,19.4860869339292,0.0301724137931034,27.2805217075008,1.29907246226194,3.01724137931034
2021-07-14,8840,5,6524,5,2316,0,7331,5,67877,53,75208,58,0,176,1,235,186,0,"Anderson",76978,24.682376782977,0.0491803278688525,75.3462028111928,6.49536231130973,4.91803278688525
2021-07-15,8843,3,6527,3,2316,0,7333,2,67910,33,75243,35,0,176,0,235,186,0,"Anderson",76978,27.2805217075008,0.0548523206751055,45.4675361791681,3.89721738678583,5.48523206751055
2021-07-16,8853,10,6529,2,2324,8,7334,1,67938,28,75272,29,0,176,0,235,186,0,"Anderson",76978,37.6731014055964,0.0588235294117647,37.6731014055964,12.9907246226195,5.88235294117647
2021-07-17,8858,5,6530,1,2328,4,7335,1,67974,36,75309,37,0,176,0,235,186,0,"Anderson",76978,41.5703187923822,0.0553191489361702,48.065681103692,6.49536231130973,5.53191489361702
2021-07-18,8861,3,6532,2,2329,1,7337,2,67994,20,75331,22,0,176,0,235,186,0,"Anderson",76978,45.4675361791681,0.0619834710743802,28.5795941697628,3.89721738678583,6.19834710743802
2021-07-19,8866,5,6536,4,2330,1,7341,4,68028,34,75369,38,0,176,0,235,186,0,"Anderson",76978,41.5703187923822,0.0625,49.3647535659539,6.49536231130973,6.25
2021-07-20,8881,15,6547,11,2334,4,7352,11,68063,35,75415,46,0,176,1,236,186,0,"Anderson",76978,59.7573332640495,0.0981132075471698,59.7573332640495,19.4860869339292,9.81132075471698
2021-07-21,8888,7,6551,4,2337,3,7357,5,68148,85,75505,90,0,176,0,236,187,1,"Anderson",76978,62.3554781885734,0.0875420875420875,116.916521603575,9.09350723583361,8.75420875420875
2021-07-22,8898,10,6556,5,2342,5,7361,4,68203,55,75564,59,0,176,0,236,187,0,"Anderson",76978,71.448985424407,0.0872274143302181,76.6452752734548,12.9907246226195,8.72274143302181
2021-07-23,8908,10,6560,4,2348,6,7366,5,68274,71,75640,76,0,176,0,236,187,0,"Anderson",76978,71.448985424407,0.0869565217391304,98.7295071319078,12.9907246226195,8.69565217391304
2021-07-24,8916,8,6564,4,2352,4,7370,4,68328,54,75698,58,0,176,0,236,188,1,"Anderson",76978,75.3462028111928,0.089974293059126,75.3462028111928,10.3925796980956,8.9974293059126
2021-07-25,8921,5,6567,3,2354,2,7371,1,68350,22,75721,23,0,176,0,236,188,0,"Anderson",76978,77.9443477357167,0.0871794871794872,29.8786666320247,6.49536231130973,8.71794871794872
2021-07-26,8944,23,6576,9,2368,14,7379,8,68400,50,75779,58,2,178,0,236,188,0,"Anderson",76978,101.327652056432,0.0926829268292683,75.3462028111928,29.8786666320247,9.26829268292683
2021-07-27,8959,15,6581,5,2378,10,7384,5,68453,53,75837,58,0,178,0,236,188,0,"Anderson",76978,101.327652056432,0.0758293838862559,75.3462028111928,19.4860869339292,7.58293838862559
2021-07-28,8980,21,6590,9,2390,12,7397,13,68536,83,75933,96,0,178,0,236,188,0,"Anderson",76978,119.514666528099,0.0934579439252336,124.710956377147,27.2805217075008,9.34579439252336
2021-07-29,8992,12,6600,10,2392,2,7409,12,68585,49,75994,61,0,178,0,236,188,0,"Anderson",76978,122.112811452623,0.111627906976744,79.2434201979787,15.5888695471433,11.1627906976744
2021-07-30,9023,31,6621,21,2402,10,7432,23,68633,48,76065,71,0,178,1,237,188,0,"Anderson",76978,149.393333160124,0.155294117647059,92.2341448205981,40.2712463301203,15.5294117647059
2021-07-31,9036,13,6627,6,2409,7,7438,6,68675,42,76113,48,0,178,0,237,188,0,"Anderson",76978,155.888695471433,0.163855421686747,62.3554781885734,16.8879420094053,16.3855421686747
2021-08-01,9055,19,6639,12,2416,7,7453,15,68714,39,76167,54,0,178,0,237,188,0,"Anderson",76978,174.075709943101,0.183856502242152,70.149912962145,24.682376782977,18.3856502242152
2021-08-02,9067,12,6645,6,2422,6,7459,6,68793,79,76252,85,0,178,0,237,188,0,"Anderson",76978,159.785912858219,0.169133192389006,110.421159292265,15.5888695471433,16.9133192389006
2021-08-03,9090,23,6656,11,2434,12,7472,13,68865,72,76337,85,0,178,1,238,188,0,"Anderson",76978,170.178492556315,0.176,110.421159292265,29.8786666320247,17.6
2021-08-04,9116,26,6678,22,2438,4,7493,21,68967,102,76460,123,0,178,0,238,188,0,"Anderson",76978,176.673854867625,0.182163187855787,159.785912858219,33.7758840188106,18.2163187855787
2021-08-05,9147,31,6695,17,2452,14,7510,17,69064,97,76574,114,0,178,1,239,188,0,"Anderson",76978,201.356231650601,0.174137931034483,148.094260697862,40.2712463301203,17.4137931034483
2021-08-06,9172,25,6711,16,2461,9,7528,18,69207,143,76735,161,0,178,1,240,188,0,"Anderson",76978,193.56179687703,0.143283582089552,209.150666424173,32.4768115565486,14.3283582089552
2021-08-07,9186,14,6718,7,2468,7,7536,8,69282,75,76818,83,0,178,0,240,188,0,"Anderson",76978,194.860869339292,0.139007092198582,107.823014367741,18.1870144716672,13.9007092198582
2021-08-08,9200,14,6726,8,2474,6,7546,10,69334,52,76880,62,0,178,0,240,188,0,"Anderson",76978,188.365507027982,0.130434782608696,80.5424926602406,18.1870144716672,13.0434782608696
2021-08-09,9236,36,6745,19,2491,17,7565,19,69433,99,76998,118,0,178,0,240,188,0,"Anderson",76978,219.543246122269,0.142091152815013,153.29055054691,46.76660864143,14.2091152815013
2021-08-10,9275,39,6765,20,2510,19,7585,20,69533,100,77118,120,0,178,2,242,188,0,"Anderson",76978,240.32840551846,0.144686299615877,155.888695471433,50.6638260282159,14.4686299615877
2021-08-11,9330,55,6790,25,2540,30,7615,30,69665,132,77280,162,0,178,1,243,188,0,"Anderson",76978,278.001506924056,0.148780487804878,210.449738886435,71.448985424407,14.8780487804878
2021-08-12,9379,49,6827,37,2552,12,7653,38,69832,167,77485,205,0,178,0,243,190,2,"Anderson",76978,301.384811244771,0.156970362239297,266.309854763699,63.6545506508353,15.6970362239297
2021-08-13,9442,63,6862,35,2580,28,7691,38,69946,114,77637,152,2,180,1,244,191,1,"Anderson",76978,350.749564810725,0.180709534368071,197.459014263816,81.8415651225025,18.0709534368071
2021-08-14,9492,50,6897,35,2595,15,7723,32,70132,186,77855,218,0,180,0,244,191,0,"Anderson",76978,397.516173452155,0.180327868852459,283.197796773104,64.9536231130973,18.0327868852459
2021-08-15,9515,23,6910,13,2605,10,7738,15,70221,89,77959,104,0,180,0,244,191,0,"Anderson",76978,409.207825612513,0.177942539388323,135.103536075242,29.8786666320247,17.7942539388323
2021-08-16,9553,38,6934,24,2619,14,7762,24,70310,89,78072,113,0,180,0,244,192,1,"Anderson",76978,411.805970537037,0.18342644320298,146.7951882356,49.3647535659539,18.342644320298
2021-08-17,9596,43,6955,21,2641,22,7786,24,70418,108,78204,132,1,181,0,244,192,0,"Anderson",76978,417.002260386084,0.185082872928177,171.477565018577,55.8601158772636,18.5082872928177
2021-08-18,9648,52,6982,27,2666,25,7817,31,70529,111,78346,142,0,181,0,244,193,1,"Anderson",76978,413.105042999299,0.189493433395872,184.468289641196,67.5517680376211,18.9493433395872
2021-08-19,9722,74,7015,33,2707,41,7853,36,70681,152,78534,188,0,181,0,244,193,0,"Anderson",76978,445.581854555847,0.190657769304099,244.225622905246,96.1313622073839,19.0657769304099
2021-08-20,9782,60,7057,42,2725,18,7897,44,70875,194,78772,238,0,181,2,246,193,0,"Anderson",76978,441.684637169061,0.181497797356828,309.179246018343,77.9443477357167,18.1497797356828
2021-08-21,9864,82,7091,34,2773,48,7931,34,71149,274,79080,308,0,181,1,247,193,0,"Anderson",76978,483.254955961444,0.169795918367347,400.114318376679,106.523941905479,16.9795918367347
2021-08-22,9886,22,7112,21,2774,1,7959,28,71305,156,79264,184,0,181,0,247,193,0,"Anderson",76978,481.955883499182,0.169348659003831,239.029333056198,28.5795941697628,16.9348659003831
2021-08-23,9936,50,7127,15,2809,35,7977,18,71440,135,79417,153,0,181,2,249,194,1,"Anderson",76978,497.544753046325,0.159851301115242,198.758086726078,64.9536231130973,15.9851301115242
2021-08-24,9981,45,7155,28,2826,17,8001,24,71526,86,79527,110,1,182,0,249,195,1,"Anderson",76978,500.142897970849,0.162509448223734,142.897970848814,58.4582608017875,16.2509448223734
2021-08-25,10054,73,7182,27,2872,46,8024,23,71570,44,79594,67,0,182,1,250,195,0,"Anderson",76978,527.42341967835,0.165865384615385,87.0378549715503,94.832289745122,16.5865384615385
2021-08-26,10122,68,7218,36,2904,32,8068,44,71742,172,79810,216,1,183,2,252,196,1,"Anderson",76978,519.628984904778,0.168495297805643,280.59965184858,88.3369274338123,16.8495297805643
2021-08-27,10200,78,7275,57,2925,21,8132,64,71919,177,80051,241,0,183,0,252,196,0,"Anderson",76978,543.012289225493,0.183737294761532,313.076463405129,101.327652056432,18.3737294761532
2021-08-28,10258,58,7306,31,2952,27,8172,40,72123,204,80295,244,0,183,0,252,196,0,"Anderson",76978,511.834550131206,0.198353909465021,316.973680791915,75.3462028111928,19.8353909465021
2021-08-29,10322,64,7355,49,2967,15,8225,53,72334,211,80559,264,0,183,1,253,197,1,"Anderson",76978,566.395593546208,0.205405405405405,342.955130037153,83.1406375847645,20.5405405405405
2021-08-30,10395,73,7402,47,2993,26,8274,49,72560,226,80834,275,0,183,3,256,197,0,"Anderson",76978,596.274260178233,0.209597741707833,357.244927122035,94.832289745122,20.9597741707833
2021-08-31,10529,134,7484,82,3045,52,8362,88,72817,257,81179,345,0,183,0,256,198,1,"Anderson",76978,711.891709319546,0.218523002421308,448.179999480371,174.075709943101,21.8523002421308
2021-09-01,10559,30,7506,22,3053,8,8386,24,72908,91,81294,115,0,183,0,256,199,1,"Anderson",76978,656.031593442282,0.212941176470588,149.393333160124,38.9721738678584,21.2941176470588
2021-09-02,10622,63,7535,29,3087,34,8418,32,73009,101,81427,133,1,184,0,256,199,0,"Anderson",76978,649.536231130973,0.216450216450216,172.776637480839,81.8415651225025,21.6450216450216
2021-09-03,10650,28,7552,17,3098,11,8435,17,73082,73,81517,90,0,184,0,256,199,0,"Anderson",76978,584.582608017875,0.20668485675307,116.916521603575,36.3740289433345,20.668485675307
2021-09-04,10757,107,7621,69,3136,38,8510,75,73403,321,81913,396,0,184,1,257,199,0,"Anderson",76978,648.23715866871,0.208899876390606,514.43269505573,139.000753462028,20.8899876390606
2021-09-05,10870,113,7695,74,3175,39,8586,76,73707,304,82293,380,0,184,1,258,200,1,"Anderson",76978,711.891709319546,0.208189158016148,493.647535659539,146.7951882356,20.8189158016148
2021-09-06,10990,120,7776,81,3214,39,8677,91,74114,407,82791,498,0,184,4,262,201,1,"Anderson",76978,772.948115045857,0.205927439959121,646.938086206449,155.888695471433,20.5927439959121
2021-09-07,11027,37,7796,20,3231,17,8695,18,74213,99,82908,117,0,184,0,262,201,0,"Anderson",76978,646.938086206449,0.192596876807403,151.991478084648,48.065681103692,19.2596876807403
2021-09-08,11068,41,7828,32,3240,9,8729,34,74320,107,83049,141,0,184,2,264,204,3,"Anderson",76978,661.22788329133,0.195441595441595,183.169217178934,53.2619709527397,19.5441595441595
2021-09-09,11127,59,7849,21,3278,38,8747,18,74526,206,83273,224,0,184,1,265,207,3,"Anderson",76978,656.031593442282,0.178223185265439,290.992231546676,76.6452752734548,17.8223185265439
2021-09-10,11281,154,7923,74,3358,80,8828,81,74818,292,83646,373,1,185,2,267,208,1,"Anderson",76978,819.714723687287,0.184593705965242,484.554028423705,200.05715918834,18.4593705965242
2021-09-11,11401,120,7990,67,3411,53,8902,74,75164,346,84066,420,0,185,2,269,208,0,"Anderson",76978,836.602665696693,0.182071528100325,545.610434150017,155.888695471433,18.2071528100325
2021-09-12,11439,38,8022,32,3417,6,8937,35,75307,143,84244,178,0,185,4,273,209,1,"Anderson",76978,739.172231027047,0.179907739620707,231.234898282626,49.3647535659539,17.9907739620707
2021-09-13,11526,87,8056,34,3470,53,8971,34,75437,130,84408,164,4,189,3,276,209,0,"Anderson",76978,696.302839772403,0.181818181818182,213.047883810959,113.019304216789,18.1818181818182
2021-09-14,11588,62,8087,31,3501,31,9007,36,75596,159,84603,195,1,190,1,277,209,0,"Anderson",76978,728.779651328951,0.184070796460177,253.319130141079,80.5424926602406,18.4070796460177
2021-09-15,11628,40,8104,17,3524,23,9022,15,75657,61,84679,76,0,190,1,278,210,1,"Anderson",76978,727.480578866689,0.179754601226994,98.7295071319078,51.9628984904778,17.9754601226994
2021-09-16,11717,89,8161,57,3556,32,9081,59,75879,222,84960,281,0,190,1,279,210,0,"Anderson",76978,766.452752734548,0.197984588026082,365.039361895607,115.617449141313,19.7984588026082
2021-09-17,11788,71,8201,40,3587,31,9120,39,76042,163,85162,202,0,190,1,280,214,4,"Anderson",76978,658.629738366806,0.192612137203166,262.412637376913,92.2341448205981,19.2612137203166
2021-09-18,11840,52,8231,30,3609,22,9153,33,76196,154,85349,187,0,190,1,281,215,1,"Anderson",76978,570.292810932994,0.195635229929852,242.926550442984,67.5517680376211,19.5635229929852
2021-09-19,11863,23,8240,9,3623,14,9163,10,76264,68,85427,78,0,190,0,281,215,0,"Anderson",76978,550.806723999065,0.191039729501268,101.327652056432,29.8786666320247,19.1039729501268
2021-09-20,11927,64,8276,36,3651,28,9200,37,76450,186,85650,223,0,190,3,284,215,0,"Anderson",76978,520.92805736704,0.184380032206119,289.693159084414,83.1406375847645,18.4380032206119
2021-09-21,11981,54,8302,26,3679,28,9224,24,76568,118,85792,142,0,190,1,285,216,1,"Anderson",76978,510.535477668944,0.182506307821699,184.468289641196,70.149912962145,18.2506307821699
2021-09-22,12032,51,8336,34,3696,17,9264,40,76840,272,86104,312,0,190,0,285,219,3,"Anderson",76978,524.825274753826,0.169824561403509,405.310608225727,66.2526955753592,16.9824561403509
2021-09-23,12108,76,8384,48,3724,28,9315,51,77048,208,86363,259,2,192,1,286,219,0,"Anderson",76978,507.93733274442,0.166785459729152,336.459767725844,98.7295071319078,16.6785459729152
2021-09-24,12147,39,8404,20,3743,19,9339,24,77188,140,86527,164,2,194,1,287,222,3,"Anderson",76978,466.367013952038,0.16043956043956,213.047883810959,50.6638260282159,16.043956043956
2021-09-25,12157,10,8408,4,3749,6,9345,6,77283,95,86628,101,0,194,0,287,222,0,"Anderson",76978,411.805970537037,0.150117279124316,131.206318688456,12.9907246226195,15.0117279124316
2021-09-26,12175,18,8423,15,3752,3,9363,18,77420,137,86783,155,1,195,0,287,222,0,"Anderson",76978,405.310608225727,0.147492625368732,201.356231650601,23.383304320715,14.7492625368732
2021-09-27,12226,51,8445,22,3781,29,9386,23,77506,86,86892,109,1,196,1,288,223,1,"Anderson",76978,388.422666216322,0.14975845410628,141.598898386552,66.2526955753592,14.975845410628
2021-09-28,12275,49,8469,24,3806,25,9413,27,77601,95,87014,122,0,196,1,289,223,0,"Anderson",76978,381.927303905012,0.154664484451718,158.486840395957,63.6545506508353,15.4664484451718
2021-09-29,12314,39,8485,16,3829,23,9430,17,77792,191,87222,208,2,198,0,289,225,2,"Anderson",76978,366.338434357868,0.148479427549195,270.207072150485,50.6638260282159,14.8479427549195
2021-09-30,12376,62,8523,38,3853,24,9470,40,77964,172,87434,212,0,198,1,290,226,1,"Anderson",76978,348.151419886201,0.144724556489262,275.403361999532,80.5424926602406,14.4724556489262
2021-10-01,12427,51,8550,27,3877,24,9499,29,78115,151,87614,180,0,198,1,291,227,1,"Anderson",76978,363.740289433345,0.147194112235511,233.83304320715,66.2526955753592,14.7194112235511
2021-10-02,12444,17,8557,7,3887,10,9505,6,78195,80,87700,86,1,199,0,291,229,2,"Anderson",76978,372.833796669178,0.149253731343284,111.720231754527,22.0842318584531,14.9253731343284
2021-10-03,12458,14,8567,10,3891,4,9515,10,78293,98,87808,108,4,203,0,291,229,0,"Anderson",76978,367.63750682013,0.148292682926829,140.29982592429,18.1870144716672,14.8292682926829
2021-10-04,12503,45,8590,23,3913,22,9541,26,78413,120,87954,146,1,204,0,291,231,2,"Anderson",76978,359.843072046559,0.145951035781544,189.664579490244,58.4582608017875,14.5951035781544
2021-10-05,12556,53,8619,29,3937,24,9571,30,78541,128,88112,158,2,206,0,291,232,1,"Anderson",76978,365.039361895607,0.143897996357013,205.253449037387,68.8508404998831,14.3897996357013
2021-10-06,12585,29,8641,22,3944,7,9597,26,78706,165,88303,191,1,207,0,291,233,1,"Anderson",76978,352.048637272987,0.154486586493987,248.122840292031,37.6731014055964,15.4486586493987
2021-10-07,12618,33,8662,21,3956,12,9621,24,78845,139,88466,163,0,207,0,291,235,2,"Anderson",76978,314.375535867391,0.146317829457364,211.748811348697,42.8693912546442,14.6317829457364
2021-10-08,12637,19,8667,5,3970,14,9630,9,78975,130,88605,139,1,208,1,292,235,0,"Anderson",76978,272.805217075008,0.132189707366297,180.57107225441,24.682376782977,13.2189707366297
2021-10-09,12652,15,8670,3,3982,12,9637,7,79037,62,88674,69,0,208,0,292,236,1,"Anderson",76978,270.207072150485,0.135523613963039,89.6359998960742,19.4860869339292,13.5523613963039
2021-10-10,12662,10,8678,8,3984,2,9646,9,79124,87,88770,96,0,208,0,292,236,0,"Anderson",76978,265.010782301437,0.136174636174636,124.710956377147,12.9907246226195,13.6174636174636
2021-10-11,12702,40,8692,14,4010,26,9659,13,79225,101,88884,114,0,208,1,293,236,0,"Anderson",76978,258.515419990127,0.126881720430108,148.094260697862,51.9628984904778,12.6881720430108
2021-10-12,12738,36,8717,25,4021,11,9682,23,79324,99,89006,122,2,210,3,296,236,0,"Anderson",76978,236.431188131674,0.124161073825503,158.486840395957,46.76660864143,12.4161073825503
2021-10-13,12764,26,8731,14,4033,12,9700,18,79436,112,89136,130,0,210,1,297,239,3,"Anderson",76978,232.533970744888,0.123649459783914,168.879420094053,33.7758840188106,12.3649459783914
2021-10-14,12784,20,8741,10,4043,10,9714,14,79539,103,89253,117,1,211,0,297,239,0,"Anderson",76978,215.646028735483,0.118170266836086,151.991478084648,25.9814492452389,11.8170266836086
2021-10-15,12807,23,8753,12,4054,11,9727,13,79660,121,89387,134,0,211,1,298,239,0,"Anderson",76978,220.842318584531,0.124040920716113,174.075709943101,29.8786666320247,12.4040920716113
2021-10-16,12817,10,8760,7,4057,3,9736,9,79715,55,89451,64,0,211,1,299,239,0,"Anderson",76978,214.346956273221,0.127413127413127,83.1406375847645,12.9907246226195,12.7413127413127
2021-10-17,12819,2,8761,1,4058,1,9737,1,79766,51,89503,52,0,211,0,299,239,0,"Anderson",76978,203.954376575125,0.124147339699864,67.5517680376211,2.59814492452389,12.4147339699864
2021-10-18,12843,24,8771,10,4072,14,9748,11,79834,68,89582,79,1,212,1,300,239,0,"Anderson",76978,183.169217178934,0.127507163323782,102.626724518694,31.1777390942867,12.7507163323782
2021-10-19,12873,30,8784,13,4089,17,9759,11,79945,111,89704,122,2,214,1,301,239,0,"Anderson",76978,175.374782405363,0.110315186246418,158.486840395957,38.9721738678584,11.0315186246418
2021-10-20,12908,35,8810,26,4098,9,9788,29,80056,111,89844,140,0,214,1,302,240,1,"Anderson",76978,187.06643456572,0.124293785310734,181.870144716672,45.4675361791681,12.4293785310734
2021-10-21,12940,32,8828,18,4112,14,9806,18,80149,93,89955,111,0,214,1,303,241,1,"Anderson",76978,202.655304112863,0.131054131054131,144.197043311076,41.5703187923822,13.1054131054131
2021-10-22,12950,10,8835,7,4115,3,9815,9,80225,76,90040,85,0,214,1,304,241,0,"Anderson",76978,185.767362103458,0.134762633996937,110.421159292265,12.9907246226195,13.4762633996937
2021-10-23,12967,17,8839,4,4128,13,9819,4,80278,53,90097,57,0,214,1,305,241,0,"Anderson",76978,194.860869339292,0.128482972136223,74.0471303489309,22.0842318584531,12.8482972136223
2021-10-24,12973,6,8844,5,4129,1,9826,7,80330,52,90156,59,0,214,0,305,242,1,"Anderson",76978,200.05715918834,0.136294027565084,76.6452752734548,7.79443477357167,13.6294027565084
2021-10-25,12998,25,8858,14,4140,11,9841,15,80401,71,90242,86,1,215,2,307,242,0,"Anderson",76978,201.356231650601,0.140909090909091,111.720231754527,32.4768115565486,14.0909090909091
2021-10-26,13010,12,8864,6,4146,6,9847,6,80465,64,90312,70,0,215,0,307,243,1,"Anderson",76978,177.972927329886,0.144736842105263,90.9350723583361,15.5888695471433,14.4736842105263
2021-10-27,13028,18,8874,10,4154,8,9860,13,80586,121,90446,134,1,216,2,309,245,2,"Anderson",76978,155.888695471433,0.119601328903654,174.075709943101,23.383304320715,11.9601328903654
2021-10-28,13050,22,8888,14,4162,8,9877,17,80668,82,90545,99,1,217,0,309,246,1,"Anderson",76978,142.897970848814,0.120338983050847,128.608173763933,28.5795941697628,12.0338983050847
2021-10-29,13071,21,8899,11,4172,10,9889,12,80782,114,90671,126,0,217,1,310,246,0,"Anderson",76978,157.187767933695,0.117274167987322,163.683130245005,27.2805217075008,11.7274167987322
2021-10-30,13083,12,8903,4,4180,8,9894,5,80869,87,90763,92,0,217,1,311,246,0,"Anderson",76978,150.692405622386,0.112612612612613,119.514666528099,15.5888695471433,11.2612612612613
2021-10-31,13086,3,8905,2,4181,1,9897,3,80908,39,90805,42,0,217,0,311,246,0,"Anderson",76978,146.7951882356,0.10939907550077,54.5610434150017,3.89721738678583,10.939907550077
2021-11-01,13113,27,8910,5,4203,22,9901,4,80996,88,90897,92,1,218,1,312,247,1,"Anderson",76978,149.393333160124,0.0916030534351145,119.514666528099,35.0749564810725,9.16030534351145
2021-11-02,13133,20,8915,5,4218,15,9906,5,81072,76,90978,81,2,220,1,313,247,0,"Anderson",76978,159.785912858219,0.0885885885885886,105.224869443218,25.9814492452389,8.85885885885886
2021-11-03,13163,30,8933,18,4230,12,9924,18,81272,200,91196,218,1,221,0,313,247,0,"Anderson",76978,175.374782405363,0.0853333333333333,283.197796773104,38.9721738678584,8.53333333333333
2021-11-04,13185,22,8948,15,4237,7,9940,16,81405,133,91345,149,0,221,0,313,247,0,"Anderson",76978,175.374782405363,0.07875,193.56179687703,28.5795941697628,7.875
2021-11-05,13195,10,8951,3,4244,7,9941,1,81527,122,91468,123,0,221,0,313,247,0,"Anderson",76978,161.084985320481,0.0652446675031368,159.785912858219,12.9907246226195,6.52446675031368
2021-11-06,13204,9,8955,4,4249,5,9946,5,81614,87,91560,92,0,221,3,316,248,1,"Anderson",76978,157.187767933695,0.0652446675031368,119.514666528099,11.6916521603575,6.52446675031368
2021-11-07,13210,6,8960,5,4250,1,9952,6,81662,48,91614,54,0,221,0,316,248,0,"Anderson",76978,161.084985320481,0.0679851668726823,70.149912962145,7.79443477357167,6.79851668726823
2021-11-08,13235,25,8971,11,4264,14,9965,13,81750,88,91715,101,1,222,0,316,248,0,"Anderson",76978,158.486840395957,0.078239608801956,131.206318688456,32.4768115565486,7.8239608801956
2021-11-09,13258,23,8978,7,4280,16,9971,6,81908,158,91879,164,1,223,0,316,249,1,"Anderson",76978,162.384057782743,0.072142064372919,213.047883810959,29.8786666320247,7.2142064372919
2021-11-10,13276,18,8990,12,4286,6,9984,13,82024,116,92008,129,0,223,1,317,250,1,"Anderson",76978,146.7951882356,0.0738916256157636,167.580347631791,23.383304320715,7.38916256157635
2021-11-11,13299,23,9008,18,4291,5,10002,18,82214,190,92216,208,0,223,0,317,251,1,"Anderson",76978,148.094260697862,0.0711825487944891,270.207072150485,29.8786666320247,7.11825487944891
2021-11-12,13312,13,9016,8,4296,5,10010,8,82347,133,92357,141,0,223,1,318,251,0,"Anderson",76978,151.991478084648,0.077615298087739,183.169217178934,16.8879420094053,7.7615298087739
2021-11-13,13319,7,9020,4,4299,3,10014,4,82398,51,92412,55,3,226,1,319,252,1,"Anderson",76978,149.393333160124,0.07981220657277,71.448985424407,9.09350723583361,7.981220657277
2021-11-14,13321,2,9022,2,4299,0,10017,3,82477,79,92494,82,0,226,0,319,252,0,"Anderson",76978,144.197043311076,0.0738636363636364,106.523941905479,2.59814492452389,7.38636363636364
2021-11-15,13353,32,9036,14,4317,18,10031,14,82562,85,92593,99,0,226,0,319,253,1,"Anderson",76978,153.29055054691,0.0751708428246014,128.608173763933,41.5703187923822,7.51708428246014
2021-11-16,13378,25,9049,13,4329,12,10044,13,82688,126,92732,139,1,227,0,319,254,1,"Anderson",76978,155.888695471433,0.0855803048065651,180.57107225441,32.4768115565486,8.5580304806565
2021-11-17,13395,17,9058,9,4337,8,10053,9,82802,114,92855,123,0,227,2,321,256,2,"Anderson",76978,154.589623009171,0.0814639905548996,159.785912858219,22.0842318584531,8.14639905548996
2021-11-18,13417,22,9071,13,4346,9,10070,17,82937,135,93007,152,4,231,0,321,258,2,"Anderson",76978,153.29055054691,0.0859671302149178,197.459014263816,28.5795941697628,8.59671302149178
2021-11-19,13431,14,9077,6,4354,8,10077,7,83046,109,93123,116,1,232,0,321,258,0,"Anderson",76978,154.589623009171,0.087467362924282,150.692405622386,18.1870144716672,8.7467362924282
2021-11-20,13440,9,9082,5,4358,4,10082,5,83139,93,93221,98,0,232,0,321,259,1,"Anderson",76978,157.187767933695,0.0840543881334982,127.309101301671,11.6916521603575,8.40543881334981
2021-11-21,13452,12,9088,6,4364,6,10088,6,83179,40,93267,46,0,232,0,321,259,0,"Anderson",76978,170.178492556315,0.091849935316947,59.7573332640495,15.5888695471433,9.1849935316947
2021-11-22,13480,28,9105,17,4375,11,10106,18,83301,122,93407,140,1,233,0,321,259,0,"Anderson",76978,164.982202707267,0.0921375921375921,181.870144716672,36.3740289433345,9.21375921375921
2021-11-23,13497,17,9111,6,4386,11,10111,5,83398,97,93509,102,0,233,1,322,261,2,"Anderson",76978,154.589623009171,0.0862290862290862,132.505391150718,22.0842318584531,8.62290862290862
2021-11-24,13522,25,9127,16,4395,9,10123,12,83508,110,93631,122,1,234,1,323,261,0,"Anderson",76978,164.982202707267,0.0902061855670103,158.486840395957,32.4768115565486,9.02061855670103
2021-11-25,13527,5,9129,2,4398,3,10124,1,83553,45,93677,46,0,234,2,325,261,0,"Anderson",76978,142.897970848814,0.0805970149253731,59.7573332640495,6.49536231130973,8.05970149253731
2021-11-26,13534,7,9135,6,4399,1,10133,9,83596,43,93729,52,0,234,0,325,262,1,"Anderson",76978,133.80446361298,0.0924092409240924,67.5517680376211,9.09350723583361,9.24092409240924
2021-11-27,13539,5,9137,2,4402,3,10135,2,83632,36,93767,38,0,234,0,325,262,0,"Anderson",76978,128.608173763933,0.0970695970695971,49.3647535659539,6.49536231130973,9.70695970695971
2021-11-28,13549,10,9138,1,4411,9,10136,1,83670,38,93806,39,0,234,0,325,262,0,"Anderson",76978,126.010028839409,0.0890538033395176,50.6638260282159,12.9907246226195,8.90538033395176
2021-11-29,13576,27,9153,15,4423,12,10152,16,83749,79,93901,95,0,234,0,325,262,0,"Anderson",76978,124.710956377147,0.0931174089068826,123.411883914885,35.0749564810725,9.31174089068826
2021-11-30,13602,26,9166,13,4436,13,10164,12,83851,102,94015,114,0,234,1,326,262,0,"Anderson",76978,136.402608537504,0.104743083003953,148.094260697862,33.7758840188106,10.4743083003953
2021-12-01,13634,32,9185,19,4449,13,10183,19,83958,107,94141,126,0,234,2,328,262,0,"Anderson",76978,145.496115773338,0.117647058823529,163.683130245005,41.5703187923822,11.7647058823529
2021-12-02,13676,42,9209,24,4467,18,10209,26,84096,138,94305,164,0,234,0,328,265,3,"Anderson",76978,193.56179687703,0.135350318471338,213.047883810959,54.5610434150017,13.5350318471338
2021-12-03,13707,31,9227,18,4480,13,10228,19,84283,187,94511,206,1,235,1,329,265,0,"Anderson",76978,224.739535971316,0.121483375959079,267.608927225961,40.2712463301203,12.1483375959079
2021-12-04,13727,20,9240,13,4487,7,10242,14,84352,69,94594,83,0,235,0,329,265,0,"Anderson",76978,244.225622905246,0.129383313180169,107.823014367741,25.9814492452389,12.9383313180169
2021-12-05,13740,13,9242,2,4498,11,10244,2,84394,42,94638,44,0,235,0,329,265,0,"Anderson",76978,248.122840292031,0.129807692307692,57.1591883395256,16.8879420094053,12.9807692307692
2021-12-06,13775,35,9262,20,4513,15,10266,22,84496,102,94762,124,2,237,1,330,265,0,"Anderson",76978,258.515419990127,0.132404181184669,161.084985320481,45.4675361791681,13.2404181184669
2021-12-07,13805,30,9277,15,4528,15,10282,16,84591,95,94873,111,0,237,0,330,265,0,"Anderson",76978,263.711709839175,0.137529137529138,144.197043311076,38.9721738678584,13.7529137529138
2021-12-08,13832,27,9298,21,4534,6,10302,20,84712,121,95014,141,0,237,2,332,265,0,"Anderson",76978,257.216347527865,0.13631156930126,183.169217178934,35.0749564810725,13.631156930126
2021-12-09,13860,28,9314,16,4546,12,10319,17,84922,210,95241,227,0,237,1,333,265,0,"Anderson",76978,239.029333056198,0.117521367521368,294.889448933461,36.3740289433345,11.7521367521368
2021-12-10,13889,29,9331,17,4558,12,10336,17,85075,153,95411,170,0,237,2,335,265,0,"Anderson",76978,236.431188131674,0.12,220.842318584531,37.6731014055964,12
2021-12-11,13898,9,9336,5,4562,4,10342,6,85150,75,95492,81,0,237,0,335,266,1,"Anderson",76978,222.141391046793,0.111358574610245,105.224869443218,11.6916521603575,11.1358574610245
2021-12-12,13918,20,9347,11,4571,9,10353,11,85220,70,95573,81,0,237,0,335,266,0,"Anderson",76978,231.234898282626,0.116577540106952,105.224869443218,25.9814492452389,11.6577540106952
2021-12-13,13947,29,9353,6,4594,23,10360,7,85295,75,95655,82,0,237,0,335,269,3,"Anderson",76978,223.440463509055,0.105263157894737,106.523941905479,37.6731014055964,10.5263157894737
2021-12-14,13961,14,9358,5,4603,9,10366,6,85374,79,95740,85,3,240,1,336,269,0,"Anderson",76978,202.655304112863,0.0968858131487889,110.421159292265,18.1870144716672,9.68858131487889
2021-12-15,13987,26,9372,14,4615,12,10381,15,85503,129,95884,144,0,240,0,336,270,1,"Anderson",76978,201.356231650601,0.0908045977011494,187.06643456572,33.7758840188106,9.08045977011494
2021-12-16,14015,28,9382,10,4633,18,10396,15,85598,95,95994,110,0,240,2,338,270,0,"Anderson",76978,201.356231650601,0.102257636122178,142.897970848814,36.3740289433345,10.2257636122178
2021-12-17,14046,31,9405,23,4641,8,10418,22,85753,155,96171,177,1,241,0,338,271,1,"Anderson",76978,203.954376575125,0.107894736842105,229.935825820364,40.2712463301203,10.7894736842105
2021-12-18,14057,11,9414,9,4643,2,10428,10,85835,82,96263,92,0,241,0,338,271,0,"Anderson",76978,206.552521499649,0.111543450064851,119.514666528099,14.2897970848814,11.1543450064851
2021-12-19,14071,14,9422,8,4649,6,10439,11,85915,80,96354,91,0,241,0,338,271,0,"Anderson",76978,198.758086726078,0.1101152368758,118.215594065837,18.1870144716672,11.01152368758
2021-12-20,14095,24,9438,16,4657,8,10453,14,86001,86,96454,100,0,241,0,338,272,1,"Anderson",76978,192.262724414768,0.11639549436796,129.907246226195,31.1777390942867,11.639549436796
2021-12-21,14123,28,9446,8,4677,20,10464,11,86082,81,96546,92,0,241,0,338,272,0,"Anderson",76978,210.449738886435,0.121588089330025,119.514666528099,36.3740289433345,12.1588089330025
2021-12-22,14171,48,9460,14,4711,34,10475,11,86197,115,96672,126,19,260,1,339,273,1,"Anderson",76978,239.029333056198,0.119289340101523,163.683130245005,62.3554781885734,11.9289340101523
2021-12-23,14198,27,9475,15,4723,12,10492,17,86297,100,96789,117,-1,259,1,340,274,1,"Anderson",76978,237.730260593936,0.120754716981132,151.991478084648,35.0749564810725,12.0754716981132
2021-12-24,14224,26,9490,15,4734,11,10509,17,86384,87,96893,104,0,259,1,341,274,0,"Anderson",76978,231.234898282626,0.126038781163435,135.103536075242,33.7758840188106,12.6038781163435
2021-12-25,14238,14,9497,7,4741,7,10519,10,86442,58,96961,68,1,260,0,341,275,1,"Anderson",76978,235.132115669412,0.130372492836676,88.3369274338123,18.1870144716672,13.0372492836676
2021-12-26,14249,11,9501,4,4748,7,10525,6,86486,44,97011,50,1,261,0,341,275,0,"Anderson",76978,231.234898282626,0.13089802130898,64.9536231130973,14.2897970848814,13.089802130898
2021-12-27,14296,47,9520,19,4776,28,10545,20,86590,104,97135,124,1,262,2,343,276,1,"Anderson",76978,261.113564914651,0.135095447870778,161.084985320481,61.0564057263114,13.5095447870778
2021-12-28,14383,87,9556,36,4827,51,10581,36,86699,109,97280,145,0,262,0,343,276,0,"Anderson",76978,337.758840188106,0.159400544959128,188.365507027982,113.019304216789,15.9400544959128
2021-12-29,14464,81,9600,44,4864,37,10628,47,86857,158,97485,205,2,264,0,343,276,0,"Anderson",76978,380.62823144275,0.188191881918819,266.309854763699,105.224869443218,18.8191881918819
2021-12-30,14557,93,9642,42,4915,51,10666,38,86976,119,97642,157,1,265,0,343,276,0,"Anderson",76978,466.367013952038,0.203985932004689,203.954376575125,120.813738990361,20.3985932004689
2021-12-31,14625,68,9683,41,4942,27,10711,45,87093,117,97804,162,0,265,0,343,277,1,"Anderson",76978,520.92805736704,0.221734357848518,210.449738886435,88.3369274338123,22.1734357848518
2022-01-01,14686,61,9717,34,4969,27,10748,37,87192,99,97940,136,0,265,0,343,277,0,"Anderson",76978,581.984463093351,0.23391215526047,176.673854867625,79.2434201979787,23.391215526047
2022-01-02,14718,32,9740,23,4978,9,10781,33,87308,116,98089,149,0,265,0,343,278,1,"Anderson",76978,609.264984800852,0.23747680890538,193.56179687703,41.5703187923822,23.747680890538
2022-01-03,14779,61,9761,21,5018,40,10804,23,87384,76,98188,99,1,266,0,343,278,0,"Anderson",76978,627.451999272519,0.245963912630579,128.608173763933,79.2434201979787,24.5963912630579
2022-01-04,14905,126,9826,65,5079,61,10867,63,87558,174,98425,237,1,267,0,343,279,1,"Anderson",76978,678.115825300735,0.249781659388646,307.880173556081,163.683130245005,24.9781659388646
2022-01-05,15072,167,9912,86,5160,81,10953,86,87704,146,98657,232,1,268,0,343,280,1,"Anderson",76978,789.836057055263,0.277303754266212,301.384811244771,216.945101197745,27.7303754266212
2022-01-06,15214,142,9984,72,5230,70,11024,71,87824,120,98848,191,1,269,1,344,280,0,"Anderson",76978,853.490607706098,0.296849087893864,248.122840292031,184.468289641196,29.6849087893864
2022-01-07,15356,142,10057,73,5299,69,11102,78,87964,140,99066,218,0,269,1,345,280,0,"Anderson",76978,949.621969913482,0.309825673534073,283.197796773104,184.468289641196,30.9825673534073
2022-01-08,15459,103,10099,42,5360,61,11147,45,88039,75,99186,120,0,269,2,347,282,2,"Anderson",76978,1004.18301332848,0.320224719101124,155.888695471433,133.80446361298,32.0224719101124
2022-01-09,15544,85,10155,56,5389,29,11209,62,88182,143,99391,205,0,269,1,348,282,0,"Anderson",76978,1073.03385382837,0.328725038402458,266.309854763699,110.421159292265,32.8725038402458
2022-01-10,15699,155,10229,74,5470,81,11287,78,88295,113,99582,191,1,270,3,351,284,2,"Anderson",76978,1195.14666528099,0.34648493543759,248.122840292031,201.356231650601,34.648493543759
2022-01-11,15874,175,10338,109,5536,66,11389,102,88436,141,99825,243,0,270,0,351,285,1,"Anderson",76978,1258.80121593182,0.372857142857143,315.674608329653,227.33768089584,37.2857142857143
2022-01-12,16133,259,10501,163,5632,96,11553,164,88627,191,100180,355,0,270,1,352,285,0,"Anderson",76978,1378.31588245992,0.393959290873276,461.17072410299,336.459767725844,39.3959290873276
2022-01-13,16365,232,10652,151,5713,81,11708,155,88859,232,100567,387,4,274,0,352,285,0,"Anderson",76978,1495.2324040635,0.397905759162304,502.741042895373,301.384811244771,39.7905759162304
2022-01-14,16619,254,10795,143,5824,111,11857,149,89015,156,100872,305,2,276,1,353,285,0,"Anderson",76978,1640.72851983684,0.418050941306755,396.217100989893,329.964405414534,41.8050941306755
2022-01-15,16716,97,10854,59,5862,38,11919,62,89133,118,101052,180,1,277,2,355,285,0,"Anderson",76978,1632.93408506326,0.413719185423365,233.83304320715,126.010028839409,41.3719185423366
2022-01-16,16868,152,10982,128,5886,24,12052,133,89330,197,101382,330,0,277,1,356,285,0,"Anderson",76978,1719.97194003482,0.42340532395781,428.693912546442,197.459014263816,42.340532395781
2022-01-17,17048,180,11094,112,5954,68,12168,116,89449,119,101617,235,0,277,2,358,285,0,"Anderson",76978,1752.44875159136,0.432923832923833,305.282028631557,233.83304320715,43.2923832923833
2022-01-18,17264,216,11234,140,6030,76,12311,143,89586,137,101897,280,0,277,0,358,287,2,"Anderson",76978,1805.7107225441,0.444980694980695,363.740289433345,280.59965184858,44.4980694980695
2022-01-19,17567,303,11446,212,6121,91,12526,215,89806,220,102332,435,3,280,0,358,287,0,"Anderson",76978,1862.86991088363,0.452137546468401,565.096521083946,393.618956065369,45.2137546468402
2022-01-20,17865,298,11689,243,6176,55,12788,262,89963,157,102751,419,1,281,2,360,288,1,"Anderson",76978,1948.60869339292,0.494505494505495,544.311361687755,387.12359375406,49.4505494505495
2022-01-21,18111,246,11904,215,6207,31,13013,225,90182,219,103195,444,2,283,1,361,290,2,"Anderson",76978,1938.21611369482,0.497632371932845,576.788173244304,319.571825716438,49.7632371932845
2022-01-22,18240,129,11996,92,6244,37,13117,104,90301,119,103418,223,0,283,0,361,290,0,"Anderson",76978,1979.7864324872,0.506339814032122,289.693159084414,167.580347631791,50.6339814032122
2022-01-23,18368,128,12107,111,6261,17,13231,114,90408,107,103639,221,0,283,0,361,291,1,"Anderson",76978,1948.60869339292,0.522374833850244,287.09501415989,166.281275169529,52.2374833850244
2022-01-24,18636,268,12257,150,6379,118,13392,161,90586,178,103978,339,1,284,1,362,292,1,"Anderson",76978,2062.92707007197,0.518424396442186,440.385564706799,348.151419886201,51.8424396442186
2022-01-25,18820,184,12390,133,6430,51,13537,145,90706,120,104243,265,1,285,0,362,293,1,"Anderson",76978,2021.35675127959,0.522591645353794,344.254202499415,239.029333056198,52.2591645353794
2022-01-26,19026,206,12545,155,6481,51,13704,167,90858,152,104562,319,1,286,2,364,293,0,"Anderson",76978,1895.34672244018,0.528251121076233,414.40411546156,267.608927225961,52.8251121076233
2022-01-27,19249,223,12719,174,6530,49,13884,180,91078,220,104962,400,0,286,0,364,293,0,"Anderson",76978,1797.91628777053,0.495703301673451,519.628984904778,289.693159084414,49.5703301673451
2022-01-28,19439,190,12857,138,6582,52,14028,144,91241,163,105269,307,1,287,1,365,294,1,"Anderson",76978,1725.16822988386,0.489392478302797,398.815245914417,246.82376782977,48.9392478302797
2022-01-29,19583,144,12958,101,6625,43,14134,106,91358,117,105492,223,0,287,0,365,296,2,"Anderson",76978,1744.65431681779,0.490356798457088,289.693159084414,187.06643456572,49.0356798457088
2022-01-30,19650,67,13004,46,6646,21,14184,50,91449,91,105633,141,0,287,2,367,297,1,"Anderson",76978,1665.41089661981,0.477933801404213,183.169217178934,87.0378549715503,47.7933801404213
2022-01-31,19845,195,13124,120,6721,75,14324,140,91599,150,105923,290,4,291,1,368,299,2,"Anderson",76978,1570.57860687469,0.479177377892031,376.731014055964,253.319130141079,47.9177377892031
2022-02-01,20008,163,13219,95,6789,68,14431,107,91719,120,106150,227,1,292,1,369,299,0,"Anderson",76978,1543.29808516719,0.468799160985842,294.889448933461,211.748811348697,46.8799160985842
2022-02-02,20152,144,13306,87,6846,57,14524,93,91860,141,106384,234,1,293,0,369,300,1,"Anderson",76978,1462.75559250695,0.450054884742042,303.982956169295,187.06643456572,45.0054884742042
2022-02-03,20786,634,13398,92,7388,542,14623,99,92068,208,106691,307,2,295,1,370,302,2,"Anderson",76978,1996.67437449661,0.427414690572585,398.815245914417,823.611941074073,42.7414690572585
2022-02-04,20932,146,13508,110,7424,36,14733,110,92192,124,106925,234,0,295,0,370,305,3,"Anderson",76978,1939.51518615708,0.425724637681159,303.982956169295,189.664579490244,42.5724637681159
2022-02-05,20981,49,13534,26,7447,23,14763,30,92268,76,107031,106,0,295,0,370,306,1,"Anderson",76978,1816.1033022422,0.408706952566602,137.701680999766,63.6545506508353,40.8706952566602
2022-02-06,21040,59,13578,44,7462,15,14812,49,92342,74,107154,123,0,295,1,371,308,2,"Anderson",76978,1805.7107225441,0.412886259040105,159.785912858219,76.6452752734548,41.2886259040105
2022-02-07,21124,84,13629,51,7495,33,14868,56,92444,102,107312,158,3,298,0,371,309,1,"Anderson",76978,1661.51367923303,0.391648668106551,205.253449037387,109.122086830003,39.1648668106551
2022-02-08,21210,86,13677,48,7533,38,14926,58,92541,97,107467,155,0,298,0,371,309,0,"Anderson",76978,1561.48509963886,0.375854214123007,201.356231650601,111.720231754527,37.5854214123007
2022-02-09,21309,99,13741,64,7568,35,15000,74,92648,107,107648,181,0,298,0,371,310,1,"Anderson",76978,1503.02683883707,0.376582278481013,235.132115669412,128.608173763933,37.6582278481013
2022-02-10,21397,88,13791,50,7606,38,15054,54,92774,126,107828,180,2,300,0,371,311,1,"Anderson",76978,793.733274442048,0.379067722075638,233.83304320715,114.318376679051,37.9067722075638
2022-02-11,21457,60,13834,43,7623,17,15100,46,92876,102,107976,148,1,301,0,371,311,0,"Anderson",76978,682.013042687521,0.34919124643197,192.262724414768,77.9443477357167,34.919124643197
2022-02-12,21488,31,13857,23,7631,8,15125,25,92938,62,108063,87,0,301,1,372,311,0,"Anderson",76978,658.629738366806,0.35077519379845,113.019304216789,40.2712463301203,35.077519379845
2022-02-13,21509,21,13871,14,7638,7,15140,15,92985,47,108125,62,0,301,0,372,312,1,"Anderson",76978,609.264984800852,0.337796086508754,80.5424926602406,27.2805217075008,33.7796086508754
2022-02-14,21560,51,13898,27,7662,24,15176,36,93042,57,108218,93,1,302,0,372,312,0,"Anderson",76978,566.395593546208,0.339955849889625,120.813738990361,66.2526955753592,33.9955849889625
2022-02-15,21617,57,13937,39,7680,18,15221,45,93119,77,108340,122,0,302,0,372,313,1,"Anderson",76978,528.722492140612,0.337915234822451,158.486840395957,74.0471303489309,33.7915234822451
2022-02-16,21679,62,13970,33,7709,29,15252,31,93211,92,108463,123,0,302,0,372,313,0,"Anderson",76978,480.65681103692,0.30920245398773,159.785912858219,80.5424926602406,30.920245398773
2022-02-17,21727,48,14003,33,7724,15,15287,35,93305,94,108592,129,0,302,0,372,314,1,"Anderson",76978,428.693912546442,0.304973821989529,167.580347631791,62.3554781885734,30.4973821989529
2022-02-18,21775,48,14034,31,7741,17,15324,37,93377,72,108701,109,0,302,0,372,315,1,"Anderson",76978,413.105042999299,0.308965517241379,141.598898386552,62.3554781885734,30.8965517241379
2022-02-19,21801,26,14044,10,7757,16,15335,11,93432,55,108767,66,0,302,0,372,317,2,"Anderson",76978,406.609680687989,0.298295454545455,85.7387825092884,33.7758840188106,29.8295454545455
2022-02-20,21811,10,14047,3,7764,7,15337,2,93469,37,108806,39,0,302,0,372,317,0,"Anderson",76978,392.319883603107,0.28928046989721,50.6638260282159,12.9907246226195,28.928046989721
2022-02-21,21827,16,14056,9,7771,7,15347,10,93498,29,108845,39,0,302,2,374,318,1,"Anderson",76978,346.852347423939,0.272727272727273,50.6638260282159,20.7851593961911,27.2727272727273
2022-02-22,21862,35,14071,15,7791,20,15365,18,93575,77,108940,95,2,304,0,374,318,0,"Anderson",76978,318.272753254177,0.24,123.411883914885,45.4675361791681,24
2022-02-23,21898,36,14089,18,7809,18,15385,20,93641,66,109026,86,4,308,0,374,319,1,"Anderson",76978,284.496869235366,0.236234458259325,111.720231754527,46.76660864143,23.6234458259325
2022-02-24,21926,28,14103,14,7823,14,15402,17,93719,78,109121,95,1,309,0,374,320,1,"Anderson",76978,258.515419990127,0.217391304347826,123.411883914885,36.3740289433345,21.7391304347826
2022-02-25,21939,13,14109,6,7830,7,15408,6,93786,67,109194,73,-1,308,0,374,320,0,"Anderson",76978,213.047883810959,0.170385395537525,94.832289745122,16.8879420094053,17.0385395537525
2022-02-26,21952,13,14114,5,7838,8,15415,7,93831,45,109246,52,0,308,1,375,320,0,"Anderson",76978,196.159941801554,0.167014613778706,67.5517680376211,16.8879420094053,16.7014613778706
2022-02-27,21952,0,14114,0,7838,0,15416,1,93848,17,109264,18,0,308,0,375,320,0,"Anderson",76978,183.169217178934,0.172489082969432,23.383304320715,0,17.2489082969432
2022-02-28,21970,18,14123,9,7847,9,15428,12,93905,57,109333,69,0,308,0,375,320,0,"Anderson",76978,185.767362103458,0.165983606557377,89.6359998960742,23.383304320715,16.5983606557377
2022-03-01,21983,13,14130,7,7853,6,15436,8,93950,45,109386,53,-1,307,0,375,322,2,"Anderson",76978,157.187767933695,0.159192825112108,68.8508404998831,16.8879420094053,15.9192825112108
2022-03-02,21993,10,14136,6,7857,4,15444,8,94003,53,109447,61,2,309,0,375,323,1,"Anderson",76978,123.411883914885,0.140142517814727,79.2434201979787,12.9907246226195,14.0142517814727
2022-03-03,22003,10,14138,2,7865,8,15446,2,94047,44,109493,46,2,311,0,375,323,0,"Anderson",76978,100.02857959417,0.118279569892473,59.7573332640495,12.9907246226195,11.8279569892473
2022-03-04,22012,9,14141,3,7871,6,15451,5,94111,64,109562,69,0,311,0,375,324,1,"Anderson",76978,94.832289745122,0.116847826086957,89.6359998960742,11.6916521603575,11.6847826086957
2022-03-05,22017,5,14142,1,7875,4,15452,1,94152,41,109604,42,0,311,0,375,325,1,"Anderson",76978,84.4397100470264,0.103351955307263,54.5610434150017,6.49536231130973,10.3351955307263
2022-03-06,22019,2,14143,1,7876,1,15453,1,94176,24,109629,25,0,311,1,376,326,1,"Anderson",76978,87.0378549715503,0.101369863013699,32.4768115565486,2.59814492452389,10.1369863013699
2022-03-07,22032,13,14145,2,7887,11,15455,2,94209,33,109664,35,1,312,0,376,326,0,"Anderson",76978,80.5424926602406,0.081570996978852,45.4675361791681,16.8879420094053,8.1570996978852
2022-03-08,22083,51,14147,2,7936,49,15458,3,94239,30,109697,33,0,312,0,376,327,1,"Anderson",76978,129.907246226195,0.0707395498392283,42.8693912546442,66.2526955753592,7.07395498392283
2022-03-09,22090,7,14153,6,7937,1,15463,5,94277,38,109740,43,0,312,0,376,327,0,"Anderson",76978,126.010028839409,0.0648464163822526,55.8601158772636,9.09350723583361,6.48464163822526
2022-03-10,22095,5,14157,4,7938,1,15470,7,94323,46,109793,53,3,315,0,376,327,0,"Anderson",76978,119.514666528099,0.08,68.8508404998831,6.49536231130973,8
2022-03-11,22101,6,14157,0,7944,6,15471,1,94362,39,109833,40,1,316,1,377,327,0,"Anderson",76978,115.617449141313,0.0738007380073801,51.9628984904778,7.79443477357167,7.38007380073801
2022-03-12,22101,0,14157,0,7944,0,15471,0,94384,22,109855,22,0,316,0,377,329,2,"Anderson",76978,109.122086830003,0.0756972111553785,28.5795941697628,0,7.56972111553785
2022-03-13,22104,3,14159,2,7945,1,15472,1,94428,44,109900,45,1,317,0,377,329,0,"Anderson",76978,110.421159292265,0.0701107011070111,58.4582608017875,3.89721738678583,7.01107011070111
2022-03-14,22111,7,14163,4,7948,3,15479,7,94454,26,109933,33,2,319,1,378,329,0,"Anderson",76978,102.626724518694,0.0892193308550186,42.8693912546442,9.09350723583361,8.92193308550186
2022-03-15,22115,4,14164,1,7951,3,15479,0,94476,22,109955,22,0,319,0,378,330,1,"Anderson",76978,41.5703187923822,0.0813953488372093,28.5795941697628,5.19628984904778,8.13953488372093
2022-03-16,22117,2,14166,2,7951,0,15482,3,94500,24,109982,27,1,320,0,378,330,0,"Anderson",76978,35.0749564810725,0.0785123966942149,35.0749564810725,2.59814492452389,7.85123966942149
2022-03-17,22117,0,14166,0,7951,0,15484,2,94529,29,110013,31,0,320,0,378,330,0,"Anderson",76978,28.5795941697628,0.0636363636363636,40.2712463301203,0,6.36363636363636
2022-03-18,22119,2,14168,2,7951,0,15486,2,94573,44,110059,46,0,320,0,378,331,1,"Anderson",76978,23.383304320715,0.0663716814159292,59.7573332640495,2.59814492452389,6.63716814159292
2022-03-19,22119,0,14168,0,7951,0,15486,0,94593,20,110079,20,0,320,0,378,331,0,"Anderson",76978,23.383304320715,0.0669642857142857,25.9814492452389,0,6.69642857142857
2022-03-20,22124,5,14172,4,7952,1,15491,5,94612,19,110103,24,0,320,0,378,332,1,"Anderson",76978,25.9814492452389,0.0935960591133005,31.1777390942867,6.49536231130973,9.35960591133005
2022-03-21,22125,1,14172,0,7953,1,15491,0,94625,13,110116,13,2,322,0,378,332,0,"Anderson",76978,18.1870144716672,0.0655737704918033,16.8879420094053,1.29907246226194,6.55737704918033
2022-03-22,22125,0,14172,0,7953,0,15492,1,94631,6,110123,7,0,322,0,378,332,0,"Anderson",76978,12.9907246226194,0.0773809523809524,9.09350723583361,0,7.73809523809524
2022-03-23,22127,2,14174,2,7953,0,15494,2,94656,25,110150,27,0,322,0,378,333,1,"Anderson",76978,12.9907246226194,0.0714285714285714,35.0749564810725,2.59814492452389,7.14285714285714
2022-03-24,22128,1,14174,0,7954,1,15495,1,94672,16,110167,17,0,322,0,378,334,1,"Anderson",76978,14.2897970848814,0.0714285714285714,22.0842318584531,1.29907246226194,7.14285714285714
2022-03-25,22129,1,14175,1,7954,0,15497,2,94695,23,110192,25,0,322,0,378,334,0,"Anderson",76978,12.9907246226194,0.0827067669172932,32.4768115565486,1.29907246226194,8.27067669172932
2022-03-26,22130,1,14176,1,7954,0,15498,1,94714,19,110212,20,0,322,0,378,334,0,"Anderson",76978,14.2897970848814,0.0902255639097744,25.9814492452389,1.29907246226194,9.02255639097744
2022-03-27,22130,0,14176,0,7954,0,15498,0,94725,11,110223,11,0,322,0,378,334,0,"Anderson",76978,7.79443477357167,0.0583333333333333,14.2897970848814,0,5.83333333333333
2022-03-28,22134,4,14179,3,7955,1,15501,3,94769,44,110270,47,1,323,0,378,336,2,"Anderson",76978,11.6916521603575,0.0649350649350649,61.0564057263114,5.19628984904778,6.49350649350649
2022-03-29,22134,0,14179,0,7955,0,15501,0,94782,13,110283,13,1,324,0,378,337,1,"Anderson",76978,11.6916521603575,0.05625,16.8879420094053,0,5.625
2022-03-30,22136,2,14179,0,7957,2,15502,1,94805,23,110307,24,1,325,0,378,337,0,"Anderson",76978,11.6916521603575,0.0509554140127389,31.1777390942867,2.59814492452389,5.09554140127389
2022-03-31,22138,2,14180,1,7958,1,15503,1,94825,20,110328,21,0,325,0,378,337,0,"Anderson",76978,12.9907246226194,0.0496894409937888,27.2805217075008,2.59814492452389,4.96894409937888
2022-04-01,22141,3,14181,1,7960,2,15504,1,94862,37,110366,38,3,328,0,378,337,0,"Anderson",76978,15.5888695471433,0.0402298850574713,49.3647535659539,3.89721738678583,4.02298850574713
2022-04-02,22142,1,14182,1,7960,0,15506,2,94882,20,110388,22,0,328,0,378,337,0,"Anderson",76978,15.5888695471433,0.0454545454545455,28.5795941697628,1.29907246226194,4.54545454545455
2022-04-03,22142,0,14182,0,7960,0,15506,0,94894,12,110400,12,0,328,0,378,337,0,"Anderson",76978,15.5888695471433,0.0451977401129944,15.5888695471433,0,4.51977401129944
2022-04-04,22144,2,14183,1,7961,1,15507,1,94913,19,110420,20,0,328,0,378,337,0,"Anderson",76978,12.9907246226194,0.04,25.9814492452389,2.59814492452389,4
2022-04-05,22150,6,14184,1,7966,5,15508,1,94932,19,110440,20,3,331,0,378,338,1,"Anderson",76978,20.7851593961911,0.0445859872611465,25.9814492452389,7.79443477357167,4.45859872611465
2022-04-06,22153,3,14187,3,7966,0,15512,4,94956,24,110468,28,0,331,0,378,338,0,"Anderson",76978,22.0842318584531,0.062111801242236,36.3740289433345,3.89721738678583,6.2111801242236
2022-04-07,22156,3,14187,0,7969,3,15512,0,94979,23,110491,23,1,332,0,378,338,0,"Anderson",76978,23.383304320715,0.0552147239263804,29.8786666320247,3.89721738678583,5.52147239263804
2022-04-08,22157,1,14187,0,7970,1,15512,0,95010,31,110522,31,1,333,0,378,338,0,"Anderson",76978,20.7851593961911,0.0512820512820513,40.2712463301203,1.29907246226194,5.12820512820513
2022-04-09,22157,0,14187,0,7970,0,15512,0,95020,10,110532,10,0,333,0,378,338,0,"Anderson",76978,19.4860869339292,0.0416666666666667,12.9907246226195,0,4.16666666666667
2022-04-10,22157,0,14187,0,7970,0,15512,0,95030,10,110542,10,0,333,0,378,338,0,"Anderson",76978,19.4860869339292,0.0422535211267606,12.9907246226195,0,4.22535211267606
2022-04-11,22160,3,14187,0,7973,3,15512,0,95048,18,110560,18,0,333,0,378,338,0,"Anderson",76978,20.7851593961911,0.0357142857142857,23.383304320715,3.89721738678583,3.57142857142857
2022-04-12,22164,4,14190,3,7974,1,15516,4,95066,18,110582,22,1,334,0,378,339,1,"Anderson",76978,18.1870144716672,0.0563380281690141,28.5795941697628,5.19628984904778,5.63380281690141
2022-04-13,22167,3,14191,1,7976,2,15517,1,95088,22,110605,23,0,334,0,378,339,0,"Anderson",76978,18.1870144716672,0.0364963503649635,29.8786666320247,3.89721738678583,3.64963503649635
2022-04-14,22170,3,14191,0,7979,3,15517,0,95104,16,110621,16,0,334,0,378,339,0,"Anderson",76978,18.1870144716672,0.0384615384615385,20.7851593961911,3.89721738678583,3.84615384615385
2022-04-15,22174,4,14194,3,7980,1,15521,4,95124,20,110645,24,0,334,0,378,339,0,"Anderson",76978,22.0842318584531,0.0731707317073171,31.1777390942867,5.19628984904778,7.31707317073171
2022-04-16,22175,1,14194,0,7981,1,15521,0,95138,14,110659,14,0,334,0,378,339,0,"Anderson",76978,23.383304320715,0.0708661417322835,18.1870144716672,1.29907246226194,7.08661417322835
2022-04-17,22177,2,14194,0,7983,2,15522,1,95153,15,110675,16,0,334,0,378,339,0,"Anderson",76978,25.9814492452389,0.075187969924812,20.7851593961911,2.59814492452389,7.5187969924812
2022-04-18,22183,6,14196,2,7987,4,15524,2,95173,20,110697,22,-1,333,0,378,339,0,"Anderson",76978,29.8786666320247,0.0875912408759124,28.5795941697628,7.79443477357167,8.75912408759124
2022-04-19,22187,4,14197,1,7990,3,15525,1,95186,13,110711,14,0,333,0,378,339,0,"Anderson",76978,29.8786666320247,0.0697674418604651,18.1870144716672,5.19628984904778,6.97674418604651
2022-04-20,22193,6,14199,2,7994,4,15527,2,95219,33,110746,35,1,334,0,378,339,0,"Anderson",76978,33.7758840188106,0.0709219858156028,45.4675361791681,7.79443477357167,7.09219858156028
2022-04-21,22196,3,14200,1,7996,2,15528,1,95245,26,110773,27,0,334,0,378,339,0,"Anderson",76978,33.7758840188106,0.0723684210526316,35.0749564810725,3.89721738678583,7.23684210526316
2022-04-22,22198,2,14201,1,7997,1,15529,1,95277,32,110806,33,0,334,0,378,339,0,"Anderson",76978,31.1777390942867,0.0496894409937888,42.8693912546442,2.59814492452389,4.96894409937888
2022-04-23,22200,2,14203,2,7997,0,15530,1,95302,25,110832,26,0,334,0,378,339,0,"Anderson",76978,32.4768115565486,0.0520231213872832,33.7758840188106,2.59814492452389,5.20231213872832
2022-04-24,22203,3,14203,0,8000,3,15530,0,95319,17,110849,17,0,334,0,378,339,0,"Anderson",76978,33.7758840188106,0.0459770114942529,22.0842318584531,3.89721738678583,4.59770114942529
2022-04-25,22221,18,14205,2,8016,16,15532,2,95330,11,110862,13,0,334,0,378,340,1,"Anderson",76978,49.3647535659539,0.0484848484848485,16.8879420094053,23.383304320715,4.84848484848485
2022-04-26,22235,14,14210,5,8025,9,15538,6,95351,21,110889,27,0,334,0,378,340,0,"Anderson",76978,62.3554781885734,0.0730337078651685,35.0749564810725,18.1870144716672,7.30337078651685
2022-04-27,22249,14,14215,5,8034,9,15543,5,95387,36,110930,41,0,334,0,378,341,1,"Anderson",76978,72.7480578866689,0.0869565217391304,53.2619709527397,18.1870144716672,8.69565217391304
2022-04-28,22254,5,14217,2,8037,3,15545,2,95410,23,110955,25,0,334,0,378,341,0,"Anderson",76978,75.3462028111928,0.0934065934065934,32.4768115565486,6.49536231130973,9.34065934065934
2022-04-29,22260,6,14218,1,8042,5,15546,1,95431,21,110977,22,0,334,0,378,341,0,"Anderson",76978,80.5424926602406,0.0994152046783626,28.5795941697628,7.79443477357167,9.94152046783626
2022-04-30,22262,2,14219,1,8043,1,15546,0,95460,29,111006,29,0,334,0,378,341,0,"Anderson",76978,80.5424926602406,0.0919540229885057,37.6731014055964,2.59814492452389,9.19540229885057
2022-05-01,22264,2,14219,0,8045,2,15546,0,95468,8,111014,8,0,334,0,378,341,0,"Anderson",76978,79.2434201979786,0.096969696969697,10.3925796980956,2.59814492452389,9.6969696969697
2022-05-02,22272,8,14224,5,8048,3,15550,4,95499,31,111049,35,0,334,0,378,341,0,"Anderson",76978,66.2526955753592,0.0962566844919786,45.4675361791681,10.3925796980956,9.62566844919786
2022-05-03,22278,6,14229,5,8049,1,15555,5,95510,11,111065,16,0,334,0,378,341,0,"Anderson",76978,55.8601158772636,0.0965909090909091,20.7851593961911,7.79443477357167,9.65909090909091
2022-05-04,22290,12,14233,4,8057,8,15560,5,95534,24,111094,29,0,334,0,378,341,0,"Anderson",76978,53.2619709527397,0.103658536585366,37.6731014055964,15.5888695471433,10.3658536585366
2022-05-05,22298,8,14239,6,8059,2,15566,6,95552,18,111118,24,0,334,0,378,341,0,"Anderson",76978,57.1591883395256,0.128834355828221,31.1777390942867,10.3925796980956,12.8834355828221
2022-05-06,22299,1,14239,0,8060,1,15566,0,95576,24,111142,24,0,334,0,378,341,0,"Anderson",76978,50.6638260282159,0.121212121212121,31.1777390942867,1.29907246226194,12.1212121212121
2022-05-07,22308,9,14243,4,8065,5,15570,4,95592,16,111162,20,0,334,0,378,342,1,"Anderson",76978,59.7573332640495,0.153846153846154,25.9814492452389,11.6916521603575,15.3846153846154
2022-05-08,22309,1,14243,0,8066,1,15570,0,95606,14,111176,14,0,334,0,378,342,0,"Anderson",76978,58.4582608017875,0.148148148148148,18.1870144716672,1.29907246226194,14.8148148148148
2022-05-09,22315,6,14245,2,8070,4,15571,1,95621,15,111192,16,0,334,0,378,342,0,"Anderson",76978,55.8601158772636,0.146853146853147,20.7851593961911,7.79443477357167,14.6853146853147
2022-05-10,22325,10,14247,2,8078,8,15574,3,95653,32,111227,35,1,335,0,378,342,0,"Anderson",76978,61.0564057263114,0.117283950617284,45.4675361791681,12.9907246226195,11.7283950617284
2022-05-11,22338,13,14257,10,8081,3,15586,12,95671,18,111257,30,0,335,0,378,342,0,"Anderson",76978,62.3554781885734,0.159509202453988,38.9721738678584,16.8879420094053,15.9509202453988
2022-05-12,22344,6,14262,5,8082,1,15591,5,95699,28,111290,33,0,335,0,378,342,0,"Anderson",76978,59.7573332640495,0.145348837209302,42.8693912546442,7.79443477357167,14.5348837209302
2022-05-13,22352,8,14267,5,8085,3,15596,5,95735,36,111331,41,2,337,0,378,343,1,"Anderson",76978,68.8508404998831,0.158730158730159,53.2619709527397,10.3925796980956,15.8730158730159
2022-05-14,22355,3,14269,2,8086,1,15598,2,95744,9,111342,11,0,337,0,378,343,0,"Anderson",76978,61.0564057263114,0.155555555555556,14.2897970848814,3.89721738678583,15.5555555555556
2022-05-15,22359,4,14269,0,8090,4,15598,0,95758,14,111356,14,0,337,0,378,343,0,"Anderson",76978,64.9536231130973,0.155555555555556,18.1870144716672,5.19628984904778,15.5555555555556
2022-05-16,22369,10,14275,6,8094,4,15603,5,95781,23,111384,28,0,337,0,378,343,0,"Anderson",76978,70.149912962145,0.166666666666667,36.3740289433345,12.9907246226195,16.6666666666667
2022-05-17,22382,13,14284,9,8098,4,15613,10,95808,27,111421,37,2,339,0,378,343,0,"Anderson",76978,74.0471303489309,0.201030927835052,48.065681103692,16.8879420094053,20.1030927835052
2022-05-18,22390,8,14291,7,8099,1,15621,8,95835,27,111456,35,0,339,0,378,344,1,"Anderson",76978,67.5517680376211,0.175879396984925,45.4675361791681,10.3925796980956,17.5879396984925
2022-05-19,22400,10,14298,7,8102,3,15629,8,95862,27,111491,35,1,340,0,378,344,0,"Anderson",76978,72.7480578866689,0.189054726368159,45.4675361791681,12.9907246226195,18.9054726368159
2022-05-20,22412,12,14307,9,8105,3,15638,9,95891,29,111529,38,0,340,0,378,344,0,"Anderson",76978,77.9443477357167,0.212121212121212,49.3647535659539,15.5888695471433,21.2121212121212
2022-05-21,22418,6,14313,6,8105,0,15644,6,95917,26,111561,32,0,340,0,378,344,0,"Anderson",76978,81.8415651225025,0.210045662100457,41.5703187923822,7.79443477357167,21.0045662100457
2022-05-22,22427,9,14319,6,8108,3,15650,6,95942,25,111592,31,1,341,0,378,344,0,"Anderson",76978,88.3369274338123,0.220338983050847,40.2712463301203,11.6916521603575,22.0338983050847
2022-05-23,22438,11,14328,9,8110,2,15657,7,95975,33,111632,40,0,341,0,378,344,0,"Anderson",76978,89.6359998960742,0.217741935483871,51.9628984904778,14.2897970848814,21.7741935483871
2022-05-24,22459,21,14335,7,8124,14,15665,8,95996,21,111661,29,0,341,0,378,344,0,"Anderson",76978,100.02857959417,0.216666666666667,37.6731014055964,27.2805217075008,21.6666666666667
2022-05-25,22471,12,14341,6,8130,6,15671,6,96029,33,111700,39,1,342,0,378,344,0,"Anderson",76978,105.224869443218,0.204918032786885,50.6638260282159,15.5888695471433,20.4918032786885
2022-05-26,22488,17,14349,8,8139,9,15681,10,96070,41,111751,51,0,342,0,378,344,0,"Anderson",76978,114.318376679051,0.2,66.2526955753592,22.0842318584531,20
2022-05-27,22503,15,14358,9,8145,6,15690,9,96116,46,111806,55,0,342,0,378,344,0,"Anderson",76978,118.215594065837,0.187725631768953,71.448985424407,19.4860869339292,18.7725631768953
2022-05-28,22512,9,14364,6,8148,3,15696,6,96167,51,111863,57,0,342,0,378,344,0,"Anderson",76978,122.112811452623,0.172185430463576,74.0471303489309,11.6916521603575,17.2185430463576
2022-05-29,22520,8,14366,2,8154,6,15698,2,96189,22,111887,24,0,342,0,378,344,0,"Anderson",76978,120.813738990361,0.16271186440678,31.1777390942867,10.3925796980956,16.271186440678
2022-05-30,22525,5,14367,1,8158,4,15700,2,96204,15,111904,17,0,342,0,378,344,0,"Anderson",76978,113.019304216789,0.158088235294118,22.0842318584531,6.49536231130973,15.8088235294118
2022-05-31,22540,15,14374,7,8166,8,15706,6,96231,27,111937,33,0,342,0,378,344,0,"Anderson",76978,105.224869443218,0.148550724637681,42.8693912546442,19.4860869339292,14.8550724637681
2022-06-01,22564,24,14387,13,8177,11,15723,17,96258,27,111981,44,0,342,0,378,344,0,"Anderson",76978,120.813738990361,0.185053380782918,57.1591883395256,31.1777390942867,18.5053380782918
2022-06-02,22581,17,14396,9,8185,8,15731,8,96282,24,112013,32,0,342,0,378,344,0,"Anderson",76978,120.813738990361,0.190839694656489,41.5703187923822,22.0842318584531,19.0839694656489
2022-06-03,22595,14,14404,8,8191,6,15740,9,96332,50,112072,59,0,342,0,378,344,0,"Anderson",76978,119.514666528099,0.18796992481203,76.6452752734548,18.1870144716672,18.796992481203
2022-06-04,22602,7,14409,5,8193,2,15746,6,96361,29,112107,35,0,342,0,378,344,0,"Anderson",76978,116.916521603575,0.204918032786885,45.4675361791681,9.09350723583361,20.4918032786885
2022-06-05,22612,10,14416,7,8196,3,15754,8,96378,17,112132,25,0,342,0,378,344,0,"Anderson",76978,119.514666528099,0.228571428571429,32.4768115565486,12.9907246226195,22.8571428571429
2022-06-06,22638,26,14429,13,8209,13,15767,13,96401,23,112168,36,0,342,0,378,345,1,"Anderson",76978,146.7951882356,0.253787878787879,46.76660864143,33.7758840188106,25.3787878787879
2022-06-07,22660,22,14437,8,8223,14,15775,8,96421,20,112196,28,0,342,0,378,345,0,"Anderson",76978,155.888695471433,0.266409266409266,36.3740289433345,28.5795941697628,26.6409266409266
2022-06-08,22683,23,14452,15,8231,8,15793,18,96470,49,112263,67,0,342,0,378,345,0,"Anderson",76978,154.589623009171,0.24822695035461,87.0378549715503,29.8786666320247,24.822695035461
2022-06-09,22701,18,14464,12,8237,6,15806,13,96505,35,112311,48,0,342,1,379,346,1,"Anderson",76978,155.888695471433,0.251677852348993,62.3554781885734,23.383304320715,25.1677852348993
2022-06-10,22724,23,14480,16,8244,7,15823,17,96566,61,112389,78,0,342,0,379,346,0,"Anderson",76978,167.580347631791,0.261829652996845,101.327652056432,29.8786666320247,26.1829652996845
2022-06-11,22733,9,14484,4,8249,5,15828,5,96584,18,112412,23,0,342,0,379,346,0,"Anderson",76978,170.178492556315,0.268852459016393,29.8786666320247,11.6916521603575,26.8852459016393
2022-06-12,22741,8,14486,2,8255,6,15830,2,96598,14,112428,16,0,342,0,379,346,0,"Anderson",76978,167.580347631791,0.256756756756757,20.7851593961911,10.3925796980956,25.6756756756757
2022-06-13,22758,17,14492,6,8266,11,15836,6,96622,24,112458,30,0,342,0,379,346,0,"Anderson",76978,155.888695471433,0.237931034482759,38.9721738678584,22.0842318584531,23.7931034482759
2022-06-14,22788,30,14506,14,8282,16,15852,16,96659,37,112511,53,1,343,0,379,347,1,"Anderson",76978,166.281275169529,0.244444444444444,68.8508404998831,38.9721738678584,24.4444444444444
2022-06-15,22805,17,14518,12,8287,5,15866,14,96682,23,112548,37,1,344,0,379,347,0,"Anderson",76978,158.486840395957,0.256140350877193,48.065681103692,22.0842318584531,25.6140350877193
2022-06-16,22830,25,14530,12,8300,13,15877,11,96710,28,112587,39,1,345,0,379,347,0,"Anderson",76978,167.580347631791,0.257246376811594,50.6638260282159,32.4768115565486,25.7246376811594
2022-06-17,22852,22,14542,12,8310,10,15892,15,96733,23,112625,38,0,345,0,379,348,1,"Anderson",76978,166.281275169529,0.292372881355932,49.3647535659539,28.5795941697628,29.2372881355932
2022-06-18,22863,11,14550,8,8313,3,15901,9,96756,23,112657,32,1,346,0,379,348,0,"Anderson",76978,168.879420094053,0.297959183673469,41.5703187923822,14.2897970848814,29.7959183673469
2022-06-19,22878,15,14555,5,8323,10,15906,5,96774,18,112680,23,0,346,0,379,348,0,"Anderson",76978,177.972927329886,0.301587301587302,29.8786666320247,19.4860869339292,30.1587301587302
2022-06-20,22890,12,14559,4,8331,8,15913,7,96790,16,112703,23,0,346,0,379,348,0,"Anderson",76978,171.477565018577,0.314285714285714,29.8786666320247,15.5888695471433,31.4285714285714
2022-06-21,22915,25,14568,9,8347,16,15920,7,96802,12,112722,19,0,346,0,379,348,0,"Anderson",76978,164.982202707267,0.322274881516588,24.682376782977,32.4768115565486,32.2274881516588
2022-06-22,22955,40,14598,30,8357,10,15950,30,96852,50,112802,80,0,346,0,379,348,0,"Anderson",76978,194.860869339292,0.330708661417323,103.925796980956,51.9628984904778,33.0708661417323
2022-06-23,22973,18,14609,11,8364,7,15964,14,96875,23,112839,37,0,346,0,379,349,1,"Anderson",76978,185.767362103458,0.345238095238095,48.065681103692,23.383304320715,34.5238095238095
2022-06-24,23006,33,14620,11,8386,22,15976,12,96908,33,112884,45,0,346,0,379,349,0,"Anderson",76978,200.05715918834,0.324324324324324,58.4582608017875,42.8693912546442,32.4324324324324
2022-06-25,23017,11,14623,3,8394,8,15982,6,96937,29,112919,35,0,346,0,379,349,0,"Anderson",76978,200.05715918834,0.309160305343511,45.4675361791681,14.2897970848814,30.9160305343511
2022-06-26,23027,10,14629,6,8398,4,15987,5,96963,26,112950,31,0,346,0,379,349,0,"Anderson",76978,193.56179687703,0.3,40.2712463301203,12.9907246226195,30
2022-06-27,23050,23,14641,12,8409,11,15999,12,96979,16,112978,28,1,347,0,379,349,0,"Anderson",76978,207.851593961911,0.312727272727273,36.3740289433345,29.8786666320247,31.2727272727273
2022-06-28,23080,30,14657,16,8423,14,16015,16,97008,29,113023,45,1,348,0,379,349,0,"Anderson",76978,214.346956273221,0.315614617940199,58.4582608017875,38.9721738678584,31.5614617940199
2022-06-29,23102,22,14666,9,8436,13,16026,11,97050,42,113076,53,1,349,0,379,349,0,"Anderson",76978,190.963651952506,0.277372262773723,68.8508404998831,28.5795941697628,27.7372262773723
2022-06-30,23138,36,14678,12,8460,24,16039,13,97095,45,113134,58,0,349,0,379,349,0,"Anderson",76978,214.346956273221,0.254237288135593,75.3462028111928,46.76660864143,25.4237288135593
2022-07-01,23160,22,14690,12,8470,10,16052,13,97135,40,113187,53,0,349,0,379,349,0,"Anderson",76978,200.05715918834,0.250825082508251,68.8508404998831,28.5795941697628,25.0825082508251
2022-07-02,23188,28,14704,14,8484,14,16067,15,97155,20,113222,35,0,349,0,379,349,0,"Anderson",76978,222.141391046793,0.280528052805281,45.4675361791681,36.3740289433345,28.0528052805281
2022-07-03,23199,11,14710,6,8489,5,16073,6,97172,17,113245,23,0,349,0,379,349,0,"Anderson",76978,223.440463509055,0.291525423728814,29.8786666320247,14.2897970848814,29.1525423728814
2022-07-04,23215,16,14715,5,8500,11,16078,5,97180,8,113258,13,0,349,0,379,350,1,"Anderson",76978,214.346956273221,0.282142857142857,16.8879420094053,20.7851593961911,28.2142857142857
2022-07-05,23236,21,14725,10,8511,11,16089,11,97205,25,113294,36,0,349,0,379,351,1,"Anderson",76978,202.655304112863,0.273062730627306,46.76660864143,27.2805217075008,27.3062730627306
2022-07-06,23250,14,14731,6,8519,8,16096,7,97234,29,113330,36,0,349,0,379,351,0,"Anderson",76978,192.262724414768,0.275590551181102,46.76660864143,18.1870144716672,27.5590551181102
2022-07-07,23282,32,14746,15,8536,17,16111,15,97260,26,113371,41,0,349,0,379,351,0,"Anderson",76978,187.06643456572,0.30379746835443,53.2619709527397,41.5703187923822,30.379746835443
2022-07-08,23316,34,14757,11,8559,23,16121,10,97287,27,113408,37,0,349,0,379,351,0,"Anderson",76978,202.655304112863,0.312217194570136,48.065681103692,44.1684637169061,31.2217194570136
2022-07-09,23344,28,14762,5,8582,23,16126,5,97301,14,113427,19,0,349,0,379,351,0,"Anderson",76978,202.655304112863,0.28780487804878,24.682376782977,36.3740289433345,28.780487804878
2022-07-10,23363,19,14766,4,8597,15,16129,3,97307,6,113436,9,0,349,0,379,351,0,"Anderson",76978,213.047883810959,0.293193717277487,11.6916521603575,24.682376782977,29.3193717277487
2022-07-11,23386,23,14776,10,8610,13,16142,13,97345,38,113487,51,0,349,0,379,351,0,"Anderson",76978,222.141391046793,0.279475982532751,66.2526955753592,29.8786666320247,27.9475982532751
2022-07-12,23431,45,14794,18,8637,27,16161,19,97379,34,113540,53,0,349,0,379,351,0,"Anderson",76978,253.319130141079,0.292682926829268,68.8508404998831,58.4582608017875,29.2682926829268
2022-07-13,23468,37,14812,18,8656,19,16180,19,97426,47,113606,66,0,349,0,379,352,1,"Anderson",76978,283.197796773104,0.304347826086957,85.7387825092884,48.065681103692,30.4347826086957
2022-07-14,23509,41,14824,12,8685,29,16192,12,97448,22,113640,34,0,349,1,380,352,0,"Anderson",76978,294.889448933461,0.301115241635688,44.1684637169061,53.2619709527397,30.1115241635688
2022-07-15,23541,32,14840,16,8701,16,16208,16,97474,26,113682,42,0,349,0,380,352,0,"Anderson",76978,292.291304008938,0.317518248175182,54.5610434150017,41.5703187923822,31.7518248175182
2022-07-16,23563,22,14847,7,8716,15,16215,7,97483,9,113698,16,0,349,0,380,352,0,"Anderson",76978,284.496869235366,0.328413284132841,20.7851593961911,28.5795941697628,32.8413284132841
2022-07-17,23573,10,14851,4,8722,6,16218,3,97495,12,113713,15,0,349,0,380,352,0,"Anderson",76978,272.805217075008,0.32129963898917,19.4860869339292,12.9907246226195,32.129963898917
2022-07-18,23619,46,14872,21,8747,25,16239,21,97545,50,113784,71,0,349,0,380,352,0,"Anderson",76978,302.683883707033,0.326599326599327,92.2341448205981,59.7573332640495,32.6599326599327
2022-07-19,23669,50,14895,23,8774,27,16265,26,97561,16,113826,42,3,352,0,380,352,0,"Anderson",76978,309.179246018343,0.363636363636364,54.5610434150017,64.9536231130973,36.3636363636364
2022-07-20,23705,36,14911,16,8794,20,16281,16,97591,30,113872,46,0,352,0,380,352,0,"Anderson",76978,307.880173556081,0.379699248120301,59.7573332640495,46.76660864143,37.9699248120301
2022-07-21,23748,43,14940,29,8808,14,16311,30,97643,52,113954,82,0,352,0,380,353,1,"Anderson",76978,310.478318480605,0.378980891719745,106.523941905479,55.8601158772636,37.8980891719745
2022-07-22,23786,38,14954,14,8832,24,16326,15,97678,35,114004,50,0,352,0,380,354,1,"Anderson",76978,318.272753254177,0.366459627329193,64.9536231130973,49.3647535659539,36.6459627329193
2022-07-23,23796,10,14957,3,8839,7,16330,4,97689,11,114019,15,0,352,0,380,354,0,"Anderson",76978,302.683883707033,0.358255451713396,19.4860869339292,12.9907246226195,35.8255451713396
2022-07-24,23819,23,14966,9,8853,14,16339,9,97703,14,114042,23,0,352,0,380,354,0,"Anderson",76978,319.571825716438,0.367781155015198,29.8786666320247,29.8786666320247,36.7781155015198
2022-07-25,23865,46,14992,26,8873,20,16366,27,97735,32,114101,59,0,352,0,380,354,0,"Anderson",76978,319.571825716438,0.400630914826498,76.6452752734548,59.7573332640495,40.0630914826498
2022-07-26,23912,47,15016,24,8896,23,16390,24,97768,33,114158,57,0,352,0,380,355,1,"Anderson",76978,315.674608329653,0.376506024096386,74.0471303489309,61.0564057263114,37.6506024096386
2022-07-27,23955,43,15034,18,8921,25,16411,21,97810,42,114221,63,0,352,0,380,355,0,"Anderson",76978,324.768115565486,0.372492836676218,81.8415651225025,55.8601158772636,37.2492836676218
2022-07-28,23991,36,15051,17,8940,19,16429,18,97849,39,114278,57,0,352,0,380,355,0,"Anderson",76978,315.674608329653,0.364197530864198,74.0471303489309,46.76660864143,36.4197530864198
2022-07-29,24024,33,15072,21,8952,12,16450,21,97884,35,114334,56,0,352,0,380,355,0,"Anderson",76978,309.179246018343,0.375757575757576,72.7480578866689,42.8693912546442,37.5757575757576
2022-07-30,24048,24,15086,14,8962,10,16464,14,97900,16,114364,30,0,352,0,380,355,0,"Anderson",76978,327.36626049001,0.388405797101449,38.9721738678584,31.1777390942867,38.8405797101449
2022-07-31,24054,6,15089,3,8965,3,16469,5,97916,16,114385,21,0,352,0,380,356,1,"Anderson",76978,305.282028631557,0.379008746355685,27.2805217075008,7.79443477357167,37.9008746355685
2022-08-01,24089,35,15105,16,8984,19,16487,18,97935,19,114422,37,0,352,0,380,356,0,"Anderson",76978,290.992231546676,0.376947040498442,48.065681103692,45.4675361791681,37.6947040498442
2022-08-02,24147,58,15150,45,8997,13,16531,44,97971,36,114502,80,1,353,0,380,356,0,"Anderson",76978,305.282028631557,0.409883720930233,103.925796980956,75.3462028111928,40.9883720930233
2022-08-03,24180,33,15169,19,9011,14,16554,23,98007,36,114561,59,0,353,0,380,357,1,"Anderson",76978,292.291304008938,0.420588235294118,76.6452752734548,42.8693912546442,42.0588235294118
2022-08-04,24221,41,15197,28,9024,13,16587,33,98102,95,114689,128,1,354,0,380,357,0,"Anderson",76978,298.786666320247,0.384428223844282,166.281275169529,53.2619709527397,38.4428223844282
2022-08-05,24253,32,15219,22,9034,10,16608,21,98134,32,114742,53,0,354,0,380,357,0,"Anderson",76978,297.487593857985,0.387254901960784,68.8508404998831,41.5703187923822,38.7254901960784
2022-08-06,24271,18,15227,8,9044,10,16616,8,98149,15,114765,23,0,354,0,380,357,0,"Anderson",76978,289.693159084414,0.379052369077307,29.8786666320247,23.383304320715,37.9052369077307
2022-08-07,24287,16,15237,10,9050,6,16626,10,98165,16,114791,26,0,354,0,380,357,0,"Anderson",76978,302.683883707033,0.386699507389163,33.7758840188106,20.7851593961911,38.6699507389163
2022-08-08,24344,57,15266,29,9078,28,16654,28,98177,12,114831,40,0,354,0,380,358,1,"Anderson",76978,331.263477876796,0.408312958435208,51.9628984904778,74.0471303489309,40.8312958435208
2022-08-09,24375,31,15284,18,9091,13,16673,19,98227,50,114900,69,3,357,0,380,359,1,"Anderson",76978,296.188521395723,0.35678391959799,89.6359998960742,40.2712463301203,35.678391959799
2022-08-10,24413,38,15310,26,9103,12,16702,29,98259,32,114961,61,0,357,0,380,359,0,"Anderson",76978,302.683883707033,0.37,79.2434201979787,49.3647535659539,37
2022-08-11,24447,34,15334,24,9113,10,16727,25,98290,31,115017,56,0,357,0,380,359,0,"Anderson",76978,293.5903764712,0.426829268292683,72.7480578866689,44.1684637169061,42.6829268292683
2022-08-12,24485,38,15356,22,9129,16,16751,24,98329,39,115080,63,0,357,0,380,360,1,"Anderson",76978,301.384811244771,0.423076923076923,81.8415651225025,49.3647535659539,42.3076923076923
2022-08-13,24502,17,15366,10,9136,7,16762,11,98359,30,115121,41,0,357,0,380,361,1,"Anderson",76978,300.085738782509,0.410112359550562,53.2619709527397,22.0842318584531,41.0112359550562
2022-08-14,24514,12,15374,8,9140,4,16770,8,98379,20,115149,28,0,357,0,380,361,0,"Anderson",76978,294.889448933461,0.402234636871508,36.3740289433345,15.5888695471433,40.2234636871508
2022-08-15,24567,53,15400,26,9167,27,16797,27,98401,22,115198,49,0,357,0,380,362,1,"Anderson",76978,289.693159084414,0.389645776566757,63.6545506508353,68.8508404998831,38.9645776566758
2022-08-16,24616,49,15430,30,9186,19,16829,32,98433,32,115262,64,1,358,0,380,362,0,"Anderson",76978,313.076463405129,0.430939226519337,83.1406375847645,63.6545506508353,43.0939226519337
2022-08-17,24662,46,15457,27,9205,19,16855,26,98466,33,115321,59,0,358,0,380,362,0,"Anderson",76978,323.469043103224,0.425,76.6452752734548,59.7573332640495,42.5
2022-08-18,24946,284,15500,43,9446,241,16897,42,98510,44,115407,86,0,358,0,380,362,0,"Anderson",76978,648.23715866871,0.435897435897436,111.720231754527,368.936579282392,43.5897435897436
2022-08-19,24978,32,15515,15,9463,17,16913,16,98547,37,115460,53,0,358,0,380,362,0,"Anderson",76978,640.442723895139,0.426315789473684,68.8508404998831,41.5703187923822,42.6315789473684
2022-08-20,24992,14,15522,7,9470,7,16921,8,98576,29,115497,37,0,358,0,380,362,0,"Anderson",76978,636.545506508353,0.422872340425532,48.065681103692,18.1870144716672,42.2872340425532
2022-08-21,25006,14,15528,6,9478,8,16928,7,98607,31,115535,38,0,358,0,380,362,0,"Anderson",76978,639.143651432877,0.409326424870466,49.3647535659539,18.1870144716672,40.9326424870466
2022-08-22,25070,64,15553,25,9517,39,16953,25,98644,37,115597,62,0,358,0,380,363,1,"Anderson",76978,653.433448517758,0.390977443609023,80.5424926602406,83.1406375847645,39.0977443609023
2022-08-23,25150,80,15585,32,9565,48,16986,33,98676,32,115662,65,3,361,0,380,364,1,"Anderson",76978,693.704694847879,0.3925,84.4397100470264,103.925796980956,39.25
2022-08-24,25215,65,15608,23,9607,42,17012,26,98714,38,115726,64,0,361,0,380,364,0,"Anderson",76978,718.387071630856,0.387654320987654,83.1406375847645,84.4397100470264,38.7654320987654
2022-08-25,25259,44,15631,23,9628,21,17037,25,98753,39,115790,64,1,362,0,380,365,1,"Anderson",76978,406.609680687989,0.365535248041775,83.1406375847645,57.1591883395256,36.5535248041775
2022-08-26,25291,32,15646,15,9645,17,17053,16,98810,57,115863,73,0,362,0,380,365,0,"Anderson",76978,406.609680687989,0.347394540942928,94.832289745122,41.5703187923822,34.7394540942928
2022-08-27,25331,40,15655,9,9676,31,17062,9,98846,36,115908,45,0,362,0,380,365,0,"Anderson",76978,440.385564706799,0.343065693430657,58.4582608017875,51.9628984904778,34.3065693430657
2022-08-28,25340,9,15659,4,9681,5,17066,4,98874,28,115940,32,0,362,0,380,365,0,"Anderson",76978,433.89020239549,0.340740740740741,41.5703187923822,11.6916521603575,34.0740740740741
2022-08-29,25375,35,15673,14,9702,21,17082,16,98885,11,115967,27,0,362,0,380,366,1,"Anderson",76978,396.217100989893,0.348648648648649,35.0749564810725,45.4675361791681,34.8648648648649
2022-08-30,25420,45,15689,16,9731,29,17099,17,98901,16,116000,33,2,364,0,380,366,0,"Anderson",76978,350.749564810725,0.334319526627219,42.8693912546442,58.4582608017875,33.4319526627219
2022-08-31,25467,47,15720,31,9747,16,17132,33,98950,49,116082,82,0,364,0,380,366,0,"Anderson",76978,327.36626049001,0.337078651685393,106.523941905479,61.0564057263114,33.7078651685393
2022-09-01,25497,30,15734,14,9763,16,17147,15,98978,28,116125,43,1,365,0,380,366,0,"Anderson",76978,309.179246018343,0.328358208955224,55.8601158772636,38.9721738678584,32.8358208955224
2022-09-02,25524,27,15748,14,9776,13,17161,14,99022,44,116183,58,0,365,0,380,366,0,"Anderson",76978,302.683883707033,0.3375,75.3462028111928,35.0749564810725,33.75
2022-09-03,25544,20,15759,11,9785,9,17172,11,99042,20,116214,31,0,365,0,380,367,1,"Anderson",76978,276.702434461794,0.359477124183007,40.2712463301203,25.9814492452389,35.9477124183007
2022-09-04,25556,12,15761,2,9795,10,17174,2,99056,14,116230,16,0,365,0,380,367,0,"Anderson",76978,280.59965184858,0.372413793103448,20.7851593961911,15.5888695471433,37.2413793103448
2022-09-05,25565,9,15763,2,9802,7,17176,2,99070,14,116246,16,0,365,0,380,367,0,"Anderson",76978,246.82376782977,0.336917562724014,20.7851593961911,11.6916521603575,33.6917562724014
2022-09-06,25601,36,15775,12,9826,24,17188,12,99087,17,116275,29,0,365,0,380,367,0,"Anderson",76978,235.132115669412,0.323636363636364,37.6731014055964,46.76660864143,32.3636363636364
2022-09-07,25640,39,15790,15,9850,24,17204,16,99121,34,116325,50,0,365,0,380,367,0,"Anderson",76978,224.739535971316,0.296296296296296,64.9536231130973,50.6638260282159,29.6296296296296
2022-09-08,25662,22,15799,9,9863,13,17213,9,99139,18,116352,27,0,365,0,380,368,1,"Anderson",76978,214.346956273221,0.290748898678414,35.0749564810725,28.5795941697628,29.0748898678414
2022-09-09,25676,14,15806,7,9870,7,17220,7,99184,45,116404,52,0,365,0,380,369,1,"Anderson",76978,197.459014263816,0.266968325791855,67.5517680376211,18.1870144716672,26.6968325791855
2022-09-10,25691,15,15813,7,9878,8,17229,9,99204,20,116433,29,0,365,0,380,369,0,"Anderson",76978,190.963651952506,0.26027397260274,37.6731014055964,19.4860869339292,26.027397260274
2022-09-11,25698,7,15815,2,9883,5,17232,3,99218,14,116450,17,0,365,0,380,369,0,"Anderson",76978,184.468289641196,0.263636363636364,22.0842318584531,9.09350723583361,26.3636363636364
2022-09-12,25711,13,15820,5,9891,8,17238,6,99230,12,116468,18,0,365,0,380,369,0,"Anderson",76978,189.664579490244,0.279279279279279,23.383304320715,16.8879420094053,27.9279279279279
2022-09-13,25737,26,15832,12,9905,14,17251,13,99252,22,116503,35,0,365,0,380,369,0,"Anderson",76978,176.673854867625,0.276315789473684,45.4675361791681,33.7758840188106,27.6315789473684
2022-09-14,25754,17,15840,8,9914,9,17259,8,99278,26,116537,34,1,366,0,380,369,0,"Anderson",76978,148.094260697862,0.259433962264151,44.1684637169061,22.0842318584531,25.9433962264151
2022-09-15,25812,58,15857,17,9955,41,17277,18,99320,42,116597,60,2,368,0,380,369,0,"Anderson",76978,194.860869339292,0.261224489795918,77.9443477357167,75.3462028111928,26.1224489795918
2022-09-16,25828,16,15861,4,9967,12,17281,4,99366,46,116647,50,0,368,0,380,369,0,"Anderson",76978,197.459014263816,0.251028806584362,64.9536231130973,20.7851593961911,25.1028806584362
2022-09-17,25838,10,15862,1,9976,9,17284,3,99379,13,116663,16,0,368,0,380,369,0,"Anderson",76978,190.963651952506,0.239130434782609,20.7851593961911,12.9907246226195,23.9130434782609
2022-09-18,25846,8,15863,1,9983,7,17285,1,99384,5,116669,6,0,368,0,380,369,0,"Anderson",76978,192.262724414768,0.242009132420091,7.79443477357167,10.3925796980956,24.2009132420091
2022-09-19,25862,16,15866,3,9996,13,17289,4,99404,20,116693,24,0,368,0,380,370,1,"Anderson",76978,196.159941801554,0.226666666666667,31.1777390942867,20.7851593961911,22.6666666666667
2022-09-20,25868,6,15871,5,9997,1,17295,6,99413,9,116708,15,0,368,0,380,370,0,"Anderson",76978,170.178492556315,0.214634146341463,19.4860869339292,7.79443477357167,21.4634146341463
2022-09-21,25878,10,15873,2,10005,8,17297,2,99436,23,116733,25,1,369,0,380,370,0,"Anderson",76978,161.084985320481,0.193877551020408,32.4768115565486,12.9907246226195,19.3877551020408
2022-09-22,25894,16,15879,6,10015,10,17303,6,99472,36,116775,42,0,369,0,380,370,0,"Anderson",76978,106.523941905479,0.146067415730337,54.5610434150017,20.7851593961911,14.6067415730337
2022-09-23,25915,21,15891,12,10024,9,17316,13,99517,45,116833,58,0,369,0,380,370,0,"Anderson",76978,113.019304216789,0.188172043010753,75.3462028111928,27.2805217075008,18.8172043010753
2022-09-24,25920,5,15894,3,10026,2,17319,3,99534,17,116853,20,0,369,0,380,370,0,"Anderson",76978,106.523941905479,0.184210526315789,25.9814492452389,6.49536231130973,18.4210526315789
2022-09-25,25925,5,15896,2,10029,3,17321,2,99549,15,116870,17,0,369,0,380,370,0,"Anderson",76978,102.626724518694,0.17910447761194,22.0842318584531,6.49536231130973,17.910447761194
2022-09-26,25940,15,15902,6,10038,9,17328,7,99560,11,116888,18,0,369,0,380,370,0,"Anderson",76978,101.327652056432,0.2,23.383304320715,19.4860869339292,20
2022-09-27,25947,7,15903,1,10044,6,17330,2,99581,21,116911,23,0,369,0,380,370,0,"Anderson",76978,102.626724518694,0.172413793103448,29.8786666320247,9.09350723583361,17.2413793103448
2022-09-28,25963,16,15907,4,10056,12,17335,5,99624,43,116959,48,1,370,0,380,370,0,"Anderson",76978,110.421159292265,0.168141592920354,62.3554781885734,20.7851593961911,16.8141592920354
2022-09-29,25973,10,15915,8,10058,2,17343,8,99646,22,116989,30,0,370,0,380,370,0,"Anderson",76978,102.626724518694,0.186915887850467,38.9721738678584,12.9907246226195,18.6915887850467
2022-09-30,25981,8,15919,4,10062,4,17347,4,99680,34,117027,38,0,370,0,380,370,0,"Anderson",76978,85.7387825092884,0.15979381443299,49.3647535659539,10.3925796980956,15.979381443299
2022-10-01,25986,5,15919,0,10067,5,17347,0,99684,4,117031,4,0,370,0,380,370,0,"Anderson",76978,85.7387825092884,0.157303370786517,5.19628984904778,6.49536231130973,15.7303370786517
2022-10-02,25988,2,15920,1,10068,1,17348,1,99687,3,117035,4,0,370,0,380,370,0,"Anderson",76978,81.8415651225025,0.163636363636364,5.19628984904778,2.59814492452389,16.3636363636364
2022-10-03,25999,11,15923,3,10076,8,17352,4,99693,6,117045,10,0,370,0,380,370,0,"Anderson",76978,76.6452752734548,0.152866242038217,12.9907246226195,14.2897970848814,15.2866242038217
2022-10-04,26001,2,15923,0,10078,2,17352,0,99730,37,117082,37,0,370,0,380,370,0,"Anderson",76978,70.149912962145,0.128654970760234,48.065681103692,2.59814492452389,12.8654970760234
2022-10-05,26007,6,15925,2,10082,4,17355,3,99746,16,117101,19,0,370,0,380,370,0,"Anderson",76978,57.1591883395256,0.140845070422535,24.682376782977,7.79443477357167,14.0845070422535
2022-10-06,26020,13,15932,7,10088,6,17363,8,99771,25,117134,33,0,370,0,380,370,0,"Anderson",76978,61.0564057263114,0.137931034482759,42.8693912546442,16.8879420094053,13.7931034482759
2022-10-07,26036,16,15943,11,10093,5,17374,11,99793,22,117167,33,0,370,0,380,370,0,"Anderson",76978,71.448985424407,0.192857142857143,42.8693912546442,20.7851593961911,19.2857142857143
2022-10-08,26036,0,15943,0,10093,0,17374,0,99811,18,117185,18,0,370,0,380,370,0,"Anderson",76978,64.9536231130973,0.175324675324675,23.383304320715,0,17.5324675324675
2020-03-12,1,1,1,1,0,0,1,1,11,11,12,12,0,0,0,0,0,0,"East TN",2455501,NA,NA,0.488698640318208,0.040724886693184,NA
2020-03-13,1,0,1,0,0,0,1,0,23,12,24,12,0,0,0,0,0,0,"East TN",2455501,NA,NA,0.488698640318208,0,NA
2020-03-14,3,2,3,2,0,0,3,2,50,27,53,29,0,0,0,0,0,0,"East TN",2455501,NA,NA,1.18102171410234,0.081449773386368,NA
2020-03-15,3,0,3,0,0,0,3,0,53,3,56,3,0,0,0,0,0,0,"East TN",2455501,NA,NA,0.122174660079552,0,NA
2020-03-16,5,2,5,2,0,0,5,2,89,36,94,38,0,0,0,0,0,0,"East TN",2455501,NA,NA,1.54754569434099,0.081449773386368,NA
2020-03-17,6,1,6,1,0,0,5,0,130,41,135,41,0,0,0,0,0,0,"East TN",2455501,NA,NA,1.66972035442054,0.040724886693184,NA
2020-03-18,8,2,8,2,0,0,7,2,171,41,178,43,0,0,0,0,0,0,"East TN",2455501,0.325799093545472,0.0393258426966292,1.75117012780691,0.081449773386368,3.93258426966292
2020-03-19,11,3,11,3,0,0,11,4,238,67,249,71,0,0,0,0,0,0,"East TN",2455501,0.40724886693184,0.0421940928270042,2.89146695521606,0.122174660079552,4.21940928270042
2020-03-20,29,18,29,18,0,0,27,16,382,144,409,160,0,0,2,2,0,0,"East TN",2455501,1.14029682740915,0.0675324675324675,6.51598187090944,0.733047960477312,6.75324675324675
2020-03-21,38,9,38,9,0,0,38,11,610,228,648,239,0,0,1,3,1,1,"East TN",2455501,1.42537103426144,0.0588235294117647,9.73324791967098,0.366523980238656,5.88235294117647
2020-03-22,48,10,47,9,1,1,43,5,713,103,756,108,0,0,4,7,2,1,"East TN",2455501,1.83261990119328,0.0571428571428571,4.39828776286387,0.40724886693184,5.71428571428571
2020-03-23,64,16,63,16,1,0,56,13,846,133,902,146,0,0,4,11,2,0,"East TN",2455501,2.40276831489786,0.0631188118811881,5.94583345720486,0.651598187090944,6.31188118811881
2020-03-24,83,19,82,19,1,0,70,14,987,141,1057,155,0,0,5,16,2,0,"East TN",2455501,3.13581627537517,0.0704989154013015,6.31235743744352,0.773772847170496,7.04989154013015
2020-03-25,116,33,115,33,1,0,99,29,1288,301,1387,330,0,0,12,28,3,1,"East TN",2455501,4.39828776286387,0.076095947063689,13.4392126087507,1.34392126087507,7.6095947063689
2020-03-26,144,28,143,28,1,0,130,31,1774,486,1904,517,0,0,5,33,4,1,"East TN",2455501,5.41640993019347,0.0719033232628399,21.0547664203761,1.14029682740915,7.19033232628399
2020-03-27,166,22,165,22,1,0,147,17,2171,397,2318,414,0,0,6,39,4,0,"East TN",2455501,5.57930947696621,0.0628601361969618,16.8601030909782,0.895947507250048,6.28601361969618
2020-03-28,197,31,196,31,1,0,180,33,2608,437,2788,470,0,0,8,47,4,0,"East TN",2455501,6.47525698421626,0.0663551401869159,19.1406967457965,1.2624714874887,6.63551401869159
2020-03-29,213,16,212,16,1,0,196,16,2795,187,2991,203,0,0,3,50,7,3,"East TN",2455501,6.71960630437536,0.0684563758389262,8.26715199871635,0.651598187090944,6.84563758389262
2020-03-30,246,33,245,33,1,0,226,30,3345,550,3571,580,0,0,8,58,9,2,"East TN",2455501,7.41192937815949,0.0636942675159236,23.6204342820467,1.34392126087507,6.36942675159236
2020-03-31,295,49,294,49,1,0,278,52,3645,300,3923,352,0,0,12,70,10,1,"East TN",2455501,8.63367597895501,0.0725750174459177,14.3351601160008,1.99551944796602,7.25750174459177
2020-04-01,346,51,345,51,1,0,336,58,4243,598,4579,656,0,0,9,79,12,2,"East TN",2455501,9.36672393943232,0.0742481203007519,26.7155256707287,2.07696922135238,7.42481203007519
2020-04-02,391,45,390,45,1,0,383,47,4839,596,5222,643,2,7,5,84,14,2,"East TN",2455501,10.0590470132164,0.0762507534659433,26.1861021437173,1.83261990119328,7.62507534659433
2020-04-03,412,21,411,21,1,0,401,18,5124,285,5525,303,1,8,2,86,17,3,"East TN",2455501,10.0183221265233,0.0792017461802308,12.3396406680348,0.855222620556864,7.92017461802307
2020-04-04,447,35,446,35,1,0,431,30,5716,592,6147,622,3,11,5,91,19,2,"East TN",2455501,10.181221673296,0.0747246204227449,25.3308795231604,1.42537103426144,7.47246204227449
2020-04-05,473,26,472,26,1,0,464,33,6093,377,6557,410,-1,10,2,93,20,1,"East TN",2455501,10.5884705402278,0.0751542344363432,16.6972035442054,1.05884705402278,7.51542344363432
2020-04-06,514,41,513,41,1,0,514,50,6626,533,7140,583,8,18,5,98,20,0,"East TN",2455501,10.9142696337733,0.080694872513309,23.7426089421263,1.66972035442054,8.0694872513309
2020-04-07,570,56,569,56,1,0,592,78,7755,1129,8347,1207,0,18,7,105,21,1,"East TN",2455501,11.1993438406256,0.0709764918625678,49.1549382386731,2.2805936548183,7.09764918625678
2020-04-08,607,37,606,37,1,0,632,40,8162,407,8794,447,1,19,8,113,25,4,"East TN",2455501,10.629195426921,0.0702253855278766,18.2040243518532,1.50682080764781,7.02253855278766
2020-04-09,633,26,632,26,1,0,662,30,8613,451,9275,481,3,22,2,115,25,0,"East TN",2455501,9.85542257975053,0.0688378978534419,19.5886704994215,1.05884705402278,6.88378978534419
2020-04-10,655,22,654,22,1,0,682,20,8941,328,9623,348,0,22,4,119,25,0,"East TN",2455501,9.89614746644371,0.0685700341630063,14.172260569228,0.895947507250048,6.85700341630063
2020-04-11,679,24,678,24,1,0,728,46,10022,1081,10750,1127,2,24,5,124,27,2,"East TN",2455501,9.44817371281869,0.0645231370845101,45.8969473032184,0.977397280636416,6.45231370845101
2020-04-12,709,30,708,30,1,0,761,33,11472,1450,12233,1483,0,24,1,125,28,1,"East TN",2455501,9.61107325959142,0.0523255813953488,60.3950069659919,1.22174660079552,5.23255813953488
2020-04-13,738,29,737,29,1,0,803,42,12435,963,13238,1005,0,24,7,132,32,4,"East TN",2455501,9.12237461927321,0.0473925877336832,40.9285111266499,1.18102171410234,4.73925877336832
2020-04-14,749,11,748,11,1,0,823,20,12720,285,13543,305,4,28,1,133,33,1,"East TN",2455501,7.28975471807994,0.0444572748267898,12.4210904414211,0.447973753625024,4.44572748267898
2020-04-15,773,24,772,24,1,0,850,27,13132,412,13982,439,2,30,4,137,34,1,"East TN",2455501,6.76033119106854,0.0420200462606014,17.8782252583078,0.977397280636416,4.20200462606014
2020-04-16,801,28,800,28,1,0,886,36,13808,676,14694,712,1,31,6,143,34,0,"East TN",2455501,6.84178096445491,0.0413360398597527,28.996119325547,1.14029682740915,4.13360398597527
2020-04-17,823,22,821,21,2,1,916,30,14137,329,15053,359,0,31,4,147,35,1,"East TN",2455501,6.84178096445491,0.0430939226519337,14.6202343228531,0.895947507250048,4.30939226519337
2020-04-18,835,12,833,12,2,0,935,19,14918,781,15853,800,0,31,0,147,35,0,"East TN",2455501,6.3530823241367,0.0405643738977072,32.5799093545472,0.488698640318208,4.05643738977072
2020-04-19,914,79,912,79,2,0,1016,81,15604,686,16620,767,1,32,1,148,35,0,"East TN",2455501,8.34860177210272,0.0581262821974014,31.2359880936721,3.21726604876154,5.81262821974014
2020-04-20,939,25,931,19,8,6,1033,17,16567,963,17600,980,0,32,2,150,35,0,"East TN",2455501,8.18570222532998,0.0527281063732233,39.9103889593203,1.0181221673296,5.27281063732233
2020-04-21,1045,106,1037,106,8,0,1154,121,19273,2706,20427,2827,0,32,6,156,36,1,"East TN",2455501,12.0545664611825,0.0480825101685067,115.129254681631,4.3168379894775,4.80825101685067
2020-04-22,1247,202,1237,200,10,2,1354,200,21825,2552,23179,2752,2,34,2,158,36,0,"East TN",2455501,19.3035962925692,0.0548004784168751,112.074888179642,8.22642711202317,5.48004784168751
2020-04-23,1492,245,1480,243,12,2,1601,247,22932,1107,24533,1354,0,34,3,161,36,0,"East TN",2455501,28.1408967049901,0.0726699867872751,55.1414965825711,9.97759723983008,7.26699867872751
2020-04-24,1540,48,1527,47,13,1,1655,54,25621,2689,27276,2743,0,34,4,165,36,0,"East TN",2455501,29.1997437590129,0.0604597889225231,111.708364199404,1.95479456127283,6.04597889225231
2020-04-25,1563,23,1546,19,17,4,1674,19,26396,775,28070,794,0,34,3,168,37,1,"East TN",2455501,29.647717512638,0.0604894818695261,32.3355600343881,0.936672393943232,6.04894818695261
2020-04-26,1583,20,1565,19,18,1,1700,26,27513,1117,29213,1143,0,34,0,168,37,0,"East TN",2455501,27.2449491977401,0.0543158897800365,46.5485454903093,0.81449773386368,5.43158897800365
2020-04-27,1652,69,1633,68,19,1,1772,72,28428,915,30200,987,0,34,8,176,38,1,"East TN",2455501,29.0368442122402,0.0586507936507936,40.1954631661726,2.8100171818297,5.86507936507936
2020-04-28,1689,37,1667,34,22,3,1812,40,30602,2174,32414,2214,2,36,1,177,39,1,"East TN",2455501,26.2268270304105,0.0548928005339117,90.1648991387094,1.50682080764781,5.48928005339117
2020-04-29,1752,63,1729,62,23,1,1878,66,33345,2743,35223,2809,1,37,6,183,40,1,"East TN",2455501,20.5660677800579,0.0435071404848887,114.396206721154,2.56566786167059,4.35071404848887
2020-04-30,1774,22,1750,21,24,1,1900,22,33894,549,35794,571,0,37,1,184,40,0,"East TN",2455501,11.4844180474779,0.0265518160021312,23.2539103018081,0.895947507250048,2.65518160021312
2020-05-01,1814,40,1786,36,28,4,1929,29,35556,1662,37485,1691,0,37,0,184,40,0,"East TN",2455501,11.1586189539324,0.0268390635713586,68.8657833981741,1.62899546772736,2.68390635713586
2020-05-02,1835,21,1807,21,28,0,1966,37,37433,1877,39399,1914,0,37,3,187,40,0,"East TN",2455501,11.077169180546,0.0257745608615059,77.9474331307542,0.855222620556864,2.57745608615059
2020-05-03,1873,38,1840,33,33,5,2003,37,39553,2120,41556,2157,0,37,3,190,42,2,"East TN",2455501,11.8102171410234,0.0245483269869562,87.8435805971979,1.54754569434099,2.45483269869562
2020-05-04,1920,47,1884,44,36,3,2060,57,41499,1946,43559,2003,0,37,1,191,42,0,"East TN",2455501,10.9142696337733,0.0215584998877161,81.5719480464475,1.91406967457965,2.15584998877161
2020-05-05,1948,28,1911,27,37,1,2092,32,44409,2910,46501,2942,2,39,1,192,42,0,"East TN",2455501,10.5477456535347,0.0198764818627103,119.812616651347,1.14029682740915,1.98764818627103
2020-05-06,1985,37,1948,37,37,0,2135,43,45453,1044,47588,1087,1,40,0,192,42,0,"East TN",2455501,9.48889859951187,0.0207844723008492,44.267951835491,1.50682080764781,2.07844723008492
2020-05-07,2028,43,1989,41,39,2,2183,48,46845,1392,49028,1440,0,40,4,196,46,4,"East TN",2455501,10.3441212200687,0.0213843131328397,58.643836838185,1.75117012780691,2.13843131328397
2020-05-08,2047,19,2008,19,39,0,2219,36,48515,1670,50734,1706,1,41,0,196,47,1,"East TN",2455501,9.48889859951187,0.0218884444108989,69.4766566985719,0.773772847170496,2.18884444108989
2020-05-09,2063,16,2022,14,41,2,2237,18,51333,2818,53570,2836,0,41,1,197,48,1,"East TN",2455501,9.28527416604595,0.0191235622045022,115.49577866187,0.651598187090944,1.91235622045022
2020-05-10,2079,16,2037,15,42,1,2256,19,53897,2564,56153,2583,1,42,3,200,48,0,"East TN",2455501,8.3893266587959,0.0173323285606631,105.192382328494,0.651598187090944,1.73323285606631
2020-05-11,2140,61,2097,60,43,1,2307,51,55468,1571,57775,1622,3,45,5,205,50,2,"East TN",2455501,8.95947507250048,0.0173747889701744,66.0557662163444,2.48421808828422,1.73747889701745
2020-05-12,2193,53,2150,53,43,0,2373,66,59022,3554,61395,3620,3,48,3,208,50,0,"East TN",2455501,9.97759723983008,0.0188666577145159,147.424089829326,2.15841899473875,1.88666577145159
2020-05-13,2247,54,2201,51,46,3,2425,52,60647,1625,63072,1677,0,48,7,215,52,2,"East TN",2455501,10.6699203136142,0.0187290105915784,68.2956349844696,2.19914388143194,1.87290105915784
2020-05-14,2278,31,2232,31,46,0,2470,45,62356,1709,64826,1754,1,49,2,217,53,1,"East TN",2455501,10.181221673296,0.018166856564122,71.4314512598447,1.2624714874887,1.8166856564122
2020-05-15,2306,28,2260,28,46,0,2507,37,64675,2319,67182,2356,1,50,4,221,53,0,"East TN",2455501,10.5477456535347,0.0175097276264591,95.9478330491415,1.14029682740915,1.75097276264591
2020-05-16,2316,10,2270,10,46,0,2525,18,67443,2768,69968,2786,1,51,1,222,53,0,"East TN",2455501,10.3033963333756,0.017563117453348,113.459534327211,0.40724886693184,1.7563117453348
2020-05-17,2396,80,2350,80,46,0,2604,79,69670,2227,72274,2306,0,51,4,226,55,2,"East TN",2455501,12.9097890817393,0.0215867502016004,93.9115887144823,3.25799093545472,2.15867502016004
2020-05-18,2445,49,2398,48,47,1,2665,61,71548,1878,74213,1939,0,51,3,229,55,0,"East TN",2455501,12.4210904414211,0.0217788052074462,78.9655552980838,1.99551944796602,2.17788052074462
2020-05-19,2486,41,2438,40,48,1,2705,40,72672,1124,75377,1164,1,52,3,232,55,0,"East TN",2455501,11.9323918011029,0.0237448147618366,47.4037681108662,1.66972035442054,2.37448147618366
2020-05-20,2528,42,2480,42,48,0,2750,45,74412,1740,77162,1785,0,52,3,235,55,0,"East TN",2455501,11.4436931607847,0.0230660042583392,72.6939227473334,1.71044524111373,2.30660042583392
2020-05-21,2769,241,2720,240,49,1,2988,238,75874,1462,78862,1700,0,52,4,239,56,1,"East TN",2455501,19.9959193663533,0.0369051011684241,69.2323073784128,9.81469769305734,3.69051011684241
2020-05-22,2860,91,2808,88,52,3,3066,78,77398,1524,80464,1602,0,52,7,246,56,0,"East TN",2455501,22.5615872280239,0.0420870350850776,65.2412684824808,3.70596468907974,4.20870350850775
2020-05-23,2926,66,2870,62,56,4,3157,91,79612,2214,82769,2305,2,54,7,253,57,1,"East TN",2455501,24.8421808828422,0.0493711428794625,93.8708638277891,2.68784252175014,4.93711428794625
2020-05-24,2978,52,2922,52,56,0,3227,70,81732,2120,84959,2190,0,54,0,253,58,1,"East TN",2455501,23.7018840554331,0.0491131257390619,89.187501858073,2.11769410804557,4.91131257390619
2020-05-25,3062,84,3005,83,57,1,3321,94,84382,2650,87703,2744,1,55,2,255,58,0,"East TN",2455501,25.1272550896945,0.0486286137879911,111.749089086097,3.42089048222746,4.86286137879911
2020-05-26,3123,61,3057,52,66,9,3377,56,86768,2386,90145,2442,1,56,3,258,58,0,"East TN",2455501,25.9417528235582,0.0455037919826652,99.4501733047553,2.48421808828422,4.55037919826652
2020-05-27,3199,76,3130,73,69,3,3444,67,88635,1867,92079,1934,0,56,9,267,58,0,"East TN",2455501,27.3263989711265,0.0465241000201113,78.7619308646179,3.09509138868198,4.65241000201113
2020-05-28,3273,74,3204,74,69,0,3511,67,90034,1399,93545,1466,0,56,1,268,58,0,"East TN",2455501,20.5253428933647,0.0356194238234693,59.7026838922077,3.01364161529562,3.56194238234693
2020-05-29,3348,75,3278,74,70,1,3594,83,91312,1278,94906,1361,0,56,4,272,58,0,"East TN",2455501,19.8737447062738,0.0365600332363939,55.4265707894234,3.0543665019888,3.65600332363939
2020-05-30,3421,73,3350,72,71,1,3675,81,93557,2245,97232,2326,0,56,5,277,59,1,"East TN",2455501,20.1588189131261,0.0358155292816152,94.726086448346,2.97291672860243,3.58155292816152
2020-05-31,3533,112,3460,110,73,2,3769,94,96340,2783,100109,2877,0,56,1,278,60,1,"East TN",2455501,22.6023121147171,0.0357755775577558,117.16549901629,4.56118730963661,3.57755775577558
2020-06-01,3629,96,3553,93,76,3,3902,133,100171,3831,104073,3964,0,56,5,283,60,0,"East TN",2455501,23.0910107550353,0.0354917532070861,161.433450851781,3.90958912254566,3.54917532070861
2020-06-02,3736,107,3658,105,78,2,4017,115,104230,4059,108247,4174,1,57,3,286,64,4,"East TN",2455501,24.9643555429218,0.0353552093691305,169.98567705735,4.35756287617069,3.53552093691305
2020-06-03,3786,50,3708,50,78,0,4067,50,106161,1931,110228,1981,0,57,4,290,65,1,"East TN",2455501,23.905508488899,0.0343269601630944,80.6760005391975,2.0362443346592,3.43269601630944
2020-06-04,3837,51,3757,49,80,2,4128,61,107708,1547,111836,1608,6,63,5,295,66,1,"East TN",2455501,22.9688360949558,0.0337324367175113,65.4856178026399,2.07696922135238,3.37324367175113
2020-06-05,3936,99,3852,95,84,4,4210,82,109864,2156,114074,2238,1,64,4,299,67,1,"East TN",2455501,23.9462333755922,0.0321368948247078,91.1422964193458,4.03176378262522,3.21368948247079
2020-06-06,3989,53,3902,50,87,3,4285,75,112967,3103,117252,3178,1,65,4,303,67,0,"East TN",2455501,23.1317356417285,0.0304695304695305,129.423689910939,2.15841899473875,3.04695304695305
2020-06-07,4047,58,3958,56,89,2,4366,81,116924,3957,121290,4038,0,65,6,309,68,1,"East TN",2455501,20.9325917602966,0.0281856380718569,164.447092467077,2.36204342820467,2.81856380718569
2020-06-08,4207,160,4114,156,93,4,4523,157,119875,2951,124398,3108,0,65,6,315,68,0,"East TN",2455501,23.5389845086604,0.0305535055350553,126.572947842416,6.51598187090944,3.05535055350553
2020-06-09,4315,108,4221,107,94,1,4641,118,122202,2327,126843,2445,1,66,7,322,69,1,"East TN",2455501,23.5797093953535,0.0335556033555603,99.5723479648349,4.39828776286387,3.35556033555603
2020-06-10,4392,77,4295,74,97,3,4715,74,125038,2836,129753,2910,0,66,6,328,69,0,"East TN",2455501,24.6792813360695,0.0331882202304737,118.509420277165,3.13581627537517,3.31882202304738
2020-06-11,4656,264,4557,262,99,2,4995,280,127329,2291,132324,2571,1,67,8,336,69,0,"East TN",2455501,33.3536822017177,0.0423174541194846,104.703683688176,10.7513700870006,4.23174541194846
2020-06-12,4827,171,4727,170,100,1,5167,172,129955,2626,135122,2798,2,69,3,339,70,1,"East TN",2455501,36.2858740436269,0.0454675028506271,113.948232967529,6.96395562453446,4.54675028506271
2020-06-13,4975,148,4871,144,104,4,5335,168,132146,2191,137481,2359,0,69,4,343,71,1,"East TN",2455501,40.1547382794794,0.0519056799644075,96.0700077092211,6.02728323059123,5.19056799644075
2020-06-14,5091,116,4986,115,105,1,5470,135,136014,3868,141484,4003,0,69,4,347,72,1,"East TN",2455501,42.5167817076841,0.0546697038724374,163.021721432816,4.72408685640934,5.46697038724374
2020-06-15,5273,182,5157,171,116,11,5649,179,139187,3173,144836,3352,0,69,9,356,77,5,"East TN",2455501,43.4127292149341,0.0550934533711713,136.509820195553,7.41192937815949,5.50934533711713
2020-06-16,5427,154,5309,152,118,2,5807,158,140986,1799,146793,1957,3,72,4,360,80,3,"East TN",2455501,45.2860740028206,0.0584461152882206,79.6986032585611,6.27163255075034,5.84461152882206
2020-06-17,5560,133,5439,130,121,3,5929,122,142426,1440,148355,1562,3,75,6,366,82,2,"East TN",2455501,47.5666676576389,0.0652617998064724,63.6122730147534,5.41640993019347,6.52617998064724
2020-06-18,5738,178,5616,177,122,1,6135,206,146017,3591,152152,3797,1,76,12,378,82,0,"East TN",2455501,44.0643274020251,0.0574944522896913,154.63239477402,7.24902983138675,5.74944522896913
2020-06-19,5873,135,5747,131,126,4,6253,118,147480,1463,153733,1581,4,80,13,391,83,1,"East TN",2455501,42.5982314810705,0.058352587179625,64.3860458619239,5.49785970357984,5.8352587179625
2020-06-20,5939,66,5812,65,127,1,6348,95,149655,2175,156003,2270,0,80,7,398,83,0,"East TN",2455501,39.2587907722294,0.0546917179570241,92.4454927935277,2.68784252175014,5.46917179570241
2020-06-21,6027,88,5899,87,128,1,6467,119,153005,3350,159472,3469,1,81,3,401,86,3,"East TN",2455501,38.1184939448202,0.0554258394485212,141.274631938655,3.58379002900019,5.54258394485212
2020-06-22,6223,196,6088,189,135,7,6665,198,156416,3411,163081,3609,1,82,7,408,87,1,"East TN",2455501,38.6886423585248,0.0556864894491642,146.976116075701,7.98207779186406,5.56864894491642
2020-06-23,6413,190,6272,184,141,6,6849,184,158220,1804,165069,1988,4,86,15,423,87,0,"East TN",2455501,40.1547382794794,0.0570146640402714,80.9610747460498,7.73772847170496,5.70146640402714
2020-06-24,6591,178,6448,176,143,2,7032,183,159851,1631,166883,1814,2,88,9,432,87,0,"East TN",2455501,41.9873581806727,0.0595315198618307,73.8749444614358,7.24902983138675,5.95315198618307
2020-06-25,6760,169,6608,160,152,9,7216,184,163024,3173,170240,3357,0,88,8,440,87,0,"East TN",2455501,41.620834200434,0.0597633790358249,136.713444629019,6.8825058511481,5.97633790358249
2020-06-26,6974,214,6812,204,162,10,7388,172,164612,1588,172000,1760,1,89,16,456,87,0,"East TN",2455501,44.8381002491956,0.0621339026660097,71.6758005800038,8.71512575234138,6.21339026660097
2020-06-27,7048,74,6881,69,167,5,7434,46,164821,209,172255,255,-1,88,5,461,89,2,"East TN",2455501,45.1638993427411,0.0668225449175486,10.3848461067619,3.01364161529562,6.68225449175486
2020-06-28,7175,127,7006,125,169,2,7605,171,167908,3087,175513,3258,0,88,5,466,90,1,"East TN",2455501,46.7521699237752,0.0709432080294246,132.681680846393,5.17206061003437,7.09432080294246
2020-06-29,7518,343,7347,341,171,2,7945,340,173175,5267,181120,5607,1,89,22,488,91,1,"East TN",2455501,52.7387282676733,0.0709573701424691,228.344439688683,13.9686361357621,7.09573701424691
2020-06-30,7788,270,7613,266,175,4,8393,448,179461,6286,187854,6734,0,89,22,510,92,1,"East TN",2455501,55.996719203128,0.0677638797454466,274.241386991901,10.9957194071597,6.77638797454466
2020-07-01,8063,275,7885,272,178,3,8727,334,182665,3204,191392,3538,0,89,17,527,95,3,"East TN",2455501,59.9470332123668,0.0691582683912032,144.084649120485,11.1993438406256,6.91582683912032
2020-07-02,8543,480,8360,475,183,5,9333,606,189047,6382,198380,6988,2,91,25,552,98,3,"East TN",2455501,72.6124729739471,0.0752309879175551,284.58550821197,19.5479456127283,7.52309879175551
2020-07-03,8769,226,8580,220,189,6,9561,228,192402,3355,201963,3583,5,96,14,566,99,1,"East TN",2455501,73.1011716142653,0.0725227780929813,145.917269021678,9.20382439265958,7.25227780929813
2020-07-04,8989,220,8798,218,191,2,9841,280,197166,4764,207007,5044,2,98,15,581,105,6,"East TN",2455501,79.0470050714701,0.0692622007366483,205.41632848042,8.95947507250048,6.92622007366483
2020-07-05,9309,320,9117,319,192,1,10209,368,201011,3845,211220,4213,2,100,12,593,108,3,"East TN",2455501,86.9069082032546,0.0729268770829249,171.573947638384,13.0319637418189,7.29268770829249
2020-07-06,9543,234,9340,223,203,11,10419,210,202641,1630,213060,1840,4,104,26,619,108,0,"East TN",2455501,82.4678955536976,0.0774577332498435,74.9337915154586,9.52962348620506,7.74577332498435
2020-07-07,9991,448,9779,439,212,9,10985,566,208917,6276,219902,6842,0,104,32,651,109,1,"East TN",2455501,89.7169253850844,0.0808786819770344,278.639674754765,18.2447492385464,8.08786819770345
2020-07-08,10372,381,10150,371,222,10,11419,434,213085,4168,224504,4602,1,105,20,671,109,0,"East TN",2455501,94.0337633745619,0.0812998308770234,187.415928562033,15.5161818301031,8.12998308770234
2020-07-09,10821,449,10585,435,236,14,11891,472,219034,5949,230925,6421,1,106,24,695,113,4,"East TN",2455501,92.7712918870731,0.0785988631126133,261.494497456934,18.2854741252396,7.85988631126133
2020-07-10,11288,467,11040,455,248,12,12344,453,222318,3284,234662,3737,0,106,29,724,115,2,"East TN",2455501,102.58598958013,0.0851096363803174,152.188901572429,19.0185220857169,8.51096363803175
2020-07-11,11594,306,11339,299,255,7,12766,422,226796,4478,239562,4900,5,111,23,747,120,5,"East TN",2455501,106.088329835744,0.0898479496237137,199.551944796602,12.4618153281143,8.98479496237137
2020-07-12,12064,470,11801,462,263,8,13399,633,232725,5929,246124,6562,1,112,25,772,125,5,"East TN",2455501,112.197062839722,0.0913935365574146,267.236706480673,19.1406967457965,9.13935365574146
2020-07-13,12418,354,12142,341,276,13,13742,343,236158,3433,249900,3776,3,115,20,792,129,4,"East TN",2455501,117.084049242904,0.0902008686210641,153.777172153463,14.4166098893871,9.02008686210641
2020-07-14,12933,515,12652,510,281,5,14326,584,240646,4488,254972,5072,4,119,34,826,133,4,"East TN",2455501,119.812616651347,0.0952666096378671,206.556625307829,20.9733166469898,9.52666096378671
2020-07-15,13313,380,13026,374,287,6,14709,383,243742,3096,258451,3479,6,125,24,850,140,7,"East TN",2455501,119.771891764654,0.0969157804813386,141.681880805587,15.4754569434099,9.69157804813386
2020-07-16,14140,827,13838,812,302,15,15806,1097,253573,9831,269379,10928,6,131,44,894,142,2,"East TN",2455501,135.165898934678,0.101809954751131,445.041561783115,33.6794812952632,10.1809954751131
2020-07-17,14608,468,14292,454,316,14,16317,511,257892,4319,274209,4830,3,134,24,918,147,5,"East TN",2455501,135.206623821371,0.100462740536577,196.701202728079,19.0592469724101,10.0462740536577
2020-07-18,15117,509,14786,494,331,15,16985,668,265980,8088,282965,8756,6,140,27,945,150,3,"East TN",2455501,143.473775820087,0.097205262309057,356.587107885519,20.7289673268307,9.7205262309057
2020-07-19,15598,481,15248,462,350,19,17545,560,270832,4852,288377,5412,0,140,26,971,154,4,"East TN",2455501,143.921749573712,0.098123210186259,220.403086783512,19.5886704994215,9.8123210186259
2020-07-20,16033,435,15668,420,365,15,17956,411,273289,2457,291245,2868,2,142,29,1000,158,4,"East TN",2455501,147.22046539586,0.101922844358447,116.798975036052,17.715325711535,10.1922844358447
2020-07-21,17034,1001,16652,984,382,17,19168,1212,281667,8378,300835,9590,1,143,61,1061,161,3,"East TN",2455501,167.012760328748,0.105575300351046,390.551663387635,40.7656115798772,10.5575300351046
2020-07-22,17618,584,17220,568,398,16,19822,654,284967,3300,304789,3954,4,147,29,1090,166,5,"East TN",2455501,175.320637214157,0.11034140446286,161.02620198485,23.7833338288195,11.034140446286
2020-07-23,18412,794,17992,772,420,22,20821,999,295168,10201,315989,11200,4,151,50,1140,172,6,"East TN",2455501,173.976715953282,0.107594936708861,456.118730963661,32.3355600343881,10.7594936708861
2020-07-24,19015,603,18582,590,433,13,21505,684,300975,5807,322480,6491,2,153,34,1174,179,7,"East TN",2455501,179.474575656862,0.107476538708541,264.345239525457,24.55710667599,10.7476538708541
2020-07-25,19992,977,19547,965,445,12,22706,1201,310582,9607,333288,10808,10,163,29,1203,187,8,"East TN",2455501,198.533822629272,0.113685591081613,440.154575379933,39.7882142992408,11.3685591081613
2020-07-26,20767,775,20307,760,460,15,23603,897,318100,7518,341703,8415,1,164,21,1224,194,7,"East TN",2455501,210.506939317068,0.113603120429059,342.699921523143,31.5617871872176,11.3603120429059
2020-07-27,21412,645,20930,623,482,22,24308,705,322563,4463,346871,5168,6,170,38,1262,198,4,"East TN",2455501,219.059165522637,0.114191205551361,210.466214430375,26.2675519171037,11.4191205551361
2020-07-28,22227,815,21722,792,505,23,25280,972,330777,8214,356057,9186,7,177,50,1312,203,5,"East TN",2455501,211.484336597704,0.110680525877368,374.098809163588,33.190782654945,11.0680525877368
2020-07-29,22570,343,22054,332,516,11,25596,316,332347,1570,357943,1886,5,182,24,1336,212,9,"East TN",2455501,201.669638904647,0.108627760845844,76.807136303345,13.9686361357621,10.8627760845844
2020-07-30,23757,1187,23226,1172,531,15,26976,1380,344877,12530,371853,13910,5,187,46,1382,219,7,"East TN",2455501,217.674519375068,0.110178290133181,566.48317390219,48.3404405048094,11.0178290133181
2020-07-31,24379,622,23832,606,547,16,27630,654,348844,3967,376474,4621,6,193,27,1409,228,9,"East TN",2455501,218.448292222239,0.11343853020706,188.189701409203,25.3308795231604,11.343853020706
2020-08-01,24938,559,24374,542,564,17,28266,636,355819,6975,384085,7611,1,194,16,1425,231,3,"East TN",2455501,201.425289584488,0.109455282792291,309.957112621823,22.7652116614899,10.9455282792291
2020-08-02,25369,431,24794,420,575,11,28749,483,359614,3795,388363,4278,4,198,21,1446,236,5,"East TN",2455501,187.415928562033,0.110287183883412,174.221065273441,17.5524261647623,11.0287183883412
2020-08-03,25995,626,25402,608,593,18,29457,708,363758,4144,393215,4852,3,201,39,1485,244,8,"East TN",2455501,186.642155714862,0.111103918522355,197.597150235329,25.4937790699332,11.1103918522355
2020-08-04,26481,486,25868,466,613,20,29983,526,369128,5370,399111,5896,6,207,34,1519,253,9,"East TN",2455501,173.243667992805,0.109234914293678,240.113931943013,19.7922949328874,10.9234914293678
2020-08-05,26949,468,26328,460,621,8,30504,521,373340,4212,403844,4733,9,216,20,1539,259,6,"East TN",2455501,178.334278829453,0.106925775037581,192.75088871884,19.0592469724101,10.6925775037581
2020-08-06,27679,730,27020,692,659,38,31355,851,380409,7069,411764,7920,7,223,37,1576,265,6,"East TN",2455501,159.723005610668,0.109719125053243,322.541102610017,29.7291672860243,10.9719125053243
2020-08-07,28234,555,27561,541,673,14,31974,619,384377,3968,416351,4587,6,229,34,1610,278,13,"East TN",2455501,156.994438202224,0.108934975048273,186.805055261635,22.6023121147171,10.8934975048273
2020-08-08,28909,675,28224,663,685,12,32774,800,394454,10077,427228,10877,8,237,24,1634,289,11,"East TN",2455501,161.718525058634,0.104489720232714,442.964592561762,27.4892985178992,10.4489720232714
2020-08-09,29437,528,28740,516,697,12,33408,634,398755,4301,432163,4935,2,239,20,1654,296,7,"East TN",2455501,165.668839067873,0.106369863013699,200.977315830863,21.5027401740012,10.6369863013699
2020-08-10,29740,303,29032,292,708,11,33736,328,401044,2289,434780,2617,3,242,26,1680,300,4,"East TN",2455501,152.514700665974,0.102947191146397,106.577028476063,12.3396406680348,10.2947191146397
2020-08-11,30352,612,29627,595,725,17,34421,685,407141,6097,441562,6782,17,259,28,1708,305,5,"East TN",2455501,157.646036389315,0.104544062566253,276.196181553174,24.9236306562286,10.4544062566253
2020-08-12,30797,445,30051,424,746,21,34895,474,410889,3748,445784,4222,6,265,25,1733,310,5,"East TN",2455501,156.709363995372,0.104697186456843,171.940471618623,18.1225745784669,10.4697186456843
2020-08-13,31614,817,30855,804,759,13,36012,1117,419450,8561,455462,9678,6,271,44,1777,318,8,"East TN",2455501,160.252429137679,0.106572383175431,394.135453416635,33.2722324283313,10.6572383175431
2020-08-14,32075,461,31287,432,788,29,36546,534,424106,4656,460652,5190,4,275,18,1795,325,7,"East TN",2455501,156.42428978852,0.103203087966412,211.362161937625,18.7741727655578,10.3203087966412
2020-08-15,32725,650,31925,638,800,12,37423,877,431041,6935,468464,7812,4,279,17,1812,334,9,"East TN",2455501,155.40616762119,0.112741294014938,318.142814847153,26.4711763505696,11.2741294014938
2020-08-16,33199,474,32388,463,811,11,38016,593,436505,5464,474521,6057,2,281,10,1822,343,9,"East TN",2455501,153.207023739758,0.108787005996506,246.670638700615,19.3035962925692,10.8787005996506
2020-08-17,33472,273,32591,203,881,70,38243,227,437974,1469,476217,1696,8,289,12,1834,349,6,"East TN",2455501,151.985277138963,0.108767526606656,69.0694078316401,11.1178940672392,10.8767526606656
2020-08-18,34102,630,33156,565,946,65,39055,812,448566,10592,487621,11404,8,297,22,1856,352,3,"East TN",2455501,152.71832509944,0.100610087062246,464.42660784907,25.6566786167059,10.0610087062246
2020-08-19,34557,455,33590,434,967,21,39552,497,453349,4783,492901,5280,7,304,22,1878,359,7,"East TN",2455501,153.125573966372,0.0988390602118131,215.027401740011,18.5298234453987,9.88390602118131
2020-08-20,35333,776,34345,755,988,21,40424,872,464881,11532,505305,12404,6,310,27,1905,367,8,"East TN",2455501,151.455853611951,0.0885179463515438,505.151494542254,31.6025120739108,8.85179463515438
2020-08-21,35542,209,34542,197,1000,12,40637,213,467332,2451,507969,2664,17,327,17,1922,374,7,"East TN",2455501,141.193182165269,0.0864594120506372,108.491098150642,8.51150131887546,8.64594120506372
2020-08-22,36411,869,35399,857,1012,12,41609,972,480698,13366,522307,14338,2,329,20,1942,381,7,"East TN",2455501,150.111932351076,0.0777445536095686,583.913425406872,35.3899265363769,7.77445536095686
2020-08-23,36664,253,35641,242,1023,11,41863,254,485802,5104,527665,5358,0,329,20,1962,386,5,"East TN",2455501,141.111732391883,0.072388228210146,218.20394290208,10.3033963333756,7.2388228210146
2020-08-24,36856,192,35816,175,1040,17,42061,198,487145,1343,529206,1541,8,337,15,1977,396,10,"East TN",2455501,137.813016569735,0.072052690180981,62.7570503941965,7.81917824509133,7.2052690180981
2020-08-25,37470,614,36405,589,1065,25,42746,685,496872,9727,539618,10412,16,353,23,2000,405,9,"East TN",2455501,137.161418382644,0.0709848645114141,424.027520249432,25.005080429615,7.09848645114141
2020-08-26,37813,343,36723,318,1090,25,43129,383,500834,3962,543963,4345,6,359,11,2011,413,8,"East TN",2455501,132.600231073007,0.0700520935333516,176.949632681884,13.9686361357621,7.00520935333516
2020-08-27,38674,861,37567,844,1107,17,44105,976,511121,10287,555226,11263,8,367,29,2040,420,7,"East TN",2455501,136.061846441928,0.0737365036758078,458.684398825331,35.0641274428314,7.37365036758078
2020-08-28,39008,334,37881,314,1127,20,44443,338,513730,2609,558173,2947,12,379,10,2050,426,6,"East TN",2455501,141.152457278576,0.0758106923751096,120.016241084813,13.6021121555235,7.58106923751096
2020-08-29,39459,451,38316,435,1143,16,44971,528,520249,6519,565220,7047,8,387,16,2066,435,9,"East TN",2455501,124.129454640825,0.0783445575932701,286.988276526868,18.366923898626,7.83445575932701
2020-08-30,39722,263,38568,252,1154,11,45238,267,522130,1881,567368,2148,8,395,14,2080,438,3,"East TN",2455501,124.536703507757,0.0850061708183261,87.4770566169592,10.7106452003074,8.50061708183261
2020-08-31,40129,407,38946,378,1183,29,45688,450,525616,3486,571304,3936,2,397,17,2097,443,5,"East TN",2455501,133.292554146791,0.0861561119293078,160.293154024372,16.5750288841259,8.61561119293078
2020-09-01,40736,607,39511,565,1225,42,46362,674,531279,5663,577641,6337,6,403,28,2125,452,9,"East TN",2455501,133.007479939939,0.0951003340083634,258.073606974707,24.7200062227627,9.51003340083634
2020-09-02,41224,488,39970,459,1254,29,46815,453,536072,4793,582887,5246,7,410,22,2147,459,7,"East TN",2455501,138.912588510451,0.0946973589559141,213.642755592443,19.8737447062738,9.46973589559141
2020-09-03,41779,555,40492,522,1287,33,47462,647,544328,8256,591790,8903,6,416,22,2169,462,3,"East TN",2455501,126.450773182336,0.0918116179849032,362.573666229417,22.6023121147171,9.18116179849032
2020-09-04,42136,357,40835,343,1301,14,47810,348,547660,3332,595470,3680,7,423,11,2180,463,1,"East TN",2455501,127.38744557628,0.0902753572673405,149.867583030917,14.5387845494667,9.02753572673405
2020-09-05,43134,998,41818,983,1316,15,48900,1090,556971,9311,605871,10401,1,424,26,2206,469,6,"East TN",2455501,149.663958597451,0.0966519888809623,423.579546495807,40.6434369197976,9.66519888809623
2020-09-06,43397,263,42065,247,1332,16,49168,268,559595,2624,608763,2892,0,424,9,2215,483,14,"East TN",2455501,149.663958597451,0.0949390022949632,117.776372316688,10.7106452003074,9.49390022949632
2020-09-07,43601,204,42262,197,1339,7,49405,237,560931,1336,610336,1573,3,427,13,2228,487,4,"East TN",2455501,141.396806598735,0.0952295552367288,64.0602467683784,8.30787688540954,9.52295552367288
2020-09-08,43912,311,42551,289,1361,22,49725,320,564356,3425,614081,3745,7,434,24,2252,494,7,"East TN",2455501,129.342240137552,0.0922886937431394,152.514700665974,12.6654397615802,9.22886937431394
2020-09-09,44245,333,42867,316,1378,17,50099,374,569498,5142,619597,5516,6,440,16,2268,501,7,"East TN",2455501,123.029882700109,0.0894579133751022,224.638474999603,13.5613872688303,8.94579133751022
2020-09-10,44920,675,43505,638,1415,37,50806,707,577304,7806,628110,8513,18,458,39,2307,512,11,"East TN",2455501,127.916869103291,0.0920704845814978,346.690960419075,27.4892985178992,9.20704845814978
2020-09-11,45245,325,43807,302,1438,23,51160,354,581459,4155,632619,4509,17,475,26,2333,523,11,"East TN",2455501,126.613672729109,0.0901773937387278,183.628514099567,13.2355881752848,9.01773937387278
2020-09-12,45663,418,44207,400,1456,18,51671,511,588443,6984,640114,7495,10,485,14,2347,534,11,"East TN",2455501,102.993238447062,0.0809216482200742,305.233025765414,17.0230026377509,8.09216482200742
2020-09-13,46102,439,44626,419,1476,20,52171,500,594017,5574,646188,6074,2,487,21,2368,539,5,"East TN",2455501,110.160818505063,0.0802404809619238,247.3629617744,17.8782252583078,8.02404809619238
2020-09-14,46546,444,45055,429,1491,15,52656,485,598990,4973,651646,5458,9,496,25,2393,549,10,"East TN",2455501,119.934791311427,0.0786976519002663,222.276431571398,18.0818496917737,7.86976519002663
2020-09-15,47039,493,45511,456,1528,37,53196,540,607164,8174,660360,8714,7,503,20,2413,552,3,"East TN",2455501,127.346720689586,0.0750016206054582,354.876662644405,20.0773691397397,7.50016206054582
2020-09-16,47392,353,45821,310,1571,43,53590,394,610578,3414,664168,3808,6,509,17,2430,561,9,"East TN",2455501,128.16121842345,0.0783244710686321,155.080368527645,14.375885002694,7.83244710686321
2020-09-17,47943,551,46340,519,1603,32,54167,577,617753,7175,671920,7752,8,517,21,2451,572,11,"East TN",2455501,123.111332473495,0.0767176443734307,315.699321645562,22.4394125679444,7.67176443734307
2020-09-18,48477,534,46826,486,1651,48,54733,566,625866,8113,680599,8679,17,534,30,2481,578,6,"East TN",2455501,131.622833792371,0.074468528553564,353.451291610144,21.7470894941603,7.4468528553564
2020-09-19,48985,508,47311,485,1674,23,55306,573,634218,8352,689524,8925,3,537,30,2511,580,2,"East TN",2455501,135.288073594757,0.0735681036227484,363.469613736667,20.6882424401375,7.35681036227484
2020-09-20,49291,306,47592,281,1699,25,55635,329,639176,4958,694811,5287,1,538,13,2524,591,11,"East TN",2455501,129.871663664564,0.0712420048125373,215.312475946864,12.4618153281143,7.12420048125373
2020-09-21,49454,163,47725,133,1729,30,55787,152,640692,1516,696479,1668,3,541,9,2533,596,5,"East TN",2455501,118.427970503779,0.0698369504605982,67.9291110042309,6.63815653098899,6.98369504605982
2020-09-22,49914,460,48127,402,1787,58,56277,490,646841,6149,703118,6639,6,547,29,2562,603,7,"East TN",2455501,117.084049242904,0.0720566911455166,270.372522756049,18.7334478788646,7.20566911455166
2020-09-23,50208,294,48381,254,1827,40,56559,282,648934,2093,705493,2375,8,555,13,2575,612,9,"East TN",2455501,114.681280928006,0.0718451300665457,96.721605896312,11.9731166877961,7.18451300665457
2020-09-24,50671,463,48823,442,1848,21,57039,480,655824,6890,712863,7370,11,566,28,2603,617,5,"East TN",2455501,111.097490899006,0.0701463009549862,300.142414928766,18.8556225389442,7.01463009549862
2020-09-25,51125,454,49253,430,1872,24,57525,486,662498,6674,720023,7160,11,577,18,2621,624,7,"East TN",2455501,107.839499963551,0.0708198051948052,291.590188723197,18.4890985587055,7.08198051948052
2020-09-26,51683,558,49787,534,1896,24,58163,638,673052,10554,731215,11192,5,582,29,2650,631,7,"East TN",2455501,109.87574429821,0.0685279796598786,455.792931870115,22.7244867747967,6.85279796598786
2020-09-27,52076,393,50152,365,1924,28,58570,407,679069,6017,737639,6424,3,585,30,2680,638,7,"East TN",2455501,113.418809440517,0.0685299336882413,261.616672117014,16.0048804704213,6.85299336882413
2020-09-28,52310,234,50347,195,1963,39,58795,225,680755,1686,739550,1911,4,589,15,2695,645,7,"East TN",2455501,116.310276395733,0.0698381741775208,77.8252584706746,9.52962348620506,6.98381741775208
2020-09-29,52693,383,50687,340,2006,43,59192,397,686563,5808,745755,6205,9,598,33,2728,647,2,"East TN",2455501,113.174460120358,0.0683678495203696,252.697921931207,15.5976316034895,6.83678495203696
2020-09-30,53175,482,51137,450,2038,32,59668,476,690001,3438,749669,3914,6,604,23,2751,651,4,"East TN",2455501,120.830738818677,0.0703775805867439,159.397206517122,19.6293953861147,7.0377580586744
2020-10-01,53563,388,51486,349,2077,39,60047,379,693279,3278,753326,3657,11,615,31,2782,656,5,"East TN",2455501,117.776372316688,0.0743395200553592,148.930910636974,15.8012560369554,7.43395200553592
2020-10-02,54027,464,51922,436,2105,28,60509,462,696900,3621,757409,4083,2,617,17,2799,660,4,"East TN",2455501,118.18362118362,0.079815973893971,166.27971236827,18.8963474256374,7.9815973893971
2020-10-03,54432,405,52310,388,2122,17,60992,483,704358,7458,765350,7941,12,629,22,2821,666,6,"East TN",2455501,111.952713519563,0.082876812655632,323.396325230574,16.4935791107395,8.2876812655632
2020-10-04,54887,455,52735,425,2152,30,61531,539,714480,10122,776011,10661,4,633,27,2848,679,13,"East TN",2455501,114.47765649454,0.0771656416136766,434.168017036035,18.5298234453987,7.71656416136766
2020-10-05,55558,671,53347,612,2211,59,62282,751,721729,7249,784011,8000,5,638,42,2890,688,9,"East TN",2455501,132.274431979462,0.0784282854636648,325.799093545472,27.3263989711265,7.84282854636648
2020-10-06,56308,750,54013,666,2295,84,63021,739,728366,6637,791387,7376,8,646,46,2936,697,9,"East TN",2455501,147.22046539586,0.0839104137447405,300.386764248925,30.543665019888,8.39104137447405
2020-10-07,57045,737,54672,659,2373,78,63729,708,735117,6751,798846,7459,3,649,38,2974,703,6,"East TN",2455501,157.605311502622,0.0825792545295565,303.766929844459,30.0142414928766,8.25792545295565
2020-10-08,57763,718,55329,657,2434,61,64407,678,741575,6458,805982,7136,10,659,32,3006,709,6,"East TN",2455501,171.044524111373,0.082801580066849,290.612791442561,29.2404686457061,8.2801580066849
2020-10-09,58304,541,55828,499,2476,42,64967,560,747054,5479,812021,6039,4,663,20,3026,716,7,"East TN",2455501,174.180340386748,0.0816304108987036,245.937590740138,22.0321637010125,8.16304108987036
2020-10-10,58922,618,56416,588,2506,30,65636,669,755480,8426,821116,9095,12,675,20,3046,730,14,"East TN",2455501,182.854741252396,0.08327654843453,370.392844474508,25.1679799763877,8.327654843453
2020-10-11,59865,943,57328,912,2537,31,66665,1029,765906,10426,832571,11455,1,676,37,3083,737,7,"East TN",2455501,202.72848595867,0.0907708628005658,466.503577070423,38.4035681516725,9.07708628005658
2020-10-12,60221,356,57613,285,2608,71,66982,317,768827,2921,835809,3238,6,682,19,3102,748,11,"East TN",2455501,189.900146650317,0.0907370940962972,131.86718311253,14.4980596627735,9.07370940962972
2020-10-13,60726,505,58066,453,2660,52,67466,484,773208,4381,840674,4865,9,691,24,3126,755,7,"East TN",2455501,179.922549410487,0.0901860531174549,198.12657376234,20.5660677800579,9.01860531174549
2020-10-14,61600,874,58878,812,2722,62,68314,848,779392,6184,847706,7032,1,692,44,3170,762,7,"East TN",2455501,185.501858887453,0.0938395415472779,286.37740322647,35.5935509698428,9.38395415472779
2020-10-15,62109,509,59318,440,2791,69,68779,465,783545,4153,852324,4618,14,706,19,3189,771,9,"East TN",2455501,176.990357568578,0.0943420655129256,188.067526749124,20.7289673268307,9.43420655129256
2020-10-16,62748,639,59914,596,2834,43,69363,584,787634,4089,856997,4673,2,708,22,3211,783,12,"East TN",2455501,180.98139646451,0.097741017431519,190.307395517249,26.0232025969446,9.7741017431519
2020-10-17,63466,718,60595,681,2871,37,70223,860,796417,8783,866640,9643,6,714,37,3248,790,7,"East TN",2455501,185.053885133828,0.100760038660926,392.710082382373,29.2404686457061,10.0760038660926
2020-10-18,64270,804,61353,758,2917,46,71093,870,804525,8108,875618,8978,3,717,39,3287,798,8,"East TN",2455501,179.393125883476,0.102864311101819,365.628032731406,32.7428089013199,10.2864311101819
2020-10-19,65018,748,62038,685,2980,63,71852,759,809423,4898,881275,5657,3,720,67,3354,809,11,"East TN",2455501,195.357281467204,0.107113007522104,230.380684023342,30.4622152465016,10.7113007522104
2020-10-20,65704,686,62647,609,3057,77,72543,691,813037,3614,885580,4305,15,735,32,3386,822,13,"East TN",2455501,202.72848595867,0.113058388634036,175.320637214157,27.9372722715242,11.3058388634036
2020-10-21,66297,593,63199,552,3098,41,73159,616,816780,3743,889939,4359,5,740,27,3413,836,14,"East TN",2455501,191.284792797885,0.114720716027751,177.519781095589,24.1498578090581,11.4720716027751
2020-10-22,67427,1130,64235,1036,3192,94,74260,1101,825344,8564,899604,9665,10,750,43,3456,851,15,"East TN",2455501,216.574947434353,0.115926395939086,393.606029889623,46.0191219632979,11.5926395939086
2020-10-23,68398,971,65139,904,3259,67,75230,970,832460,7116,907690,8086,19,769,39,3495,859,8,"East TN",2455501,230.09560981649,0.115735900420176,329.301433801086,39.5438649790817,11.5735900420176
2020-10-24,69635,1237,66314,1175,3321,62,76557,1327,842981,10521,919538,11848,12,781,50,3545,876,17,"East TN",2455501,251.231826010252,0.119739876743922,482.508457540844,50.3766848394686,11.9739876743922
2020-10-25,70564,929,67186,872,3378,57,77604,1047,850856,7875,928460,8922,9,790,43,3588,887,11,"East TN",2455501,256.3224368469,0.123216380909125,363.347439076588,37.8334197379679,12.3216380909125
2020-10-26,71026,462,67592,406,3434,56,78038,434,853611,2755,931649,3189,6,796,21,3609,900,13,"East TN",2455501,244.675119252649,0.122801445189979,129.871663664564,18.814897652251,12.2801445189979
2020-10-27,71868,842,68304,712,3564,130,78821,783,857995,4384,936816,5167,12,808,54,3663,924,24,"East TN",2455501,251.028201576786,0.122531032867515,210.425489543682,34.2903545956609,12.2531032867515
2020-10-28,72865,997,69215,911,3650,86,79791,970,865211,7216,945002,8186,13,821,41,3704,938,14,"East TN",2455501,267.481055800833,0.120443855220384,333.373922470404,40.6027120331044,12.0443855220384
2020-10-29,73773,908,70008,793,3765,115,80625,834,871713,6502,952338,7336,11,832,40,3744,950,12,"East TN",2455501,258.440130954946,0.120700117571206,298.757768781198,36.9781971174111,12.0700117571206
2020-10-30,74673,900,70815,807,3858,93,81465,840,876569,4856,958034,5696,28,860,39,3783,966,16,"East TN",2455501,255.54866399973,0.123847926267281,231.968954604376,36.6523980238656,12.3847926267281
2020-10-31,74687,14,70829,14,3858,0,81481,16,876590,21,958071,37,5,865,0,3783,977,11,"East TN",2455501,205.742127573966,0.127786572548205,1.50682080764781,0.570148413704576,12.7786572548205
2020-11-01,75194,507,71219,390,3975,117,81951,470,883153,6563,965104,7033,0,865,27,3810,993,16,"East TN",2455501,188.556225389442,0.118627879052505,286.418128113163,20.6475175534443,11.8627879052505
2020-11-02,76004,810,71961,742,4043,68,82726,775,887381,4228,970107,5003,11,876,38,3848,1007,14,"East TN",2455501,202.72848595867,0.121899214727755,203.746608126,32.987158221479,12.1899214727755
2020-11-03,77044,1040,72921,960,4123,80,83802,1076,894243,6862,978045,7938,31,907,29,3877,1020,13,"East TN",2455501,210.79201352392,0.120813019961677,323.274150570495,42.3538821609114,12.0813019961677
2020-11-04,77955,911,73733,812,4222,99,84649,847,899128,4885,983777,5732,6,913,35,3912,1044,24,"East TN",2455501,207.289673268307,0.12528691166989,233.435050525331,37.1003717774906,12.528691166989
2020-11-05,78533,578,74217,484,4316,94,85150,501,901789,2661,986939,3162,17,930,27,3939,1058,14,"East TN",2455501,193.850460659556,0.130776567151238,128.772091723848,23.5389845086603,13.0776567151238
2020-11-06,79499,966,75066,849,4433,117,86077,927,908196,6407,994273,7334,10,940,37,3976,1082,24,"East TN",2455501,196.538303181306,0.127266204917354,298.676319007811,39.3402405456157,12.7266204917354
2020-11-07,80826,1327,76307,1241,4519,86,87496,1419,919116,10920,1006612,12339,21,961,52,4028,1092,10,"East TN",2455501,250.010079409457,0.123915864938918,502.504376907197,54.0419246418552,12.3915864938918
2020-11-08,82383,1557,77746,1439,4637,118,89163,1667,932015,12899,1021178,14566,3,964,52,4080,1109,17,"East TN",2455501,292.7712104373,0.128615757748689,593.198699572918,63.4086485812875,12.8615757748689
2020-11-09,83002,619,78285,539,4717,80,89743,580,935467,3452,1025210,4032,9,973,19,4099,1120,11,"East TN",2455501,284.992757078902,0.127343338838176,164.202743146918,25.2087048630809,12.7343338838176
2020-11-10,83941,939,79135,850,4806,89,90666,923,940468,5001,1031134,5924,27,1000,44,4143,1138,18,"East TN",2455501,280.87954352289,0.12929232044303,241.254228770422,38.2406686048998,12.929232044303
2020-11-11,85245,1304,80235,1100,5010,204,91835,1169,947015,6547,1038850,7716,26,1026,59,4202,1152,14,"East TN",2455501,296.884423993311,0.130481361102537,314.233225724608,53.1052522479119,13.0481361102537
2020-11-12,86082,837,80940,705,5142,132,92599,764,951228,4213,1043827,4977,15,1041,34,4236,1170,18,"East TN",2455501,307.432169646846,0.130941499085923,202.687761071977,34.086730162195,13.0941499085923
2020-11-13,87540,1458,82227,1287,5313,171,93898,1299,957087,5859,1050985,7158,27,1068,47,4283,1186,16,"East TN",2455501,327.468813899893,0.137907321201862,291.508738949811,59.3768847986623,13.7907321201862
2020-11-14,89015,1475,83618,1391,5397,84,95433,1535,965982,8895,1061415,10430,7,1075,52,4335,1215,29,"East TN",2455501,333.496097130484,0.144827837892086,424.760568209909,60.0692078724464,14.4827837892086
2020-11-15,90967,1952,85351,1733,5616,219,97393,1960,977151,11169,1074544,13129,7,1082,56,4391,1232,17,"East TN",2455501,349.582427374291,0.154218041449612,534.677037394813,79.4949788250952,15.4218041449612
2020-11-16,92492,1525,86750,1399,5742,126,98930,1537,984770,7619,1083700,9156,10,1092,41,4432,1251,19,"East TN",2455501,386.479174718316,0.157069584544367,372.877062562793,62.1054522071056,15.7069584544367
2020-11-17,93704,1212,87869,1119,5835,93,100151,1221,989913,5143,1090064,6364,31,1123,46,4478,1278,27,"East TN",2455501,397.597068785555,0.160953673850331,259.173178915423,49.358562672139,16.0953673850331
2020-11-18,94902,1198,88825,956,6077,242,101184,1033,995057,5144,1096241,6177,14,1137,53,4531,1293,15,"East TN",2455501,393.280230796078,0.162900106288442,251.557625103798,48.7884142584344,16.2900106288442
2020-11-19,95982,1080,89706,881,6276,199,102043,859,999718,4661,1101761,5520,45,1182,52,4583,1313,20,"East TN",2455501,403.176378262522,0.163013083854041,224.801374546376,43.9828776286387,16.3013083854041
2020-11-20,97108,1126,90669,963,6439,163,103066,1023,1004617,4899,1107683,5922,28,1210,36,4619,1339,26,"East TN",2455501,389.655715880384,0.161698825355392,241.172778997036,45.8562224165252,16.1698825355392
2020-11-21,98326,1218,91733,1064,6593,154,104165,1099,1011023,6406,1115188,7505,3,1213,47,4666,1363,24,"East TN",2455501,379.189420000236,0.162386327710933,305.640274632346,49.6029119922981,16.2386327710933
2020-11-22,99912,1586,93162,1429,6750,157,105831,1666,1020624,9601,1126455,11267,17,1230,57,4723,1390,27,"East TN",2455501,364.284111470531,0.162547436959411,458.847298372104,64.5896702953898,16.2547436959411
2020-11-23,100803,891,93920,758,6883,133,106533,702,1023740,3116,1130273,3818,18,1248,35,4758,1417,27,"East TN",2455501,338.464533307052,0.163249092822021,155.487617394577,36.2858740436269,16.3249092822021
2020-11-24,101714,911,94655,735,7059,176,107238,705,1026767,3027,1134005,3732,13,1261,57,4815,1445,28,"East TN",2455501,326.206342412404,0.161284449602877,151.985277138963,37.1003717774906,16.1284449602877
2020-11-25,102620,906,95341,686,7279,220,107783,545,1029075,2308,1136858,2853,38,1299,56,4871,1470,25,"East TN",2455501,314.314675497994,0.162468916955954,116.188101735654,36.8967473440247,16.2468916955954
2020-11-26,104085,1465,96728,1387,7357,78,109452,1669,1037440,8365,1146892,10034,18,1317,25,4896,1489,19,"East TN",2455501,329.99375687487,0.164166537413308,408.633513079408,59.6619590055146,16.4166537413308
2020-11-27,105788,1703,98294,1566,7494,137,111201,1749,1044979,7539,1156180,9288,5,1322,50,4946,1517,28,"East TN",2455501,353.492016496837,0.167742334577397,378.252747606293,69.3544820384923,16.7742334577397
2020-11-28,107412,1624,99674,1380,7738,244,112695,1494,1052509,7530,1165204,9024,2,1324,45,4991,1545,28,"East TN",2455501,370.02632049427,0.170545425463852,367.501377519292,66.1372159897308,17.0545425463852
2020-11-29,109699,2287,101794,2120,7905,167,115020,2325,1063204,10695,1178224,13020,4,1328,51,5042,1570,25,"East TN",2455501,398.574466066192,0.177500048291449,530.238024745256,93.1378158673118,17.7500048291449
2020-11-30,111933,2234,103799,2005,8134,229,117240,2220,1072654,9450,1189894,11670,15,1343,53,5095,1601,31,"East TN",2455501,453.267988895138,0.179584374633099,475.259427709457,90.979396872573,17.9584374633099
2020-12-01,114194,2261,105805,2006,8389,255,119378,2138,1081489,8835,1200867,10973,20,1363,63,5158,1629,28,"East TN",2455501,508.246585930936,0.181568005743173,446.874181684308,92.078968813289,18.1568005743172
2020-12-02,115251,1057,106718,913,8533,144,120254,876,1084397,2908,1204651,3784,15,1378,42,5200,1662,33,"East TN",2455501,514.396043821607,0.183957045712684,154.102971247008,43.0462052346955,18.3957045712684
2020-12-03,117059,1808,108287,1569,8772,239,121976,1722,1090388,5991,1212364,7713,33,1411,45,5245,1683,21,"East TN",2455501,528.364679957369,0.191287878787879,314.111051064528,73.6305951412767,19.1287878787879
2020-12-04,118788,1729,109675,1388,9113,341,123434,1458,1095908,5520,1219342,6978,37,1448,36,5281,1718,35,"East TN",2455501,529.423527011392,0.193676577689117,284.178259345038,70.4133290925151,19.3676577689117
2020-12-05,119921,1133,110584,909,9337,224,124363,929,1098972,3064,1223335,3993,5,1453,24,5305,1744,26,"East TN",2455501,509.427607645039,0.200719065558824,162.614472565884,46.1412966233775,20.0719065558824
2020-12-06,121390,1469,111847,1263,9543,206,125604,1241,1103464,4492,1229068,5733,20,1473,40,5345,1780,36,"East TN",2455501,476.114650330014,0.20816615529856,233.475775412024,59.8248585522873,20.816615529856
2020-12-07,124113,2723,114252,2405,9861,318,128175,2571,1113010,9546,1241185,12117,31,1504,51,5396,1802,22,"East TN",2455501,496.029119922981,0.2131952974206,493.46345206131,110.89386646554,21.31952974206
2020-12-08,126877,2764,116615,2363,10262,401,130706,2531,1121369,8359,1252075,10890,45,1549,71,5467,1826,24,"East TN",2455501,516.513737929653,0.221215435088267,443.494016088774,112.563586819961,22.1215435088267
2020-12-09,129521,2644,118998,2383,10523,261,133283,2577,1128467,7098,1261750,9675,21,1570,56,5523,1849,23,"East TN",2455501,581.144133111736,0.228182630168654,394.013278756555,107.676600416778,22.8182630168654
2020-12-10,132596,3075,121680,2682,10916,393,136233,2950,1139936,11469,1276169,14419,30,1600,74,5597,1886,37,"East TN",2455501,632.742564552,0.223446438366899,587.21214122902,125.229026581541,22.3446438366899
2020-12-11,134580,1984,123428,1748,11152,236,138023,1790,1147107,7171,1285130,8961,35,1635,50,5647,1911,25,"East TN",2455501,643.127410658762,0.221757767373989,364.935709657622,80.798175199277,22.1757767373989
2020-12-12,137841,3261,126155,2727,11686,534,140997,2974,1158339,11232,1299336,14206,21,1656,73,5720,1936,25,"East TN",2455501,729.789969541857,0.218865541242878,578.537740363372,132.803855506473,21.8865541242878
2020-12-13,142131,4290,130014,3859,12117,431,145361,4364,1175619,17280,1320980,21644,15,1671,62,5782,1970,34,"East TN",2455501,844.674874903329,0.214955609713639,881.449447587274,174.709763913759,21.4955609713639
2020-12-14,144990,2859,132471,2457,12519,402,148034,2673,1184897,9278,1332931,11951,37,1708,72,5854,2004,34,"East TN",2455501,850.213459493602,0.216456303272077,486.703120870242,116.432451055813,21.6456303272077
2020-12-15,149116,4126,136011,3540,13105,586,151897,3863,1199918,15021,1351815,18884,34,1742,94,5948,2035,31,"East TN",2455501,905.680755169719,0.212462402245839,769.048760314087,168.030882496077,21.2462402245839
2020-12-16,152334,3218,138268,2257,14066,961,154283,2386,1207814,7896,1362097,10282,19,1761,60,6008,2077,42,"East TN",2455501,929.056840131607,0.209273819845137,418.733284979318,131.052685378666,20.9273819845137
2020-12-17,156401,4067,141640,3372,14761,695,157890,3607,1218513,10699,1376403,14306,58,1819,75,6083,2116,39,"East TN",2455501,969.455927731245,0.216064409282279,582.61022903269,165.628114181179,21.6064409282279
2020-12-18,159608,3207,144376,2736,15232,471,160769,2879,1227202,8689,1387971,11568,43,1862,62,6145,2146,30,"East TN",2455501,1019.26246415701,0.221176379070604,471.105489266752,130.604711625041,22.1176379070604
2020-12-19,162248,2640,146618,2242,15630,398,163237,2468,1235565,8363,1398802,10831,27,1889,41,6186,2183,37,"East TN",2455501,993.972309520542,0.223593991916836,441.091247773876,107.513700870006,22.3593991916836
2020-12-20,165878,3630,149583,2965,16295,665,166553,3316,1249508,13943,1416061,17259,16,1905,55,6241,2217,34,"East TN",2455501,967.09388430304,0.222883646575026,702.870819437663,147.831338696258,22.2883646575026
2020-12-21,168191,2313,151325,1742,16866,571,168456,1903,1256420,6912,1424876,8815,14,1919,35,6276,2252,35,"East TN",2455501,944.858096168562,0.222111044646256,358.989876200417,94.1966629213346,22.2111044646256
2020-12-22,170845,2654,153026,1701,17819,953,170255,1799,1261473,5053,1431728,6852,62,1981,60,6336,2297,45,"East TN",2455501,884.911062956195,0.229724825748001,279.046923621697,108.08384928371,22.9724825748001
2020-12-23,173063,2218,154472,1446,18591,772,171795,1540,1267250,5777,1439045,7317,41,2022,35,6371,2337,40,"East TN",2455501,844.186176263011,0.227582263346676,297.983995934027,90.3277986854821,22.7582263346676
2020-12-24,175155,2092,155930,1458,19225,634,173393,1598,1273539,6289,1446932,7887,15,2037,30,6401,2375,38,"East TN",2455501,763.754525043973,0.219810290802365,321.197181349142,85.1964629621409,21.9810290802365
2020-12-25,177521,2366,157909,1979,19612,387,175559,2166,1282086,8547,1457645,10713,3,2040,27,6428,2411,36,"East TN",2455501,729.504895335005,0.212274306053908,436.28571114408,96.3550819160733,21.2274306053908
2020-12-26,179460,1939,159376,1467,20084,472,177171,1612,1287739,5653,1464910,7265,2,2042,43,6471,2449,38,"East TN",2455501,700.956749763083,0.210776305439584,295.866301825982,78.9655552980838,21.0776305439584
2020-12-27,180756,1296,160286,910,20470,386,178161,990,1290532,2793,1468693,3783,27,2069,41,6512,2480,31,"East TN",2455501,605.904864221191,0.220550235598115,154.062246360315,52.7794531543665,22.0550235598115
2020-12-28,182152,1396,161264,978,20888,418,179181,1020,1292351,1819,1471532,2839,25,2094,42,6554,2517,37,"East TN",2455501,568.560143123542,0.229873971193416,115.617953321949,56.8519418236849,22.9873971193416
2020-12-29,185057,2905,162990,1726,22067,1179,180959,1778,1296438,4087,1477397,5865,50,2144,64,6618,2559,42,"East TN",2455501,578.782089683531,0.234382184851869,238.851460455524,118.3057958437,23.4382184851869
2020-12-30,187385,2328,164606,1616,22779,712,182636,1677,1300917,4479,1483553,6156,40,2184,44,6662,2597,38,"East TN",2455501,583.261827219781,0.243574188909859,250.702402483241,94.8075362217323,24.3574188909859
2020-12-31,190830,3445,167286,2680,23544,765,185531,2895,1308040,7123,1493571,10018,52,2236,30,6692,2640,43,"East TN",2455501,638.362598915659,0.26025429361693,407.981914892317,140.297234658019,26.025429361693
2021-01-01,193067,2237,169000,1714,24067,523,187387,1856,1314234,6194,1501621,8050,24,2260,31,6723,2680,40,"East TN",2455501,633.109088532238,0.268964889939967,327.835337880131,91.1015715326526,26.8964889939967
2021-01-02,195791,2724,171111,2111,24680,613,189634,2247,1320788,6554,1510422,8801,4,2264,64,6787,2717,37,"East TN",2455501,665.078124586388,0.273839866408859,358.419727786712,110.934591352233,27.3839866408859
2021-01-03,197105,1314,172016,905,25089,409,190571,937,1324156,3368,1514727,4305,15,2279,25,6812,2761,44,"East TN",2455501,665.811172546865,0.269583351435895,175.320637214157,53.5125011148438,26.9583351435895
2021-01-04,198661,1556,173142,1126,25519,430,191748,1177,1326521,2365,1518269,3542,46,2325,34,6846,2811,50,"East TN",2455501,672.327154417775,0.268887605109442,144.247548667258,63.3679236945943,26.8887605109442
2021-01-05,201556,2895,174875,1733,26681,1162,193570,1822,1331785,5264,1525355,7086,43,2368,60,6906,2855,44,"East TN",2455501,671.919905550843,0.26295925601568,288.576547107902,117.898546976768,26.295925601568
2021-01-06,204096,2540,176667,1792,27429,748,195471,1901,1337363,5578,1532834,7479,52,2420,63,6969,2898,43,"East TN",2455501,680.553581529798,0.260445202004829,304.581427578323,103.441212200687,26.0445202004829
2021-01-07,206598,2502,178797,2130,27801,372,197787,2316,1344466,7103,1542253,9419,33,2453,44,7013,2930,32,"East TN",2455501,642.150013378125,0.251756295961546,383.5877077631,101.893666506346,25.1756295961546
2021-01-08,208941,2343,180650,1853,28291,490,199770,1983,1351795,7329,1551565,9312,50,2503,47,7060,2985,55,"East TN",2455501,646.466851367603,0.247937690213039,379.230144886929,95.4184095221301,24.7937690213039
2021-01-09,211509,2568,182647,1997,28862,571,201943,2173,1359980,8185,1561923,10358,27,2530,32,7092,3013,28,"East TN",2455501,640.113769043466,0.23900506786276,421.828376368,104.581509028097,23.900506786276
2021-01-10,213171,1662,183778,1131,29393,531,203192,1249,1365779,5799,1568971,7048,36,2566,41,7133,3053,40,"East TN",2455501,654.286029612694,0.232670894476808,287.029001413561,67.6847616840718,23.2670894476808
2021-01-11,214593,1422,184789,1011,29804,411,204289,1097,1369050,3271,1573339,4368,28,2594,40,7173,3093,40,"East TN",2455501,648.828894795807,0.227728345741783,177.886305075828,57.9107888777077,22.7728345741783
2021-01-12,216408,1815,185922,1133,30486,682,205476,1187,1373247,4197,1578723,5384,60,2654,39,7212,3132,39,"East TN",2455501,604.846017167169,0.223092489881577,219.262789956103,73.915669348129,22.3092489881577
2021-01-13,217930,1522,186993,1071,30937,451,206607,1131,1377976,4729,1584583,5860,49,2703,32,7244,3159,27,"East TN",2455501,563.388082513507,0.215192564107519,238.647836022058,61.983277547026,21.5192564107519
2021-01-14,220180,2250,188774,1781,31406,469,208570,1963,1386498,8522,1595068,10485,38,2741,50,7294,3201,42,"East TN",2455501,553.125411066825,0.204165483290732,427.000436978034,91.630995059664,20.4165483290732
2021-01-15,221143,963,189444,670,31699,293,209265,695,1389555,3057,1598820,3752,23,2764,30,7324,3242,41,"East TN",2455501,496.925067430231,0.200931118400169,152.799774872826,39.2180658855362,20.0931118400169
2021-01-16,223573,2430,191192,1748,32381,682,211265,2000,1400431,10876,1611696,12876,13,2777,54,7378,3285,43,"East TN",2455501,491.305033066572,0.187290297952705,524.373641061437,98.9614746644371,18.7290297952705
2021-01-17,224429,856,191798,606,32631,250,211935,670,1404049,3618,1615984,4288,13,2790,24,7402,3319,34,"East TN",2455501,458.480774391865,0.185969838129879,174.628314140373,34.8605030093655,18.5969838129879
2021-01-18,224996,567,192120,322,32876,245,212289,354,1406131,2082,1618420,2436,13,2803,21,7423,3350,31,"East TN",2455501,423.660996269193,0.177458352742841,99.2058239845962,23.0910107550353,17.7458352742841
2021-01-19,226676,1680,193093,973,33583,707,213347,1058,1410336,4205,1623683,5263,21,2824,53,7476,3390,40,"East TN",2455501,418.163136565613,0.175066725978648,214.335078666227,68.4178096445491,17.5066725978648
2021-01-20,227660,984,193751,658,33909,326,214043,696,1414327,3991,1628370,4687,32,2856,29,7505,3430,40,"East TN",2455501,396.25314752468,0.169822093315368,190.877543930953,40.073288506093,16.9822093315368
2021-01-21,229213,1553,194883,1132,34330,421,215312,1269,1421254,6927,1636566,8196,65,2921,36,7541,3476,46,"East TN",2455501,367.867901499531,0.162465660995711,333.781171337336,63.2457490345148,16.2465660995711
2021-01-22,230199,986,195587,704,34612,282,216126,814,1426693,5439,1642819,6253,32,2953,31,7572,3508,32,"East TN",2455501,368.804573893474,0.155935362167322,254.65271649248,40.1547382794794,15.5935362167322
2021-01-23,231629,1430,196554,967,35075,463,217226,1100,1434970,8277,1652196,9377,19,2972,41,7613,3534,26,"East TN",2455501,328.07968720029,0.147185185185185,381.877262521986,58.2365879712531,14.7185185185185
2021-01-24,232248,619,197041,487,35207,132,217767,541,1438341,3371,1656108,3912,19,2991,20,7633,3562,28,"East TN",2455501,318.427889054006,0.145349416807896,159.315756743736,25.2087048630809,14.5349416807896
2021-01-25,232987,739,197552,511,35435,228,218316,549,1440097,1756,1658413,2305,44,3035,20,7653,3593,31,"East TN",2455501,325.432569565233,0.15070137274023,93.8708638277891,30.095691266263,15.070137274023
2021-01-26,234016,1029,198278,726,35738,303,219096,780,1444560,4463,1663656,5243,63,3098,26,7679,3616,23,"East TN",2455501,298.920668327971,0.143822079903935,213.520580932364,41.9059084072863,14.3822079903935
2021-01-27,234970,954,198983,705,35987,249,219851,755,1449077,4517,1668928,5272,55,3153,28,7707,3639,23,"East TN",2455501,297.698921727175,0.143202327530943,214.701602646466,38.8515419052975,14.3202327530943
2021-01-28,236298,1328,199698,715,36600,613,220644,793,1453506,4429,1674150,5222,46,3199,29,7736,3667,28,"East TN",2455501,288.535822221209,0.141868880374627,212.665358311807,54.0826495285484,14.1868880374627
2021-01-29,236893,595,200050,352,36843,243,221041,397,1456170,2664,1677211,3061,17,3216,17,7753,3688,21,"East TN",2455501,272.612391524174,0.142911142126076,124.658878167836,24.2313075824445,14.2911142126076
2021-01-30,238048,1155,201017,967,37031,188,222138,1097,1465218,9048,1687356,10145,44,3260,29,7782,3708,20,"East TN",2455501,261.413047683548,0.139704209328783,413.153975502352,47.0372441306275,13.9704209328783
2021-01-31,238725,677,201455,438,37270,239,222627,489,1469140,3922,1691767,4411,29,3289,30,7812,3727,19,"East TN",2455501,263.775091111753,0.136290978434617,179.637475203635,27.5707482912856,13.6290978434617
2021-02-01,239417,692,201864,409,37553,283,223069,442,1470836,1696,1693905,2138,39,3328,10,7822,3754,27,"East TN",2455501,261.861021437173,0.133917502535783,87.0698077500274,28.1816215916833,13.3917502535783
2021-02-02,239954,537,202211,347,37743,190,223428,359,1471894,1058,1695322,1417,57,3385,13,7835,3770,16,"East TN",2455501,241.824377184127,0.136802880060633,57.7071644442417,21.8692641542398,13.6802880060633
2021-02-03,241064,1110,202969,758,38095,352,224252,824,1477897,6003,1702149,6827,46,3431,39,7874,3783,13,"East TN",2455501,248.177459508263,0.132476445621745,278.028801454367,45.2046242294342,13.2476445621745
2021-02-04,242158,1094,203749,780,38409,314,225114,862,1485606,7709,1710720,8571,58,3489,36,7910,3801,18,"East TN",2455501,238.647836022058,0.122231337161608,349.05300384728,44.5530260423433,12.2231337161608
2021-02-05,242972,814,204305,556,38667,258,225715,601,1489412,3806,1715127,4407,67,3556,28,7938,3815,14,"East TN",2455501,247.566586207866,0.12327249709885,179.474575656862,33.1500577682518,12.327249709885
2021-02-06,244196,1224,205119,814,39077,410,226676,961,1498059,8647,1724735,9608,27,3583,22,7960,3844,29,"East TN",2455501,250.376603389695,0.121405067016239,391.284711348112,49.8472613124572,12.1405067016239
2021-02-07,244713,517,205472,353,39241,164,227082,406,1501143,3084,1728225,3490,2,3585,10,7970,3861,17,"East TN",2455501,243.860621518786,0.122195402929398,142.129854559212,21.0547664203761,12.2195402929398
2021-02-08,245221,508,205767,295,39454,213,227397,315,1502507,1364,1729904,1679,32,3617,9,7979,3877,16,"East TN",2455501,236.36724236724,0.120225561821162,68.3770847578559,20.6882424401375,12.0225561821162
2021-02-09,246244,1023,206395,628,39849,395,228059,662,1506739,4232,1734798,4894,16,3633,38,8017,3888,11,"East TN",2455501,256.159537300127,0.117311784375317,199.307595476443,41.6615590871272,11.7311784375317
2021-02-10,247090,846,206976,581,40114,265,228692,633,1512723,5984,1741415,6617,39,3672,30,8047,3901,13,"East TN",2455501,245.408167213127,0.11307492487139,269.476575248798,34.4532541424337,11.307492487139
2021-02-11,247957,867,207559,583,40398,284,229341,649,1518293,5570,1747634,6219,37,3709,31,8078,3919,18,"East TN",2455501,236.163617933774,0.114509400227556,253.268070344911,35.3084767629905,11.4509400227556
2021-02-12,248786,829,208149,590,40637,239,229986,645,1523801,5508,1753787,6153,34,3743,12,8090,3928,9,"East TN",2455501,236.774491234172,0.110475944128298,250.580227823161,33.7609310686495,11.0475944128298
2021-02-13,249378,592,208520,371,40858,221,230420,434,1528225,4424,1758645,4858,12,3755,17,8107,3940,12,"East TN",2455501,211.03636284408,0.110409908581539,197.841499555488,24.1091329223649,11.0409908581539
2021-02-14,249916,538,208932,412,40984,126,230872,452,1531190,2965,1762062,3417,15,3770,15,8122,3953,13,"East TN",2455501,211.891585464636,0.112007565682537,139.15693783061,21.909989040933,11.2007565682537
2021-02-15,250295,379,209143,211,41152,168,231101,229,1532514,1324,1763615,1553,5,3775,10,8132,3964,11,"East TN",2455501,206.638075081216,0.109875114947643,63.2457490345148,15.4347320567167,10.9875114947643
2021-02-16,251060,765,209571,428,41489,337,231575,474,1535923,3409,1767498,3883,8,3783,26,8158,3974,10,"East TN",2455501,196.131054314374,0.107522935779817,158.134735029633,31.1545383202858,10.7522935779817
2021-02-17,251680,620,209990,419,41690,201,232025,450,1539172,3249,1771197,3699,11,3794,11,8169,3991,17,"East TN",2455501,186.927229921715,0.111913236182929,150.641355878088,25.2494297497741,11.1913236182929
2021-02-18,252466,786,210534,544,41932,242,232624,599,1544889,5717,1777513,6316,42,3836,19,8188,4008,17,"East TN",2455501,183.628514099567,0.10987650189096,257.21838435415,32.0097609408426,10.987650189096
2021-02-19,252941,475,210834,300,42107,175,232967,343,1547597,2708,1780564,3051,5,3841,11,8199,4017,9,"East TN",2455501,169.21190421018,0.111326885013258,124.251629300904,19.3443211792624,11.1326885013258
2021-02-20,253564,623,211283,449,42281,174,233473,506,1552821,5224,1786294,5730,18,3859,18,8217,4027,10,"East TN",2455501,170.474375697668,0.110419906687403,233.353600751944,25.3716044098536,11.0419906687403
2021-02-21,253913,349,211511,228,42402,121,233736,263,1554955,2134,1788691,2397,7,3866,12,8229,4045,18,"East TN",2455501,162.777372112656,0.10755191708288,97.617553403562,14.2129854559212,10.755191708288
2021-02-22,254269,356,211705,194,42564,162,233962,226,1556335,1380,1790297,1606,7,3873,22,8251,4061,16,"East TN",2455501,161.840699718713,0.107225845139045,65.4041680292535,14.4980596627735,10.7225845139045
2021-02-23,254905,636,212047,342,42858,294,234323,361,1559282,2947,1793605,3308,26,3899,27,8278,4068,7,"East TN",2455501,156.587189335292,0.10525912590493,134.717925181053,25.901027936865,10.525912590493
2021-02-24,255644,739,212595,548,43049,191,234931,608,1565475,6193,1800406,6801,19,3918,23,8301,4075,7,"East TN",2455501,161.433450851781,0.0994898832551611,276.969954400344,30.095691266263,9.94898832551611
2021-02-25,256279,635,213040,445,43239,190,235427,496,1570241,4766,1805668,5262,21,3939,16,8317,4084,9,"East TN",2455501,155.283992961111,0.0995560291244894,214.294353779534,25.8603030501718,9.95560291244894
2021-02-26,256739,460,213362,322,43377,138,235795,368,1573362,3121,1809157,3489,14,3953,11,8328,4089,5,"East TN",2455501,154.673119660713,0.0989053264785087,142.089129672519,18.7334478788646,9.89053264785087
2021-02-27,257179,440,213589,227,43590,213,236070,275,1577454,4092,1813524,4367,7,3960,16,8344,4098,9,"East TN",2455501,147.22046539586,0.0953727506426735,177.845580189135,17.918950145001,9.53727506426735
2021-02-28,257545,366,213863,274,43682,92,236383,313,1580014,2560,1816397,2873,5,3965,11,8355,4107,9,"East TN",2455501,147.912788469644,0.0955388724464015,117.002599469518,14.9053085297053,9.55388724464015
2021-03-01,257786,241,214009,146,43777,95,236537,154,1580793,779,1817330,933,4,3969,11,8366,4116,9,"East TN",2455501,143.229426499928,0.0952539488772981,37.9963192847407,9.81469769305734,9.52539488772981
2021-03-02,258406,620,214399,390,44007,230,236984,447,1584249,3456,1821233,3903,7,3976,24,8390,4126,10,"East TN",2455501,142.577828312837,0.0963153322716085,158.949232763497,25.2494297497741,9.63153322716085
2021-03-03,258884,478,214697,298,44187,180,237336,352,1588421,4172,1825757,4524,7,3983,17,8407,4129,3,"East TN",2455501,131.948632885916,0.094868052542306,184.239387399964,19.466495839342,9.4868052542306
2021-03-04,259492,608,215111,414,44381,194,237808,472,1593241,4820,1831049,5292,18,4001,21,8428,4134,5,"East TN",2455501,130.8490609452,0.0938103305622316,215.51610038033,24.7607311094559,9.38103305622316
2021-03-05,259961,469,215421,310,44540,159,238161,353,1596920,3679,1835081,4032,15,4016,16,8444,4139,5,"East TN",2455501,131.215584925439,0.0912667798179293,164.202743146918,19.0999718591033,9.12667798179293
2021-03-06,260422,461,215742,321,44680,140,238532,371,1601194,4274,1839726,4645,1,4017,10,8454,4145,6,"East TN",2455501,132.070807545996,0.0939622929547363,189.16709868984,18.7741727655578,9.39622929547363
2021-03-07,260675,253,215905,163,44770,90,238715,183,1602924,1730,1841639,1913,1,4018,4,8458,4149,4,"East TN",2455501,127.468895349666,0.0923857063624118,77.906708244061,10.3033963333756,9.23857063624119
2021-03-08,261131,456,216198,293,44933,163,239027,312,1604506,1582,1843533,1894,3,4021,9,8467,4157,8,"East TN",2455501,136.2247459887,0.0950272869518757,77.1329353968905,18.5705483320919,9.50272869518757
2021-03-09,261669,538,216479,281,45190,257,239345,318,1607081,2575,1846426,2893,6,4027,21,8488,4169,12,"East TN",2455501,132.885305279859,0.0937165085539634,117.817097203381,21.909989040933,9.37165085539634
2021-03-10,262319,650,216943,464,45376,186,239851,506,1612550,5469,1852401,5975,7,4034,28,8516,4179,10,"East TN",2455501,139.889985791087,0.0943927338237502,243.331197991774,26.4711763505696,9.43927338237502
2021-03-11,262847,528,217279,336,45568,192,240214,363,1615888,3338,1856102,3701,5,4039,9,8525,4187,8,"East TN",2455501,136.631994855632,0.0960364028260089,150.722805651474,21.5027401740012,9.60364028260089
2021-03-12,263307,460,217644,365,45663,95,240630,416,1619233,3345,1859863,3761,5,4044,12,8537,4195,8,"East TN",2455501,136.265470875394,0.0996287628117182,153.166298853065,18.7334478788646,9.96287628117182
2021-03-13,263752,445,217858,214,45894,231,240908,278,1622872,3639,1863780,3917,2,4046,21,8558,4202,7,"East TN",2455501,135.613872688303,0.0987777500623597,159.519381177202,18.1225745784669,9.87777500623597
2021-03-14,264013,261,218033,175,45980,86,241119,211,1624713,1841,1865832,2052,0,4046,10,8568,4208,6,"East TN",2455501,135.939671781848,0.0993675856652751,83.5674674944136,10.629195426921,9.93675856652751
2021-03-15,264369,356,218218,185,46151,171,241334,215,1625908,1195,1867242,1410,4,4050,15,8583,4212,4,"East TN",2455501,131.86718311253,0.0973048209540681,57.4220902373894,14.4980596627735,9.73048209540681
2021-03-16,265068,699,218669,451,46399,248,241830,496,1629173,3265,1871003,3761,4,4054,36,8619,4213,1,"East TN",2455501,138.423889870132,0.1011107946454,153.166298853065,28.4666957985356,10.11107946454
2021-03-17,265494,426,219002,333,46492,93,242194,364,1632897,3724,1875091,4088,1,4055,16,8635,4222,9,"East TN",2455501,129.301515250859,0.103261348611723,166.483336801736,17.3488017312964,10.3261348611723
2021-03-18,266044,550,219351,349,46693,201,242579,385,1636185,3288,1878764,3673,6,4061,31,8666,4229,7,"East TN",2455501,130.197462758109,0.104359721119054,149.582508824065,22.3986876812512,10.4359721119054
2021-03-19,266836,792,219881,530,46955,262,243139,560,1641224,5039,1884363,5599,15,4076,25,8691,4235,6,"East TN",2455501,143.718125140246,0.102408163265306,228.018640595137,32.2541102610017,10.2408163265306
2021-03-20,267108,272,220046,165,47062,107,243333,194,1643344,2120,1886677,2314,1,4077,15,8706,4237,2,"East TN",2455501,136.672719742325,0.105909071057344,94.2373878080278,11.077169180546,10.5909071057344
2021-03-21,267389,281,220243,197,47146,84,243558,225,1645142,1798,1888700,2023,-17,4060,8,8714,4245,8,"East TN",2455501,137.487217476189,0.106655588595417,82.3864457803112,11.4436931607847,10.6655588595417
2021-03-22,267915,526,220584,341,47331,185,243914,356,1647229,2087,1891143,2443,14,4074,19,8733,4252,7,"East TN",2455501,144.41044821403,0.107945274256307,99.4908981914485,21.4212904006148,10.7945274256307
2021-03-23,268352,437,220832,248,47520,189,244179,265,1649684,2455,1893863,2720,11,4085,17,8750,4258,6,"East TN",2455501,133.740527900416,0.102755905511811,110.77169180546,17.7967754849214,10.2755905511811
2021-03-24,268950,598,221292,460,47658,138,244672,493,1654381,4697,1899053,5190,4,4089,26,8776,4264,6,"East TN",2455501,140.745208411644,0.103413738419164,211.362161937625,24.353482242524,10.3413738419164
2021-03-25,269349,399,221598,306,47751,93,245005,333,1657350,2969,1902355,3302,8,4097,23,8799,4268,4,"East TN",2455501,134.595750520973,0.102835827222246,134.473575860894,16.2492297905804,10.2835827222246
2021-03-26,269759,410,221921,323,47838,87,245350,345,1659981,2631,1905331,2976,7,4104,14,8813,4278,10,"East TN",2455501,119.038843804177,0.105446394505914,121.197262798916,16.6972035442054,10.5446394505914
2021-03-27,269963,204,222102,181,47861,23,245560,210,1662492,2511,1908052,2721,2,4106,13,8826,4289,11,"East TN",2455501,116.26955150904,0.104187134502924,110.812416692154,8.30787688540954,10.4187134502924
2021-03-28,270279,316,222321,219,47958,97,245805,245,1664566,2074,1910371,2319,5,4111,17,8843,4296,7,"East TN",2455501,117.694922543302,0.103686954916709,94.4410122414937,12.8690641950461,10.3686954916709
2021-03-29,270717,438,222557,236,48160,202,246058,253,1666420,1854,1912478,2107,18,4129,18,8861,4301,5,"East TN",2455501,114.111132514302,0.100492149050855,85.8073362625387,17.8375003716146,10.0492149050855
2021-03-30,271092,375,222815,258,48277,117,246380,322,1668896,2476,1915276,2798,5,4134,20,8881,4307,6,"East TN",2455501,111.586189539324,0.102788025965535,113.948232967529,15.271832509944,10.2788025965535
2021-03-31,271752,660,223256,441,48496,219,246867,487,1673710,4814,1920577,5301,4,4138,18,8899,4312,5,"East TN",2455501,114.111132514302,0.101979186024902,215.882624360568,26.8784252175014,10.1979186024902
2021-04-01,272202,450,223579,323,48623,127,247217,350,1676537,2827,1923754,3177,1,4139,18,8917,4320,8,"East TN",2455501,116.188101735654,0.103369316323193,129.382965024246,18.3261990119328,10.3369316323193
2021-04-02,272548,346,223810,231,48738,115,247467,250,1679556,3019,1927023,3269,0,4139,12,8929,4325,5,"East TN",2455501,113.58170898729,0.0975935828877005,133.129654600019,14.0908107958417,9.75935828877005
2021-04-03,272890,342,224060,250,48830,92,247741,274,1681908,2352,1929649,2626,0,4139,13,8942,4334,9,"East TN",2455501,119.20174335095,0.100986248090012,106.943552456301,13.9279112490689,10.0986248090012
2021-04-04,273061,171,224183,123,48878,48,247882,141,1683502,1594,1931384,1735,6,4145,8,8950,4338,4,"East TN",2455501,113.296634780438,0.0988435730262219,70.6576784126742,6.96395562453446,9.88435730262219
2021-04-05,273468,407,224418,235,49050,172,248105,223,1684721,1219,1932826,1442,6,4151,40,8990,4344,6,"East TN",2455501,112.034163292949,0.100599567525064,58.7252866115713,16.5750288841259,10.0599567525064
2021-04-06,273896,428,224667,249,49229,179,248381,276,1686805,2084,1935186,2360,3,4154,27,9017,4349,5,"East TN",2455501,114.192582287688,0.100502260170768,96.1107325959142,17.4302515046828,10.0502260170768
2021-04-07,274525,629,225128,461,49397,168,248888,507,1691497,4692,1940385,5199,5,4159,24,9041,4353,4,"East TN",2455501,112.930110800199,0.102029483037157,211.728685917864,25.6159537300127,10.2029483037157
2021-04-08,274930,405,225382,254,49548,151,249176,288,1694508,3011,1943684,3299,-1,4158,21,9062,4358,5,"East TN",2455501,111.097490899006,0.0982940291018565,134.351401200814,16.4935791107395,9.82940291018565
2021-04-09,275448,518,225788,406,49660,112,249625,449,1698383,3875,1948008,4324,4,4162,31,9093,4361,3,"East TN",2455501,118.102171410234,0.102835358589469,176.094410061328,21.0954913070693,10.2835358589469
2021-04-10,275753,305,226004,216,49749,89,249873,248,1701163,2780,1951036,3028,1,4163,15,9108,4366,5,"East TN",2455501,116.595350602586,0.0996867255809604,123.314956906961,12.4210904414211,9.96867255809604
2021-04-11,275990,237,226168,164,49822,73,250047,174,1702874,1711,1952921,1885,2,4165,10,9118,4370,4,"East TN",2455501,119.283193124336,0.100524678460324,76.7664114166518,9.65179814628461,10.0524678460324
2021-04-12,276455,465,226491,323,49964,142,250377,330,1704636,1762,1955013,2092,3,4168,16,9134,4379,9,"East TN",2455501,121.645236552541,0.102402307657637,85.1964629621409,18.9370723123306,10.2402307657637
2021-04-13,276833,378,226731,240,50102,138,250627,250,1706693,2057,1957320,2307,3,4171,16,9150,4383,4,"East TN",2455501,119.608992217881,0.101472847203397,93.9523136011755,15.3940071700236,10.1472847203397
2021-04-14,277511,678,227231,500,50280,178,251183,556,1711513,4820,1962696,5376,0,4171,29,9179,4386,3,"East TN",2455501,121.604511665847,0.102864058087939,218.936990862557,27.6114731779788,10.2864058087939
2021-04-15,278053,542,227599,368,50454,174,251563,380,1714657,3144,1966220,3524,2,4173,24,9203,4391,5,"East TN",2455501,127.183821142814,0.105919417820376,143.51450070678,22.0728885877057,10.5919417820376
2021-04-16,279026,973,228489,890,50537,83,252670,1107,1722141,7484,1974811,8591,3,4176,32,9235,4394,3,"East TN",2455501,145.713644588212,0.113606685818752,349.867501581144,39.625314752468,11.3606685818752
2021-04-17,279228,202,228636,147,50592,55,252843,173,1724372,2231,1977215,2404,0,4176,10,9245,4395,1,"East TN",2455501,141.518981258814,0.113449711600901,97.9026276104143,8.22642711202317,11.3449711600901
2021-04-18,279447,219,228824,188,50623,31,253045,202,1726175,1803,1979220,2005,6,4182,8,9253,4404,9,"East TN",2455501,140.785933298337,0.113996729913685,81.6533978198339,8.9187501858073,11.3996729913685
2021-04-19,279774,327,229018,194,50756,133,253255,210,1727624,1449,1980879,1659,8,4190,15,9268,4411,7,"East TN",2455501,135.165898934678,0.111265754272017,67.5625870239923,13.3170379486712,11.1265754272017
2021-04-20,280127,353,229295,277,50832,76,253534,279,1730072,2448,1983606,2727,4,4194,20,9288,4415,4,"East TN",2455501,134.147776767348,0.110591189226204,111.056766012313,14.375885002694,11.0591189226204
2021-04-21,280640,513,229625,330,51015,183,253870,336,1733853,3781,1987723,4117,4,4198,15,9303,4421,6,"East TN",2455501,127.428170462973,0.107364046829424,167.664358515839,20.8918668736034,10.7364046829424
2021-04-22,281280,640,230022,397,51258,243,254316,446,1738105,4252,1992421,4698,3,4201,26,9329,4425,4,"East TN",2455501,131.419209358905,0.10507232548376,191.325517684578,26.0639274836378,10.507232548376
2021-04-23,281662,382,230299,277,51363,105,254624,308,1741306,3201,1995930,3509,0,4201,11,9340,4430,5,"East TN",2455501,107.350801323233,0.0925233202329656,142.903627406383,15.5569067167963,9.25233202329656
2021-04-24,281922,260,230487,188,51435,72,254833,209,1744301,2995,1999134,3204,0,4201,19,9359,4437,7,"East TN",2455501,109.712844751438,0.0907888133582736,130.482536964962,10.5884705402278,9.07888133582737
2021-04-25,282120,198,230634,147,51486,51,254991,158,1745950,1649,2000941,1807,4,4205,17,9376,4442,5,"East TN",2455501,108.857622130881,0.0895907186593619,73.5898702545835,8.06352756525043,8.95907186593619
2021-04-26,282509,389,230881,247,51628,142,255242,251,1747922,1972,2003164,2223,6,4211,16,9392,4450,8,"East TN",2455501,111.382565105858,0.0891631142023783,90.531423118948,15.8419809236486,8.91631142023783
2021-04-27,282896,387,231083,202,51813,185,255461,219,1750285,2363,2005746,2582,3,4214,25,9417,4456,6,"East TN",2455501,112.767211253426,0.087037037037037,105.151657441801,15.7605311502622,8.7037037037037
2021-04-28,283382,486,231427,344,51955,142,255842,381,1754412,4127,2010254,4508,6,4220,23,9440,4464,8,"East TN",2455501,111.667639312711,0.0875238560205938,183.587789212873,19.7922949328874,8.75238560205938
2021-04-29,283774,392,231706,279,52068,113,256146,304,1757343,2931,2013489,3235,1,4221,22,9462,4469,5,"East TN",2455501,101.567867412801,0.0868615910385419,131.74500845245,15.9641555837281,8.68615910385419
2021-04-30,284144,370,231934,228,52210,142,256385,239,1760607,3264,2016992,3503,0,4221,18,9480,4474,5,"East TN",2455501,101.079168772483,0.0836102934194284,142.659278086224,15.0682080764781,8.36102934194284
2021-05-01,284379,235,232116,182,52263,53,256573,188,1763097,2490,2019670,2678,-1,4220,15,9495,4475,1,"East TN",2455501,100.061046605153,0.0847292559407869,109.061246564347,9.57034837289824,8.47292559407869
2021-05-02,284554,175,232244,128,52310,47,256706,133,1764574,1477,2021280,1610,1,4221,11,9506,4479,4,"East TN",2455501,99.1243742112099,0.0843207630660308,65.5670675760262,7.1268551713072,8.43207630660308
2021-05-03,284767,213,232359,115,52408,98,256832,126,1766058,1484,2022890,1610,5,4226,17,9523,4483,4,"East TN",2455501,91.9567941532095,0.0806042786170536,65.5670675760262,8.67440086564819,8.06042786170536
2021-05-04,285086,319,232578,219,52508,100,257077,245,1768457,2399,2025534,2644,7,4233,12,9535,4491,8,"East TN",2455501,89.187501858073,0.0816656559531029,107.676600416778,12.9912388551257,8.16656559531029
2021-05-05,285550,464,232871,293,52679,171,257388,311,1772607,4150,2029995,4461,5,4238,22,9557,4496,5,"East TN",2455501,88.2915543508229,0.0783141684818398,181.673719538294,18.8963474256374,7.83141684818398
2021-05-06,285835,285,233067,196,52768,89,257619,231,1775043,2436,2032662,2667,4,4242,10,9567,4502,6,"East TN",2455501,83.9339914746522,0.0768267876701612,108.613272810722,11.6065927075574,7.68267876701612
2021-05-07,286200,365,233315,248,52885,117,257888,269,1778491,3448,2036379,3717,0,4242,15,9582,4507,5,"East TN",2455501,83.7303670411863,0.0775261773353278,151.374403838565,14.8645836430122,7.75261773353278
2021-05-08,286371,171,233418,103,52953,68,258002,114,1780385,1894,2038387,2008,0,4242,7,9589,4514,7,"East TN",2455501,81.1239742928225,0.0763477052946519,81.7755724799135,6.96395562453446,7.63477052946519
2021-05-09,286517,146,233533,115,52984,31,258134,132,1782096,1711,2040230,1843,3,4245,11,9600,4519,5,"East TN",2455501,79.9429525787202,0.0753562005277045,75.0559661755381,5.94583345720486,7.53562005277045
2021-05-10,286752,235,233669,136,53083,99,258279,145,1783612,1516,2041891,1661,7,4252,22,9622,4522,3,"East TN",2455501,80.8389000859702,0.0761538866375454,67.6440367973786,9.57034837289824,7.61538866375454
2021-05-11,287067,315,233897,228,53170,87,258523,244,1786289,2677,2044812,2921,1,4253,19,9641,4526,4,"East TN",2455501,80.6760005391975,0.0750077808901338,118.95739403079,12.828339308353,7.50077808901338
2021-05-12,287371,304,234114,217,53257,87,258774,251,1790353,4064,2049127,4315,3,4256,16,9657,4528,2,"East TN",2455501,74.1600186682881,0.0724440727576835,175.727886081089,12.3803655547279,7.24440727576835
2021-05-13,287581,210,234251,137,53330,73,258919,145,1793086,2733,2052005,2878,1,4257,9,9666,4533,5,"East TN",2455501,71.1056521662993,0.0672077754226335,117.206223902984,8.55222620556864,6.72077754226335
2021-05-14,287882,301,234470,219,53412,82,259167,248,1795771,2685,2054938,2933,1,4258,21,9687,4538,5,"East TN",2455501,68.4992594179355,0.0689153510426208,119.446092671109,12.2581908946484,6.89153510426208
2021-05-15,287990,108,234551,81,53439,27,259269,102,1797758,1987,2057027,2089,0,4258,6,9693,4542,4,"East TN",2455501,65.9335915562649,0.0679721030042919,85.0742883020614,4.39828776286387,6.79721030042919
2021-05-16,288090,100,234625,74,53465,26,259354,85,1799207,1449,2058561,1534,3,4261,4,9697,4546,4,"East TN",2455501,64.0602467683784,0.0665539250450057,62.4719761873443,4.0724886693184,6.65539250450057
2021-05-17,288288,198,234728,103,53560,95,259464,110,1800774,1567,2060238,1677,6,4267,10,9707,4553,7,"East TN",2455501,62.5534259607306,0.0645882160571211,68.2956349844696,8.06352756525043,6.45882160571211
2021-05-18,288499,211,234861,133,53638,78,259608,144,1803011,2237,2062619,2381,8,4275,23,9730,4559,6,"East TN",2455501,58.3180377446395,0.0609310945133936,96.9659552164711,8.59295109226182,6.09310945133936
2021-05-19,288717,218,235026,165,53691,53,259775,167,1806280,3269,2066055,3436,1,4276,21,9751,4562,3,"East TN",2455501,54.8156974890257,0.059132797731569,139.93071067778,8.87802529911411,5.9132797731569
2021-05-20,288893,176,235159,133,53734,43,259929,154,1820448,14168,2080377,14322,3,4279,7,9758,4567,5,"East TN",2455501,53.4310513414574,0.035598477372057,583.261827219781,7.16758005800038,3.5598477372057
2021-05-21,289056,163,235266,107,53790,56,260049,120,1822726,2278,2082775,2398,0,4279,10,9768,4570,3,"East TN",2455501,47.811016977798,0.0316844487552538,97.6582782902552,6.63815653098899,3.16844487552538
2021-05-22,289125,69,235312,46,53813,23,260110,61,1824312,1586,2084422,1647,0,4279,12,9780,4571,1,"East TN",2455501,46.2227463967638,0.0306990326701953,67.073888383674,2.8100171818297,3.06990326701953
2021-05-23,289199,74,235363,51,53836,23,260171,61,1825377,1065,2085548,1126,3,4282,5,9785,4574,3,"East TN",2455501,45.1638993427411,0.0302738355504502,45.8562224165252,3.01364161529562,3.02738355504502
2021-05-24,289359,160,235474,111,53885,49,260297,126,1827301,1924,2087598,2050,0,4282,7,9792,4578,4,"East TN",2455501,43.6163536484001,0.0304459064327485,83.4860177210272,6.51598187090944,3.04459064327485
2021-05-25,289503,144,235570,96,53933,48,260384,87,1829028,1727,2089412,1814,0,4282,9,9801,4584,6,"East TN",2455501,40.8877862399567,0.0289627887881163,73.8749444614358,5.8643836838185,2.89627887881163
2021-05-26,289689,186,235712,142,53977,44,260549,165,1831911,2883,2092460,3048,7,4289,14,9815,4589,5,"East TN",2455501,39.5845898657748,0.0293126301836773,124.129454640825,7.57482892493222,2.93126301836773
2021-05-27,289812,123,235787,75,54025,48,260687,138,1834883,2972,2095570,3110,4,4293,11,9826,4593,4,"East TN",2455501,37.4261708710361,0.0498913973540446,126.654397615802,5.00916106326163,4.98913973540446
2021-05-28,289928,116,235877,90,54051,26,260785,98,1836995,2112,2097780,2210,0,4293,9,9835,4596,3,"East TN",2455501,35.5121011964564,0.0490503165611463,90.0019995919366,4.72408685640934,4.90503165611463
2021-05-29,289979,51,235909,32,54070,19,260822,37,1838071,1076,2098893,1113,0,4293,7,9842,4599,3,"East TN",2455501,34.7790532359791,0.0492018519798217,45.3267988895138,2.07696922135238,4.92018519798217
2021-05-30,290034,55,235949,40,54085,15,260868,46,1839158,1087,2100026,1133,0,4293,7,9849,4604,5,"East TN",2455501,34.0052803888086,0.0481420085647189,46.1412966233775,2.23986876812512,4.81420085647189
2021-05-31,290114,80,236015,66,54099,14,260939,71,1840585,1427,2101524,1498,6,4299,4,9853,4609,5,"East TN",2455501,30.7472894533539,0.046100818612667,61.0058802663896,3.25799093545472,4.6100818612667
2021-06-01,290245,131,236109,94,54136,37,261033,94,1841900,1315,2102933,1409,3,4302,11,9864,4612,3,"East TN",2455501,30.2178659263425,0.0479994083277864,57.3813653506963,5.3349601568071,4.79994083277864
2021-06-02,290364,119,236180,71,54184,48,261106,73,1843879,1979,2104985,2052,1,4303,9,9873,4616,4,"East TN",2455501,27.4892985178992,0.0444710578842315,83.5674674944136,4.8462615164889,4.44710578842315
2021-06-03,290451,87,236235,55,54216,32,261225,119,1847044,3165,2108269,3284,1,4304,7,9880,4621,5,"East TN",2455501,26.0232025969446,0.0423655405937475,133.740527900416,3.54306514230701,4.23655405937475
2021-06-04,290542,91,236294,59,54248,32,261303,78,1849196,2152,2110499,2230,0,4304,7,9887,4621,0,"East TN",2455501,25.005080429615,0.0407264722069345,90.8164973258003,3.70596468907974,4.07264722069345
2021-06-05,290583,41,236320,26,54263,15,261333,30,1850579,1383,2111912,1413,-1,4303,2,9889,4626,5,"East TN",2455501,24.5978315626831,0.0392503264459636,57.544264897469,1.66972035442054,3.92503264459636
2021-06-06,290609,26,236336,16,54273,10,261352,19,1851495,916,2112847,935,-1,4302,2,9891,4629,3,"East TN",2455501,23.4168098485808,0.0377505654785118,38.077769058127,1.05884705402278,3.77505654785118
2021-06-07,290682,73,236371,35,54311,38,261404,52,1852765,1270,2114169,1322,3,4305,10,9901,4631,2,"East TN",2455501,23.1317356417285,0.036773428232503,53.8383002083892,2.97291672860243,3.6773428232503
2021-06-08,290769,87,236438,67,54331,20,261474,70,1854243,1478,2115717,1548,3,4308,4,9905,4634,3,"East TN",2455501,21.3398406272284,0.0344962453066333,63.0421246010488,3.54306514230701,3.44962453066333
2021-06-09,290817,48,236476,38,54341,10,261528,54,1856972,2729,2118500,2783,0,4308,3,9908,4637,3,"East TN",2455501,18.4483736720124,0.0312245652978172,113.337359667131,1.95479456127283,3.12245652978172
2021-06-10,290892,75,236533,57,54359,18,261594,66,1858756,1784,2120350,1850,4,4312,4,9912,4640,3,"East TN",2455501,17.9596750316941,0.0305438291532158,75.3410403823904,3.0543665019888,3.05438291532158
2021-06-11,290962,70,236579,46,54383,24,261649,55,1860241,1485,2121890,1540,2,4314,4,9916,4641,1,"East TN",2455501,17.1044524111373,0.0303748573435168,62.7163255075034,2.85074206852288,3.03748573435168
2021-06-12,290991,29,236601,22,54390,7,261680,31,1861434,1193,2123114,1224,3,4317,1,9917,4644,3,"East TN",2455501,16.6157537708191,0.0309766113194072,49.8472613124572,1.18102171410234,3.09766113194073
2021-06-13,291010,19,236615,14,54395,5,261701,21,1862277,843,2123978,864,1,4318,1,9918,4645,1,"East TN",2455501,16.3306795639668,0.0313538765609559,35.186302102911,0.773772847170496,3.13538765609559
2021-06-14,291063,53,236648,33,54415,20,261742,41,1863529,1252,2125271,1293,3,4321,3,9921,4647,2,"East TN",2455501,15.5161818301031,0.0304449648711944,52.6572784942869,2.15841899473875,3.04449648711944
2021-06-15,291151,88,236717,69,54434,19,261830,88,1865411,1882,2127241,1970,0,4321,4,9925,4651,4,"East TN",2455501,15.5569067167963,0.0308920513710517,80.2280267855725,3.58379002900019,3.08920513710517
2021-06-16,291219,68,236758,41,54461,27,261868,38,1867316,1905,2129184,1943,2,4323,8,9933,4654,3,"East TN",2455501,16.37140445066,0.0318232871583677,79.1284548448565,2.76929229513651,3.18232871583677
2021-06-17,291270,51,236796,38,54474,13,261914,46,1869667,2351,2131581,2397,1,4324,1,9934,4658,4,"East TN",2455501,15.3940071700236,0.0284925652212626,97.617553403562,2.07696922135238,2.84925652212626
2021-06-18,291332,62,236847,51,54485,11,261969,55,1871395,1728,2133364,1783,2,4326,4,9938,4660,2,"East TN",2455501,15.0682080764781,0.0278891406658532,72.6124729739471,2.52494297497741,2.78891406658532
2021-06-19,291360,28,236864,17,54496,11,261987,18,1872545,1150,2134532,1168,0,4326,5,9943,4662,2,"East TN",2455501,15.0274831897849,0.0268873708180067,47.5666676576389,1.14029682740915,2.68873708180067
2021-06-20,291385,25,236885,21,54500,4,262004,17,1873298,753,2135302,770,3,4329,2,9945,4665,3,"East TN",2455501,15.271832509944,0.0267573295655246,31.3581627537517,1.0181221673296,2.67573295655246
2021-06-21,291452,67,236925,40,54527,27,262056,52,1874569,1271,2136625,1323,6,4335,2,9947,4667,2,"East TN",2455501,15.8419809236486,0.027655451823146,53.8790250950824,2.72856740844333,2.7655451823146
2021-06-22,291545,93,236971,46,54574,47,262107,51,1875996,1427,2138103,1478,5,4340,7,9954,4671,4,"East TN",2455501,16.0456053571145,0.0255017492174553,60.1913825325259,3.78741446246611,2.55017492174554
2021-06-23,291614,69,237019,48,54595,21,262162,55,1877785,1789,2139947,1844,2,4342,5,9959,4675,4,"East TN",2455501,16.0863302438077,0.0273158041438261,75.0966910622313,2.8100171818297,2.73158041438261
2021-06-24,291697,83,237071,52,54626,31,262224,62,1879628,1843,2141852,1905,3,4345,6,9965,4676,1,"East TN",2455501,17.3895266179896,0.0301820660110992,77.5809091505155,3.38016559553427,3.01820660110992
2021-06-25,291776,79,237127,56,54649,23,262293,69,1881432,1804,2143725,1873,0,4345,3,9968,4678,2,"East TN",2455501,18.0818496917737,0.0312711128269472,76.2777127763336,3.21726604876154,3.12711128269472
2021-06-26,291811,35,237145,18,54666,17,262314,21,1882616,1184,2144930,1205,0,4345,2,9970,4680,2,"East TN",2455501,18.366923898626,0.0314483554529717,49.0734884652867,1.42537103426144,3.14483554529717
2021-06-27,291840,29,237165,20,54675,9,262338,24,1883330,714,2145668,738,2,4347,3,9973,4682,2,"East TN",2455501,18.5298234453987,0.0322207215898129,30.0549663795698,1.18102171410234,3.22207215898129
2021-06-28,291884,44,237189,24,54695,20,262363,25,1883882,552,2146245,577,4,4351,3,9976,4682,0,"East TN",2455501,17.5931510514555,0.0319126819126819,23.4982596219672,1.7918950145001,3.19126819126819
2021-06-29,292014,130,237274,85,54740,45,262458,95,1885894,2012,2148352,2107,0,4351,7,9983,4685,3,"East TN",2455501,19.0999718591033,0.0342472436335252,85.8073362625387,5.29423527011392,3.42472436335252
2021-06-30,292099,85,237337,63,54762,22,262533,75,1887538,1644,2150071,1719,3,4354,4,9987,4685,0,"East TN",2455501,19.7515700461942,0.0366455946266298,70.0060802255833,3.46161536892064,3.66455946266298
2021-07-01,292205,106,237390,53,54815,53,262598,65,1890090,2552,2152688,2617,1,4355,2,9989,4688,3,"East TN",2455501,20.6882424401375,0.0345145810262089,106.577028476063,4.3168379894775,3.45145810262089
2021-07-02,292287,82,237453,63,54834,19,262672,74,1891772,1682,2154444,1756,0,4355,3,9992,4690,2,"East TN",2455501,20.810417100217,0.0353577759119321,71.5129010332311,3.33944070884109,3.53577759119321
2021-07-03,292335,48,237489,36,54846,12,262712,40,1892858,1086,2155570,1126,1,4356,3,9995,4693,3,"East TN",2455501,21.3398406272284,0.037406015037594,45.8562224165252,1.95479456127283,3.7406015037594
2021-07-04,292362,27,237510,21,54852,6,262737,25,1893558,700,2156295,725,0,4356,1,9996,4694,1,"East TN",2455501,21.258390853842,0.0375458737178884,29.5255428525584,1.09957194071597,3.75458737178884
2021-07-05,292405,43,237534,24,54871,19,262762,25,1894040,482,2156802,507,0,4356,2,9998,4695,1,"East TN",2455501,21.2176659671489,0.037794828076158,20.6475175534443,1.75117012780691,3.7794828076158
2021-07-06,292567,162,237638,104,54929,58,262873,111,1895365,1325,2158238,1436,5,4361,6,10004,4695,0,"East TN",2455501,22.5208623413308,0.0419785555330771,58.4809372914122,6.59743164429581,4.19785555330771
2021-07-07,292710,143,237720,82,54990,61,262961,88,1896822,1457,2159783,1545,4,4365,6,10010,4697,2,"East TN",2455501,24.8829057695354,0.0440691927512356,62.9199499409693,5.82365879712531,4.40691927512356
2021-07-08,292850,140,237822,102,55028,38,263078,117,1898676,1854,2161754,1971,2,4367,3,10013,4699,2,"East TN",2455501,26.2675519171037,0.0529450694904037,80.2687516722657,5.70148413704576,5.29450694904037
2021-07-09,293013,163,237943,121,55070,42,263208,130,1900420,1744,2163628,1874,0,4367,4,10017,4701,2,"East TN",2455501,29.5662677392516,0.0583623693379791,76.3184376630268,6.63815653098899,5.83623693379791
2021-07-10,293117,104,238016,73,55101,31,263282,74,1901477,1057,2164759,1131,0,4367,13,10030,4702,1,"East TN",2455501,31.8468613940699,0.0620306888671237,46.0598468499911,4.23538821609114,6.20306888671237
2021-07-11,293165,48,238051,35,55114,13,263325,43,1902233,756,2165558,799,2,4369,7,10037,4702,0,"East TN",2455501,32.7020840146267,0.0634783547446831,32.539184467854,1.95479456127283,6.34783547446832
2021-07-12,293338,173,238168,117,55170,56,263450,125,1903599,1366,2167049,1491,1,4370,14,10051,4703,1,"East TN",2455501,37.9963192847407,0.0671416024202205,60.7208060595373,7.04540539792083,6.71416024202205
2021-07-13,293552,214,238305,137,55247,77,263595,145,1905220,1621,2168815,1766,4,4374,17,10068,4707,4,"East TN",2455501,40.1140133927862,0.0682613217358419,71.9201499001629,8.71512575234138,6.82613217358419
2021-07-14,293725,173,238441,136,55284,37,263737,142,1906781,1561,2170518,1703,0,4374,12,10080,4708,1,"East TN",2455501,41.3357599935818,0.072286911970191,69.3544820384923,7.04540539792083,7.2286911970191
2021-07-15,293945,220,238591,150,55354,70,263904,167,1908582,1801,2172486,1968,0,4374,15,10095,4708,0,"East TN",2455501,44.5937509290365,0.0769660827431979,80.1465770121861,8.95947507250048,7.69660827431979
2021-07-16,294175,230,238733,142,55442,88,264058,154,1910111,1529,2174169,1683,0,4374,10,10105,4712,4,"East TN",2455501,47.3223183374798,0.0806375106726117,68.5399843046287,9.36672393943232,8.06375106726117
2021-07-17,294321,146,238835,102,55486,44,264170,112,1911329,1218,2175499,1330,0,4374,5,10110,4714,2,"East TN",2455501,49.0327635785935,0.08268156424581,54.1640993019347,5.94583345720486,8.268156424581
2021-07-18,294465,144,238956,121,55509,23,264302,132,1912453,1124,2176755,1256,0,4374,6,10116,4716,2,"East TN",2455501,52.9423527011392,0.0872555148700545,51.1504576866391,5.8643836838185,8.72555148700545
2021-07-19,294768,303,239167,211,55601,92,264517,215,1914143,1690,2178660,1905,2,4376,14,10130,4717,1,"East TN",2455501,58.2365879712531,0.0918956162259926,77.5809091505155,12.3396406680348,9.18956162259926
2021-07-20,295124,356,239404,237,55720,119,264770,253,1915803,1660,2180573,1913,2,4378,22,10152,4719,2,"East TN",2455501,64.0195218816853,0.0999319612178942,77.906708244061,14.4980596627735,9.99319612178942
2021-07-21,295526,402,239698,294,55828,108,265079,309,1917919,2116,2182998,2425,3,4381,28,10180,4723,4,"East TN",2455501,73.3455209344244,0.107532051282051,98.7578502309712,16.37140445066,10.7532051282051
2021-07-22,296001,475,240032,334,55969,141,265447,368,1920287,2368,2185734,2736,5,4386,21,10201,4726,3,"East TN",2455501,83.7303670411863,0.116470410628019,111.423289992551,19.3443211792624,11.6470410628019
2021-07-23,296461,460,240351,319,56110,141,265780,333,1922190,1903,2187970,2236,1,4387,28,10229,4732,6,"East TN",2455501,93.0970909806186,0.124773567132816,91.0608466459594,18.7334478788646,12.4773567132816
2021-07-24,296819,358,240601,250,56218,108,266046,266,1923941,1751,2189987,2017,0,4387,21,10250,4736,4,"East TN",2455501,101.730766959574,0.129486471562673,82.1420964601521,14.5795094361599,12.9486471562673
2021-07-25,297047,228,240791,190,56256,38,266249,203,1925256,1315,2191505,1518,3,4390,17,10267,4741,5,"East TN",2455501,105.151657441801,0.132,61.8203780002533,9.28527416604595,13.2
2021-07-26,297714,667,241254,463,56460,204,266734,485,1926985,1729,2193719,2214,10,4400,36,10303,4745,4,"East TN",2455501,119.97551619812,0.147220931004715,90.1648991387094,27.1634994243537,14.7220931004715
2021-07-27,298440,726,241743,489,56697,237,267249,515,1929306,2321,2196555,2836,2,4402,28,10331,4751,6,"East TN",2455501,135.043724274598,0.155112001001126,115.49577866187,29.5662677392516,15.5112001001126
2021-07-28,299257,817,242291,548,56966,269,267863,614,1932172,2866,2200035,3480,2,4404,37,10368,4754,3,"East TN",2455501,151.94455225227,0.163409050889241,141.72260569228,33.2722324283313,16.3409050889241
2021-07-29,299946,689,242750,459,57196,230,268360,497,1934600,2428,2202960,2925,3,4407,24,10392,4758,4,"East TN",2455501,160.659678004611,0.169104841518635,119.120293577563,28.0594469316038,16.9104841518635
2021-07-30,300943,997,243498,748,57445,249,269163,803,1936403,1803,2205566,2606,4,4411,41,10433,4763,5,"East TN",2455501,182.528942158851,0.192259604455558,106.129054722438,40.6027120331044,19.2259604455558
2021-07-31,301477,534,243862,364,57615,170,269559,396,1938372,1969,2207931,2365,2,4413,32,10465,4773,10,"East TN",2455501,189.696522216851,0.195775746767722,96.3143570293801,21.7470894941603,19.5775746767722
2021-08-01,302007,530,244282,420,57725,110,270020,461,1940510,2138,2210530,2599,3,4416,28,10493,4777,4,"East TN",2455501,201.995437998193,0.198212877792378,105.843980515585,21.5841899473875,19.8212877792378
2021-08-02,302858,851,244821,539,58037,312,270557,537,1942845,2335,2213402,2872,9,4425,33,10526,4786,9,"East TN",2455501,209.488817149738,0.194228522074887,116.961874582824,34.6568785758996,19.4228522074887
2021-08-03,304196,1338,245790,969,58406,369,271573,1016,1946619,3774,2218192,4790,4,4429,41,10567,4796,10,"East TN",2455501,234.412447805967,0.19984286176457,195.072207260351,54.4898983954802,19.984286176457
2021-08-04,305283,1087,246625,835,58658,252,272459,886,1950238,3619,2222697,4505,8,4437,40,10607,4802,6,"East TN",2455501,245.408167213127,0.202806460153561,183.465614552794,44.267951835491,20.2806460153561
2021-08-05,306463,1180,247518,893,58945,287,273412,953,1954202,3964,2227614,4917,10,4447,43,10650,4809,7,"East TN",2455501,265.40408657948,0.204916037965442,200.244267870386,48.0553662979571,20.4916037965442
2021-08-06,307800,1337,248505,987,59295,350,274495,1083,1958830,4628,2233325,5711,3,4450,51,10701,4822,13,"East TN",2455501,279.250548055163,0.192081847328794,232.579827904774,54.449173508787,19.2081847328794
2021-08-07,308524,724,249030,525,59494,199,275078,583,1961832,3002,2236910,3585,0,4450,28,10729,4831,9,"East TN",2455501,286.988276526868,0.19044825563339,145.998718795065,29.4848179658652,19.044825563339
2021-08-08,309161,637,249482,452,59679,185,275603,525,1963948,2116,2239551,2641,5,4455,30,10759,4841,10,"East TN",2455501,291.345839403038,0.192377933220771,107.554425756699,25.9417528235582,19.2377933220771
2021-08-09,310534,1373,250447,965,60087,408,276613,1010,1967485,3537,2244098,4547,13,4468,67,10826,4853,12,"East TN",2455501,312.60423025688,0.197289549126922,185.176059793908,55.9152694297416,19.7289549126922
2021-08-10,311859,1325,251296,849,60563,476,277529,916,1970736,3251,2248265,4167,6,4474,49,10875,4867,14,"East TN",2455501,312.074806729869,0.198051408239949,169.700602850498,53.9604748684688,19.8051408239949
2021-08-11,313747,1888,252609,1313,61138,575,278913,1384,1976091,5355,2255004,6739,8,4482,63,10938,4887,20,"East TN",2455501,344.695440971109,0.199770947472684,274.445011425367,76.8885860767314,19.9770947472684
2021-08-12,315208,1461,253676,1067,61532,394,280073,1160,1980571,4480,2260644,5640,10,4492,45,10983,4901,14,"East TN",2455501,356.139134131894,0.201665152891311,229.688360949558,59.4990594587418,20.1665152891311
2021-08-13,316853,1645,254798,1122,62055,523,281246,1173,1985990,5419,2267236,6592,11,4503,30,11013,4925,24,"East TN",2455501,368.682399233395,0.199079944560762,268.458453081469,66.9924386102877,19.9079944560762
2021-08-14,318384,1531,255888,1090,62496,441,282447,1201,1991461,5471,2273908,6672,1,4504,27,11040,4939,14,"East TN",2455501,401.547382794794,0.199172928266393,271.716444016924,62.3498015272647,19.9172928266393
2021-08-15,319528,1144,256855,967,62673,177,283506,1059,1995268,3807,2278774,4866,11,4515,21,11061,4952,13,"East TN",2455501,422.194900348238,0.201488922315988,198.167298649033,46.5892703770025,20.1488922315988
2021-08-16,320963,1435,257774,919,63189,516,284468,962,1998327,3059,2282795,4021,17,4532,27,11088,4970,18,"East TN",2455501,424.719843323216,0.202987311677908,163.754769393293,58.440212404719,20.2987311677908
2021-08-17,322698,1735,258988,1214,63710,521,285788,1320,2003186,4859,2288974,6179,10,4542,25,11113,4987,17,"East TN",2455501,441.417046867421,0.202878970252278,251.639074877184,70.6576784126742,20.2878970252278
2021-08-18,324788,2090,260380,1392,64408,698,287265,1477,2008606,5420,2295871,6897,13,4555,32,11145,5002,15,"East TN",2455501,449.643473979445,0.204370274304451,280.87954352289,85.1150131887546,20.4370274304451
2021-08-19,327178,2390,261881,1501,65297,889,288839,1574,2018558,9952,2307397,11526,23,4578,43,11188,5024,22,"East TN",2455501,487.476893717412,0.187495989562167,469.395044025639,97.3324791967098,18.7495989562167
2021-08-20,329632,2454,263860,1979,65772,475,290950,2111,2025449,6891,2316399,9002,4,4582,37,11225,5057,33,"East TN",2455501,520.423327052198,0.197384211703924,366.605430012042,99.9388719450735,19.7384211703924
2021-08-21,332559,2927,265837,1977,66722,950,293067,2117,2034374,8925,2327441,11042,0,4582,57,11282,5081,24,"East TN",2455501,577.275268875883,0.19838230624101,449.684198866138,119.20174335095,19.838230624101
2021-08-22,334040,1481,267176,1339,66864,142,294584,1517,2039884,5510,2334468,7027,7,4589,17,11299,5100,19,"East TN",2455501,590.999555691486,0.1989083204654,286.173778793004,60.3135571926055,19.89083204654
2021-08-23,335988,1948,268305,1129,67683,819,295770,1186,2043850,3966,2339620,5152,17,4606,38,11337,5121,21,"East TN",2455501,611.89142256509,0.198891333040035,209.814616243284,79.3320792783224,19.8891333040035
2021-08-24,337963,1975,269695,1390,68268,585,297203,1433,2047629,3779,2344832,5212,15,4621,25,11362,5159,38,"East TN",2455501,621.665395371454,0.204357477890365,212.258109444875,80.4316512190384,20.4357477890365
2021-08-25,340186,2223,270908,1213,69278,1010,298447,1244,2051664,4035,2350111,5279,17,4638,39,11401,5198,39,"East TN",2455501,627.081805301647,0.206157817109145,214.986676853318,90.531423118948,20.6157817109145
2021-08-26,342839,2653,272743,1835,70096,818,300402,1955,2058509,6845,2358911,8800,24,4662,40,11441,5228,30,"East TN",2455501,637.792450501955,0.224463252708002,358.379002900019,108.043124397017,22.4463252708002
2021-08-27,345845,3006,275022,2279,70823,727,302775,2373,2065581,7072,2368356,9445,19,4681,44,11485,5250,22,"East TN",2455501,660.272587956592,0.227592047269858,384.646554817123,122.419009399711,22.7592047269858
2021-08-28,347987,2142,276562,1540,71425,602,304447,1672,2071447,5866,2375894,7538,1,4682,33,11518,5285,35,"East TN",2455501,628.303551902443,0.234866778114874,306.984195893221,87.2327072968001,23.4866778114874
2021-08-29,350321,2334,278391,1829,71930,505,306471,2024,2078440,6993,2384911,9017,9,4691,45,11563,5316,31,"East TN",2455501,663.041880251729,0.235652122197332,367.21630331244,95.0518855418915,23.5652122197332
2021-08-30,353561,3240,280807,2416,72754,824,309077,2606,2087480,9040,2396557,11646,21,4712,71,11634,5356,40,"East TN",2455501,715.658433859322,0.233714456328925,474.282030428821,131.948632885916,23.3714456328925
2021-08-31,357147,3586,283217,2410,73930,1176,311685,2608,2096065,8585,2407750,11193,7,4719,80,11714,5392,36,"East TN",2455501,781.266226322042,0.230172605613656,455.833656756809,146.039443681758,23.0172605613656
2021-09-01,358576,1429,284168,951,74408,478,312670,985,2098347,2282,2411017,3267,14,4733,32,11746,5434,42,"East TN",2455501,748.930666287654,0.233523790759531,133.048204826632,58.1958630845599,23.3523790759531
2021-09-02,360889,2313,285663,1495,75226,818,314186,1516,2102604,4257,2416790,5773,19,4752,44,11790,5464,30,"East TN",2455501,735.084204811971,0.23815200677275,235.104770879751,94.1966629213346,23.815200677275
2021-09-03,362641,1752,286888,1225,75753,527,315479,1293,2106709,4105,2422188,5398,17,4769,32,11822,5494,30,"East TN",2455501,684.015196898718,0.235993461138356,219.832938369807,71.3500014864584,23.5993461138356
2021-09-04,365896,3255,289227,2339,76669,916,318051,2572,2114754,8045,2432805,10617,3,4772,56,11878,5525,31,"East TN",2455501,729.341995788232,0.239039904412152,432.376122021534,132.559506186314,23.9039904412152
2021-09-05,370350,4454,292484,3257,77866,1197,321540,3489,2127263,12509,2448803,15998,8,4780,58,11936,5580,55,"East TN",2455501,815.678755577782,0.235851123771364,651.516737317558,181.388645331442,23.5851123771364
2021-09-06,375256,4906,296419,3935,78837,971,325828,4288,2142896,15633,2468724,19921,11,4791,102,12038,5617,37,"East TN",2455501,883.526416808627,0.232114401319162,811.280467814918,199.796294116761,23.2114401319162
2021-09-07,377330,2074,297874,1455,79456,619,327344,1516,2147321,4425,2474665,5941,34,4825,64,12102,5649,32,"East TN",2455501,821.950388128533,0.234013300455802,241.946551844206,84.4634150016636,23.4013300455802
2021-09-08,379007,1677,299050,1176,79957,501,328605,1261,2151698,4377,2480303,5638,19,4844,60,12162,5690,41,"East TN",2455501,832.050160028442,0.229988742314465,229.606911176171,68.2956349844696,22.9988742314465
2021-09-09,380917,1910,300057,1007,80860,903,329683,1078,2155363,3665,2485046,4743,8,4852,55,12217,5730,40,"East TN",2455501,815.638030691089,0.22704231129864,193.158137585772,77.7845335839814,22.704231129864
2021-09-10,386401,5484,303893,3836,82508,1648,333818,4135,2167465,12102,2501283,16237,23,4875,144,12361,5766,36,"East TN",2455501,967.623307830052,0.231860421012706,661.249985237229,223.335278625421,23.1860421012706
2021-09-11,390675,4274,306993,3100,83682,1174,337132,3314,2179283,11818,2516415,15132,8,4883,119,12480,5810,44,"East TN",2455501,1009.12196737041,0.228214328429614,616.24898544126,174.058165726668,22.8214328429614
2021-09-12,392251,1576,308414,1421,83837,155,338685,1553,2184523,5240,2523208,6793,23,4906,50,12530,5854,44,"East TN",2455501,891.915743467423,0.2304280626302,276.644155306799,64.182421428458,23.04280626302
2021-09-13,394597,2346,309861,1447,84736,899,340185,1500,2189646,5123,2529831,6623,63,4969,84,12614,5904,50,"East TN",2455501,787.660033532872,0.234948532901304,269.720924568958,95.5405841822097,23.4948532901304
2021-09-14,397406,2809,311814,1953,85592,856,342259,2074,2195866,6220,2538125,8294,43,5012,63,12677,5948,44,"East TN",2455501,817.592825252362,0.23502994011976,337.772210233268,114.396206721154,23.502994011976
2021-09-15,399200,1794,313012,1198,86188,596,343476,1217,2199641,3775,2543117,4992,23,5035,36,12713,5987,39,"East TN",2455501,822.357636995464,0.236746585156175,203.298634372375,73.0604467275721,23.6746585156175
2021-09-16,401838,2638,314863,1851,86975,787,345433,1957,2206298,6657,2551731,8614,23,5058,65,12778,6024,37,"East TN",2455501,852.005354508102,0.236185049111494,350.804173975087,107.432251096619,23.6185049111494
2021-09-17,404511,2673,316734,1871,87777,802,347435,2002,2213500,7202,2560935,9204,23,5081,82,12860,6079,55,"East TN",2455501,737.527698013562,0.228273989136995,374.831857124065,108.857622130881,22.8273989136995
2021-09-18,405958,1447,317907,1173,88051,274,348769,1334,2218972,5472,2567741,6806,3,5084,39,12899,6137,58,"East TN",2455501,622.398443331931,0.226727194794061,277.17357883381,58.9289110450372,22.6727194794061
2021-09-19,406600,642,318352,445,88248,197,349281,512,2221049,2077,2570330,2589,17,5101,25,12924,6180,43,"East TN",2455501,584.361399160497,0.224863121259709,105.436731648653,26.1453772570241,22.4863121259709
2021-09-20,408578,1978,319604,1252,88974,726,350650,1369,2226685,5636,2577335,7005,48,5149,70,12994,6224,44,"East TN",2455501,569.374640857405,0.220297238127316,285.277831285754,80.553825879118,22.0297238127316
2021-09-21,410445,1867,320704,1100,89741,767,351785,1135,2230989,4304,2582774,5439,31,5180,61,13055,6272,48,"East TN",2455501,531.011797592426,0.213353042621335,221.502658724228,76.0333634561745,21.3353042621335
2021-09-22,412037,1592,321821,1117,90216,475,353006,1221,2236345,5356,2589351,6577,14,5194,45,13100,6312,40,"East TN",2455501,522.785370480403,0.206125362287494,267.847579781071,64.8340196155489,20.6125362287494
2021-09-23,414383,2346,323327,1506,91056,840,354670,1664,2242701,6356,2597371,8020,32,5226,60,13160,6350,38,"East TN",2455501,510.893703565993,0.202388255915863,326.613591279336,95.5405841822097,20.2388255915863
2021-09-24,415920,1537,324308,981,91612,556,355768,1098,2247580,4879,2603348,5977,37,5263,40,13200,6400,50,"East TN",2455501,464.630232282536,0.196472779572301,243.412647765161,62.5941508474238,19.6472779572301
2021-09-25,416617,697,324797,489,91820,208,356330,562,2250601,3021,2606931,3583,2,5265,21,13221,6442,42,"East TN",2455501,434.086567262648,0.192931870375096,145.917269021678,28.3852460251492,19.2931870375096
2021-09-26,417477,860,325425,628,92052,232,357053,723,2254576,3975,2611629,4698,6,5271,26,13247,6478,36,"East TN",2455501,442.964592561762,0.188188575994576,191.325517684578,35.0234025561382,18.8188575994576
2021-09-27,418934,1457,326255,830,92679,627,357975,922,2258167,3591,2616142,4513,46,5317,45,13292,6512,34,"East TN",2455501,421.746926594613,0.18875460612776,183.791413646339,59.3361599119691,18.875460612776
2021-09-28,420218,1284,327036,781,93182,503,358826,851,2261827,3660,2620653,4511,14,5331,34,13326,6548,36,"East TN",2455501,398.004317652487,0.185881359064389,183.709963872953,52.2907545140483,18.5881359064389
2021-09-29,421888,1670,328040,1004,93848,666,359959,1133,2267324,5497,2627283,6630,30,5361,51,13377,6593,45,"East TN",2455501,401.180858814556,0.183301697774966,270.00599877581,68.0105607776173,18.3301697774966
2021-09-30,423097,1209,328801,761,94296,448,360779,820,2271995,4671,2632774,5491,11,5372,40,13417,6628,35,"East TN",2455501,354.876662644405,0.172555998079259,223.620352832273,49.2363880120595,17.2555998079259
2021-10-01,424463,1366,329771,970,94692,396,361851,1072,2276968,4973,2638819,6045,14,5386,47,13464,6657,29,"East TN",2455501,347.912707019871,0.171492204899777,246.181940060297,55.6301952228893,17.1492204899777
2021-10-02,425016,553,330122,351,94894,202,362246,395,2279637,2669,2641883,3064,11,5397,19,13483,6695,38,"East TN",2455501,342.048323336052,0.169260700389105,124.781052827916,22.5208623413308,16.9260700389105
2021-10-03,425555,539,330588,466,94967,73,362770,524,2282728,3091,2645498,3615,13,5410,15,13498,6728,33,"East TN",2455501,328.97563470754,0.168797425374236,147.22046539586,21.9507139276262,16.8797425374236
2021-10-04,426896,1341,331441,853,95455,488,363710,940,2286865,4137,2650575,5077,22,5432,29,13527,6751,23,"East TN",2455501,324.251547851131,0.166555339354689,206.760249741295,54.6120730555597,16.6555339354689
2021-10-05,428159,1263,332197,756,95962,507,364525,815,2291327,4462,2655852,5277,17,5449,41,13568,6791,40,"East TN",2455501,323.396325230574,0.161908008750249,214.905227079932,51.4355318934914,16.1908008750249
2021-10-06,429093,934,332902,705,96191,229,365305,780,2295748,4421,2661053,5201,18,5467,26,13594,6826,35,"East TN",2455501,293.422808624391,0.158306188925081,211.81013569125,38.0370441714339,15.8306188925081
2021-10-07,430207,1114,333693,791,96514,323,366161,856,2300529,4781,2666690,5637,24,5491,26,13620,6857,31,"East TN",2455501,289.553944388538,0.158686165821441,229.566186289478,45.367523776207,15.8686165821441
2021-10-08,431254,1047,334281,588,96973,459,366803,642,2304774,4245,2671577,4887,9,5500,31,13651,6878,21,"East TN",2455501,276.562705533413,0.151169180047622,199.02252126959,42.6389563677636,15.1169180047622
2021-10-09,431794,540,334634,353,97160,187,367219,416,2307583,2809,2674802,3225,4,5504,32,13683,6908,30,"East TN",2455501,276.033282006401,0.15106777241107,131.337759585518,21.9914388143194,15.106777241107
2021-10-10,432110,316,334898,264,97212,52,367529,310,2309815,2232,2677344,2542,6,5510,16,13699,6932,24,"East TN",2455501,266.951632273821,0.149437919989952,103.522661974074,12.8690641950461,14.9437919989952
2021-10-11,433325,1215,335436,538,97889,677,368077,548,2313261,3446,2681338,3994,52,5562,33,13732,6946,14,"East TN",2455501,261.82029655048,0.141956246139843,162.655197452577,49.4807373322186,14.1956246139843
2021-10-12,434259,934,336073,637,98186,297,369082,1005,2316905,3644,2685987,4649,29,5591,32,13764,6980,34,"East TN",2455501,248.421808828422,0.151219512195122,189.329998236612,38.0370441714339,15.1219512195122
2021-10-13,435104,845,336622,549,98482,296,369731,649,2320769,3864,2690500,4513,25,5616,37,13801,7003,23,"East TN",2455501,244.797293912729,0.15030393588481,183.791413646339,34.4125292557405,15.030393588481
2021-10-14,436051,947,337275,653,98776,294,370452,721,2324772,4003,2695224,4724,31,5647,33,13834,7035,32,"East TN",2455501,237.996237834967,0.150382000420551,192.384364738601,38.5664676984452,15.0382000420551
2021-10-15,436854,803,337788,513,99066,290,371027,575,2328665,3893,2699692,4468,24,5671,30,13864,7060,25,"East TN",2455501,228.05936548183,0.150240085363685,181.958793745146,32.7020840146267,15.0240085363685
2021-10-16,437162,308,338027,239,99135,69,371298,271,2330895,2230,2702193,2501,7,5678,12,13876,7075,15,"East TN",2455501,218.611191769012,0.148917527655069,101.852941619653,12.5432651015007,14.8917527655069
2021-10-17,437414,252,338237,210,99177,42,371546,248,2332558,1663,2704104,1911,7,5685,14,13890,7091,16,"East TN",2455501,216.004799020648,0.150112107623318,77.8252584706746,10.2626714466824,15.0112107623318
2021-10-18,438199,785,338702,465,99497,320,372060,514,2335748,3190,2707808,3704,23,5708,37,13927,7112,21,"East TN",2455501,198.493097742579,0.150472232716283,150.844980311554,31.9690360541494,15.0472232716283
2021-10-19,439030,831,339143,441,99887,390,372534,474,2339076,3328,2711610,3802,25,5733,23,13950,7128,16,"East TN",2455501,194.298434413181,0.134722710065176,154.836019207486,33.8423808420359,13.4722710065176
2021-10-20,439792,762,339632,489,100160,273,373074,540,2343097,4021,2716171,4561,15,5748,21,13971,7147,19,"East TN",2455501,190.918268817647,0.130224767247088,185.746208207612,31.0323636602062,13.0224767247088
2021-10-21,440422,630,340055,423,100367,207,373544,470,2346734,3637,2720278,4107,17,5765,21,13992,7165,18,"East TN",2455501,178.008479735907,0.123413426997685,167.257109648907,25.6566786167059,12.3413426997685
2021-10-22,440965,543,340397,342,100568,201,373930,386,2349838,3104,2723768,3490,6,5771,18,14010,7183,18,"East TN",2455501,167.420009195679,0.120576507725536,142.129854559212,22.1136134743989,12.0576507725536
2021-10-23,441321,356,340641,244,100680,112,374203,273,2352222,2384,2726425,2657,0,5771,15,14025,7203,20,"East TN",2455501,169.374803756952,0.11988279960383,108.20602394379,14.4980596627735,11.988279960383
2021-10-24,441564,243,340803,162,100761,81,374399,196,2354119,1897,2728518,2093,7,5778,14,14039,7215,12,"East TN",2455501,169.008279776714,0.116859179159499,85.2371878488341,9.89614746644371,11.6859179159499
2021-10-25,441986,422,341051,248,100935,174,374670,271,2356550,2431,2731220,2702,28,5806,21,14060,7226,11,"East TN",2455501,154.225145907088,0.11148129164531,110.038643844983,17.1859021845236,11.148129164531
2021-10-26,442511,525,341379,328,101132,197,375008,338,2359189,2639,2734197,2977,12,5818,28,14088,7237,11,"East TN",2455501,141.763330578973,0.10953203169965,121.237987685609,21.3805655139216,10.953203169965
2021-10-27,443131,620,341773,394,101358,226,375432,424,2363387,4198,2738819,4622,10,5828,21,14109,7258,21,"East TN",2455501,135.980396668541,0.104115153655952,188.230426295896,25.2494297497741,10.4115153655952
2021-10-28,443547,416,342029,256,101518,160,375723,291,2366184,2797,2741907,3088,16,5844,15,14124,7273,15,"East TN",2455501,127.2652709162,0.100744370983402,125.758450108552,16.9415528643645,10.0744370983402
2021-10-29,444006,459,342333,304,101673,155,376055,332,2369701,3517,2745756,3849,4,5848,10,14134,7290,17,"East TN",2455501,123.844380433973,0.0966436237947972,156.750088882065,18.6927229921715,9.66436237947972
2021-10-30,444269,263,342535,202,101734,61,376284,229,2372275,2574,2748559,2803,0,5848,16,14150,7305,15,"East TN",2455501,120.056965971506,0.0940182524622752,114.151857400995,10.7106452003074,9.40182524622752
2021-10-31,444440,171,342662,127,101778,44,376430,146,2373899,1624,2750329,1770,0,5848,5,14155,7316,11,"East TN",2455501,117.124774129597,0.0931181513914997,72.0830494469357,6.96395562453446,9.31181513914997
2021-11-01,445036,596,343023,361,102013,235,376820,390,2377016,3117,2753836,3507,14,5862,23,14178,7325,9,"East TN",2455501,124.210904414211,0.0950654403961797,142.822177632996,24.2720324691377,9.50654403961797
2021-11-02,445449,413,343244,221,102205,192,377047,227,2379227,2211,2756274,2438,25,5887,16,14194,7348,23,"East TN",2455501,119.649717104575,0.0923585632105812,99.2872737579826,16.819378204285,9.23585632105812
2021-11-03,446022,573,343624,380,102398,193,377441,394,2383805,4578,2761246,4972,6,5893,14,14208,7359,11,"East TN",2455501,117.735647429995,0.0895795246800731,202.484136638511,23.3353600751944,8.95795246800731
2021-11-04,446438,416,343926,302,102512,114,377771,330,2387340,3535,2765111,3865,13,5906,9,14217,7370,11,"East TN",2455501,117.735647429995,0.0882606447164282,157.401687069156,16.9415528643645,8.82606447164282
2021-11-05,446873,435,344211,285,102662,150,378095,324,2390923,3583,2769018,3907,2,5908,13,14230,7376,6,"East TN",2455501,116.758250149359,0.0876966726850658,159.11213231027,17.715325711535,8.76966726850658
2021-11-06,447106,233,344382,171,102724,62,378283,188,2393163,2240,2771446,2428,0,5908,13,14243,7384,8,"East TN",2455501,115.536503548563,0.0873421593044086,98.8800248910507,9.48889859951187,8.73421593044086
2021-11-07,447305,199,344510,128,102795,71,378437,154,2395064,1901,2773501,2055,6,5914,8,14251,7396,12,"East TN",2455501,116.676800375972,0.086613153806318,83.6896421544931,8.10425245194362,8.6613153806318
2021-11-08,447846,541,344856,346,102990,195,378822,385,2398596,3532,2777418,3917,25,5939,25,14276,7408,12,"East TN",2455501,114.436931607847,0.0848952590959206,159.519381177202,22.0321637010125,8.48952590959206
2021-11-09,448708,862,345468,612,103240,250,379617,795,2405863,7267,2785480,8062,10,5949,27,14303,7423,15,"East TN",2455501,132.722405733087,0.087995617338903,328.324036520449,35.1048523295246,8.7995617338903
2021-11-10,449333,625,345905,437,103428,188,380118,501,2411114,5251,2791232,5752,7,5956,28,14331,7435,12,"East TN",2455501,134.840099841132,0.0892749949976656,234.249548259194,25.45305418324,8.92749949976656
2021-11-11,449836,503,346288,383,103548,120,380523,405,2415402,4288,2795925,4693,5,5961,10,14341,7448,13,"East TN",2455501,138.383164983439,0.0893100538716168,191.121893251113,20.4846180066715,8.93100538716168
2021-11-12,450316,480,346609,321,103707,159,380854,331,2418852,3450,2799706,3781,2,5963,24,14365,7458,10,"East TN",2455501,140.215784884633,0.0899048488008342,153.980796586929,19.5479456127283,8.99048488008342
2021-11-13,450553,237,346751,142,103802,95,381003,149,2420850,1998,2801853,2147,4,5967,11,14376,7467,9,"East TN",2455501,140.378684431405,0.0894530864603545,87.436331730266,9.65179814628461,8.94530864603545
2021-11-14,450914,361,347067,316,103847,45,381348,345,2423828,2978,2805176,3323,1,5968,14,14390,7475,8,"East TN",2455501,146.976116075701,0.0919021310181531,135.32879848145,14.7016840962394,9.19021310181531
2021-11-15,451491,577,347358,291,104133,286,381649,301,2426595,2767,2808244,3068,26,5994,20,14410,7485,10,"East TN",2455501,148.442211996656,0.0917082981898397,124.943952374689,23.4982596219672,9.17082981898398
2021-11-16,452162,671,347790,432,104372,239,382109,460,2430202,3607,2812311,4067,24,6018,17,14427,7495,10,"East TN",2455501,140.663758638258,0.0928776415340464,165.628114181179,27.3263989711265,9.28776415340464
2021-11-17,452874,712,348256,466,104618,246,382617,508,2434847,4645,2817464,5153,5,6023,27,14454,7505,10,"East TN",2455501,144.206823780565,0.0952653247941446,209.855341129977,28.996119325547,9.52653247941446
2021-11-18,453498,624,348666,410,104832,214,383095,478,2439709,4862,2822804,5340,12,6035,19,14473,7514,9,"East TN",2455501,149.13453507044,0.0956880836340638,217.470894941603,25.4123292965468,9.56880836340638
2021-11-19,454111,613,349108,442,105003,171,383555,460,2444183,4474,2827738,4934,7,6042,13,14486,7522,8,"East TN",2455501,154.550945000633,0.0963541666666667,200.93659094417,24.9643555429218,9.63541666666667
2021-11-20,454433,322,349355,247,105078,75,383842,287,2446887,2704,2830729,2991,0,6042,14,14500,7530,8,"East TN",2455501,158.012560369554,0.0983169414046267,121.808136099313,13.1134135152052,9.83169414046267
2021-11-21,454697,264,349507,152,105190,112,384006,164,2448370,1483,2832376,1647,9,6051,11,14511,7541,11,"East TN",2455501,154.062246360315,0.0977205882352941,67.073888383674,10.7513700870006,9.77205882352941
2021-11-22,455449,752,350002,495,105447,257,384518,512,2452238,3868,2836756,4380,20,6071,38,14549,7547,6,"East TN",2455501,161.189101531622,0.100624298540965,178.375003716146,30.6251147932744,10.0624298540965
2021-11-23,456124,675,350471,469,105653,206,385006,488,2455539,3301,2840545,3789,21,6092,20,14569,7554,7,"East TN",2455501,161.352001078395,0.102606786144365,154.306595680474,27.4892985178992,10.2606786144365
2021-11-24,456860,736,351003,532,105857,204,385579,573,2459567,4028,2845146,4601,6,6098,21,14590,7564,10,"East TN",2455501,162.329398359031,0.107000939238494,187.37520367534,29.9735166061834,10.7000939238494
2021-11-25,457146,286,351161,158,105985,128,385753,174,2461203,1636,2846956,1810,1,6099,12,14602,7573,9,"East TN",2455501,148.564386656735,0.110052997681351,73.712044914663,11.6473175942506,11.0052997681351
2021-11-26,457376,230,351363,202,106013,28,385997,244,2462880,1677,2848877,1921,1,6100,15,14617,7577,4,"East TN",2455501,132.966755053246,0.115521074790671,78.2325073376065,9.36672393943232,11.5521074790671
2021-11-27,457660,284,351591,228,106069,56,386251,254,2464474,1594,2850725,1848,0,6100,14,14631,7588,11,"East TN",2455501,131.419209358905,0.120474094818964,75.259590609004,11.5658678208643,12.0474094818964
2021-11-28,457976,316,351803,212,106173,104,386468,217,2465984,1510,2852452,1727,7,6107,20,14651,7599,11,"East TN",2455501,133.53690346695,0.122633990834828,70.3318793191288,12.8690641950461,12.2633990834828
2021-11-29,459073,1097,352518,715,106555,382,387206,738,2470531,4547,2857737,5285,19,6126,36,14687,7607,8,"East TN",2455501,147.586989376099,0.128115914398742,215.231026173477,44.6752007024228,12.8115914398742
2021-11-30,459911,838,353027,509,106884,329,387713,507,2473898,3367,2861611,3874,64,6190,26,14713,7619,12,"East TN",2455501,154.225145907088,0.128500901927276,157.768211049395,34.1274550488882,12.8500901927276
2021-12-01,460994,1083,353798,771,107196,312,388521,808,2479068,5170,2867589,5978,48,6238,33,14746,7640,21,"East TN",2455501,168.356681589623,0.131087644254333,243.453372651854,44.1050522887183,13.1087644254333
2021-12-02,461897,903,354422,624,107475,279,389187,666,2483729,4661,2872916,5327,39,6277,18,14764,7657,17,"East TN",2455501,193.483936679317,0.132280431432974,216.941471414591,36.7745726839452,13.2280431432974
2021-12-03,462915,1018,355157,735,107758,283,389969,782,2488705,4976,2878674,5758,21,6298,26,14790,7670,13,"East TN",2455501,225.575147393546,0.13330201026949,234.493897579353,41.4579346536613,13.330201026949
2021-12-04,463338,423,355491,334,107847,89,390350,381,2491457,2752,2881807,3133,3,6301,29,14819,7682,12,"East TN",2455501,231.235906643899,0.131876970593913,127.591070009745,17.2266270712168,13.1876970593913
2021-12-05,463723,385,355707,216,108016,169,390581,231,2493388,1931,2883969,2162,12,6313,15,14834,7690,8,"East TN",2455501,234.045923825728,0.130500999460609,88.0472050306638,15.6790813768758,13.0500999460609
2021-12-06,464674,951,356352,645,108322,306,391271,690,2497572,4184,2888843,4874,69,6382,32,14866,7704,14,"East TN",2455501,228.100090368524,0.130682183501575,198.493097742579,38.729367245218,13.0682183501575
2021-12-07,465516,842,356884,532,108632,310,391812,541,2501048,3476,2892860,4017,8,6390,28,14894,7709,5,"East TN",2455501,228.262989915296,0.13117219751032,163.59186984652,34.2903545956609,13.117219751032
2021-12-08,466562,1046,357521,637,109041,409,392469,657,2505661,4613,2898130,5270,4,6394,29,14923,7726,17,"East TN",2455501,226.756169107649,0.129268851707541,214.62015287308,42.5982314810705,12.9268851707541
2021-12-09,467481,919,358141,620,109340,299,393136,667,2510638,4977,2903774,5644,19,6413,34,14957,7740,14,"East TN",2455501,227.407767294739,0.127973297038045,229.85126049633,37.4261708710361,12.7973297038045
2021-12-10,468277,796,358689,548,109588,248,393737,601,2515147,4509,2908884,5110,5,6418,22,14979,7754,14,"East TN",2455501,218.366842448853,0.124726911618669,208.10417100217,32.4170098077745,12.4726911618669
2021-12-11,468673,396,358975,286,109698,110,394062,325,2518068,2921,2912130,3246,0,6418,19,14998,7763,9,"East TN",2455501,217.267270508137,0.122415328298651,132.192982206075,16.1270551305009,12.2415328298651
2021-12-12,469104,431,359238,263,109866,168,394356,294,2520586,2518,2914942,2812,9,6427,18,15016,7770,7,"East TN",2455501,219.140615296023,0.121880347399348,114.518381381233,17.5524261647623,12.1880347399348
2021-12-13,469985,881,359813,575,110172,306,394959,603,2525188,4602,2920147,5205,23,6450,24,15040,7779,9,"East TN",2455501,216.2898732275,0.117812420138002,211.973035238023,35.8786251766951,11.7812420138002
2021-12-14,470745,760,360272,459,110473,301,395445,486,2529210,4022,2924655,4508,36,6486,24,15064,7787,8,"East TN",2455501,212.950432518659,0.114263248938512,183.587789212873,30.9509138868198,11.4263248938512
2021-12-15,471613,868,360861,589,110752,279,396073,628,2534012,4802,2930085,5430,19,6505,23,15087,7802,15,"East TN",2455501,205.701402687272,0.112783601940228,221.136134743989,35.3492016496837,11.2783601940228
2021-12-16,472407,794,361373,512,111034,282,396618,545,2537832,3820,2934450,4365,19,6524,22,15109,7819,17,"East TN",2455501,200.610791850624,0.113508932064154,177.764130415748,32.3355600343881,11.3508932064154
2021-12-17,473216,809,361908,535,111308,274,397203,585,2542500,4668,2939703,5253,24,6548,34,15143,7833,14,"East TN",2455501,201.140215377636,0.112463090950388,213.927829799296,32.9464333347859,11.2463090950388
2021-12-18,473786,570,362289,381,111497,189,397629,426,2545844,3344,2943473,3770,0,6548,29,15172,7846,13,"East TN",2455501,208.22634566225,0.113805315381425,153.532822833304,23.2131854151149,11.3805315381425
2021-12-19,474206,420,362569,280,111637,140,397939,310,2548505,2661,2946444,2971,6,6554,16,15188,7855,9,"East TN",2455501,207.778371908625,0.113738810234271,120.99363836545,17.1044524111373,11.3738810234271
2021-12-20,475138,932,363191,622,111947,310,398577,638,2552465,3960,2951042,4598,40,6594,31,15219,7867,12,"East TN",2455501,209.855341129977,0.117106327884771,187.25302901526,37.9555943980475,11.7106327884771
2021-12-21,476148,1010,363847,656,112301,354,399246,669,2556848,4383,2956094,5052,30,6624,29,15248,7877,10,"East TN",2455501,220.036562803273,0.120900792009924,205.742127573966,41.1321355601158,12.0900792009924
2021-12-22,477633,1485,364578,731,113055,754,399994,748,2561185,4337,2961179,5085,852,7476,40,15288,7893,16,"East TN",2455501,245.163817892968,0.126101498681418,207.086048834841,60.4764567393782,12.6101498681418
2021-12-23,478798,1165,365383,805,113415,360,400858,864,2565670,4485,2966528,5349,27,7503,35,15323,7910,17,"East TN",2455501,260.272750856139,0.132177816572106,217.837418921841,47.4444929975594,13.2177816572106
2021-12-24,479736,938,366033,650,113703,288,401566,708,2569505,3835,2971071,4543,0,7503,18,15341,7932,22,"East TN",2455501,265.52626123956,0.139090793165009,185.013160247135,38.1999437182066,13.9090793165009
2021-12-25,480216,480,366316,283,113900,197,401899,333,2571624,2119,2973523,2452,8,7511,19,15360,7940,8,"East TN",2455501,261.861021437173,0.142096505823627,99.8574221716871,19.5479456127283,14.2096505823627
2021-12-26,480559,343,366593,277,113966,66,402219,320,2573499,1875,2975718,2195,62,7573,19,15379,7957,17,"East TN",2455501,258.725205161798,0.146204823392772,89.3911262915389,13.9686361357621,14.6204823392772
2021-12-27,482433,1874,367854,1261,114579,613,403529,1310,2578251,4752,2981780,6062,64,7637,36,15415,7976,19,"East TN",2455501,297.088048426777,0.161103520072874,246.874263134081,76.3184376630268,16.1103520072874
2021-12-28,484856,2423,369297,1443,115559,980,405014,1485,2582628,4377,2987642,5862,18,7655,27,15442,7989,13,"East TN",2455501,354.632313324246,0.182832509192342,238.729285795445,98.6764004575848,18.2832509192342
2021-12-29,487740,2884,371224,1927,116516,957,407018,2004,2587917,5289,2994935,7293,37,7692,30,15472,8004,15,"East TN",2455501,411.606429808011,0.208081526247186,297.006598653391,117.450573223143,20.8081526247186
2021-12-30,490562,2822,373008,1784,117554,1038,408840,1822,2592379,4462,3001219,6284,14,7706,34,15506,8019,15,"East TN",2455501,479.087567058617,0.230088495575221,255.915187979968,114.925630248165,23.0088495575221
2021-12-31,493085,2523,374822,1814,118263,709,410787,1947,2597212,4833,3007999,6780,0,7706,25,15531,8038,19,"East TN",2455501,543.636512467313,0.24970212305026,276.114731779788,102.748889126903,24.970212305026
2022-01-01,494544,1459,376053,1231,118491,228,412126,1339,2600861,3649,3012987,4988,0,7706,34,15565,8046,8,"East TN",2455501,583.50617653994,0.259147577539023,203.135734825602,59.4176096853555,25.9147577539023
2022-01-02,496006,1462,377015,962,118991,500,413348,1222,2603877,3016,3017225,4238,6,7712,27,15592,8066,20,"East TN",2455501,629.077324749613,0.268123449056786,172.592069805714,59.539784345435,26.8123449056786
2022-01-03,498899,2893,379199,2184,119700,709,415574,2226,2608047,4170,3023621,6396,33,7745,38,15630,8080,14,"East TN",2455501,670.575984289968,0.287875528787553,260.476375289605,117.817097203381,28.7875528787553
2022-01-04,503069,4170,381655,2456,121414,1714,417964,2390,2613284,5237,3031248,7627,14,7759,43,15673,8098,18,"East TN",2455501,741.72236134296,0.29697748016328,310.608710808914,169.822777510577,29.697748016328
2022-01-05,507998,4929,385062,3407,122936,1522,421463,3499,2618518,5234,3039981,8733,15,7774,44,15717,8123,25,"East TN",2455501,825.004754630521,0.320672201749323,355.650435491576,200.732966510704,32.0672201749323
2022-01-06,513147,5149,388528,3466,124619,1683,425108,3645,2624129,5611,3049237,9256,11,7785,43,15760,8143,20,"East TN",2455501,919.771565965561,0.338789620558957,376.949551232111,209.692441583204,33.8789620558957
2022-01-07,517515,4368,391752,3224,125763,1144,428387,3279,2628813,4684,3057200,7963,12,7797,40,15800,8165,22,"East TN",2455501,994.908981914485,0.357716306579135,324.292272737824,177.886305075828,35.7716306579135
2022-01-08,520656,3141,394174,2422,126482,719,430991,2604,2633575,4762,3064566,7366,1,7798,43,15843,8185,20,"East TN",2455501,1063.40824133242,0.365749626786095,299.979515381993,127.916869103291,36.5749626786095
2022-01-09,524157,3501,396856,2682,127301,819,433890,2899,2638576,5001,3072466,7900,15,7813,42,15885,8203,18,"East TN",2455501,1146.44628529982,0.37186147969805,321.726604876154,142.577828312837,37.186147969805
2022-01-10,528795,4638,399928,3072,128867,1566,437130,3240,2643354,4778,3080484,8018,29,7842,63,15948,8236,33,"East TN",2455501,1217.51121257943,0.37908657650845,326.532141505949,188.882024482987,37.908657650845
2022-01-11,534393,5598,403966,4038,130427,1560,441264,4134,2648543,5189,3089807,9323,30,7872,50,15998,8261,25,"East TN",2455501,1275.6663507773,0.397889308219061,379.678118640554,227.977915708444,39.7889308219061
2022-01-12,540078,5685,407946,3980,132132,1705,445430,4166,2653312,4769,3098742,8935,16,7888,32,16030,8283,22,"East TN",2455501,1306.45436511734,0.407872568540358,363.876862603599,231.520980850751,40.7872568540358
2022-01-13,547402,7324,413192,5246,134210,2078,450907,5477,2660238,6926,3111145,12403,65,7953,50,16080,8299,16,"East TN",2455501,1395.03099367502,0.416731278671577,505.110769655561,298.26907014088,41.6731278671577
2022-01-14,553896,6494,417968,4776,135928,1718,455836,4929,2666117,5879,3121953,10808,68,8021,39,16119,8332,33,"East TN",2455501,1481.61210278473,0.423903139622875,440.154575379933,264.467414185537,42.3903139622875
2022-01-15,558435,4539,421353,3385,137082,1154,459449,3613,2671204,5087,3130653,8700,9,8030,38,16157,8347,15,"East TN",2455501,1538.5454943818,0.430614190385401,354.306514230701,184.850260700362,43.0614190385401
2022-01-16,562287,3852,424668,3315,137619,537,462939,3490,2675851,4647,3138790,8137,7,8037,40,16197,8365,18,"East TN",2455501,1552.83992961111,0.437986249321513,331.378403022438,156.872263542145,43.7986249321513
2022-01-17,566919,4632,427995,3327,138924,1305,466409,3470,2680586,4735,3146995,8205,15,8052,43,16240,8389,24,"East TN",2455501,1552.59558029095,0.440212897114763,334.147695317575,188.637675162828,44.0212897114763
2022-01-18,572872,5953,431670,3675,141202,2278,470146,3737,2684047,3461,3154193,7198,49,8101,48,16288,8421,32,"East TN",2455501,1567.05291506703,0.448575777342901,293.137734417538,242.435250484524,44.8575777342901
2022-01-19,581170,8298,437670,6000,143500,2298,476319,6173,2689894,5847,3166213,12020,22,8123,53,16341,8453,32,"East TN",2455501,1673.46704399632,0.457811504201805,489.513138052072,337.935109780041,45.7811504201805
2022-01-20,589458,8288,443732,6062,145726,2226,482594,6275,2695611,5717,3178205,11992,44,8167,43,16384,8487,34,"East TN",2455501,1712.72583476855,0.47251714882195,488.372841224663,337.527860913109,47.251714882195
2022-01-21,596756,7298,449343,5611,147413,1687,488476,5882,2701333,5722,3189809,11604,53,8220,31,16415,8518,31,"East TN",2455501,1745.46864366987,0.48101862768215,472.571585187707,297.210223086857,48.101862768215
2022-01-22,602754,5998,454206,4863,148548,1135,493639,5163,2707419,6086,3201058,11249,0,8220,57,16472,8545,27,"East TN",2455501,1804.88625335522,0.485618919110859,458.114250411627,244.267870385718,48.5618919110859
2022-01-23,606349,3595,457180,2974,149169,621,496784,3145,2710688,3269,3207472,6414,6,8226,31,16503,8577,32,"East TN",2455501,1794.41995747507,0.492778311639149,261.209423250082,146.405967661996,49.2778311639149
2022-01-24,613032,6683,461860,4680,151172,2003,501747,4963,2716068,5380,3217815,10343,37,8263,45,16548,8612,35,"East TN",2455501,1877.94670008279,0.498983338040102,421.217503067602,272.164417770549,49.8983338040102
2022-01-25,618731,5699,465938,4078,152793,1621,506011,4264,2720721,4653,3226732,8917,30,8293,36,16584,8641,29,"East TN",2455501,1867.60257886273,0.494423689325742,363.143814643122,232.091129264456,49.4423689325742
2022-01-26,624530,5799,470360,4422,154170,1377,510688,4677,2725614,4893,3236302,9570,26,8319,37,16621,8675,34,"East TN",2455501,1765.83108701646,0.490362253706002,389.737165653771,236.163617933774,49.0362253706002
2022-01-27,631780,7250,476128,5768,155652,1482,516829,6141,2732767,7153,3249596,13294,29,8348,52,16673,8722,47,"East TN",2455501,1723.55865462893,0.479542239217829,541.396643699188,295.255428525584,47.9542239217829
2022-01-28,636733,4953,479827,3699,156906,1254,520756,3927,2737606,4839,3258362,8766,38,8386,42,16715,8756,34,"East TN",2455501,1628.05879533342,0.470876548072294,356.994356752451,201.71036379134,47.0876548072294
2022-01-29,640795,4062,483094,3267,157701,795,524300,3544,2743035,5429,3267335,8973,5,8391,32,16747,8794,38,"East TN",2455501,1549.21541469541,0.462619008102358,365.42440829794,165.424489747713,46.2619008102358
2022-01-30,642861,2066,484603,1509,158258,557,525896,1596,2745511,2476,3271407,4072,17,8408,24,16771,8840,46,"East TN",2455501,1486.94706294153,0.455337452099789,165.831738614645,84.1376159081181,45.5337452099789
2022-01-31,646770,3909,487069,2466,159701,1443,528468,2572,2748443,2932,3276911,5504,68,8476,38,16809,8878,38,"East TN",2455501,1373.97622725464,0.452162582915933,224.149776359285,159.193582083656,45.2162582915933
2022-02-01,651724,4954,490585,3516,161139,1438,532369,3901,2753702,5259,3286071,9160,28,8504,40,16849,8910,32,"East TN",2455501,1343.63618666822,0.444193532078397,373.039962109565,201.751088678034,44.4193532078397
2022-02-02,656432,4708,494094,3509,162338,1199,536122,3753,2758601,4899,3294723,8652,21,8525,47,16896,8952,42,"East TN",2455501,1299.20533528596,0.435357148970404,352.351719669428,191.73276655151,43.5357148970404
2022-02-03,665359,8927,496772,2678,168587,6249,538949,2827,2762954,4353,3301903,7180,26,8551,41,16937,8980,28,"East TN",2455501,1367.50097027043,0.422887949987573,292.404686457061,363.551063510054,42.2887949987573
2022-02-04,668889,3530,499293,2521,169596,1009,541695,2746,2767544,4590,3309239,7336,12,8563,38,16975,9009,29,"East TN",2455501,1309.54945650602,0.411561216266682,298.757768781198,143.75885002694,41.1561216266682
2022-02-05,670565,1676,500476,1183,170089,493,543031,1336,2770166,2622,3313197,3958,3,8566,26,17001,9053,44,"East TN",2455501,1212.37987685609,0.408420914918669,161.189101531622,68.2549100977764,40.8420914918669
2022-02-06,671870,1305,501422,946,170448,359,544117,1086,2772818,2652,3316935,3738,1,8567,36,17037,9085,32,"East TN",2455501,1181.38823808257,0.400215252152522,152.229626459122,53.1459771346051,40.0215252152522
2022-02-07,674677,2807,503254,1832,171423,975,546091,1974,2775703,2885,3321794,4859,50,8617,46,17083,9117,32,"East TN",2455501,1136.50941294669,0.392643094267317,197.882224442181,114.314756947767,39.2643094267317
2022-02-08,677336,2659,504960,1706,172376,953,547980,1889,2778370,2667,3326350,4556,21,8638,43,17126,9154,37,"East TN",2455501,1043.04579798583,0.387571687479828,185.542583774146,108.287473717176,38.7571687479828
2022-02-09,680237,2901,507036,2076,173201,825,550291,2311,2782041,3671,3332332,5982,26,8664,28,17154,9187,33,"East TN",2455501,969.455927731245,0.376744928075727,243.616272198627,118.142896296927,37.6744928075727
2022-02-10,682741,2504,508814,1778,173927,726,552263,1972,2785250,3209,3337513,5181,28,8692,30,17184,9225,38,"East TN",2455501,707.879980500924,0.373883740522325,210.995637957386,101.975116279733,37.3883740522325
2022-02-11,685035,2294,510538,1724,174497,570,554160,1897,2788614,3364,3342774,5261,31,8723,41,17225,9256,31,"East TN",2455501,657.544020548149,0.371701207693455,214.253628892841,93.4228900741641,37.1701207693455
2022-02-12,685965,930,511223,685,174742,245,554940,780,2791116,2502,3346056,3282,3,8726,17,17242,9298,42,"East TN",2455501,627.163255075034,0.362427341063331,133.65907812703,37.8741446246611,36.2427341063331
2022-02-13,686541,576,511639,416,174902,160,555424,484,2792516,1400,3347940,1884,35,8761,11,17253,9321,23,"East TN",2455501,597.474812675702,0.364683115626512,76.7256865299587,23.457534735274,36.4683115626512
2022-02-14,688780,2239,513067,1428,175713,811,557043,1619,2795523,3007,3352566,4626,146,8907,26,17279,9353,32,"East TN",2455501,574.343077033974,0.355907968282855,188.393325842669,91.183021306039,35.5907968282855
2022-02-15,690670,1890,514462,1395,176208,495,558578,1535,2798388,2865,3356966,4400,37,8944,30,17309,9383,30,"East TN",2455501,543.025639166915,0.346158871178469,179.18950145001,76.9700358501178,34.6158871178469
2022-02-16,692435,1765,515696,1234,176739,531,559949,1371,2801593,3205,3361542,4576,14,8958,20,17329,9405,22,"East TN",2455501,496.762167883458,0.330640191715166,186.35708150801,71.8794250134698,33.0640191715166
2022-02-17,694205,1770,516947,1251,177258,519,561331,1382,2805115,3522,3366446,4904,13,8971,23,17352,9429,24,"East TN",2455501,466.870101050661,0.313413749006325,199.714844343374,72.0830494469357,31.3413749006325
2022-02-18,695382,1177,517671,724,177711,453,562167,836,2808080,2965,3370247,3801,8,8979,10,17362,9457,28,"East TN",2455501,421.380402614375,0.291449787063662,154.795294320792,47.9331916378776,29.1449787063662
2022-02-19,695917,535,518014,343,177903,192,562579,412,2810182,2102,3372761,2514,1,8980,15,17377,9491,34,"East TN",2455501,405.294072370567,0.286051301254447,102.382365146665,21.7878143808534,28.6051301254447
2022-02-20,696285,368,518246,232,178039,136,562851,272,2811617,1435,3374468,1707,8,8988,5,17382,9507,16,"East TN",2455501,396.823295938385,0.279968335343788,69.5173815852651,14.9867583030917,27.9968335343788
2022-02-21,697005,720,518654,408,178351,312,563296,445,2813168,1551,3376464,1996,7,8995,13,17395,9527,20,"East TN",2455501,334.962193051438,0.261653694869864,81.2868738395953,29.3219184190925,26.1653694869864
2022-02-22,698179,1174,519305,651,178874,523,564023,727,2815518,2350,3379541,3077,44,9039,23,17418,9546,19,"East TN",2455501,305.803174179119,0.241196013289037,125.310476354927,47.811016977798,24.1196013289037
2022-02-23,699039,860,519776,471,179263,389,564555,532,2818115,2597,3382670,3129,79,9118,9,17427,9574,28,"East TN",2455501,268.947151721787,0.218004543733434,127.428170462973,35.0234025561382,21.8004543733434
2022-02-24,699894,855,520263,487,179631,368,565121,566,2820617,2502,3385738,3068,50,9168,13,17440,9595,21,"East TN",2455501,231.683880397524,0.196454488907319,124.943952374689,34.8197781226723,19.6454488907319
2022-02-25,700657,763,520716,453,179941,310,565627,506,2822994,2377,3388621,2883,5,9173,24,17464,9611,16,"East TN",2455501,214.823777306546,0.188309567867639,117.409848336449,31.0730885468994,18.8309567867639
2022-02-26,700912,255,520896,180,180016,75,565844,217,2824730,1736,3390574,1953,0,9173,6,17470,9629,18,"East TN",2455501,203.420809032454,0.183293100544546,79.5357037117883,10.3848461067619,18.3293100544546
2022-02-27,700935,23,520918,22,180017,1,565874,30,2825085,355,3390959,385,4,9177,2,17472,9650,21,"East TN",2455501,189.370723123306,0.183312109635559,15.6790813768758,0.936672393943232,18.3312109635559
2022-02-28,701799,864,521376,458,180423,406,566387,513,2827772,2687,3394159,3200,27,9204,19,17491,9671,21,"East TN",2455501,195.235106807124,0.17468211359141,130.319637418189,35.186302102911,17.468211359141
2022-03-01,702561,762,521738,362,180823,400,566790,403,2829990,2218,3396780,2621,28,9232,17,17508,9687,16,"East TN",2455501,178.456453489532,0.160508150124717,106.739928022835,31.0323636602062,16.0508150124717
2022-03-02,703017,456,522001,263,181016,193,567100,310,2832303,2313,3399403,2623,8,9240,11,17519,9710,23,"East TN",2455501,162.003599265486,0.152094663240304,106.821377796222,18.5705483320919,15.2094663240304
2022-03-03,703372,355,522187,186,181185,169,567321,221,2834259,1956,3401580,2177,15,9255,11,17530,9726,16,"East TN",2455501,141.641155918894,0.138871354626941,88.6580783310616,14.4573347760803,13.8871354626941
2022-03-04,703708,336,522400,213,181308,123,567586,265,2836502,2243,3404088,2508,10,9265,10,17540,9736,10,"East TN",2455501,124.251629300904,0.126656753087218,102.138015826505,13.6835619289098,12.6656753087218
2022-03-05,703850,142,522502,102,181348,40,567702,116,2838214,1712,3405916,1828,0,9265,7,17547,9753,17,"East TN",2455501,119.649717104575,0.1211054621301,74.4450928751403,5.78293391043213,12.11054621301
2022-03-06,703949,99,522561,59,181388,40,567774,72,2839425,1211,3407199,1283,2,9267,4,17551,9763,10,"East TN",2455501,122.744808493257,0.116995073891626,52.2500296273551,4.03176378262522,11.6995073891626
2022-03-07,704211,262,522733,172,181478,90,567985,211,2841129,1704,3409114,1915,13,9280,9,17560,9774,11,"East TN",2455501,98.2284267039598,0.106853895018389,77.9881580174473,10.6699203136142,10.6853895018389
2022-03-08,704473,262,522832,99,181641,163,568108,123,2842881,1752,3410989,1875,27,9307,9,17569,9790,16,"East TN",2455501,77.8659833573678,0.0927581110563727,76.35916254972,10.6699203136142,9.27581110563727
2022-03-09,704766,293,522959,127,181807,166,568257,149,2844892,2011,3413149,2160,23,9330,7,17576,9800,10,"East TN",2455501,71.2278268263788,0.0841699403462826,87.9657552572774,11.9323918011029,8.41699403462826
2022-03-10,704952,186,523058,99,181894,87,568386,129,2846988,2096,3415374,2225,75,9405,3,17579,9809,9,"East TN",2455501,64.3453209752307,0.0772074815137016,90.6128728923344,7.57482892493222,7.72074815137016
2022-03-11,705163,211,523149,91,182014,120,568490,104,2849178,2190,3417668,2294,79,9484,5,17584,9825,16,"East TN",2455501,59.2547101385827,0.0665684830633284,93.4228900741641,8.59295109226182,6.65684830633284
2022-03-12,705232,69,523184,35,182048,34,568531,41,2850463,1285,3418994,1326,0,9484,3,17587,9834,9,"East TN",2455501,56.2817934099803,0.0633888973849212,54.001199755162,2.8100171818297,6.33888973849212
2022-03-13,705323,91,523237,53,182086,38,568601,70,2852072,1609,3420673,1679,4,9488,5,17592,9840,6,"East TN",2455501,55.9559943164348,0.0613774677156004,68.3770847578559,3.70596468907974,6.13774677156004
2022-03-14,705480,157,523320,83,182160,74,568707,106,2853157,1085,3421864,1191,69,9557,3,17595,9851,11,"East TN",2455501,51.6798812136505,0.0566274509803922,48.5033400515821,6.39380721082989,5.66274509803922
2022-03-15,705666,186,523399,79,182267,107,568798,91,2854590,1433,3423388,1524,4,9561,1,17596,9859,8,"East TN",2455501,48.5847898249685,0.0556496491652553,62.0647273204124,7.57482892493222,5.56496491652553
2022-03-16,705821,155,523491,92,182330,63,568907,109,2856157,1567,3425064,1676,10,9571,5,17601,9865,6,"East TN",2455501,42.9647554613091,0.0545530843474612,68.2549100977764,6.31235743744352,5.45530843474612
2022-03-17,705962,141,523585,94,182377,47,569022,115,2857456,1299,3426478,1414,7,9578,1,17602,9874,9,"East TN",2455501,41.1321355601158,0.0572766570605187,57.5849897841622,5.74220902373894,5.72766570605187
2022-03-18,706105,143,523673,88,182432,55,569116,94,2858947,1491,3428063,1585,2,9580,1,17603,9885,11,"East TN",2455501,38.3628432649793,0.0602212602212602,64.5489454086966,5.82365879712531,6.02212602212602
2022-03-19,706178,73,523731,58,182447,15,569182,66,2860120,1173,3429302,1239,0,9580,1,17604,9890,5,"East TN",2455501,38.5257428117521,0.0631548311990687,50.458134612855,2.97291672860243,6.31548311990687
2022-03-20,706244,66,523780,49,182464,17,569240,58,2860775,655,3430015,713,3,9583,0,17604,9896,6,"East TN",2455501,37.5076206444225,0.0684007707129094,29.0368442122402,2.68784252175014,6.84007707129094
2022-03-21,706341,97,523846,66,182495,31,569318,78,2861664,889,3430982,967,16,9599,1,17605,9902,6,"East TN",2455501,35.0641274428314,0.0670103092783505,39.3809654323089,3.95031400923885,6.70103092783505
2022-03-22,706425,84,523901,55,182524,29,569381,63,2862667,1003,3432048,1066,2,9601,5,17610,9909,7,"East TN",2455501,30.9101890001267,0.0673210161662817,43.4127292149341,3.42089048222746,6.73210161662818
2022-03-23,706520,95,523974,73,182546,22,569460,79,2864110,1443,3433570,1522,11,9612,0,17610,9919,10,"East TN",2455501,28.4666957985356,0.0650129320479661,61.983277547026,3.86886423585248,6.50129320479661
2022-03-24,706623,103,524008,34,182615,69,569503,43,2865194,1084,3434697,1127,5,9617,0,17610,9927,8,"East TN",2455501,26.9191501041946,0.0585229346635844,45.8969473032184,4.19466332939795,5.85229346635844
2022-03-25,706687,64,524054,46,182633,18,569560,57,2866648,1454,3436208,1511,0,9617,2,17612,9931,4,"East TN",2455501,23.7018840554331,0.05451197053407,61.535303793401,2.60639274836378,5.451197053407
2022-03-26,706728,41,524087,33,182641,8,569599,39,2867645,997,3437244,1036,0,9617,1,17613,9940,9,"East TN",2455501,22.3986876812512,0.0525056660790733,42.1909826141386,1.66972035442054,5.25056660790733
2022-03-27,706749,21,524102,15,182647,6,569616,17,2868091,446,3437707,463,2,9619,3,17616,9944,4,"East TN",2455501,20.5660677800579,0.0488819552782111,18.8556225389442,0.855222620556864,4.88819552782111
2022-03-28,706862,113,524151,49,182711,64,569678,62,2869513,1422,3439191,1484,30,9649,2,17618,9950,6,"East TN",2455501,21.2176659671489,0.0438543062492386,60.435731852685,4.60191219632979,4.38543062492386
2022-03-29,706976,114,524206,55,182770,59,569738,60,2870623,1110,3440361,1170,6,9655,0,17618,9961,11,"East TN",2455501,22.4394125679444,0.0429447852760736,47.6481174310253,4.64263708302298,4.29447852760736
2022-03-30,707075,99,524264,58,182811,41,569802,64,2872003,1380,3441805,1444,6,9661,4,17622,9967,6,"East TN",2455501,22.6023121147171,0.0415300546448087,58.8067363849577,4.03176378262522,4.15300546448087
2022-03-31,707159,84,524319,55,182840,29,569869,67,2873186,1183,3443055,1250,8,9669,0,17622,9968,1,"East TN",2455501,21.8285392675466,0.0437903804737976,50.90610836648,3.42089048222746,4.37903804737976
2022-04-01,707255,96,524372,53,182883,43,569932,63,2874463,1277,3444395,1340,15,9684,0,17622,9971,3,"East TN",2455501,23.1317356417285,0.0454378893367534,54.5713481688666,3.90958912254566,4.54378893367534
2022-04-02,707341,86,524398,26,182943,60,569963,31,2875265,802,3445228,833,0,9684,1,17623,9976,5,"East TN",2455501,24.9643555429218,0.0455911823647295,33.9238306154223,3.50234025561382,4.55911823647295
2022-04-03,707365,24,524410,12,182955,12,569980,17,2875745,480,3445725,497,10,9694,0,17623,9979,3,"East TN",2455501,25.0865302030013,0.0453978548266401,20.2402686865124,0.977397280636416,4.53978548266401
2022-04-04,707455,90,524461,51,182994,39,570039,59,2876753,1008,3446792,1067,51,9745,4,17627,9981,2,"East TN",2455501,24.1498578090581,0.0474937508222602,43.4534541016273,3.66523980238656,4.74937508222602
2022-04-05,707551,96,524501,40,183050,56,570088,49,2877768,1015,3447856,1064,36,9781,1,17628,9985,4,"East TN",2455501,23.4168098485808,0.0466977985323549,43.3312794415478,3.90958912254566,4.66977985323549
2022-04-06,707650,99,524555,54,183095,45,570150,62,2878935,1167,3449085,1229,0,9781,0,17628,9990,5,"East TN",2455501,23.4168098485808,0.0478021978021978,50.0508857459231,4.03176378262522,4.78021978021978
2022-04-07,707833,183,524601,46,183232,137,570204,54,2880048,1113,3450252,1167,53,9834,1,17629,9990,0,"East TN",2455501,27.448573631206,0.0465471724329582,47.5259427709457,7.45265426485267,4.65471724329582
2022-04-08,707902,69,524652,51,183250,18,570259,55,2881267,1219,3451526,1274,6,9840,0,17629,9992,2,"East TN",2455501,26.34900169049,0.0458561211611275,51.8835056471164,2.8100171818297,4.58561211611275
2022-04-09,707956,54,524682,30,183274,24,570300,41,2882128,861,3452428,902,0,9840,0,17629,9995,3,"East TN",2455501,25.0458053163082,0.0468055555555556,36.733847797252,2.19914388143194,4.68055555555556
2022-04-10,708022,66,524717,35,183305,31,570342,42,2882761,633,3453103,675,1,9841,1,17630,9996,1,"East TN",2455501,26.7562505574219,0.0490647872052047,27.4892985178992,2.68784252175014,4.90647872052047
2022-04-11,708126,104,524783,66,183343,38,570417,75,2883668,907,3454085,982,5,9846,2,17632,10000,4,"East TN",2455501,27.3263989711265,0.0518305224187577,39.9918387327067,4.23538821609114,5.18305224187577
2022-04-12,708217,91,524839,56,183378,35,570486,69,2884681,1013,3455167,1082,26,9872,2,17634,10004,4,"East TN",2455501,27.1227745376605,0.0544385173026946,44.0643274020251,3.70596468907974,5.44385173026946
2022-04-13,708341,124,524918,79,183423,45,570571,85,2885874,1193,3456445,1278,0,9872,1,17635,10008,4,"East TN",2455501,28.1408967049901,0.0572010869565217,52.0464051938891,5.04988594995482,5.72010869565217
2022-04-14,708444,103,524965,47,183479,56,570623,52,2886909,1035,3457532,1087,3,9875,0,17635,10011,3,"East TN",2455501,24.8829057695354,0.057554945054945,44.267951835491,4.19466332939795,5.7554945054945
2022-04-15,708519,75,525016,51,183503,24,570685,62,2887942,1033,3458627,1095,1,9876,1,17636,10012,1,"East TN",2455501,25.1272550896945,0.0599915504858471,44.5937509290365,3.0543665019888,5.99915504858471
2022-04-16,708578,59,525062,46,183516,13,570738,53,2888686,744,3459424,797,0,9876,1,17637,10013,1,"East TN",2455501,25.3308795231604,0.0626072041166381,32.4577346944676,2.40276831489786,6.26072041166381
2022-04-17,708616,38,525089,27,183527,11,570771,33,2889286,600,3460057,633,0,9876,0,17637,10015,2,"East TN",2455501,24.1905826957513,0.0616911130284728,25.7788532767855,1.54754569434099,6.16911130284728
2022-04-18,708847,231,525217,128,183630,103,570909,138,2890169,883,3461078,1021,-1,9875,2,17639,10015,0,"East TN",2455501,29.3626433057857,0.0703560703560704,41.5801093137409,9.4074488261255,7.03560703560704
2022-04-19,708963,116,525279,62,183684,54,570972,63,2891127,958,3462099,1021,2,9877,2,17641,10018,3,"East TN",2455501,30.3807654731153,0.0701096364685516,41.5801093137409,4.72408685640934,7.01096364685516
2022-04-20,709103,140,525370,91,183733,49,571073,101,2892557,1430,3463630,1531,8,9885,1,17642,10020,2,"East TN",2455501,31.0323636602062,0.0698677800974252,62.3498015272647,5.70148413704576,6.98677800974252
2022-04-21,709221,118,525450,80,183771,38,571161,88,2893699,1142,3464860,1230,5,9890,1,17643,10023,3,"East TN",2455501,31.643236960604,0.0734170305676856,50.0916106326163,4.80553662979571,7.34170305676856
2022-04-22,709344,123,525534,84,183810,39,571251,90,2894779,1080,3466030,1170,3,9893,0,17643,10026,3,"East TN",2455501,33.5980315218768,0.0764554910171552,47.6481174310253,5.00916106326163,7.64554910171552
2022-04-23,709419,75,525581,47,183838,28,571299,48,2895636,857,3466935,905,0,9893,0,17643,10027,1,"East TN",2455501,34.2496297089677,0.0746904540007988,36.8560224573315,3.0543665019888,7.46904540007988
2022-04-24,709490,71,525621,40,183869,31,571345,46,2896303,667,3467648,713,2,9895,1,17644,10032,5,"East TN",2455501,35.5935509698428,0.0756158608878936,29.0368442122402,2.89146695521606,7.56158608878936
2022-04-25,709679,189,525720,99,183959,90,571443,98,2897038,735,3468481,833,0,9895,5,17649,10035,3,"East TN",2455501,33.8831057287291,0.0721329190868567,33.9238306154223,7.69700358501178,7.21329190868567
2022-04-26,709854,175,525833,113,184021,62,571564,121,2898273,1235,3469837,1356,0,9895,0,17649,10040,5,"East TN",2455501,36.2858740436269,0.0765055569914707,55.2229463559575,7.1268551713072,7.65055569914707
2022-04-27,710046,192,525932,99,184114,93,571666,102,2899468,1195,3471134,1297,0,9895,2,17651,10043,3,"East TN",2455501,38.4035681516725,0.0790245202558635,52.8201780410596,7.81917824509133,7.90245202558635
2022-04-28,710198,152,526021,89,184177,63,571765,99,2900629,1161,3472394,1260,4,9899,1,17652,10048,5,"East TN",2455501,39.7882142992408,0.080169896469339,51.3133572334118,6.19018277736397,8.0169896469339
2022-04-29,710336,138,526107,86,184229,52,571857,92,2901791,1162,3473648,1254,2,9901,0,17652,10050,2,"East TN",2455501,40.3990875996385,0.0795484379102127,51.0690079132527,5.62003436365939,7.95484379102127
2022-04-30,710411,75,526163,56,184248,19,571919,62,2902521,730,3474440,792,0,9901,0,17652,10050,0,"East TN",2455501,40.3990875996385,0.0826115922718188,32.2541102610017,3.0543665019888,8.26115922718188
2022-05-01,710467,56,526196,33,184271,23,571952,33,2903014,493,3474966,526,0,9901,0,17652,10053,3,"East TN",2455501,39.7882142992408,0.0829461601530473,21.4212904006148,2.2805936548183,8.29461601530473
2022-05-02,710652,185,526325,129,184327,56,572098,146,2904040,1026,3476138,1172,6,9907,2,17654,10054,1,"East TN",2455501,39.625314752468,0.085542640720909,47.7295672044116,7.53410403823904,8.5542640720909
2022-05-03,710836,184,526433,108,184403,76,572218,120,2904987,947,3477205,1067,2,9909,1,17655,10055,1,"East TN",2455501,39.9918387327067,0.0887622149837134,43.4534541016273,7.49337915154586,8.87622149837133
2022-05-04,711099,263,526601,168,184498,95,572394,176,2906262,1275,3478656,1451,3,9912,2,17657,10055,0,"East TN",2455501,42.8833056879227,0.0967827705397501,59.09181059181,10.7106452003074,9.67827705397501
2022-05-05,711317,218,526744,143,184573,75,572545,151,2907383,1121,3479928,1272,1,9913,2,17659,10057,2,"East TN",2455501,45.5711482096729,0.103530661003451,51.80205587373,8.87802529911411,10.3530661003451
2022-05-06,711539,222,526886,142,184653,80,572698,153,2908601,1218,3481299,1371,1,9914,2,17661,10060,3,"East TN",2455501,48.9920386919003,0.109920271859888,55.8338196563553,9.04092484588685,10.9920271859888
2022-05-07,711657,118,526964,78,184693,40,572790,92,2909473,872,3482263,964,0,9914,2,17663,10061,1,"East TN",2455501,50.7432088197073,0.11133836124249,39.2587907722294,4.80553662979571,11.133836124249
2022-05-08,711767,110,527044,80,184723,30,572875,85,2910124,651,3482999,736,0,9914,1,17664,10062,1,"East TN",2455501,52.9423527011392,0.114901033237894,29.9735166061834,4.47973753625024,11.4901033237894
2022-05-09,711997,230,527174,130,184823,100,573013,138,2911106,982,3484119,1120,13,9927,2,17666,10063,1,"East TN",2455501,54.7749726023325,0.114647287307355,45.6118730963661,9.36672393943232,11.4647287307355
2022-05-10,712291,294,527344,170,184947,124,573195,182,2912618,1512,3485813,1694,9,9936,4,17670,10065,2,"East TN",2455501,59.2547101385827,0.11349907063197,68.9879580582537,11.9731166877961,11.349907063197
2022-05-11,712572,281,527540,196,185032,85,573405,210,2913703,1085,3487108,1295,1,9937,0,17670,10066,1,"East TN",2455501,59.98775809906,0.119616658778987,52.7387282676733,11.4436931607847,11.9616658778987
2022-05-12,712807,235,527704,164,185103,71,573582,177,2914979,1276,3488561,1453,2,9939,2,17672,10067,1,"East TN",2455501,60.6800811728442,0.120120467971736,59.1732603651963,9.57034837289824,12.0120467971736
2022-05-13,713086,279,527899,195,185187,84,573789,207,2916330,1351,3490119,1558,0,9939,0,17672,10069,2,"East TN",2455501,63.0013997143556,0.123696145124717,63.4493734679807,11.3622433873983,12.3696145124717
2022-05-14,713195,109,527978,79,185217,30,573872,83,2917057,727,3490929,810,0,9939,1,17673,10073,4,"East TN",2455501,62.634875734117,0.124855758135241,32.987158221479,4.43901264955706,12.4855758135241
2022-05-15,713379,184,528110,132,185269,52,574016,144,2917909,852,3491925,996,0,9939,3,17676,10076,3,"East TN",2455501,65.6485173494126,0.127828814698633,40.5619871464113,7.49337915154586,12.7828814698633
2022-05-16,713686,307,528304,194,185382,113,574214,198,2919272,1363,3493486,1561,2,9941,3,17679,10080,4,"East TN",2455501,68.7843336247878,0.128216077719654,63.5715481280602,12.5025402148075,12.8216077719654
2022-05-17,714098,412,528526,222,185572,190,574450,236,2920522,1250,3494972,1486,16,9957,0,17679,10083,3,"East TN",2455501,73.5898702545835,0.137023692542854,60.5171816260714,16.7786533175918,13.7023692542854
2022-05-18,714462,364,528748,222,185714,142,574688,238,2921911,1389,3496599,1627,7,9964,3,17682,10084,1,"East TN",2455501,76.9700358501178,0.135180697502897,66.2593906498104,14.823858756319,13.5180697502897
2022-05-19,714882,420,529026,278,185856,142,574978,290,2923337,1426,3498315,1716,31,9995,4,17686,10086,2,"East TN",2455501,84.5041398883568,0.143120770965758,69.8839055655037,17.1044524111373,14.3120770965758
2022-05-20,715319,437,529295,269,186024,168,575259,281,2924737,1400,3499996,1681,0,9995,5,17691,10087,1,"East TN",2455501,90.9386719858799,0.148830616583983,68.4585345312423,17.7967754849214,14.8830616583983
2022-05-21,715534,215,529436,141,186098,74,575413,154,2925779,1042,3501192,1196,0,9995,4,17695,10088,1,"East TN",2455501,95.2555099753574,0.150151027964533,48.7069644850481,8.75585063903456,15.0151027964533
2022-05-22,715705,171,529569,133,186136,38,575556,143,2926794,1015,3502350,1158,5,10000,5,17700,10089,1,"East TN",2455501,94.726086448346,0.147721822541966,47.1594187907071,6.96395562453446,14.7721822541966
2022-05-23,716088,383,529814,245,186274,138,575803,247,2927986,1192,3503789,1439,6,10006,4,17704,10092,3,"East TN",2455501,97.821177837028,0.154226924196836,58.6031119514918,15.5976316034895,15.4226924196836
2022-05-24,716658,570,530115,301,186543,269,576117,314,2929424,1438,3505541,1752,0,10006,3,17707,10093,1,"East TN",2455501,104.255709934551,0.15772542340808,71.3500014864584,23.2131854151149,15.772542340808
2022-05-25,717134,476,530441,326,186693,150,576470,353,2930910,1486,3507380,1839,18,10024,2,17709,10095,2,"East TN",2455501,108.816897244188,0.165290789351637,74.8930666287654,19.3850460659556,16.5290789351637
2022-05-26,717626,492,530744,303,186882,189,576786,316,2932410,1500,3509196,1816,12,10036,3,17712,10101,6,"East TN",2455501,111.749089086097,0.166161198419263,73.9563942348221,20.0366442530465,16.6161198419263
2022-05-27,718043,417,531014,270,187029,147,577063,277,2934361,1951,3511424,2228,4,10040,5,17717,10102,1,"East TN",2455501,110.934591352233,0.157857892894645,90.735047552414,16.9822777510577,15.7857892894645
2022-05-28,718327,284,531232,218,187095,66,577290,227,2935421,1060,3512711,1287,0,10040,0,17717,10104,2,"East TN",2455501,113.744608534063,0.162948172584426,52.4129291741278,11.5658678208643,16.2948172584426
2022-05-29,718579,252,531381,149,187198,103,577450,160,2936309,888,3513759,1048,0,10040,2,17719,10108,4,"East TN",2455501,117.043324356211,0.166009290910685,42.6796812544568,10.2626714466824,16.6009290910685
2022-05-30,718791,212,531523,142,187268,70,577602,152,2937020,711,3514622,863,0,10040,5,17724,10108,0,"East TN",2455501,110.079368731676,0.16606664820456,35.1455772162178,8.63367597895501,16.606664820456
2022-05-31,719309,518,531820,297,187489,221,577901,299,2937947,927,3515848,1226,2,10042,4,17728,10108,0,"East TN",2455501,107.961674623631,0.173086252061706,49.9287110858436,21.0954913070693,17.3086252061706
2022-06-01,719978,669,532215,395,187763,274,578334,433,2939311,1364,3517645,1797,1,10043,5,17733,10109,1,"East TN",2455501,115.821577755415,0.181587920116902,73.1826213876516,27.2449491977401,18.1587920116902
2022-06-02,720543,565,532603,388,187940,177,578752,418,2940847,1536,3519599,1954,0,10043,3,17736,10110,1,"East TN",2455501,118.794494484018,0.188983946938383,79.5764285984815,23.009560981649,18.8983946938383
2022-06-03,721170,627,533004,401,188166,226,579177,425,2942406,1559,3521583,1984,1,10044,4,17740,10113,3,"East TN",2455501,127.346720689586,0.20809134757358,80.798175199277,25.5345039566264,20.809134757358
2022-06-04,721479,309,533249,245,188230,64,579443,266,2943562,1156,3523005,1422,0,10044,1,17741,10115,2,"East TN",2455501,128.364842856916,0.209150961725277,57.9107888777077,12.5839899881939,20.9150961725277
2022-06-05,721813,334,533480,231,188333,103,579687,244,2944556,994,3524243,1238,3,10047,3,17744,10115,0,"East TN",2455501,131.704283565757,0.213372758489126,50.4174097261618,13.6021121555235,21.3372758489126
2022-06-06,722357,544,533787,307,188570,237,580007,320,2945648,1092,3525655,1412,0,10047,4,17748,10117,2,"East TN",2455501,145.224945947894,0.217982416387202,57.5035400107758,22.1543383610921,21.7982416387202
2022-06-07,722999,642,534141,354,188858,288,580368,361,2946701,1053,3527069,1414,3,10050,6,17754,10118,1,"East TN",2455501,150.274831897849,0.219855627840656,57.5849897841622,26.1453772570241,21.9855627840656
2022-06-08,723642,643,534564,423,189078,220,580827,459,2948314,1613,3529141,2072,0,10050,4,17758,10119,1,"East TN",2455501,149.215984843826,0.216858037578288,84.3819652282772,26.1861021437173,21.6858037578288
2022-06-09,724256,614,534965,401,189291,213,581253,426,2949803,1489,3531056,1915,10,10060,3,17761,10123,4,"East TN",2455501,151.211504291792,0.218294492450031,77.9881580174473,25.005080429615,21.8294492450031
2022-06-10,724872,616,535329,364,189543,252,581649,396,2951491,1688,3533140,2084,1,10061,2,17763,10124,1,"East TN",2455501,150.763530538167,0.213896339880592,84.8706638685955,25.0865302030013,21.3896339880592
2022-06-11,725241,369,535630,301,189611,68,581989,340,2952585,1094,3534574,1434,0,10061,6,17769,10126,2,"East TN",2455501,153.207023739758,0.220070879073386,58.3994875180259,15.0274831897849,22.0070879073386
2022-06-12,725556,315,535785,155,189771,160,582154,165,2953148,563,3535302,728,2,10063,3,17772,10131,5,"East TN",2455501,152.433250892588,0.223076227507008,29.647717512638,12.828339308353,22.3076227507008
2022-06-13,726139,583,536113,328,190026,255,582489,335,2953920,772,3536409,1107,5,10068,7,17779,10136,5,"East TN",2455501,154.021521473622,0.230797842663195,45.0824495693547,23.7426089421263,23.0797842663195
2022-06-14,726845,706,536500,387,190345,319,582908,419,2955206,1286,3538114,1705,3,10071,5,17784,10138,2,"East TN",2455501,156.627914221986,0.229968311453146,69.4359318118787,28.7517700053879,22.9968311453146
2022-06-15,727552,707,536961,461,190591,246,583397,489,2956648,1442,3540045,1931,11,10082,11,17795,10143,5,"East TN",2455501,159.234306970349,0.23569332355099,78.6397562045383,28.7924948920811,23.569332355099
2022-06-16,728221,669,537394,433,190827,236,583847,450,2957951,1303,3541798,1753,6,10088,4,17799,10145,2,"East TN",2455501,161.474175738475,0.241482033140942,71.3907263731516,27.2449491977401,24.1482033140942
2022-06-17,728804,583,537743,349,191061,234,584225,378,2959188,1237,3543413,1615,7,10095,5,17804,10150,5,"East TN",2455501,160.1302544776,0.250754404750316,65.7706920094922,23.7426089421263,25.0754404750316
2022-06-18,729157,353,538022,279,191135,74,584526,301,2960162,974,3544688,1275,0,10095,6,17810,10151,1,"East TN",2455501,159.478656290509,0.250840419220882,51.9242305338096,14.375885002694,25.0840419220882
2022-06-19,729549,392,538249,227,191300,165,584771,245,2961025,863,3545796,1108,1,10096,2,17812,10152,1,"East TN",2455501,162.614472565884,0.249380598437202,45.1231744560479,15.9641555837281,24.9380598437202
2022-06-20,730195,646,538603,354,191592,292,585139,368,2961851,826,3546990,1194,1,10097,7,17819,10155,3,"East TN",2455501,165.180140427554,0.250448917871657,48.6255147116617,26.3082768037969,25.0448917871657
2022-06-21,731038,843,539059,456,191979,387,585619,480,2962843,992,3548462,1472,1,10098,5,17824,10155,0,"East TN",2455501,170.75944990452,0.261982991882489,59.9470332123668,34.3310794823541,26.1982991882489
2022-06-22,731988,950,539708,649,192280,301,586305,686,2964426,1583,3550731,2269,0,10098,5,17829,10157,2,"East TN",2455501,180.655597370964,0.272131761182856,92.4047679068345,38.6886423585248,27.2131761182856
2022-06-23,732828,840,540245,537,192583,303,586862,557,2965824,1398,3552686,1955,1,10099,5,17834,10162,5,"East TN",2455501,187.619552995499,0.27691036002939,79.6171534851747,34.2089048222746,27.691036002939
2022-06-24,733559,731,540739,494,192820,237,587392,530,2967463,1639,3554855,2169,0,10099,9,17843,10167,5,"East TN",2455501,193.64683622609,0.276787274951932,88.3322792375161,29.7698921727175,27.6787274951932
2022-06-25,734016,457,540996,257,193020,200,587677,285,2968472,1009,3556149,1294,1,10100,2,17845,10168,1,"East TN",2455501,197.882224442181,0.274932379373528,52.6980033809801,18.6112732187851,27.4932379373528
2022-06-26,734468,452,541272,276,193196,176,587963,286,2969377,905,3557340,1191,1,10101,4,17849,10169,1,"East TN",2455501,200.325717643772,0.276507276507277,48.5033400515821,18.4076487853192,27.6507276507277
2022-06-27,735221,753,541695,423,193526,330,588400,437,2970319,942,3558719,1379,8,10109,7,17856,10171,2,"East TN",2455501,204.683280519943,0.278028817460994,56.1596187499007,30.6658396799676,27.8028817460994
2022-06-28,736199,978,542284,589,193915,389,589014,614,2971629,1310,3560643,1924,3,10112,6,17862,10174,3,"East TN",2455501,210.181140223523,0.278712749363763,78.354681997686,39.828939185934,27.8712749363763
2022-06-29,737178,979,542833,549,194345,430,589598,584,2973072,1443,3562670,2027,16,10128,5,17867,10179,5,"East TN",2455501,211.362161937625,0.27581874528855,82.549345327084,39.8696640726271,27.581874528855
2022-06-30,738076,898,543338,505,194738,393,590141,543,2974498,1426,3564639,1969,2,10130,5,17872,10183,4,"East TN",2455501,213.72420536583,0.274324437379737,80.1873018988793,36.5709482504792,27.4324437379737
2022-07-01,738894,818,543851,513,195043,305,590669,528,2975992,1494,3566661,2022,1,10131,7,17879,10186,3,"East TN",2455501,217.267270508137,0.277570726749111,82.345720893618,33.3129573150245,27.7570726749111
2022-07-02,739382,488,544149,298,195233,190,590994,325,2976970,978,3567964,1303,0,10131,3,17882,10192,6,"East TN",2455501,218.529741995625,0.280744815911976,53.0645273612188,19.8737447062738,28.0744815911976
2022-07-03,739937,555,544484,335,195453,220,591349,355,2977908,938,3569257,1293,0,10131,3,17885,10195,3,"East TN",2455501,222.724405325023,0.284131912394059,52.6572784942869,22.6023121147171,28.4131912394059
2022-07-04,740358,421,544744,260,195614,161,591620,271,2978554,646,3570174,917,1,10132,4,17889,10199,4,"East TN",2455501,209.203742942886,0.281099956350938,37.3447210976497,17.1451772978305,28.1099956350938
2022-07-05,741249,891,545316,572,195933,319,592194,574,2979391,837,3571585,1411,2,10134,7,17896,10203,4,"East TN",2455501,205.660677800579,0.290623286419302,57.4628151240826,36.2858740436269,29.0623286419302
2022-07-06,742405,1156,546040,724,196365,432,592936,742,2980729,1338,3573665,2080,14,10148,15,17911,10207,4,"East TN",2455501,212.868982745273,0.303592542064575,84.7077643218227,47.0779690173207,30.3592542064575
2022-07-07,743461,1056,546637,597,196824,459,593555,619,2982249,1520,3575804,2139,0,10148,8,17919,10218,11,"East TN",2455501,219.303514842796,0.305776981639051,87.1105326367206,43.0054803480023,30.5776981639051
2022-07-08,744531,1070,547306,669,197225,401,594268,713,2984043,1794,3578311,2507,3,10151,7,17926,10222,4,"East TN",2455501,229.566186289478,0.308927038626609,102.097290939812,43.5756287617069,30.8927038626609
2022-07-09,745151,620,547647,341,197504,279,594614,346,2984815,772,3579429,1118,0,10151,3,17929,10225,3,"East TN",2455501,234.941871332978,0.31574356737898,45.5304233229797,25.2494297497741,31.574356737898
2022-07-10,745551,400,547855,208,197696,192,594824,210,2985426,611,3580250,821,2,10153,5,17934,10232,7,"East TN",2455501,228.629513895535,0.316110251978532,33.4351319751041,16.2899546772736,31.6110251978532
2022-07-11,746737,1186,548517,662,198220,524,595520,696,2986856,1430,3582376,2126,6,10159,12,17946,10233,1,"East TN",2455501,259.784052215821,0.319619734469759,86.5811091097092,48.2997156181162,31.9619734469759
2022-07-12,747914,1177,549183,666,198731,511,596224,704,2988301,1445,3584525,2149,21,10180,6,17952,10238,5,"East TN",2455501,271.431369810071,0.311437403400309,87.5177815036524,47.9331916378776,31.1437403400309
2022-07-13,749213,1299,549964,781,199249,518,597040,816,2989880,1579,3586920,2395,1,10181,7,17959,10244,6,"East TN",2455501,277.255028607197,0.3096190116937,97.5361036301757,52.901627814446,30.96190116937
2022-07-14,750313,1100,550607,643,199706,457,597711,671,2991231,1351,3588942,2022,1,10182,8,17967,10250,6,"East TN",2455501,279.046923621697,0.316334297457756,82.345720893618,44.7973753625024,31.6334297457756
2022-07-15,751369,1056,551248,641,200121,415,598372,661,2992794,1563,3591166,2224,0,10182,15,17982,10256,6,"East TN",2455501,278.476775207992,0.319253208868145,90.5721480056412,43.0054803480023,31.9253208868145
2022-07-16,751918,549,551550,302,200368,247,598686,314,2993513,719,3592199,1033,1,10183,6,17988,10266,10,"East TN",2455501,275.585308252776,0.318872357086922,42.0688079540591,22.357962794558,31.8872357086922
2022-07-17,752274,356,551809,259,200465,97,598961,275,2994088,575,3593049,850,1,10184,4,17992,10273,7,"East TN",2455501,273.793413238276,0.32322837721697,34.6161536892064,14.4980596627735,32.322837721697
2022-07-18,753864,1590,552661,852,201203,738,599882,921,2995701,1613,3595583,2534,5,10189,9,18001,10277,4,"East TN",2455501,290.246267462322,0.330279397289316,103.196862880528,64.7525698421626,33.0279397289316
2022-07-19,755250,1386,553469,808,201781,578,600709,827,2997055,1354,3597764,2181,17,10206,17,18018,10285,8,"East TN",2455501,298.757768781198,0.33877181055971,88.8209778778343,56.444692956753,33.877181055971
2022-07-20,756494,1244,554211,742,202283,502,601477,768,2998542,1487,3600019,2255,14,10220,14,18032,10288,3,"East TN",2455501,296.517900013073,0.338728147186808,91.8346194931299,50.6617590463209,33.8728147186808
2022-07-21,757850,1356,555054,843,202796,513,602370,893,3000211,1669,3602581,2562,2,10222,11,18043,10298,10,"East TN",2455501,306.943471006528,0.341593958501356,104.337159707937,55.2229463559575,34.1593958501356
2022-07-22,759223,1373,555874,820,203349,553,603221,851,3001721,1510,3604942,2361,0,10222,5,18048,10304,6,"East TN",2455501,319.853260088267,0.351988966318235,96.1514574826074,55.9152694297416,35.1988966318235
2022-07-23,759737,514,556199,325,203538,189,603565,344,3002518,797,3606083,1141,0,10222,6,18054,10306,2,"East TN",2455501,318.427889054006,0.351411696917315,46.4670957169229,20.9325917602966,35.1411696917315
2022-07-24,760334,597,556626,427,203708,170,604009,444,3003398,880,3607407,1324,0,10222,8,18062,10311,5,"East TN",2455501,328.242586747063,0.351581000139295,53.9197499817756,24.3127573558308,35.1581000139295
2022-07-25,761731,1397,557398,772,204333,625,604829,820,3004636,1238,3609465,2058,3,10225,9,18071,10314,3,"East TN",2455501,320.382683615278,0.356360754934447,83.8118168145727,56.892666710378,35.6360754934447
2022-07-26,763265,1534,558417,1019,204848,515,605883,1054,3006074,1438,3611957,2492,9,10234,13,18084,10324,10,"East TN",2455501,326.40996684587,0.364545902909885,101.486417639415,62.4719761873443,36.4545902909885
2022-07-27,764426,1161,559128,711,205298,450,606629,746,3007362,1288,3613991,2034,10,10244,4,18088,10325,1,"East TN",2455501,323.029801250335,0.3687374749499,82.8344195339362,47.2815934507866,36.87374749499
2022-07-28,765820,1394,560047,919,205773,475,607596,967,3008992,1630,3616588,2597,10,10254,6,18094,10329,4,"East TN",2455501,324.577346944676,0.373099164703363,105.762530742199,56.7704920502985,37.3099164703363
2022-07-29,766984,1164,560860,813,206124,351,608439,843,3010433,1441,3618872,2284,0,10254,14,18108,10335,6,"East TN",2455501,316.065845625801,0.374587221823403,93.0156412072322,47.4037681108662,37.4587221823403
2022-07-30,767543,559,561267,407,206276,152,608881,442,3011418,985,3620299,1427,0,10254,4,18112,10339,4,"East TN",2455501,317.898465526994,0.373944850872257,58.1144133111736,22.7652116614899,37.3944850872257
2022-07-31,768123,580,561659,392,206464,188,609309,428,3012196,778,3621505,1206,0,10254,7,18119,10345,6,"East TN",2455501,317.20614245321,0.37593984962406,49.1142133519799,23.6204342820467,37.593984962406
2022-08-01,769132,1009,562213,554,206919,455,609903,594,3012974,778,3622877,1372,9,10263,8,18127,10348,3,"East TN",2455501,301.404886416255,0.378317924246943,55.8745445430484,41.0914106734227,37.8317924246943
2022-08-02,770643,1511,563174,961,207469,550,610902,999,3014602,1628,3625504,2627,12,10275,12,18139,10350,2,"East TN",2455501,300.468214022312,0.370487930907212,106.984277342994,61.535303793401,37.0487930907212
2022-08-03,771802,1159,563940,766,207862,393,611705,803,3016146,1544,3627851,2347,1,10276,6,18145,10360,10,"East TN",2455501,300.386764248925,0.366233766233766,95.5813090689028,47.2001436774003,36.6233766233766
2022-08-04,773048,1246,564771,831,208277,415,612575,870,3017578,1432,3630153,2302,8,10284,10,18155,10370,10,"East TN",2455501,294.359481018334,0.367047548838924,93.7486891677096,50.7432088197073,36.7047548838924
2022-08-05,774225,1177,565529,758,208696,419,613362,787,3019075,1497,3632437,2284,6,10290,4,18159,10377,7,"East TN",2455501,294.888904545345,0.362919277552525,93.0156412072322,47.9331916378776,36.2919277552525
2022-08-06,774707,482,565861,332,208846,150,613718,356,3019719,644,3633437,1000,0,10290,3,18162,10382,5,"East TN",2455501,291.75308826997,0.368168671030598,40.724886693184,19.6293953861147,36.8168671030598
2022-08-07,775068,361,566121,260,208947,101,613988,270,3020327,608,3634315,878,3,10293,4,18166,10389,7,"East TN",2455501,282.834338084163,0.365261514441842,35.7564505166156,14.7016840962394,36.5261514441842
2022-08-08,776351,1283,566886,765,209465,518,614785,797,3021474,1147,3636259,1944,5,10298,9,18175,10395,6,"East TN",2455501,293.992957038095,0.364818412793304,79.1691797315497,52.2500296273551,36.4818412793304
2022-08-09,777871,1520,567915,1029,209956,491,615864,1079,3023164,1690,3639028,2769,19,10317,9,18184,10403,8,"East TN",2455501,294.359481018334,0.366903283052351,112.767211253426,61.9018277736397,36.6903283052351
2022-08-10,779138,1267,568759,844,210379,423,616746,882,3024682,1518,3641428,2400,14,10331,10,18194,10406,3,"East TN",2455501,298.757768781198,0.371289681078294,97.7397280636416,51.5984314402641,37.1289681078294
2022-08-11,780209,1071,569491,732,210718,339,617505,759,3025806,1124,3643311,1883,2,10333,4,18198,10412,6,"East TN",2455501,291.630913609891,0.374677002583979,76.6849616432655,43.6163536484001,37.4677002583979
2022-08-12,781517,1308,570349,858,211168,450,618395,890,3027604,1798,3645999,2688,1,10334,12,18210,10416,4,"East TN",2455501,296.965873766698,0.371110455685002,109.468495431279,53.2681517946847,37.1110455685002
2022-08-13,782078,561,570766,417,211312,144,618854,459,3028541,937,3647395,1396,0,10334,3,18213,10426,10,"East TN",2455501,300.183139815459,0.367961025934948,56.8519418236849,22.8466614348762,36.7961025934948
2022-08-14,782586,508,571158,392,211428,116,619269,415,3029280,739,3648549,1154,1,10335,4,18217,10431,5,"East TN",2455501,306.169698159357,0.371013067303639,46.9965192439343,20.6882424401375,37.1013067303639
2022-08-15,784191,1605,572111,953,212080,652,620246,977,3030399,1119,3650645,2096,8,10343,10,18227,10443,12,"East TN",2455501,319.283111674563,0.379605171694703,85.3593625089137,65.3634431425603,37.9605171694703
2022-08-16,785725,1534,573119,1008,212606,526,621300,1054,3031992,1593,3653292,2647,19,10362,11,18238,10446,3,"East TN",2455501,319.853260088267,0.381099270891755,107.798775076858,62.4719761873443,38.1099270891755
2022-08-17,787052,1327,573990,871,213062,456,622216,916,3033680,1688,3655896,2604,16,10378,12,18250,10454,8,"East TN",2455501,322.296753289858,0.378075753386785,106.047604949051,54.0419246418552,37.8075753386785
2022-08-18,791852,4800,574997,1007,216855,3793,623252,1036,3035540,1860,3658792,2896,0,10378,10,18260,10459,5,"East TN",2455501,474.159855768741,0.37122924875654,117.939271863461,195.479456127283,37.122924875654
2022-08-19,793208,1356,575822,825,217386,531,624100,848,3037283,1743,3661383,2591,2,10380,7,18267,10464,5,"East TN",2455501,476.114650330014,0.370839833593344,105.51818142204,55.2229463559575,37.0839833593344
2022-08-20,793644,436,576160,338,217484,98,624459,359,3038120,837,3662579,1196,0,10380,5,18272,10473,9,"East TN",2455501,471.024039493366,0.36913856691254,48.7069644850481,17.7560505982282,36.913856691254
2022-08-21,794308,664,576659,499,217649,165,625001,542,3039284,1164,3664285,1706,1,10381,5,18277,10479,6,"East TN",2455501,477.377121817503,0.364260294865277,69.4766566985719,27.0413247642742,36.4260294865277
2022-08-22,795878,1570,577485,826,218393,744,625846,845,3040735,1451,3666581,2296,1,10382,4,18281,10482,3,"East TN",2455501,475.951750783241,0.35140562248996,93.5043398475505,63.9380721082989,35.140562248996
2022-08-23,797757,1879,578581,1096,219176,783,627017,1171,3042998,2263,3670015,3434,20,10402,13,18294,10484,2,"East TN",2455501,490.00183669239,0.341864497996771,139.849260904394,76.5220620964927,34.1864497996771
2022-08-24,799531,1774,579546,965,219985,809,628003,986,3045061,2063,3673064,3049,6,10408,12,18306,10490,6,"East TN",2455501,508.205861044243,0.337080615097856,124.170179527518,72.2459489937084,33.7080615097857
2022-08-25,800962,1431,580364,818,220598,613,628861,858,3047033,1972,3675894,2830,15,10423,7,18313,10495,5,"East TN",2455501,371.003717774906,0.327973336451877,115.251429341711,58.2773128579463,32.7973336451877
2022-08-26,802187,1225,581107,743,221080,482,629645,784,3048950,1917,3678595,2701,5,10428,4,18317,10499,4,"East TN",2455501,365.668757618099,0.322158958865908,109.99791895829,49.8879861991504,32.2158958865908
2022-08-27,802899,712,581486,379,221413,333,630046,401,3050109,1159,3680155,1560,0,10428,4,18321,10502,3,"East TN",2455501,376.908826345418,0.317876649977242,63.530823241367,28.996119325547,31.7876649977242
2022-08-28,803397,498,581799,313,221598,185,630387,341,3050918,809,3681305,1150,3,10431,7,18328,10510,8,"East TN",2455501,370.148495154349,0.316451233842538,46.8336196971616,20.2809935732056,31.6451233842538
2022-08-29,804474,1077,582325,526,222149,551,630940,553,3051949,1031,3682889,1584,3,10434,7,18335,10519,9,"East TN",2455501,350.07112601461,0.312362030905077,64.5082205220035,43.8607029685592,31.2362030905077
2022-08-30,805741,1267,583048,723,222693,544,631696,756,3053390,1441,3685086,2197,19,10453,7,18342,10524,5,"East TN",2455501,325.147495358381,0.310463804657952,89.4725760649252,51.5984314402641,31.0463804657952
2022-08-31,807042,1301,583837,789,223205,512,632525,829,3055247,1857,3687772,2686,3,10456,4,18346,10530,6,"East TN",2455501,305.884623952505,0.307451726951319,109.387045657892,52.9830775878324,30.7451726951319
2022-09-01,808083,1041,584420,583,223663,458,633150,625,3056689,1442,3689839,2067,11,10467,6,18352,10535,5,"East TN",2455501,290.001918142163,0.307565435640014,84.1783407948113,42.3946070476045,30.7565435640014
2022-09-02,809059,976,585053,633,224006,343,633808,658,3058429,1740,3692237,2398,2,10469,7,18359,10540,5,"East TN",2455501,279.86142135556,0.305160533646093,97.6582782902552,39.7474894125476,30.5160533646093
2022-09-03,809540,481,585313,260,224227,221,634088,280,3059357,928,3693445,1208,0,10469,1,18360,10546,6,"East TN",2455501,270.453972529435,0.304138449962378,49.1956631253663,19.5886704994215,30.4138449962378
2022-09-04,809950,410,585523,210,224427,200,634303,215,3060075,718,3694378,933,0,10469,3,18363,10553,7,"East TN",2455501,266.870182500435,0.299548688135853,37.9963192847407,16.6972035442054,29.9548688135853
2022-09-05,810246,296,585661,138,224585,158,634453,150,3060604,529,3695057,679,2,10471,8,18371,10557,4,"East TN",2455501,235.064045993058,0.28870808678501,27.6521980646719,12.0545664611825,28.870808678501
2022-09-06,811169,923,586157,496,225012,427,634956,503,3061607,1003,3696563,1506,2,10473,13,18384,10562,5,"East TN",2455501,221.054684970603,0.284046353576719,61.3316793599351,37.5890704178088,28.4046353576719
2022-09-07,812106,937,586651,494,225455,443,635487,531,3062927,1320,3698414,1851,2,10475,16,18400,10571,9,"East TN",2455501,206.230826214284,0.278331140763014,75.3817652690836,38.1592188315134,27.8331140763014
2022-09-08,813038,932,587164,513,225874,419,636020,533,3064426,1499,3700446,2032,2,10477,13,18413,10573,2,"East TN",2455501,201.791813564727,0.27057603469407,82.7529697605499,37.9555943980475,27.057603469407
2022-09-09,813711,673,587531,367,226180,306,636418,398,3065832,1406,3702250,1804,0,10477,5,18418,10580,7,"East TN",2455501,189.452172896692,0.260661140517327,73.4676955945039,27.4078487445128,26.0661140517327
2022-09-10,814032,321,587732,201,226300,120,636635,217,3066674,842,3703309,1059,0,10477,1,18419,10585,5,"East TN",2455501,182.936191025783,0.258211678832117,43.1276550080819,13.0726886285121,25.8211678832117
2022-09-11,814298,266,587863,131,226435,135,636776,141,3067248,574,3704024,715,0,10477,9,18428,10589,4,"East TN",2455501,177.071807341964,0.256375699771926,29.1182939856266,10.8328198603869,25.6375699771926
2022-09-12,814922,624,588168,305,226754,319,637107,331,3068105,857,3705212,1188,6,10483,7,18435,10592,3,"East TN",2455501,190.429570177328,0.261349089118661,48.3811653915026,25.4123292965468,26.1349089118661
2022-09-13,815591,669,588552,384,227039,285,637512,405,3069293,1188,3706805,1593,2,10485,11,18446,10595,3,"East TN",2455501,180.08544895726,0.249560632688928,64.8747445022421,27.2449491977401,24.9560632688928
2022-09-14,816186,595,588875,323,227311,272,637860,348,3070544,1251,3708404,1599,15,10500,9,18455,10598,3,"East TN",2455501,166.157537708191,0.237537537537538,65.1190938224012,24.2313075824445,23.7537537537538
2022-09-15,816856,670,589265,390,227591,280,638274,414,3071891,1347,3710165,1761,20,10520,4,18459,10603,5,"East TN",2455501,155.487617394577,0.231916863874884,71.716525466697,27.2856740844333,23.1916863874884
2022-09-16,817375,519,589484,219,227891,300,638512,238,3073272,1381,3711784,1619,3,10523,4,18463,10605,2,"East TN",2455501,149.215984843826,0.219634990560101,65.9335915562649,21.1362161937625,21.9634990560101
2022-09-17,817579,204,589592,108,227987,96,638629,117,3073939,667,3712568,784,0,10523,3,18466,10611,6,"East TN",2455501,144.451173100724,0.215358030024841,31.9283111674563,8.30787688540954,21.5358030024841
2022-09-18,817779,200,589700,108,228079,92,638747,118,3074520,581,3713267,699,2,10525,4,18470,10618,7,"East TN",2455501,141.763330578973,0.213242453748783,28.4666957985356,8.1449773386368,21.3242453748783
2022-09-19,818373,594,590002,302,228371,292,639067,320,3075445,925,3714512,1245,5,10530,6,18476,10624,6,"East TN",2455501,140.541583978178,0.210752688172043,50.7024839330141,24.1905826957513,21.0752688172043
2022-09-20,818886,513,590308,306,228578,207,639387,320,3076499,1054,3715886,1374,4,10534,4,18480,10634,10,"East TN",2455501,134.188501654041,0.206475057813016,55.9559943164348,20.8918668736034,20.6475057813016
2022-09-21,819471,585,590672,364,228799,221,639778,391,3077655,1156,3717433,1547,28,10562,4,18484,10638,4,"East TN",2455501,133.781252787109,0.212426625318418,63.0013997143556,23.8240587155126,21.2426625318418
2022-09-22,820049,578,591073,401,228976,177,640199,421,3078971,1316,3719170,1737,13,10575,5,18489,10639,1,"East TN",2455501,130.034563211337,0.21377012770683,70.7391281860606,23.5389845086603,21.377012770683
2022-09-23,820512,463,591372,299,229140,164,640526,327,3080101,1130,3720627,1457,11,10586,1,18490,10645,6,"East TN",2455501,127.753969556518,0.227750763315617,59.3361599119691,18.8556225389442,22.7750763315617
2022-09-24,820617,105,591452,80,229165,25,640617,91,3080776,675,3721393,766,0,10586,0,18490,10648,3,"East TN",2455501,123.722205773893,0.225269121813031,31.1952632069789,4.27611310278432,22.5269121813031
2022-09-25,820818,201,591572,120,229246,81,640747,130,3081668,892,3722415,1022,0,10586,0,18490,10650,2,"East TN",2455501,123.762930660586,0.218627022299956,41.620834200434,8.18570222532998,21.8627022299956
2022-09-26,821160,342,591714,142,229446,200,640901,154,3082360,692,3723261,846,2,10588,1,18491,10654,4,"East TN",2455501,113.500259213904,0.20962395702366,34.4532541424337,13.9279112490689,20.962395702366
2022-09-27,821614,454,591968,254,229646,200,641176,275,3083482,1122,3724658,1397,3,10591,3,18494,10654,0,"East TN",2455501,111.097490899006,0.203944368445052,56.892666710378,18.4890985587055,20.3944368445052
2022-09-28,822067,453,592182,214,229885,239,641403,227,3084802,1320,3726205,1547,16,10607,1,18495,10654,0,"East TN",2455501,105.721805855506,0.185248518011856,63.0013997143556,18.4483736720124,18.5248518011856
2022-09-29,822473,406,592382,200,230091,206,641610,207,3085914,1112,3727524,1319,2,10609,1,18496,10657,3,"East TN",2455501,98.717125344278,0.16890112520948,53.7161255483097,16.5343039974327,16.890112520948
2022-09-30,822878,405,592612,230,230266,175,641860,250,3087063,1149,3728923,1399,18,10627,0,18496,10659,2,"East TN",2455501,96.3550819160733,0.160800385728062,56.9741164837644,16.4935791107395,16.0800385728062
2022-10-01,822986,108,592684,72,230302,36,641938,78,3087575,512,3729513,590,0,10627,0,18496,10659,0,"East TN",2455501,96.4772565761529,0.162684729064039,24.0276831489786,4.39828776286387,16.2684729064039
2022-10-02,823094,108,592760,76,230334,32,642020,82,3088279,704,3730299,786,2,10629,0,18496,10660,1,"East TN",2455501,92.6898421136868,0.161466260781329,32.0097609408426,4.39828776286387,16.1466260781329
2022-10-03,823649,555,592962,202,230687,353,642234,214,3088999,720,3731233,934,11,10640,1,18497,10661,1,"East TN",2455501,101.364242979335,0.167210235825389,38.0370441714339,22.6023121147171,16.7210235825389
2022-10-04,823931,282,593114,152,230817,130,642392,158,3090462,1463,3732854,1621,2,10642,0,18497,10661,0,"East TN",2455501,94.3595624681073,0.148365056124939,66.0150413296513,11.4844180474779,14.8365056124939
2022-10-05,824319,388,593306,192,231013,196,642593,201,3091511,1049,3734104,1250,0,10642,1,18498,10662,1,"East TN",2455501,91.7124448330504,0.150651981263451,50.90610836648,15.8012560369554,15.0651981263451
2022-10-06,824787,468,593588,282,231199,186,642896,303,3092618,1107,3735514,1410,19,10661,1,18499,10662,0,"East TN",2455501,94.2373878080278,0.160951188986233,57.4220902373894,19.0592469724101,16.0951188986233
2022-10-07,825174,387,593828,240,231346,147,643152,256,3093965,1347,3737117,1603,6,10667,0,18499,10662,0,"East TN",2455501,93.5043398475505,0.157676348547718,65.281993369174,15.7605311502622,15.7676348547718
2022-10-08,825293,119,593891,63,231402,56,643220,68,3094698,733,3737918,801,0,10667,0,18499,10662,0,"East TN",2455501,93.9523136011755,0.152528256989887,32.6206342412404,4.8462615164889,15.2528256989887
